9826938,9982121,6402,2240700,12222821,22.45
9826939,9989931,4381,1533350,11523281,15.35
9826940,753364,357,124950,878314,16.59
9826941,9965080,2012,704200,10669280,7.07
9826942,9675191,353,123550,9798741,1.28
9826943,9953877,3735,1307250,11261127,13.13
9826944,9953272,5696,1993600,11946872,20.03
9826945,9948844,4681,1638350,11587194,16.47
9826946,9954455,3896,1363600,11318055,13.70
9826947,9943395,6184,2164400,12107795,21.77
9826948,9963870,5957,2084950,12048820,20.93
9826949,9952258,2024,708400,10660658,7.12
9826950,9968341,4254,1488900,11457241,14.94
9826951,9968981,3126,1094100,11063081,10.98
9826952,9949277,835,292250,10241527,2.94
9826953,9982428,2639,923650,10906078,9.25
9826954,9989942,3367,1178450,11168392,11.80
9826955,8971731,3429,1200150,10171881,13.38
9826956,9971196,1253,438550,10409746,4.40
9826957,9994765,4985,1744750,11739515,17.46
9826958,4532354,601,210350,4742704,4.64
9826959,9969511,1278,447300,10416811,4.49
9826960,890072,477,166950,1057022,18.76
9826961,1290409,850,297500,1587909,23.05
9826962,9962331,3393,1187550,11149881,11.92
9826963,9782670,3725,1303750,11086420,13.33
9826964,9962906,5054,1768900,11731806,17.75
9826965,9970939,4079,1427650,11398589,14.32
9826966,9972090,4668,1633800,11605890,16.38
9826967,3664833,672,235200,3900033,6.42
9826968,9954971,3371,1179850,11134821,11.85
9826969,9946936,2407,842450,10789386,8.47
9826970,9954913,2712,949200,10904113,9.53
9826971,9969435,4360,1526000,11495435,15.31
9826973,9975835,3832,1341200,11317035,13.44
9826974,9977953,3550,1242500,11220453,12.45
9826975,9981780,5438,1903300,11885080,19.07
9826976,9971124,1138,398300,10369424,3.99
9826977,9965346,4257,1489950,11455296,14.95
9826978,9951064,688,240800,10191864,2.42
9826979,9963392,1468,513800,10477192,5.16
9826980,1714192,999,349650,2063842,20.40
9826981,4237146,1536,537600,4774746,12.69
9826982,9983470,5550,1942500,11925970,19.46
9826983,9987473,2204,771400,10758873,7.72
9826984,9998309,1493,522550,10520859,5.23
9826985,9990259,2157,754950,10745209,7.56
9826986,9987087,5121,1792350,11779437,17.95
9826987,740372,451,157850,898222,21.32
9826988,9942345,2965,1037750,10980095,10.44
9826989,9972310,399,139650,10111960,1.40
9826990,9964556,1393,487550,10452106,4.89
9826991,9978019,3953,1383550,11361569,13.87
9826992,9951067,4850,1697500,11648567,17.06
9826993,9962836,5486,1920100,11882936,19.27
9826994,9976575,1364,477400,10453975,4.79
9826995,1639713,1018,356300,1996013,21.73
9826996,9932683,5683,1989050,11921733,20.03
9826997,9974710,4652,1628200,11602910,16.32
9826998,1419620,2176,761600,2181220,53.65
9826999,9952168,1093,382550,10334718,3.84
9827000,9942086,4298,1504300,11446386,15.13
9827001,9935681,7002,2450700,12386381,24.67
9827002,2587857,1020,357000,2944857,13.80
9827003,9986562,2925,1023750,11010312,10.25
9827004,9970070,2313,809550,10779620,8.12
9827005,9953222,4341,1519350,11472572,15.26
9827006,5039681,1899,664650,5704331,13.19
9827007,9948700,1714,599900,10548600,6.03
9827008,9911025,4258,1490300,11401325,15.04
9827009,9946466,3263,1142050,11088516,11.48
9827010,6562882,4805,1681750,8244632,25.63
9827011,9957867,5887,2060450,12018317,20.69
9827012,9966390,5125,1793750,11760140,18.00
9827013,9971630,4128,1444800,11416430,14.49
9827014,9981483,2245,785750,10767233,7.87
9827015,803032,985,344750,1147782,42.93
9827017,817597,356,124600,942197,15.24
9827018,9968856,5116,1790600,11759456,17.96
9827019,9975164,5599,1959650,11934814,19.65
9827021,9931775,5200,1820000,11751775,18.33
9827022,9952081,3953,1383550,11335631,13.90
9827023,9959365,5629,1970150,11929515,19.78
9827024,9979192,7002,2450700,12429892,24.56
9827025,9938533,2401,840350,10778883,8.46
9827026,9963747,3901,1365350,11329097,13.70
9827027,9972450,3057,1069950,11042400,10.73
9827028,9981326,3385,1184750,11166076,11.87
9827029,9979802,6395,2238250,12218052,22.43
9827030,9992764,3867,1353450,11346214,13.54
9827031,9977525,1492,522200,10499725,5.23
9827032,9971878,2929,1025150,10997028,10.28
9827033,9986752,2645,925750,10912502,9.27
9827034,9986873,3409,1193150,11180023,11.95
9827035,94384,92,32200,126584,34.12
9827036,3474697,2373,830550,4305247,23.90
9827037,9959058,5775,2021250,11980308,20.30
9827039,9978625,6038,2113300,12091925,21.18
9827040,9988378,3345,1170750,11159128,11.72
9827041,9970899,1580,553000,10523899,5.55
9827042,9964098,2855,999250,10963348,10.03
9827043,9959963,1722,602700,10562663,6.05
9827044,545423,323,113050,658473,20.73
9827045,9960776,2174,760900,10721676,7.64
9827046,9991011,5026,1759100,11750111,17.61
9827047,2973477,2489,871150,3844627,29.30
9827048,9983081,3982,1393700,11376781,13.96
9827049,449608,850,297500,747108,66.17
9827050,6843702,1265,442750,7286452,6.47
9827051,9988464,5369,1879150,11867614,18.81
9827052,3462621,3570,1249500,4712121,36.09
9827053,9980406,6275,2196250,12176656,22.01
9827054,9984848,3173,1110550,11095398,11.12
9827056,9979763,6296,2203600,12183363,22.08
9827057,9984933,4664,1632400,11617333,16.35
9827058,9977112,4631,1620850,11597962,16.25
9827059,9980415,4266,1493100,11473515,14.96
9827060,7883197,3632,1271200,9154397,16.13
9827061,128808,27,9450,138258,7.34
9827062,9961733,4456,1559600,11521333,15.66
9827064,9974309,4283,1499050,11473359,15.03
9827065,9976383,6111,2138850,12115233,21.44
9827066,9988004,4814,1684900,11672904,16.87
9827067,9979319,3373,1180550,11159869,11.83
9827068,1088718,738,258300,1347018,23.73
9827069,9961218,4553,1593550,11554768,16.00
9827070,9979845,3774,1320900,11300745,13.24
9827071,3134182,1515,530250,3664432,16.92
9827072,9967840,4377,1531950,11499790,15.37
9827073,9977458,5770,2019500,11996958,20.24
9827074,2734632,1485,519750,3254382,19.01
9827075,9990581,5015,1755250,11745831,17.57
9827076,9975149,5678,1987300,11962449,19.92
9827077,9990357,3254,1138900,11129257,11.40
9827078,9978702,4849,1697150,11675852,17.01
9827079,9958033,4449,1557150,11515183,15.64
9827080,9967326,5668,1983800,11951126,19.90
9827082,9963313,5747,2011450,11974763,20.19
9827083,9953853,5276,1846600,11800453,18.55
9827084,9961453,6005,2101750,12063203,21.10
9827085,9973075,4638,1623300,11596375,16.28
9827086,9971307,6693,2342550,12313857,23.49
9827087,3400212,2392,837200,4237412,24.62
9827088,9960146,7099,2484650,12444796,24.95
9827089,9964301,6824,2388400,12352701,23.97
9827090,9979865,3825,1338750,11318615,13.41
9827091,9960967,5826,2039100,12000067,20.47
9827092,9943120,5212,1824200,11767320,18.35
9827093,4246110,2995,1048250,5294360,24.69
9827094,9959282,5010,1753500,11712782,17.61
9827095,9970636,4419,1546650,11517286,15.51
9827096,9970665,5299,1854650,11825315,18.60
9827097,9970855,5859,2050650,12021505,20.57
9827098,9962681,7013,2454550,12417231,24.64
9827100,9957077,6375,2231250,12188327,22.41
9827101,9954210,1701,595350,10549560,5.98
9827102,9947889,5274,1845900,11793789,18.56
9827103,5158766,2914,1019900,6178666,19.77
9827104,9958603,6454,2258900,12217503,22.68
9827105,9962257,3043,1065050,11027307,10.69
9827106,9970333,4864,1702400,11672733,17.07
9827107,9975523,6604,2311400,12286923,23.17
9827108,9988523,5598,1959300,11947823,19.62
9827109,5999062,2723,953050,6952112,15.89
9827110,9982885,4170,1459500,11442385,14.62
9827111,2053427,1383,484050,2537477,23.57
9827112,9968042,5587,1955450,11923492,19.62
9827113,9975408,5767,2018450,11993858,20.23
9827114,9974169,7886,2760100,12734269,27.67
9827115,9989190,5256,1839600,11828790,18.42
9827116,9997034,5471,1914850,11911884,19.15
9827117,9981656,6069,2124150,12105806,21.28
9827118,9976008,3487,1220450,11196458,12.23
9827120,6385955,3430,1200500,7586455,18.80
9827121,9977991,5657,1979950,11957941,19.84
9827122,9971075,7240,2534000,12505075,25.41
9827123,9965883,2695,943250,10909133,9.46
9827124,9977278,6004,2101400,12078678,21.06
9827125,9969213,7584,2654400,12623613,26.63
9827126,9969846,5376,1881600,11851446,18.87
9827127,9961347,5626,1969100,11930447,19.77
9827128,9981106,7330,2565500,12546606,25.70
9827129,3575914,2388,835800,4411714,23.37
9827130,9979301,6411,2243850,12223151,22.49
9827131,9969382,6200,2170000,12139382,21.77
9827132,9998595,5190,1816500,11815095,18.17
9827133,2015701,1697,593950,2609651,29.47
9827134,9969944,6411,2243850,12213794,22.51
9827135,9969458,6772,2370200,12339658,23.77
9827136,2537695,2540,889000,3426695,35.03
9827137,9951886,5870,2054500,12006386,20.64
9827138,9931908,6205,2171750,12103658,21.87
9827140,1045331,205,71750,1117081,6.86
9827141,9936341,6182,2163700,12100041,21.78
9827142,9955557,6720,2352000,12307557,23.62
9827144,1469696,1768,618800,2088496,42.10
9827145,2101021,1077,376950,2477971,17.94
9827146,5531497,4869,1704150,7235647,30.81
9827147,6139178,3582,1253700,7392878,20.42
9827148,9955068,8852,3098200,13053268,31.12
9827149,9957064,6138,2148300,12105364,21.58
9827150,9966113,4272,1495200,11461313,15.00
9827151,9976395,6596,2308600,12284995,23.14
9827152,4902696,3668,1283800,6186496,26.19
9827153,9987563,6229,2180150,12167713,21.83
9827154,7165101,4254,1488900,8654001,20.78
9827155,9948411,4988,1745800,11694211,17.55
9827156,9993773,7598,2659300,12653073,26.61
9827157,9982176,5353,1873550,11855726,18.77
9827158,9988335,4408,1542800,11531135,15.45
9827159,9997807,3864,1352400,11350207,13.53
9827160,9975198,6516,2280600,12255798,22.86
9827161,7079856,6773,2370550,9450406,33.48
9827162,9964832,5497,1923950,11888782,19.31
9827163,9989242,6013,2104550,12093792,21.07
9827164,1651064,1981,693350,2344414,41.99
9827165,9975401,5010,1753500,11728901,17.58
9827166,9975472,7719,2701650,12677122,27.08
9827167,9955595,6030,2110500,12066095,21.20
9827168,9984578,2684,939400,10923978,9.41
9827169,9989307,4761,1666350,11655657,16.68
9827170,9985759,4954,1733900,11719659,17.36
9827171,9991600,5515,1930250,11921850,19.32
9827172,9973990,5582,1953700,11927690,19.59
9827173,9979659,4978,1742300,11721959,17.46
9827174,463344,213,74550,537894,16.09
9827175,7496707,4201,1470350,8967057,19.61
9827176,9978009,6641,2324350,12302359,23.29
9827177,9979553,7851,2747850,12727403,27.53
9827178,9948248,4248,1486800,11435048,14.95
9827180,9969526,7062,2471700,12441226,24.79
9827181,1189962,499,174650,1364612,14.68
9827182,9961672,3115,1090250,11051922,10.94
9827183,9984520,4611,1613850,11598370,16.16
9827185,9975682,5762,2016700,11992382,20.22
9827186,9981775,5304,1856400,11838175,18.60
9827187,9980288,6318,2211300,12191588,22.16
9827188,9984963,6148,2151800,12136763,21.55
9827189,9987073,3403,1191050,11178123,11.93
9827190,9993495,3860,1351000,11344495,13.52
9827191,9686224,5519,1931650,11617874,19.94
9827192,9983857,3836,1342600,11326457,13.45
9827193,2528599,868,303800,2832399,12.01
9827194,1735266,1525,533750,2269016,30.76
9827195,9990020,6574,2300900,12290920,23.03
9827196,9993210,3732,1306200,11299410,13.07
9827197,9979450,2603,911050,10890500,9.13
9827198,9622243,4177,1461950,11084193,15.19
9827199,7221731,3519,1231650,8453381,17.05
9827200,9977016,7273,2545550,12522566,25.51
9827201,9987086,3590,1256500,11243586,12.58
9827202,9992356,4003,1401050,11393406,14.02
9827203,9983073,5902,2065700,12048773,20.69
9827204,491350,300,105000,596350,21.37
9827205,9971181,6125,2143750,12114931,21.50
9827206,9989338,5624,1968400,11957738,19.71
9827207,9988321,3928,1374800,11363121,13.76
9827208,9985882,6248,2186800,12172682,21.90
9827209,9976584,3813,1334550,11311134,13.38
9827210,4459534,2997,1048950,5508484,23.52
9827211,9951419,5605,1961750,11913169,19.71
9827212,9883668,3922,1372700,11256368,13.89
9827213,9954287,6680,2338000,12292287,23.49
9827214,9941736,4765,1667750,11609486,16.78
9827215,9934325,2960,1036000,10970325,10.43
9827216,9949516,5302,1855700,11805216,18.65
9827217,2369579,1154,403900,2773479,17.05
9827218,9944891,5620,1967000,11911891,19.78
9827219,268808,94,32900,301708,12.24
9827220,9946217,7760,2716000,12662217,27.31
9827221,1456603,1433,501550,1958153,34.43
9827222,3915484,2238,783300,4698784,20.01
9827223,9969689,6501,2275350,12245039,22.82
9827224,9955523,6413,2244550,12200073,22.55
9827225,9890352,6222,2177700,12068052,22.02
9827226,9944763,5713,1999550,11944313,20.11
9827227,9779741,2659,930650,10710391,9.52
9827228,9938423,5674,1985900,11924323,19.98
9827229,9927777,5855,2049250,11977027,20.64
9827230,9579087,4259,1490650,11069737,15.56
9827233,9957577,3291,1151850,11109427,11.57
9827234,9968642,6529,2285150,12253792,22.92
9827235,9956719,7646,2676100,12632819,26.88
9827236,9959536,9060,3171000,13130536,31.84
9827237,9974256,5529,1935150,11909406,19.40
9827238,9874912,7211,2523850,12398762,25.56
9827239,7016543,1299,454650,7471193,6.48
9827240,9976558,5511,1928850,11905408,19.33
9827241,9986949,8008,2802800,12789749,28.06
9827242,9992556,6182,2163700,12156256,21.65
9827243,9990166,3115,1090250,11080416,10.91
9827245,9965940,5175,1811250,11777190,18.17
9827246,9899496,5668,1983800,11883296,20.04
9827247,9943952,2630,920500,10864452,9.26
9827248,9969130,5594,1957900,11927030,19.64
9827249,143010,51,17850,160860,12.48
9827250,9962933,3816,1335600,11298533,13.41
9827251,9960393,5586,1955100,11915493,19.63
9827252,4187086,1971,689850,4876936,16.48
9827253,9973961,7308,2557800,12531761,25.64
9827254,9830105,4223,1478050,11308155,15.04
9827255,667679,395,138250,805929,20.71
9827256,9982152,5769,2019150,12001302,20.23
9827257,9957697,5042,1764700,11722397,17.72
9827258,645394,380,133000,778394,20.61
9827259,2656275,803,281050,2937325,10.58
9827260,9955654,3179,1112650,11068304,11.18
9827261,4992915,2508,877800,5870715,17.58
9827262,9705789,5657,1979950,11685739,20.40
9827263,456933,322,112700,569633,24.66
9827264,9969339,5303,1856050,11825389,18.62
9827265,9954523,4417,1545950,11500473,15.53
9827266,9966649,4661,1631350,11597999,16.37
9827267,9977312,932,326200,10303512,3.27
9827268,2772137,1231,430850,3202987,15.54
9827269,9958109,7312,2559200,12517309,25.70
9827271,9982392,5052,1768200,11750592,17.71
9827272,9980871,7022,2457700,12438571,24.62
9827273,9992260,1568,548800,10541060,5.49
9827274,1130577,307,107450,1238027,9.50
9827275,9978080,6338,2218300,12196380,22.23
9827276,749686,266,93100,842786,12.42
9827277,9956519,4114,1439900,11396419,14.46
9827278,65654,60,21000,86654,31.99
9827279,9936251,3365,1177750,11114001,11.85
9827280,9949597,4142,1449700,11399297,14.57
9827281,9961168,4564,1597400,11558568,16.04
9827282,9952538,6010,2103500,12056038,21.14
9827283,9934568,4779,1672650,11607218,16.84
9827284,1759030,2019,706650,2465680,40.17
9827285,9976286,4144,1450400,11426686,14.54
9827286,1205215,678,237300,1442515,19.69
9827287,9979609,2063,722050,10701659,7.24
9827288,9969090,4890,1711500,11680590,17.17
9827289,9962732,320,112000,10074732,1.12
9827290,9982033,6716,2350600,12332633,23.55
9827291,5541917,4970,1739500,7281417,31.39
9827292,9957251,5475,1916250,11873501,19.24
9827293,9968620,4611,1613850,11582470,16.19
9827294,9981772,6874,2405900,12387672,24.10
9827295,9980654,7248,2536800,12517454,25.42
9827296,9979604,4742,1659700,11639304,16.63
9827297,9990913,6266,2193100,12184013,21.95
9827298,4659299,3115,1090250,5749549,23.40
9827299,9862712,8194,2867900,12730612,29.08
9827300,9987508,1582,553700,10541208,5.54
9827301,4316063,4449,1557150,5873213,36.08
9827302,9978464,5780,2023000,12001464,20.27
9827303,9975469,2707,947450,10922919,9.50
9827304,9970003,3657,1279950,11249953,12.84
9827305,97382,42,14700,112082,15.10
9827306,9961662,3189,1116150,11077812,11.20
9827307,9943155,4962,1736700,11679855,17.47
9827308,9969661,4770,1669500,11639161,16.75
9827309,9984375,6139,2148650,12133025,21.52
9827310,9950198,3901,1365350,11315548,13.72
9827311,966609,444,155400,1122009,16.08
9827312,1569621,441,154350,1723971,9.83
9827313,9957988,1720,602000,10559988,6.05
9827314,9960285,3621,1267350,11227635,12.72
9827315,9944812,4388,1535800,11480612,15.44
9827316,9948339,1345,470750,10419089,4.73
9827317,9947530,3291,1151850,11099380,11.58
9827318,8600858,3088,1080800,9681658,12.57
9827319,9969724,4827,1689450,11659174,16.95
9827320,9960406,5779,2022650,11983056,20.31
9827321,9956508,5305,1856750,11813258,18.65
9827322,9965076,5858,2050300,12015376,20.57
9827324,9956870,3577,1251950,11208820,12.57
9827325,293509,197,68950,362459,23.49
9827326,9958999,1719,601650,10560649,6.04
9827327,9973372,4404,1541400,11514772,15.46
9827328,9969649,1796,628600,10598249,6.31
9827329,9993341,784,274400,10267741,2.75
9827330,9964830,5172,1810200,11775030,18.17
9827331,9971377,5554,1943900,11915277,19.49
9827332,9968740,7589,2656150,12624890,26.64
9827333,9951074,4867,1703450,11654524,17.12
9827334,9945100,6151,2152850,12097950,21.65
9827335,2027538,538,188300,2215838,9.29
9827336,9955559,5357,1874950,11830509,18.83
9827337,9948116,4760,1666000,11614116,16.75
9827339,9946224,7469,2614150,12560374,26.28
9827340,9973550,8122,2842700,12816250,28.50
9827341,9969734,6722,2352700,12322434,23.60
9827342,9973276,3006,1052100,11025376,10.55
9827343,1406459,1413,494550,1901009,35.16
9827344,9963803,4478,1567300,11531103,15.73
9827345,9960026,5827,2039450,11999476,20.48
9827346,5484329,4964,1737400,7221729,31.68
9827347,9979923,4228,1479800,11459723,14.83
9827348,6204004,3622,1267700,7471704,20.43
9827349,9994847,6289,2201150,12195997,22.02
9827350,9978539,4749,1662150,11640689,16.66
9827351,9958850,1731,605850,10564700,6.08
9827352,9968738,5325,1863750,11832488,18.70
9827353,9963857,8360,2926000,12889857,29.37
9827354,9966932,5340,1869000,11835932,18.75
9827355,9971636,1957,684950,10656586,6.87
9827356,9980723,4249,1487150,11467873,14.90
9827357,9971131,3462,1211700,11182831,12.15
9827358,721798,472,165200,886998,22.89
9827359,9972424,5650,1977500,11949924,19.83
9827360,9983732,6143,2150050,12133782,21.54
9827361,9976356,4802,1680700,11657056,16.85
9827362,9988120,5523,1933050,11921170,19.35
9827363,9987820,4723,1653050,11640870,16.55
9827364,9479080,5386,1885100,11364180,19.89
9827365,9992954,2494,872900,10865854,8.74
9827366,9975405,5304,1856400,11831805,18.61
9827367,9988810,5504,1926400,11915210,19.29
9827368,1143655,175,61250,1204905,5.36
9827369,9983454,3392,1187200,11170654,11.89
9827370,9977428,997,348950,10326378,3.50
9827371,3350489,1699,594650,3945139,17.75
9827372,9964210,4313,1509550,11473760,15.15
9827373,9967874,5427,1899450,11867324,19.06
9827374,538475,833,291550,830025,54.14
9827375,9954074,286,100100,10054174,1.01
9827376,340734,353,123550,464284,36.26
9827377,9963103,5593,1957550,11920653,19.65
9827378,9965243,5636,1972600,11937843,19.79
9827379,9955541,780,273000,10228541,2.74
9827380,9974969,7391,2586850,12561819,25.93
9827381,48074,35,12250,60324,25.48
9827382,9965403,1472,515200,10480603,5.17
9827383,9960935,5621,1967350,11928285,19.75
9827384,9979941,5167,1808450,11788391,18.12
9827385,9988070,7196,2518600,12506670,25.22
9827386,9977808,4009,1403150,11380958,14.06
9827387,2248601,1743,610050,2858651,27.13
9827388,9963780,4765,1667750,11631530,16.74
9827389,9976109,5399,1889650,11865759,18.94
9827390,9973802,7599,2659650,12633452,26.67
9827391,9971401,5205,1821750,11793151,18.27
9827392,9964883,1054,368900,10333783,3.70
9827393,9969254,1605,561750,10531004,5.63
9827394,9968156,2099,734650,10702806,7.37
9827395,9973334,1157,404950,10378284,4.06
9827396,9982204,2836,992600,10974804,9.94
9827397,9984783,5779,2022650,12007433,20.26
9827398,9983998,4565,1597750,11581748,16.00
9827399,6057873,3854,1348900,7406773,22.27
9827400,421393,433,151550,572943,35.96
9827401,9977905,7361,2576350,12554255,25.82
9827402,9994529,5788,2025800,12020329,20.27
9827403,9995000,6943,2430050,12425050,24.31
9827404,9983730,1438,503300,10487030,5.04
9827405,9990709,774,270900,10261609,2.71
9827406,9984844,2748,961800,10946644,9.63
9827407,9995699,1396,488600,10484299,4.89
9827408,9996325,4621,1617350,11613675,16.18
9827409,9993324,715,250250,10243574,2.50
9827410,9988930,2643,925050,10913980,9.26
9827411,4475825,1315,460250,4936075,10.28
9827412,9479008,896,313600,9792608,3.31
9827413,9970261,2117,740950,10711211,7.43
9827414,9959544,2883,1009050,10968594,10.13
9827415,1339267,466,163100,1502367,12.18
9827416,9966115,3885,1359750,11325865,13.64
9827417,9973613,2948,1031800,11005413,10.35
9827418,9978909,4906,1717100,11696009,17.21
9827419,9986192,7606,2662100,12648292,26.66
9827420,9976080,4826,1689100,11665180,16.93
9827421,9978761,5094,1782900,11761661,17.87
9827422,9973189,3646,1276100,11249289,12.80
9827423,9973751,3832,1341200,11314951,13.45
9827424,9977996,4535,1587250,11565246,15.91
9827425,997373,171,59850,1057223,6.00
9827426,9994053,5416,1895600,11889653,18.97
9827427,9981428,6764,2367400,12348828,23.72
9827428,9979664,7556,2644600,12624264,26.50
9827429,9984872,4976,1741600,11726472,17.44
9827430,9985233,2022,707700,10692933,7.09
9827431,9990507,4984,1744400,11734907,17.46
9827432,9993741,7034,2461900,12455641,24.63
9827433,9979601,9035,3162250,13141851,31.69
9827434,9985038,847,296450,10281488,2.97
9827435,9991114,5523,1933050,11924164,19.35
9827436,9998581,854,298900,10297481,2.99
9827437,9989530,2075,726250,10715780,7.27
9827438,9987305,1852,648200,10635505,6.49
9827439,4646588,2055,719250,5365838,15.48
9827440,9822062,6265,2192750,12014812,22.32
9827441,9979579,6565,2297750,12277329,23.02
9827442,9905563,3857,1349950,11255513,13.63
9827443,9969619,5633,1971550,11941169,19.78
9827444,9982619,2254,788900,10771519,7.90
9827447,9882751,3149,1102150,10984901,11.15
9827448,9956384,5051,1767850,11724234,17.76
9827449,9966672,4768,1668800,11635472,16.74
9827450,9982048,5120,1792000,11774048,17.95
9827451,9981767,4766,1668100,11649867,16.71
9827452,2427073,1489,521150,2948223,21.47
9827453,9957911,4777,1671950,11629861,16.79
9827454,9967261,4880,1708000,11675261,17.14
9827455,9980939,5615,1965250,11946189,19.69
9827456,9993188,4800,1680000,11673188,16.81
9827457,9987257,3233,1131550,11118807,11.33
9827458,9981894,4191,1466850,11448744,14.70
9827459,9975361,7344,2570400,12545761,25.77
9827461,7640217,2186,765100,8405317,10.01
9827462,9976374,7915,2770250,12746624,27.77
9827463,9976049,6084,2129400,12105449,21.35
9827464,9987899,7584,2654400,12642299,26.58
9827465,9991182,5390,1886500,11877682,18.88
9827466,9842658,6491,2271850,12114508,23.08
9827467,9997133,5379,1882650,11879783,18.83
9827468,766657,68,23800,790457,3.10
9827469,9969103,6681,2338350,12307453,23.46
9827470,2093870,525,183750,2277620,8.78
9827472,9963766,3938,1378300,11342066,13.83
9827473,9966282,8068,2823800,12790082,28.33
9827474,9984009,1892,662200,10646209,6.63
9827475,9990979,1759,615650,10606629,6.16
9827476,9971223,1308,457800,10429023,4.59
9827477,9974380,2388,835800,10810180,8.38
9827478,9999169,2575,901250,10900419,9.01
9827479,7674350,3591,1256850,8931200,16.38
9827480,9991470,6104,2136400,12127870,21.38
9827481,9989128,4067,1423450,11412578,14.25
9827482,9401573,1198,419300,9820873,4.46
9827483,9994327,2776,971600,10965927,9.72
9827484,9989439,3507,1227450,11216889,12.29
9827485,9364595,5338,1868300,11232895,19.95
9827486,9988154,6222,2177700,12165854,21.80
9827487,9986849,6433,2251550,12238399,22.55
9827488,3755759,2032,711200,4466959,18.94
9827489,9971965,4278,1497300,11469265,15.02
9827490,3352209,3188,1115800,4468009,33.29
9827491,9962974,6400,2240000,12202974,22.48
9827492,3473716,1966,688100,4161816,19.81
9827493,3301384,1602,560700,3862084,16.98
9827494,9929289,561,196350,10125639,1.98
9827495,9915987,3735,1307250,11223237,13.18
9827496,9916239,1935,677250,10593489,6.83
9827497,9921698,3519,1231650,11153348,12.41
9827498,9918598,4311,1508850,11427448,15.21
9827499,4782612,137,47950,4830562,1.00
9827500,9920486,2643,925050,10845536,9.32
9827501,9940053,2253,788550,10728603,7.93
9827503,9939358,1292,452200,10391558,4.55
9827504,9811020,5871,2054850,11865870,20.94
9827505,9930176,2166,758100,10688276,7.63
9827506,9949020,2879,1007650,10956670,10.13
9827507,9957126,3804,1331400,11288526,13.37
9827508,9926654,7104,2486400,12413054,25.05
9827509,9940144,3583,1254050,11194194,12.62
9827510,9952399,4897,1713950,11666349,17.22
9827511,9956126,5343,1870050,11826176,18.78
9827512,166813,231,80850,247663,48.47
9827513,9966857,3749,1312150,11279007,13.17
9827514,9953393,5385,1884750,11838143,18.94
9827515,9984406,7260,2541000,12525406,25.45
9827516,9987050,5874,2055900,12042950,20.59
9827517,9978682,1726,604100,10582782,6.05
9827518,9992714,5815,2035250,12027964,20.37
9827519,3823038,2780,973000,4796038,25.45
9827520,9965204,2257,789950,10755154,7.93
9827521,9965704,884,309400,10275104,3.10
9827522,9992149,4071,1424850,11416999,14.26
9827523,8948490,6118,2141300,11089790,23.93
9827524,9931183,4582,1603700,11534883,16.15
9827525,9986675,6242,2184700,12171375,21.88
9827526,7729168,7159,2505650,10234818,32.42
9827527,3123427,1728,604800,3728227,19.36
9827528,9988636,6993,2447550,12436186,24.50
9827529,9973321,6983,2444050,12417371,24.51
9827530,9969571,5626,1969100,11938671,19.75
9827531,9983067,1260,441000,10424067,4.42
9827532,9985725,5247,1836450,11822175,18.39
9827533,9992856,6085,2129750,12122606,21.31
9827534,9993027,7981,2793350,12786377,27.95
9827535,9988463,6269,2194150,12182613,21.97
9827536,9984679,4819,1686650,11671329,16.89
9827537,9979945,5610,1963500,11943445,19.67
9827538,9993983,3765,1317750,11311733,13.19
9827539,2784037,2841,994350,3778387,35.72
9827540,9991774,7819,2736650,12728424,27.39
9827541,9972752,7706,2697100,12669852,27.04
9827542,749082,639,223650,972732,29.86
9827543,171095,82,28700,199795,16.77
9827544,9955634,5528,1934800,11890434,19.43
9827545,9975223,6346,2221100,12196323,22.27
9827546,9978017,2406,842100,10820117,8.44
9827547,9983889,3560,1246000,11229889,12.48
9827548,9965988,6553,2293550,12259538,23.01
9827549,9984968,3152,1103200,11088168,11.05
9827550,9967332,1232,431200,10398532,4.33
9827551,9979653,2104,736400,10716053,7.38
9827552,9938445,4446,1556100,11494545,15.66
9827553,9966696,5069,1774150,11740846,17.80
9827554,9957725,3256,1139600,11097325,11.44
9827555,9970220,4524,1583400,11553620,15.88
9827556,9903869,3805,1331750,11235619,13.45
9827557,9979878,6448,2256800,12236678,22.61
9827558,9993345,4821,1687350,11680695,16.88
9827559,9981438,9115,3190250,13171688,31.96
9827560,9987506,5662,1981700,11969206,19.84
9827561,9989584,5972,2090200,12079784,20.92
9827562,9965178,3447,1206450,11171628,12.11
9827563,9979995,5802,2030700,12010695,20.35
9827564,9983952,5937,2077950,12061902,20.81
9827565,2830623,570,199500,3030123,7.05
9827566,9968308,5980,2093000,12061308,21.00
9827567,9716149,6502,2275700,11991849,23.42
9827568,9994528,7182,2513700,12508228,25.15
9827569,4521354,697,243950,4765304,5.40
9827570,9963448,7904,2766400,12729848,27.77
9827571,9964509,4258,1490300,11454809,14.96
9827572,4513113,1836,642600,5155713,14.24
9827573,9975916,3870,1354500,11330416,13.58
9827574,9972858,2123,743050,10715908,7.45
9827575,9990487,5207,1822450,11812937,18.24
9827576,9958010,3521,1232350,11190360,12.38
9827577,9989898,5265,1842750,11832648,18.45
9827578,9983386,5099,1784650,11768036,17.88
9827579,9977211,5048,1766800,11744011,17.71
9827580,9980709,5827,2039450,12020159,20.43
9827581,9973337,5589,1956150,11929487,19.61
9827582,9985416,2539,888650,10874066,8.90
9827583,4025128,741,259350,4284478,6.44
9827584,9980111,4961,1736350,11716461,17.40
9827585,9989377,5140,1799000,11788377,18.01
9827586,1453151,863,302050,1755201,20.79
9827587,4618524,646,226100,4844624,4.90
9827588,9973916,2897,1013950,10987866,10.17
9827589,9953458,3684,1289400,11242858,12.95
9827590,9979286,4679,1637650,11616936,16.41
9827591,9986939,7202,2520700,12507639,25.24
9827592,9987536,4675,1636250,11623786,16.38
9827593,9978863,3607,1262450,11241313,12.65
9827594,2135142,555,194250,2329392,9.10
9827595,9957448,5281,1848350,11805798,18.56
9827596,9967892,2043,715050,10682942,7.17
9827597,9962678,2894,1012900,10975578,10.17
9827598,9985502,4506,1577100,11562602,15.79
9827599,9999651,3605,1261750,11261401,12.62
9827600,9997135,1572,550200,10547335,5.50
9827601,9981210,3831,1340850,11322060,13.43
9827602,3794909,3918,1371300,5166209,36.14
9827603,8693441,5497,1923950,10617391,22.13
9827605,4623066,2979,1042650,5665716,22.55
9827606,3316552,1742,609700,3926252,18.38
9827607,9982885,4887,1710450,11693335,17.13
9827608,9988245,4908,1717800,11706045,17.20
9827609,9987741,3737,1307950,11295691,13.10
9827610,9983796,5427,1899450,11883246,19.03
9827611,9980484,5561,1946350,11926834,19.50
9827612,9974139,5838,2043300,12017439,20.49
9827613,9994171,4452,1558200,11552371,15.59
9827614,9980096,5332,1866200,11846296,18.70
9827615,9973920,5499,1924650,11898570,19.30
9827616,9962721,7047,2466450,12429171,24.76
9827617,5746377,4315,1510250,7256627,26.28
9827618,9955778,7022,2457700,12413478,24.69
9827619,9967229,4883,1709050,11676279,17.15
9827620,4469488,2702,945700,5415188,21.16
9827621,9961485,5562,1946700,11908185,19.54
9827622,2186013,193,67550,2253563,3.09
9827623,9974046,5686,1990100,11964146,19.95
9827624,9955183,3330,1165500,11120683,11.71
9827625,4719605,2475,866250,5585855,18.35
9827626,9957848,4465,1562750,11520598,15.69
9827627,9970795,3987,1395450,11366245,14.00
9827628,9950564,2309,808150,10758714,8.12
9827629,9956045,3793,1327550,11283595,13.33
9827630,9959518,4788,1675800,11635318,16.83
9827631,9987676,3679,1287650,11275326,12.89
9827632,9985558,6237,2182950,12168508,21.86
9827633,9978571,6240,2184000,12162571,21.89
9827634,9969037,4954,1733900,11702937,17.39
9827635,9985410,4675,1636250,11621660,16.39
9827636,9983314,3296,1153600,11136914,11.56
9827638,9985707,5983,2094050,12079757,20.97
9827639,9999450,3700,1295000,11294450,12.95
9827640,9980375,4536,1587600,11567975,15.91
9827641,9982138,5505,1926750,11908888,19.30
9827642,9991765,4908,1717800,11709565,17.19
9827643,9984884,5036,1762600,11747484,17.65
9827644,9982479,4809,1683150,11665629,16.86
9827645,9993913,4444,1555400,11549313,15.56
9827646,9996311,3297,1153950,11150261,11.54
9827647,9975087,2847,996450,10971537,9.99
9827648,9975476,4681,1638350,11613826,16.42
9827649,9985301,5730,2005500,11990801,20.08
9827650,9983462,5939,2078650,12062112,20.82
9827651,9990938,5688,1990800,11981738,19.93
9827652,9989738,5724,2003400,11993138,20.05
9827653,9972109,8928,3124800,13096909,31.34
9827654,9973673,7852,2748200,12721873,27.55
9827655,5534289,1565,547750,6082039,9.90
9827656,9988145,6035,2112250,12100395,21.15
9827657,9979070,6885,2409750,12388820,24.15
9827658,9984236,6152,2153200,12137436,21.57
9827659,9987382,6975,2441250,12428632,24.44
9827660,9980497,5410,1893500,11873997,18.97
9827661,9993474,6796,2378600,12372074,23.80
9827662,9957690,2576,901600,10859290,9.05
9827663,9966063,2815,985250,10951313,9.89
9827664,9958115,5178,1812300,11770415,18.20
9827665,9963627,2719,951650,10915277,9.55
9827666,9966526,5538,1938300,11904826,19.45
9827667,9988304,5209,1823150,11811454,18.25
9827668,5280589,2566,898100,6178689,17.01
9827669,9979124,4233,1481550,11460674,14.85
9827670,9983694,4368,1528800,11512494,15.31
9827671,9976809,7490,2621500,12598309,26.28
9827672,9951687,3669,1284150,11235837,12.90
9827673,297919,105,36750,334669,12.34
9827674,4118590,814,284900,4403490,6.92
9827675,9951763,4594,1607900,11559663,16.16
9827676,9982503,4833,1691550,11674053,16.95
9827677,9654976,3638,1273300,10928276,13.19
9827678,9985383,3553,1243550,11228933,12.45
9827679,3786925,762,266700,4053625,7.04
9827680,9969496,4838,1693300,11662796,16.98
9827681,9944463,2618,916300,10860763,9.21
9827682,9963408,3509,1228150,11191558,12.33
9827684,9962553,6973,2440550,12403103,24.50
9827685,9949611,4234,1481900,11431511,14.89
9827686,9818630,405,141750,9960380,1.44
9827687,9977591,6174,2160900,12138491,21.66
9827688,3751327,150,52500,3803827,1.40
9827690,5351876,4138,1448300,6800176,27.06
9827691,9980513,5249,1837150,11817663,18.41
9827692,9807727,2400,840000,10647727,8.56
9827693,9995997,5705,1996750,11992747,19.98
9827694,9975953,3923,1373050,11349003,13.76
9827695,9993262,4488,1570800,11564062,15.72
9827696,9985463,4007,1402450,11387913,14.04
9827697,9974038,6041,2114350,12088388,21.20
9827698,9970189,6594,2307900,12278089,23.15
9827699,8427076,2062,721700,9148776,8.56
9827700,9977149,5080,1778000,11755149,17.82
9827701,9973320,5515,1930250,11903570,19.35
9827702,9973132,3668,1283800,11256932,12.87
9827703,9978471,5521,1932350,11910821,19.37
9827704,9977366,4311,1508850,11486216,15.12
9827705,9972709,6239,2183650,12156359,21.90
9827706,9988428,5508,1927800,11916228,19.30
9827707,9995179,5671,1984850,11980029,19.86
9827708,6594248,863,302050,6896298,4.58
9827709,7502212,3126,1094100,8596312,14.58
9827710,9775023,6125,2143750,11918773,21.93
9827711,9971051,4331,1515850,11486901,15.20
9827712,9947156,7533,2636550,12583706,26.51
9827713,9625821,4397,1538950,11164771,15.99
9827714,9845205,3073,1075550,10920755,10.92
9827715,1873910,666,233100,2107010,12.44
9827716,9979226,3922,1372700,11351926,13.76
9827717,9974277,3585,1254750,11229027,12.58
9827718,6698941,4394,1537900,8236841,22.96
9827719,9963865,4189,1466150,11430015,14.71
9827720,9971159,5872,2055200,12026359,20.61
9827721,9975761,5193,1817550,11793311,18.22
9827722,9986981,5134,1796900,11783881,17.99
9827723,9981920,4037,1412950,11394870,14.16
9827724,9946216,7237,2532950,12479166,25.47
9827725,9971051,5538,1938300,11909351,19.44
9827726,9982994,6206,2172100,12155094,21.76
9827727,9994521,10315,3610250,13604771,36.12
9827728,9984362,3272,1145200,11129562,11.47
9827729,9983611,7831,2740850,12724461,27.45
9827730,9987224,1975,691250,10678474,6.92
9827731,9993965,6751,2362850,12356815,23.64
9827732,9978763,6506,2277100,12255863,22.82
9827733,9990175,3532,1236200,11226375,12.37
9827734,9978295,7801,2730350,12708645,27.36
9827735,9971608,5296,1853600,11825208,18.59
9827736,9653235,1586,555100,10208335,5.75
9827737,223871,176,61600,285471,27.52
9827738,8107855,2038,713300,8821155,8.80
9827739,9980890,3723,1303050,11283940,13.06
9827740,9982409,5630,1970500,11952909,19.74
9827741,9960295,3572,1250200,11210495,12.55
9827742,9986226,4617,1615950,11602176,16.18
9827743,9991123,6818,2386300,12377423,23.88
9827744,9998966,5437,1902950,11901916,19.03
9827745,9999689,2899,1014650,11014339,10.15
9827746,9995997,5285,1849750,11845747,18.50
9827747,9984912,9581,3353350,13338262,33.58
9827748,9991083,5264,1842400,11833483,18.44
9827750,9976303,7038,2463300,12439603,24.69
9827751,9315260,4665,1632750,10948010,17.53
9827752,9972972,5586,1955100,11928072,19.60
9827753,8168987,1679,587650,8756637,7.19
9827754,9978734,4660,1631000,11609734,16.34
9827755,9959147,5718,2001300,11960447,20.10
9827756,9973068,3723,1303050,11276118,13.07
9827757,9929402,5983,2094050,12023452,21.09
9827758,9966546,4891,1711850,11678396,17.18
9827759,9966754,5093,1782550,11749304,17.88
9827760,9979458,3009,1053150,11032608,10.55
9827761,9917342,1442,504700,10422042,5.09
9827762,9982308,5200,1820000,11802308,18.23
9827763,9847842,5961,2086350,11934192,21.19
9827764,9988180,6925,2423750,12411930,24.27
9827765,9992334,4663,1632050,11624384,16.33
9827766,9978394,5449,1907150,11885544,19.11
9827767,9989668,4485,1569750,11559418,15.71
9827768,4407640,1491,521850,4929490,11.84
9827769,9983043,3598,1259300,11242343,12.61
9827770,9960981,5898,2064300,12025281,20.72
9827771,8913326,3815,1335250,10248576,14.98
9827772,9977427,5654,1978900,11956327,19.83
9827773,9258071,4227,1479450,10737521,15.98
9827774,9971595,3399,1189650,11161245,11.93
9827775,9984203,4092,1432200,11416403,14.34
9827776,9981385,4013,1404550,11385935,14.07
9827777,9956550,5445,1905750,11862300,19.14
9827778,9975713,4023,1408050,11383763,14.11
9827779,9987651,7356,2574600,12562251,25.78
9827780,9899540,4016,1405600,11305140,14.20
9827781,9972504,5680,1988000,11960504,19.93
9827782,6339798,1229,430150,6769948,6.78
9827783,9989840,6982,2443700,12433540,24.46
9827784,9981192,4220,1477000,11458192,14.80
9827785,9980351,6062,2121700,12102051,21.26
9827786,9970080,5333,1866550,11836630,18.72
9827787,9926498,4854,1698900,11625398,17.11
9827788,9983447,4042,1414700,11398147,14.17
9827789,8446289,2626,919100,9365389,10.88
9827790,9963383,7623,2668050,12631433,26.78
9827791,9972858,4138,1448300,11421158,14.52
9827792,9953701,2765,967750,10921451,9.72
9827793,9972667,4131,1445850,11418517,14.50
9827794,9890166,4807,1682450,11572616,17.01
9827795,9976138,4035,1412250,11388388,14.16
9827796,9979011,5324,1863400,11842411,18.67
9827797,9979389,2757,964950,10944339,9.67
9827798,9974496,5511,1928850,11903346,19.34
9827799,9980104,4260,1491000,11471104,14.94
9827800,9987064,4177,1461950,11449014,14.64
9827801,9992399,4382,1533700,11526099,15.35
9827802,9967478,4535,1587250,11554728,15.92
9827803,9962306,4489,1571150,11533456,15.77
9827804,9969205,5521,1932350,11901555,19.38
9827805,9979602,4390,1536500,11516102,15.40
9827806,9986068,6247,2186450,12172518,21.90
9827807,2940744,450,157500,3098244,5.36
9827808,7899578,4185,1464750,9364328,18.54
9827809,9674620,1462,511700,10186320,5.29
9827810,9977365,5249,1837150,11814515,18.41
9827811,9985350,3886,1360100,11345450,13.62
9827812,9987384,5399,1889650,11877034,18.92
9827813,9998172,5957,2084950,12083122,20.85
9827814,9810867,2059,720650,10531517,7.35
9827815,9975834,1373,480550,10456384,4.82
9827816,9971906,3074,1075900,11047806,10.79
9827817,1776218,499,174650,1950868,9.83
9827818,9954486,5700,1995000,11949486,20.04
9827819,8532892,3877,1356950,9889842,15.90
9827820,9964564,3358,1175300,11139864,11.79
9827821,9950635,2708,947800,10898435,9.53
9827822,609730,315,110250,719980,18.08
9827823,9901133,3540,1239000,11140133,12.51
9827824,1179020,490,171500,1350520,14.55
9827825,9928086,3125,1093750,11021836,11.02
9827827,9809396,2457,859950,10669346,8.77
9827828,9948709,3150,1102500,11051209,11.08
9827829,697754,44,15400,713154,2.21
9827830,9941472,3891,1361850,11303322,13.70
9827831,9946285,6811,2383850,12330135,23.97
9827832,9951997,7889,2761150,12713147,27.74
9827833,9944204,3706,1297100,11241304,13.04
9827834,9871975,6728,2354800,12226775,23.85
9827835,5433181,1866,653100,6086281,12.02
9827836,810498,512,179200,989698,22.11
9827837,9934895,3485,1219750,11154645,12.28
9827838,9935883,1965,687750,10623633,6.92
9827839,9824803,5363,1877050,11701853,19.11
9827840,9925770,2091,731850,10657620,7.37
9827841,9915969,4784,1674400,11590369,16.89
9827842,9929780,4170,1459500,11389280,14.70
9827843,9918684,3832,1341200,11259884,13.52
9827844,9913601,3640,1274000,11187601,12.85
9827845,9935873,4122,1442700,11378573,14.52
9827846,9937804,4351,1522850,11460654,15.32
9827847,9948073,4828,1689800,11637873,16.99
9827848,9945243,4464,1562400,11507643,15.71
9827850,9946020,4531,1585850,11531870,15.94
9827851,9947513,2341,819350,10766863,8.24
9827852,93362,76,26600,119962,28.49
9827853,9926801,2940,1029000,10955801,10.37
9827854,9928854,2553,893550,10822404,9.00
9827855,9935062,3927,1374450,11309512,13.83
9827857,9969984,4036,1412600,11382584,14.17
9827859,9966623,2041,714350,10680973,7.17
9827860,8329388,2683,939050,9268438,11.27
9827861,9971722,3180,1113000,11084722,11.16
9827862,9959878,5256,1839600,11799478,18.47
9827863,9954384,6302,2205700,12160084,22.16
9827864,9777488,8298,2904300,12681788,29.70
9827865,9956053,5352,1873200,11829253,18.81
9827866,9941218,5360,1876000,11817218,18.87
9827867,9962076,5680,1988000,11950076,19.96
9827868,9957383,4500,1575000,11532383,15.82
9827869,9975911,4412,1544200,11520111,15.48
9827870,9951245,3632,1271200,11222445,12.77
9827871,9942430,3901,1365350,11307780,13.73
9827872,9960801,3738,1308300,11269101,13.13
9827873,6967162,1354,473900,7441062,6.80
9827874,6243826,2134,746900,6990726,11.96
9827875,9958687,5449,1907150,11865837,19.15
9827876,9805770,6230,2180500,11986270,22.24
9827877,4403263,1918,671300,5074563,15.25
9827878,9946428,7473,2615550,12561978,26.30
9827879,9961750,512,179200,10140950,1.80
9827880,9969238,2457,859950,10829188,8.63
9827881,842555,123,43050,885605,5.11
9827882,1462212,595,208250,1670462,14.24
9827883,9945347,4879,1707650,11652997,17.17
9827884,9952964,3138,1098300,11051264,11.03
9827885,2020502,379,132650,2153152,6.57
9827886,9962148,2135,747250,10709398,7.50
9827887,9937556,1614,564900,10502456,5.68
9827888,9952514,3614,1264900,11217414,12.71
9827889,8920317,2507,877450,9797767,9.84
9827890,2906804,2501,875350,3782154,30.11
9827891,9934719,5343,1870050,11804769,18.82
9827892,9935977,2403,841050,10777027,8.46
9827893,9928660,3974,1390900,11319560,14.01
9827894,9938732,5058,1770300,11709032,17.81
9827895,9949114,4407,1542450,11491564,15.50
9827896,9957979,5425,1898750,11856729,19.07
9827897,9941212,5727,2004450,11945662,20.16
9827898,9947514,1644,575400,10522914,5.78
9827899,9946150,2989,1046150,10992300,10.52
9827900,9931634,3589,1256150,11187784,12.65
9827901,9919102,3640,1274000,11193102,12.84
9827902,9947144,2662,931700,10878844,9.37
9827903,9926608,6672,2335200,12261808,23.52
9827905,9925927,4598,1609300,11535227,16.21
9827906,9927288,3845,1345750,11273038,13.56
9827907,9928706,7789,2726150,12654856,27.46
9827908,9141418,2471,864850,10006268,9.46
9827909,9937307,5208,1822800,11760107,18.34
9827910,9934962,7465,2612750,12547712,26.30
9827911,9942542,1899,664650,10607192,6.68
9827912,9949388,2489,871150,10820538,8.76
9827913,9958002,3063,1072050,11030052,10.77
9827914,9954359,4597,1608950,11563309,16.16
9827915,9972603,4410,1543500,11516103,15.48
9827916,9957225,5897,2063950,12021175,20.73
9827917,9966814,2907,1017450,10984264,10.21
9827918,9966698,3761,1316350,11283048,13.21
9827919,5101207,1594,557900,5659107,10.94
9827920,9969643,4166,1458100,11427743,14.63
9827921,9767246,5671,1984850,11752096,20.32
9827922,9983239,5578,1952300,11935539,19.56
9827923,9990220,5142,1799700,11789920,18.01
9827924,9991981,3827,1339450,11331431,13.41
9827925,9980574,4064,1422400,11402974,14.25
9827926,9979799,5263,1842050,11821849,18.46
9827927,9999641,3410,1193500,11193141,11.94
9827928,9975970,4314,1509900,11485870,15.14
9827929,9986962,5050,1767500,11754462,17.70
9827930,9983497,1928,674800,10658297,6.76
9827931,9991734,3996,1398600,11390334,14.00
9827932,9268057,4310,1508500,10776557,16.28
9827933,5551902,2231,780850,6332752,14.06
9827935,9993947,3852,1348200,11342147,13.49
9827936,9988415,2571,899850,10888265,9.01
9827937,9988326,3544,1240400,11228726,12.42
9827938,9995565,2316,810600,10806165,8.11
9827939,9981939,3242,1134700,11116639,11.37
9827940,9974569,3119,1091650,11066219,10.94
9827941,9976488,5309,1858150,11834638,18.63
9827942,9979371,2532,886200,10865571,8.88
9827943,9200645,6091,2131850,11332495,23.17
9827944,9981901,3159,1105650,11087551,11.08
9827945,9979525,3797,1328950,11308475,13.32
9827946,9978063,4003,1401050,11379113,14.04
9827947,9975415,5233,1831550,11806965,18.36
9827948,9986883,4636,1622600,11609483,16.25
9827949,9988804,5205,1821750,11810554,18.24
9827950,9977787,3811,1333850,11311637,13.37
9827951,9989063,6783,2374050,12363113,23.77
9827952,9998459,4886,1710100,11708559,17.10
9827953,9982101,6883,2409050,12391151,24.13
9827954,9970107,5247,1836450,11806557,18.42
9827955,9982381,3432,1201200,11183581,12.03
9827956,9968876,5943,2080050,12048926,20.87
9827958,9952592,4247,1486450,11439042,14.94
9827959,9916303,2605,911750,10828053,9.19
9827960,5966330,3913,1369550,7335880,22.95
9827961,9686536,4154,1453900,11140436,15.01
9827962,9939173,2103,736050,10675223,7.41
9827963,9953028,4185,1464750,11417778,14.72
9827964,9968165,7112,2489200,12457365,24.97
9827965,9976534,4475,1566250,11542784,15.70
9827966,9978306,4657,1629950,11608256,16.33
9827967,9956858,5043,1765050,11721908,17.73
9827968,9979773,4929,1725150,11704923,17.29
9827969,9974724,5701,1995350,11970074,20.00
9827970,9958608,6400,2240000,12198608,22.49
9827971,9977685,6135,2147250,12124935,21.52
9827972,9980488,3399,1189650,11170138,11.92
9827973,9984991,5430,1900500,11885491,19.03
9827974,9992152,5609,1963150,11955302,19.65
9827975,9992863,1092,382200,10375063,3.82
9827976,9977612,5429,1900150,11877762,19.04
9827977,9989465,4668,1633800,11623265,16.36
9827978,9979039,5925,2073750,12052789,20.78
9827979,8684630,2694,942900,9627530,10.86
9827980,9984097,5338,1868300,11852397,18.71
9827981,9984203,5221,1827350,11811553,18.30
9827982,9978050,3838,1343300,11321350,13.46
9827983,9980102,3369,1179150,11159252,11.82
9827984,9978346,4766,1668100,11646446,16.72
9827985,9048521,3372,1180200,10228721,13.04
9827986,9982204,4869,1704150,11686354,17.07
9827987,9992577,4876,1706600,11699177,17.08
9827988,9980585,4128,1444800,11425385,14.48
9827989,9970695,3737,1307950,11278645,13.12
9827990,9980269,2048,716800,10697069,7.18
9827991,9987008,5553,1943550,11930558,19.46
9827992,9984174,5792,2027200,12011374,20.30
9827993,9973233,4645,1625750,11598983,16.30
9827994,9985838,3547,1241450,11227288,12.43
9827995,9993550,3301,1155350,11148900,11.56
9827996,9974169,3337,1167950,11142119,11.71
9827997,9966233,4633,1621550,11587783,16.27
9827998,9985336,5251,1837850,11823186,18.41
9827999,9962186,5063,1772050,11734236,17.79
9828000,9983584,4588,1605800,11589384,16.08
9828001,9913549,1255,439250,10352799,4.43
9828002,9979609,4487,1570450,11550059,15.74
9828003,9998008,6559,2295650,12293658,22.96
9828005,9969579,3326,1164100,11133679,11.68
9828006,9490192,1182,413700,9903892,4.36
9828007,9982211,2569,899150,10881361,9.01
9828008,9990046,6327,2214450,12204496,22.17
9828009,9972081,4463,1562050,11534131,15.66
9828010,9966473,4038,1413300,11379773,14.18
9828011,7219973,2469,864150,8084123,11.97
9828012,4786070,4615,1615250,6401320,33.75
9828013,9924725,3504,1226400,11151125,12.36
9828014,5028720,1715,600250,5628970,11.94
9828015,9959335,5993,2097550,12056885,21.06
9828016,9977241,3737,1307950,11285191,13.11
9828017,9877810,5230,1830500,11708310,18.53
9828018,9978580,3091,1081850,11060430,10.84
9828019,9982340,4442,1554700,11537040,15.57
9828020,9963853,3699,1294650,11258503,12.99
9828021,9975211,3321,1162350,11137561,11.65
9828022,9970497,5915,2070250,12040747,20.76
9828023,9950669,3595,1258250,11208919,12.64
9828024,9951242,4275,1496250,11447492,15.04
9828025,9947760,4601,1610350,11558110,16.19
9828026,9960541,4499,1574650,11535191,15.81
9828027,9970526,2921,1022350,10992876,10.25
9828028,9957810,3600,1260000,11217810,12.65
9828029,9960261,6631,2320850,12281111,23.30
9828030,9981629,1674,585900,10567529,5.87
9828031,9922469,6143,2150050,12072519,21.67
9828032,9996381,4322,1512700,11509081,15.13
9828033,9980622,6008,2102800,12083422,21.07
9828034,9971659,4864,1702400,11674059,17.07
9828035,9986467,4697,1643950,11630417,16.46
9828036,9979000,5765,2017750,11996750,20.22
9828037,9972955,3574,1250900,11223855,12.54
9828038,9985559,4900,1715000,11700559,17.17
9828039,9994247,3715,1300250,11294497,13.01
9828040,9991922,5193,1817550,11809472,18.19
9828041,9994247,3330,1165500,11159747,11.66
9828042,9970362,4164,1457400,11427762,14.62
9828043,9973575,2539,888650,10862225,8.91
9828044,9972131,3692,1292200,11264331,12.96
9828045,9993534,2187,765450,10758984,7.66
9828046,9986661,5709,1998150,11984811,20.01
9828047,9985544,3837,1342950,11328494,13.45
9828048,9953208,150,52500,10005708,0.53
9828049,9983140,6571,2299850,12282990,23.04
9828050,9986980,3201,1120350,11107330,11.22
9828051,9985887,3842,1344700,11330587,13.47
9828052,9983770,4601,1610350,11594120,16.13
9828053,5579307,1402,490700,6070007,8.79
9828054,9987839,4412,1544200,11532039,15.46
9828055,9969808,4515,1580250,11550058,15.85
9828056,9982440,5634,1971900,11954340,19.75
9828057,9989751,3087,1080450,11070201,10.82
9828058,6846463,1648,576800,7423263,8.42
9828059,9984590,5509,1928150,11912740,19.31
9828061,9998272,3641,1274350,11272622,12.75
9828062,9982914,5033,1761550,11744464,17.65
9828063,9980392,4386,1535100,11515492,15.38
9828064,5873221,1744,610400,6483621,10.39
9828065,9985025,2934,1026900,11011925,10.28
9828066,9979545,4392,1537200,11516745,15.40
9828067,1835758,697,243950,2079708,13.29
9828068,9986823,2164,757400,10744223,7.58
9828069,9973846,5332,1866200,11840046,18.71
9828070,9980999,4954,1733900,11714899,17.37
9828071,9985422,4231,1480850,11466272,14.83
9828072,1835781,1030,360500,2196281,19.64
9828073,6110621,2276,796600,6907221,13.04
9828074,9968148,3586,1255100,11223248,12.59
9828075,9969432,2470,864500,10833932,8.67
9828076,9973126,2950,1032500,11005626,10.35
9828077,9977546,5482,1918700,11896246,19.23
9828078,9985574,3091,1081850,11067424,10.83
9828079,9931946,2883,1009050,10940996,10.16
9828080,9969056,3299,1154650,11123706,11.58
9828081,9966448,3471,1214850,11181298,12.19
9828082,3224823,3052,1068200,4293023,33.12
9828083,9964606,4893,1712550,11677156,17.19
9828084,9979515,2534,886900,10866415,8.89
9828085,9763895,5722,2002700,11766595,20.51
9828086,9981404,2481,868350,10849754,8.70
9828087,9982449,4162,1456700,11439149,14.59
9828088,9904480,6486,2270100,12174580,22.92
9828089,9979442,6010,2103500,12082942,21.08
9828090,9982599,3108,1087800,11070399,10.90
9828091,3241097,3070,1074500,4315597,33.15
9828093,9599858,2553,893550,10493408,9.31
9828094,9964508,4495,1573250,11537758,15.79
9828095,9969076,5176,1811600,11780676,18.17
9828096,9971168,6261,2191350,12162518,21.98
9828097,9980231,1811,633850,10614081,6.35
9828098,9968627,4357,1524950,11493577,15.30
9828100,5821398,1299,454650,6276048,7.81
9828101,9983509,3841,1344350,11327859,13.47
9828102,7516208,2521,882350,8398558,11.74
9828103,9974927,2255,789250,10764177,7.91
9828104,9993444,3219,1126650,11120094,11.27
9828105,9972605,6188,2165800,12138405,21.72
9828107,9944542,3696,1293600,11238142,13.01
9828108,9970824,3027,1059450,11030274,10.63
9828109,9973989,4562,1596700,11570689,16.01
9828110,9967284,3046,1066100,11033384,10.70
9828111,9982225,4492,1572200,11554425,15.75
9828112,9994111,1571,549850,10543961,5.50
9828113,9545045,4155,1454250,10999295,15.24
9828114,243009,79,27650,270659,11.38
9828115,9962246,3542,1239700,11201946,12.44
9828116,4417163,2838,993300,5410463,22.49
9828117,9956208,5233,1831550,11787758,18.40
9828118,674684,138,48300,722984,7.16
9828119,6212709,5584,1954400,8167109,31.46
9828120,9949433,3817,1335950,11285383,13.43
9828121,2602322,484,169400,2771722,6.51
9828122,9942956,4262,1491700,11434656,15.00
9828123,9956757,6262,2191700,12148457,22.01
9828124,9955428,5141,1799350,11754778,18.07
9828125,9967462,4954,1733900,11701362,17.40
9828126,9960250,5799,2029650,11989900,20.38
9828127,9973513,1539,538650,10512163,5.40
9828128,9881293,2354,823900,10705193,8.34
9828129,9976036,5940,2079000,12055036,20.84
9828130,9979040,4646,1626100,11605140,16.30
9828131,9968800,2567,898450,10867250,9.01
9828132,9978451,1434,501900,10480351,5.03
9828133,9994101,5097,1783950,11778051,17.85
9828134,9988071,3410,1193500,11181571,11.95
9828135,9977392,6244,2185400,12162792,21.90
9828136,9972988,5212,1824200,11797188,18.29
9828137,9993982,4235,1482250,11476232,14.83
9828138,9983663,5157,1804950,11788613,18.08
9828139,9983486,4901,1715350,11698836,17.18
9828140,9988475,3173,1110550,11099025,11.12
9828141,9991128,3163,1107050,11098178,11.08
9828142,9977643,8348,2921800,12899443,29.28
9828143,9986178,4259,1490650,11476828,14.93
9828144,9997349,1923,673050,10670399,6.73
9828145,9988952,3610,1263500,11252452,12.65
9828146,9907683,5539,1938650,11846333,19.57
9828147,3101734,982,343700,3445434,11.08
9828148,5236202,1569,549150,5785352,10.49
9828149,9960691,6613,2314550,12275241,23.24
9828150,9953905,4362,1526700,11480605,15.34
9828151,9962906,3825,1338750,11301656,13.44
9828152,9979564,1110,388500,10368064,3.89
9828153,4441463,689,241150,4682613,5.43
9828154,9967099,3915,1370250,11337349,13.75
9828155,9086189,1292,452200,9538389,4.98
9828156,9987295,4379,1532650,11519945,15.35
9828157,9984091,4457,1559950,11544041,15.62
9828158,9984604,2553,893550,10878154,8.95
9828159,9989055,4531,1585850,11574905,15.88
9828160,9985614,3823,1338050,11323664,13.40
9828161,9634640,4746,1661100,11295740,17.24
9828162,9999205,3846,1346100,11345305,13.46
9828163,9982055,3432,1201200,11183255,12.03
9828164,2500021,1751,612850,3112871,24.51
9828165,9965349,4000,1400000,11365349,14.05
9828166,9980787,3806,1332100,11312887,13.35
9828167,9991778,4748,1661800,11653578,16.63
9828168,5622958,4738,1658300,7281258,29.49
9828169,9999404,4127,1444450,11443854,14.45
9828170,9998742,4985,1744750,11743492,17.45
9828171,9979135,7085,2479750,12458885,24.85
9828172,9993497,4773,1670550,11664047,16.72
9828173,9999931,5228,1829800,11829731,18.30
9828174,9520445,3099,1084650,10605095,11.39
9828175,4157233,1999,699650,4856883,16.83
9828176,9629835,3069,1074150,10703985,11.15
9828177,645414,334,116900,762314,18.11
9828178,6570867,2492,872200,7443067,13.27
9828179,9945078,4044,1415400,11360478,14.23
9828180,2386044,761,266350,2652394,11.16
9828181,9955657,2586,905100,10860757,9.09
9828182,9854101,4153,1453550,11307651,14.75
9828183,9955602,3217,1125950,11081552,11.31
9828184,9480617,1750,612500,10093117,6.46
9828185,9956865,5757,2014950,11971815,20.24
9828187,9950655,6172,2160200,12110855,21.71
9828188,9957594,7084,2479400,12436994,24.90
9828189,9975378,3506,1227100,11202478,12.30
9828191,9969840,7373,2580550,12550390,25.88
9828192,9958425,5177,1811950,11770375,18.20
9828193,9961874,4386,1535100,11496974,15.41
9828194,4358512,3761,1316350,5674862,30.20
9828195,9990062,8121,2842350,12832412,28.45
9828196,9975702,6635,2322250,12297952,23.28
9828197,1970341,1584,554400,2524741,28.14
9828198,9961219,5936,2077600,12038819,20.86
9828199,9966141,3704,1296400,11262541,13.01
9828200,4975699,1686,590100,5565799,11.86
9828201,9958267,5242,1834700,11792967,18.42
9828202,9966341,6440,2254000,12220341,22.62
9828203,9977153,6120,2142000,12119153,21.47
9828204,9973155,5583,1954050,11927205,19.59
9828205,9956193,4731,1655850,11612043,16.63
9828206,9968775,2575,901250,10870025,9.04
9828207,9954040,4971,1739850,11693890,17.48
9828208,9958994,3303,1156050,11115044,11.61
9828209,9969217,4086,1430100,11399317,14.35
9828210,8218477,1821,637350,8855827,7.76
9828211,9951719,8143,2850050,12801769,28.64
9828212,9947569,6024,2108400,12055969,21.20
9828213,9961041,4470,1564500,11525541,15.71
9828214,9941303,3038,1063300,11004603,10.70
9828215,9939770,7036,2462600,12402370,24.78
9828216,8962576,5167,1808450,10771026,20.18
9828217,9960318,5373,1880550,11840868,18.88
9828218,9966647,4528,1584800,11551447,15.90
9828219,9946709,5263,1842050,11788759,18.52
9828220,9946676,7746,2711100,12657776,27.26
9828221,9961623,4535,1587250,11548873,15.93
9828222,5833605,1758,615300,6448905,10.55
9828223,9989359,5542,1939700,11929059,19.42
9828224,9978463,4330,1515500,11493963,15.19
9828225,9987928,6171,2159850,12147778,21.62
9828226,9545569,5748,2011800,11557369,21.08
9828227,9027050,3403,1191050,10218100,13.19
9828228,9948022,2123,743050,10691072,7.47
9828229,9982647,7021,2457350,12439997,24.62
9828230,9997973,4366,1528100,11526073,15.28
9828231,9986408,5067,1773450,11759858,17.76
9828232,9998033,3880,1358000,11356033,13.58
9828233,9995205,8503,2976050,12971255,29.77
9828234,9983135,3538,1238300,11221435,12.40
9828235,9981422,4658,1630300,11611722,16.33
9828236,3017648,892,312200,3329848,10.35
9828237,9941372,4348,1521800,11463172,15.31
9828238,9979003,5051,1767850,11746853,17.72
9828239,9973743,2596,908600,10882343,9.11
9828240,3171788,121,42350,3214138,1.34
9828241,9984567,5754,2013900,11998467,20.17
9828242,9996172,6665,2332750,12328922,23.34
9828243,9981658,3759,1315650,11297308,13.18
9828244,9986644,3588,1255800,11242444,12.57
9828245,9995794,2399,839650,10835444,8.40
9828246,9722951,4755,1664250,11387201,17.12
9828247,9993797,2311,808850,10802647,8.09
9828248,9591593,3407,1192450,10784043,12.43
9828249,9980494,4227,1479450,11459944,14.82
9828250,9994367,6432,2251200,12245567,22.52
9828251,9985782,4301,1505350,11491132,15.07
9828252,9982652,3314,1159900,11142552,11.62
9828253,9977972,5797,2028950,12006922,20.33
9828254,9986283,4250,1487500,11473783,14.90
9828255,9987956,4921,1722350,11710306,17.24
9828256,9988836,3974,1390900,11379736,13.92
9828257,9977638,4174,1460900,11438538,14.64
9828258,9989867,5869,2054150,12044017,20.56
9828259,9989574,4290,1501500,11491074,15.03
9828261,9989932,5617,1965950,11955882,19.68
9828262,9978990,7771,2719850,12698840,27.26
9828263,756909,142,49700,806609,6.57
9828265,9970548,6761,2366350,12336898,23.73
9828266,9970219,5107,1787450,11757669,17.93
9828267,9987664,3463,1212050,11199714,12.14
9828268,192909,143,50050,242959,25.94
9828269,9985473,5363,1877050,11862523,18.80
9828270,9986909,5767,2018450,12005359,20.21
9828271,9999463,5551,1942850,11942313,19.43
9828272,9976994,5514,1929900,11906894,19.34
9828273,9991968,4090,1431500,11423468,14.33
9828275,4273635,2872,1005200,5278835,23.52
9828276,9983350,8655,3029250,13012600,30.34
9828277,9980507,6723,2353050,12333557,23.58
9828278,1252775,499,174650,1427425,13.94
9828279,5123450,3630,1270500,6393950,24.80
9828280,9977472,8972,3140200,13117672,31.47
9828281,9996829,8067,2823450,12820279,28.24
9828282,9988583,2869,1004150,10992733,10.05
9828283,3400912,2153,753550,4154462,22.16
9828284,9978718,4428,1549800,11528518,15.53
9828285,9408036,5348,1871800,11279836,19.90
9828286,9988804,5763,2017050,12005854,20.19
9828287,9993286,2318,811300,10804586,8.12
9828288,9990929,1170,409500,10400429,4.10
9828289,1298756,1789,626150,1924906,48.21
9828290,9964398,5269,1844150,11808548,18.51
9828291,9971415,5573,1950550,11921965,19.56
9828292,4439001,1052,368200,4807201,8.29
9828293,9967961,7436,2602600,12570561,26.11
9828294,9982233,2401,840350,10822583,8.42
9828295,9955808,7318,2561300,12517108,25.73
9828296,4214129,2116,740600,4954729,17.57
9828298,2538573,828,289800,2828373,11.42
9828299,9969607,3875,1356250,11325857,13.60
9828300,9976116,5929,2075150,12051266,20.80
9828301,9987347,4082,1428700,11416047,14.31
9828302,9993567,4410,1543500,11537067,15.44
9828303,2785615,1633,571550,3357165,20.52
9828304,9972158,6872,2405200,12377358,24.12
9828305,9979659,4383,1534050,11513709,15.37
9828306,9988753,3394,1187900,11176653,11.89
9828307,9993244,4779,1672650,11665894,16.74
9828308,9987702,3913,1369550,11357252,13.71
9828309,8660023,3800,1330000,9990023,15.36
9828310,3077069,1325,463750,3540819,15.07
9828311,9991558,3213,1124550,11116108,11.26
9828312,1461045,611,213850,1674895,14.64
9828313,9965182,4206,1472100,11437282,14.77
9828314,9991125,5074,1775900,11767025,17.77
9828315,9982893,6052,2118200,12101093,21.22
9828316,9991748,5331,1865850,11857598,18.67
9828317,1685322,749,262150,1947472,15.55
9828319,1001179,410,143500,1144679,14.33
9828320,3324613,2025,708750,4033363,21.32
9828321,9997723,4354,1523900,11521623,15.24
9828322,8049853,2864,1002400,9052253,12.45
9828323,9989999,3264,1142400,11132399,11.44
9828324,9988105,3544,1240400,11228505,12.42
9828325,9991556,4722,1652700,11644256,16.54
9828326,9997428,3850,1347500,11344928,13.48
9828327,7791023,2816,985600,8776623,12.65
9828328,9975274,4243,1485050,11460324,14.89
9828329,1006488,389,136150,1142638,13.53
9828330,9618940,3228,1129800,10748740,11.75
9828331,9973557,3508,1227800,11201357,12.31
9828332,9993286,5338,1868300,11861586,18.70
9828333,9998895,7781,2723350,12722245,27.24
9828334,541045,350,122500,663545,22.64
9828335,9971622,6070,2124500,12096122,21.31
9828336,9964624,8015,2805250,12769874,28.15
9828337,9989014,3458,1210300,11199314,12.12
9828338,9990321,2777,971950,10962271,9.73
9828339,9987926,2983,1044050,11031976,10.45
9828340,9986281,1438,503300,10489581,5.04
9828341,9976865,3836,1342600,11319465,13.46
9828342,446303,213,74550,520853,16.70
9828343,9968502,5916,2070600,12039102,20.77
9828344,9978182,2124,743400,10721582,7.45
9828345,9981559,4803,1681050,11662609,16.84
9828346,9959586,599,209650,10169236,2.11
9828347,9967381,2692,942200,10909581,9.45
9828348,2317990,833,291550,2609540,12.58
9828349,9975514,6204,2171400,12146914,21.77
9828350,9956113,2184,764400,10720513,7.68
9828351,1790444,2324,813400,2603844,45.43
9828352,9952794,906,317100,10269894,3.19
9828353,9966598,3795,1328250,11294848,13.33
9828354,9981044,5679,1987650,11968694,19.91
9828355,9988725,4127,1444450,11433175,14.46
9828356,2999723,240,84000,3083723,2.80
9828357,9991597,5213,1824550,11816147,18.26
9828359,9976417,1901,665350,10641767,6.67
9828360,9980721,3302,1155700,11136421,11.58
9828361,9989682,5742,2009700,11999382,20.12
9828362,9981018,2464,862400,10843418,8.64
9828363,7637831,4037,1412950,9050781,18.50
9828364,348975,147,51450,400425,14.74
9828365,4513982,3047,1066450,5580432,23.63
9828366,9984119,5020,1757000,11741119,17.60
9828367,4692816,3190,1116500,5809316,23.79
9828369,235281,114,39900,275181,16.96
9828370,9969722,6114,2139900,12109622,21.46
9828371,9957612,4615,1615250,11572862,16.22
9828372,287305,78,27300,314605,9.50
9828373,1883281,887,310450,2193731,16.48
9828374,9956246,3710,1298500,11254746,13.04
9828375,9962542,5000,1750000,11712542,17.57
9828376,8031911,4579,1602650,9634561,19.95
9828377,9894096,4280,1498000,11392096,15.14
9828378,9985888,4476,1566600,11552488,15.69
9828379,9980488,4896,1713600,11694088,17.17
9828380,9978436,7700,2695000,12673436,27.01
9828381,9973020,2061,721350,10694370,7.23
9828382,2418417,1230,430500,2848917,17.80
9828383,9998414,5629,1970150,11968564,19.70
9828384,660289,373,130550,790839,19.77
9828385,3600305,2240,784000,4384305,21.78
9828386,9976093,5467,1913450,11889543,19.18
9828387,9966726,3180,1113000,11079726,11.17
9828388,984061,390,136500,1120561,13.87
9828389,9958873,985,344750,10303623,3.46
9828390,3540895,1263,442050,3982945,12.48
9828391,9987153,5088,1780800,11767953,17.83
9828392,9985507,743,260050,10245557,2.60
9828393,9985857,5297,1853950,11839807,18.57
9828394,559926,430,150500,710426,26.88
9828395,9960981,4244,1485400,11446381,14.91
9828396,9981566,4136,1447600,11429166,14.50
9828397,9972064,1338,468300,10440364,4.70
9828398,9989847,1032,361200,10351047,3.62
9828399,9994729,4428,1549800,11544529,15.51
9828400,9982679,4409,1543150,11525829,15.46
9828401,9962432,5125,1793750,11756182,18.01
9828402,9935971,4000,1400000,11335971,14.09
9828403,9991670,4210,1473500,11465170,14.75
9828404,9981364,3616,1265600,11246964,12.68
9828405,1336495,545,190750,1527245,14.27
9828406,9992314,4598,1609300,11601614,16.11
9828407,9996780,6953,2433550,12430330,24.34
9828408,9900190,5773,2020550,11920740,20.41
9828409,9993718,962,336700,10330418,3.37
9828410,9977402,2047,716450,10693852,7.18
9828411,9959482,1698,594300,10553782,5.97
9828412,9977604,5471,1914850,11892454,19.19
9828413,9983959,1599,559650,10543609,5.61
9828414,9994429,7478,2617300,12611729,26.19
9828415,556314,122,42700,599014,7.68
9828416,9837898,3904,1366400,11204298,13.89
9828417,9972551,4403,1541050,11513601,15.45
9828418,9975960,5228,1829800,11805760,18.34
9828419,6013343,3514,1229900,7243243,20.45
9828420,9959741,3156,1104600,11064341,11.09
9828421,9941548,3065,1072750,11014298,10.79
9828422,1306121,230,80500,1386621,6.16
9828423,1011893,689,241150,1253043,23.83
9828424,9954860,5834,2041900,11996760,20.51
9828425,9979026,2145,750750,10729776,7.52
9828426,1733352,982,343700,2077052,19.83
9828427,9963791,3460,1211000,11174791,12.15
9828428,1651708,544,190400,1842108,11.53
9828429,9971469,3306,1157100,11128569,11.60
9828430,9935850,4499,1574650,11510500,15.85
9828431,9963545,1626,569100,10532645,5.71
9828433,9997130,3456,1209600,11206730,12.10
9828435,1405646,816,285600,1691246,20.32
9828436,2236902,1883,659050,2895952,29.46
9828437,9989556,6948,2431800,12421356,24.34
9828438,1970731,754,263900,2234631,13.39
9828439,2894049,990,346500,3240549,11.97
9828440,9983605,2672,935200,10918805,9.37
9828441,9973603,3686,1290100,11263703,12.94
9828442,9981719,4644,1625400,11607119,16.28
9828443,9978917,2793,977550,10956467,9.80
9828444,9722755,3780,1323000,11045755,13.61
9828445,9990081,4453,1558550,11548631,15.60
9828446,9976235,6683,2339050,12315285,23.45
9828447,8036722,1730,605500,8642222,7.53
9828448,9991152,4995,1748250,11739402,17.50
9828449,9990399,5383,1884050,11874449,18.86
9828450,9975008,3265,1142750,11117758,11.46
9828451,9991020,6530,2285500,12276520,22.88
9828452,9984860,4050,1417500,11402360,14.20
9828453,9980556,3804,1331400,11311956,13.34
9828454,9995266,5041,1764350,11759616,17.65
9828455,9735889,868,303800,10039689,3.12
9828456,9975587,2734,956900,10932487,9.59
9828457,9983606,2877,1006950,10990556,10.09
9828458,9994830,2710,948500,10943330,9.49
9828459,8344335,2034,711900,9056235,8.53
9828460,9986077,5164,1807400,11793477,18.10
9828461,9994234,4203,1471050,11465284,14.72
9828463,9977867,7897,2763950,12741817,27.70
9828464,9967009,2609,913150,10880159,9.16
9828465,9983123,3637,1272950,11256073,12.75
9828466,1879900,649,227150,2107050,12.08
9828467,3015424,617,215950,3231374,7.16
9828468,9949627,3838,1343300,11292927,13.50
9828469,8439282,728,254800,8694082,3.02
9828470,9971130,3356,1174600,11145730,11.78
9828472,9967840,3242,1134700,11102540,11.38
9828473,9970133,3788,1325800,11295933,13.30
9828474,1034752,198,69300,1104052,6.70
9828475,9965881,4138,1448300,11414181,14.53
9828476,9958460,2804,981400,10939860,9.85
9828477,9974795,2710,948500,10923295,9.51
9828478,9962013,5310,1858500,11820513,18.66
9828479,9965401,4491,1571850,11537251,15.77
9828480,9973594,5772,2020200,11993794,20.26
9828481,9981519,2298,804300,10785819,8.06
9828482,9950767,1212,424200,10374967,4.26
9828483,827487,895,313250,1140737,37.86
9828484,9959683,2617,915950,10875633,9.20
9828485,9941729,7994,2797900,12739629,28.14
9828486,9952809,2623,918050,10870859,9.22
9828487,3978701,206,72100,4050801,1.81
9828488,9952161,2423,848050,10800211,8.52
9828489,9607906,3553,1243550,10851456,12.94
9828490,9975846,4280,1498000,11473846,15.02
9828491,9977548,2673,935550,10913098,9.38
9828492,9981112,4936,1727600,11708712,17.31
9828493,9981677,3440,1204000,11185677,12.06
9828494,9986791,5943,2080050,12066841,20.83
9828495,1437763,1010,353500,1791263,24.59
9828496,9973815,3813,1334550,11308365,13.38
9828498,5252900,1945,680750,5933650,12.96
9828499,9993869,2866,1003100,10996969,10.04
9828500,9974718,2446,856100,10830818,8.58
9828501,1483493,422,147700,1631193,9.96
9828502,9953634,3787,1325450,11279084,13.32
9828503,9974761,4621,1617350,11592111,16.21
9828504,9943876,4590,1606500,11550376,16.16
9828505,9981206,3584,1254400,11235606,12.57
9828506,9986472,2012,704200,10690672,7.05
9828507,9989272,4271,1494850,11484122,14.96
9828508,9990428,4072,1425200,11415628,14.27
9828509,7862519,1478,517300,8379819,6.58
9828510,9991720,5822,2037700,12029420,20.39
9828511,9990643,5415,1895250,11885893,18.97
9828512,9878795,883,309050,10187845,3.13
9828513,9978023,5029,1760150,11738173,17.64
9828514,3861758,1489,521150,4382908,13.50
9828515,9980375,2380,833000,10813375,8.35
9828516,9984073,2907,1017450,11001523,10.19
9828517,3522208,314,109900,3632108,3.12
9828518,9992463,2614,914900,10907363,9.16
9828519,9982845,3889,1361150,11343995,13.63
9828520,9987186,4841,1694350,11681536,16.97
9828521,8697233,2281,798350,9495583,9.18
9828522,9979203,2601,910350,10889553,9.12
9828523,9976763,3146,1101100,11077863,11.04
9828525,9997393,5848,2046800,12044193,20.47
9828526,7284080,1741,609350,7893430,8.37
9828527,9999827,3111,1088850,11088677,10.89
9828528,9995001,3670,1284500,11279501,12.85
9828529,9969884,6995,2448250,12418134,24.56
9828530,9984343,5455,1909250,11893593,19.12
9828531,9978288,5165,1807750,11786038,18.12
9828532,3181413,1899,664650,3846063,20.89
9828533,5715906,785,274750,5990656,4.81
9828534,9949637,6210,2173500,12123137,21.85
9828535,9950417,4600,1610000,11560417,16.18
9828536,9944454,4847,1696450,11640904,17.06
9828537,9947370,3866,1353100,11300470,13.60
9828538,9943230,2726,954100,10897330,9.60
9828539,9951937,3407,1192450,11144387,11.98
9828540,9946354,3536,1237600,11183954,12.44
9828541,9930085,3141,1099350,11029435,11.07
9828542,9463046,4759,1665650,11128696,17.60
9828543,9936602,4725,1653750,11590352,16.64
9828544,9929598,2388,835800,10765398,8.42
9828545,9954124,2693,942550,10896674,9.47
9828547,9927626,3646,1276100,11203726,12.85
9828548,9942339,3746,1311100,11253439,13.19
9828549,9945814,3030,1060500,11006314,10.66
9828551,9939222,4008,1402800,11342022,14.11
9828552,9943189,5438,1903300,11846489,19.14
9828553,9954585,3104,1086400,11040985,10.91
9828554,9964101,4053,1418550,11382651,14.24
9828555,9980013,4319,1511650,11491663,15.15
9828556,9991368,6759,2365650,12357018,23.68
9828557,9965145,3966,1388100,11353245,13.93
9828558,9983851,5830,2040500,12024351,20.44
9828559,898055,292,102200,1000255,11.38
9828560,8775494,1747,611450,9386944,6.97
9828561,9968037,3177,1111950,11079987,11.16
9828562,9967779,6351,2222850,12190629,22.30
9828563,9962515,2485,869750,10832265,8.73
9828564,9961805,3475,1216250,11178055,12.21
9828565,9942393,1145,400750,10343143,4.03
9828566,9949003,2271,794850,10743853,7.99
9828567,9867591,1605,561750,10429341,5.69
9828568,9958115,1983,694050,10652165,6.97
9828569,5442356,1391,486850,5929206,8.95
9828570,9928938,2765,967750,10896688,9.75
9828571,9927676,4576,1601600,11529276,16.13
9828573,9894798,3183,1114050,11008848,11.26
9828574,9886038,3386,1185100,11071138,11.99
9828575,9934116,1372,480200,10414316,4.83
9828576,9492083,5566,1948100,11440183,20.52
9828577,5773022,1908,667800,6440822,11.57
9828578,9932624,3284,1149400,11082024,11.57
9828579,9917739,2182,763700,10681439,7.70
9828580,9931082,2682,938700,10869782,9.45
9828581,9925214,3037,1062950,10988164,10.71
9828582,9939418,5570,1949500,11888918,19.61
9828583,9933320,4817,1685950,11619270,16.97
9828584,9934546,3818,1336300,11270846,13.45
9828585,9952168,3533,1236550,11188718,12.42
9828586,9943021,5250,1837500,11780521,18.48
9828587,9942419,4735,1657250,11599669,16.67
9828588,9926484,3366,1178100,11104584,11.87
9828589,9946864,5478,1917300,11864164,19.28
9828590,9959636,3022,1057700,11017336,10.62
9828591,9966526,3864,1352400,11318926,13.57
9828592,9970579,5177,1811950,11782529,18.17
9828593,9963406,2967,1038450,11001856,10.42
9828594,9943905,3310,1158500,11102405,11.65
9828595,9943951,4206,1472100,11416051,14.80
9828596,9938057,3219,1126650,11064707,11.34
9828597,9958110,3375,1181250,11139360,11.86
9828598,9965361,4105,1436750,11402111,14.42
9828599,9958718,2634,921900,10880618,9.26
9828600,9973031,3099,1084650,11057681,10.88
9828601,9973007,2377,831950,10804957,8.34
9828602,9981421,4672,1635200,11616621,16.38
9828603,9980621,5930,2075500,12056121,20.80
9828604,9986554,4757,1664950,11651504,16.67
9828605,9985808,1959,685650,10671458,6.87
9828606,9987615,2977,1041950,11029565,10.43
9828607,9971409,2467,863450,10834859,8.66
9828608,1784024,705,246750,2030774,13.83
9828609,9960784,4190,1466500,11427284,14.72
9828610,9961518,4484,1569400,11530918,15.75
9828611,9974686,4129,1445150,11419836,14.49
9828613,9984761,4383,1534050,11518811,15.36
9828614,9985951,5098,1784300,11770251,17.87
9828615,9974907,3157,1104950,11079857,11.08
9828616,9984532,3928,1374800,11359332,13.77
9828617,1433811,185,64750,1498561,4.52
9828618,3723514,1442,504700,4228214,13.55
9828619,9988646,2945,1030750,11019396,10.32
9828620,5301456,243,85050,5386506,1.60
9828621,9968191,3009,1053150,11021341,10.57
9828622,9990665,3639,1273650,11264315,12.75
9828623,9980819,7072,2475200,12456019,24.80
9828624,9968007,3422,1197700,11165707,12.02
9828625,1305670,341,119350,1425020,9.14
9828626,9968685,3220,1127000,11095685,11.31
9828627,9969845,3233,1131550,11101395,11.35
9828628,9969280,4393,1537550,11506830,15.42
9828629,9986495,2714,949900,10936395,9.51
9828631,9956133,672,235200,10191333,2.36
9828632,9587939,2049,717150,10305089,7.48
9828633,9421547,1941,679350,10100897,7.21
9828635,9926929,3976,1391600,11318529,14.02
9828636,9950123,4318,1511300,11461423,15.19
9828637,9930511,2127,744450,10674961,7.50
9828638,9939380,2324,813400,10752780,8.18
9828639,9926426,3926,1374100,11300526,13.84
9828640,2522157,687,240450,2762607,9.53
9828641,9931448,7068,2473800,12405248,24.91
9828642,9941651,5406,1892100,11833751,19.03
9828644,2311013,594,207900,2518913,9.00
9828645,9942352,3684,1289400,11231752,12.97
9828646,9948804,4370,1529500,11478304,15.37
9828647,9946663,2167,758450,10705113,7.63
9828648,9968074,1957,684950,10653024,6.87
9828649,9975727,1721,602350,10578077,6.04
9828650,9972642,2069,724150,10696792,7.26
9828651,9964253,2183,764050,10728303,7.67
9828652,9946442,3944,1380400,11326842,13.88
9828653,9972381,2533,886550,10858931,8.89
9828654,9972955,3015,1055250,11028205,10.58
9828655,9982578,3351,1172850,11155428,11.75
9828656,9957222,2808,982800,10940022,9.87
9828657,1533038,502,175700,1708738,11.46
9828658,6126610,2768,968800,7095410,15.81
9828659,9960400,1817,635950,10596350,6.38
9828660,9964815,1188,415800,10380615,4.17
9828661,2039355,763,267050,2306405,13.09
9828662,9952110,3728,1304800,11256910,13.11
9828663,9909505,3720,1302000,11211505,13.14
9828664,9958643,3471,1214850,11173493,12.20
9828665,9964090,4823,1688050,11652140,16.94
9828666,9954314,3523,1233050,11187364,12.39
9828667,9951626,4627,1619450,11571076,16.27
9828668,9954223,5900,2065000,12019223,20.74
9828669,9951910,3143,1100050,11051960,11.05
9828670,9826332,3207,1122450,10948782,11.42
9828671,9918629,2302,805700,10724329,8.12
9828673,9916999,3061,1071350,10988349,10.80
9828674,9922962,3742,1309700,11232662,13.20
9828675,3894878,1168,408800,4303678,10.50
9828676,9911723,2742,959700,10871423,9.68
9828677,1027740,212,74200,1101940,7.22
9828679,9894684,3330,1165500,11060184,11.78
9828680,9920597,4465,1562750,11483347,15.75
9828681,3130601,340,119000,3249601,3.80
9828682,9894958,4104,1436400,11331358,14.52
9828683,9892890,4148,1451800,11344690,14.68
9828684,9897477,1757,614950,10512427,6.21
9828685,9903305,4246,1486100,11389405,15.01
9828686,9903660,4388,1535800,11439460,15.51
9828688,9914397,3175,1111250,11025647,11.21
9828689,9911383,2801,980350,10891733,9.89
9828690,9906303,8338,2918300,12824603,29.46
9828691,9703788,3723,1303050,11006838,13.43
9828692,6718529,893,312550,7031079,4.65
9828693,9923784,5368,1878800,11802584,18.93
9828694,9936156,4668,1633800,11569956,16.44
9828695,9944930,3107,1087450,11032380,10.93
9828696,7746504,4076,1426600,9173104,18.42
9828697,9924162,3836,1342600,11266762,13.53
9828698,9914713,3938,1378300,11293013,13.90
9828699,9926381,3722,1302700,11229081,13.12
9828700,9932065,3435,1202250,11134315,12.10
9828701,9905163,2608,912800,10817963,9.22
9828702,9914519,6352,2223200,12137719,22.42
9828703,9924726,4341,1519350,11444076,15.31
9828704,9925466,1295,453250,10378716,4.57
9828705,9918539,3599,1259650,11178189,12.70
9828706,9922085,2590,906500,10828585,9.14
9828707,9909468,5628,1969800,11879268,19.88
9828708,9919953,3200,1120000,11039953,11.29
9828709,9937008,4478,1567300,11504308,15.77
9828710,2954326,356,124600,3078926,4.22
9828713,9886730,2616,915600,10802330,9.26
9828714,4398209,816,285600,4683809,6.49
9828715,9895233,3100,1085000,10980233,10.96
9828716,9888020,1826,639100,10527120,6.46
9828718,9900908,698,244300,10145208,2.47
9828719,9893588,1797,628950,10522538,6.36
9828720,9905377,1962,686700,10592077,6.93
9828721,9907201,4453,1558550,11465751,15.73
9828722,9920150,4309,1508150,11428300,15.20
9828723,9916335,3941,1379350,11295685,13.91
9828724,9918861,3262,1141700,11060561,11.51
9828725,9922486,4768,1668800,11591286,16.82
9828726,9916298,2852,998200,10914498,10.07
9828727,9910320,4894,1712900,11623220,17.28
9828728,9919250,5388,1885800,11805050,19.01
9828729,9937454,2244,785400,10722854,7.90
9828730,4677403,524,183400,4860803,3.92
9828731,2347397,246,86100,2433497,3.67
9828732,9939146,2054,718900,10658046,7.23
9828733,9942179,2362,826700,10768879,8.32
9828734,9924367,2642,924700,10849067,9.32
9828735,952133,315,110250,1062383,11.58
9828736,9925787,4405,1541750,11467537,15.53
9828737,2998625,310,108500,3107125,3.62
9828738,9913856,6537,2287950,12201806,23.08
9828739,7334732,3626,1269100,8603832,17.30
9828740,9895076,952,333200,10228276,3.37
9828741,9907999,4081,1428350,11336349,14.42
9828742,850135,162,56700,906835,6.67
9828743,9899749,1510,528500,10428249,5.34
9828744,9893086,5970,2089500,11982586,21.12
9828745,1562966,238,83300,1646266,5.33
9828746,9901218,4680,1638000,11539218,16.54
9828747,3219877,1424,498400,3718277,15.48
9828748,9887889,2585,904750,10792639,9.15
9828749,9882157,3324,1163400,11045557,11.77
9828750,9904160,4539,1588650,11492810,16.04
9828751,3513139,885,309750,3822889,8.82
9828752,9899601,4145,1450750,11350351,14.65
9828753,9909631,2411,843850,10753481,8.52
9828754,9903226,1211,423850,10327076,4.28
9828755,9868042,1665,582750,10450792,5.91
9828756,9893201,4263,1492050,11385251,15.08
9828757,9890553,2657,929950,10820503,9.40
9828759,9895950,5469,1914150,11810100,19.34
9828760,9906120,2587,905450,10811570,9.14
9828761,9880744,3259,1140650,11021394,11.54
9828762,9894634,3242,1134700,11029334,11.47
9828763,9903343,2523,883050,10786393,8.92
9828764,9906892,3296,1153600,11060492,11.64
9828765,9906728,4104,1436400,11343128,14.50
9828766,9913843,4863,1702050,11615893,17.17
9828767,9912207,2629,920150,10832357,9.28
9828768,9922628,2316,810600,10733228,8.17
9828770,9897327,1248,436800,10334127,4.41
9828772,9901133,3036,1062600,10963733,10.73
9828773,9885058,2982,1043700,10928758,10.56
9828774,9900186,1830,640500,10540686,6.47
9828775,9903911,2377,831950,10735861,8.40
9828776,9910954,4318,1511300,11422254,15.25
9828777,9917613,2292,802200,10719813,8.09
9828778,9892521,2742,959700,10852221,9.70
9828779,9878652,3445,1205750,11084402,12.21
9828780,9881444,2895,1013250,10894694,10.25
9828781,9862773,3084,1079400,10942173,10.94
9828782,9868591,2673,935550,10804141,9.48
9828783,9842349,4280,1498000,11340349,15.22
9828784,9244027,2294,802900,10046927,8.69
9828785,6225814,2657,929950,7155764,14.94
9828786,8866022,2466,863100,9729122,9.73
9828787,9854034,2716,950600,10804634,9.65
9828788,9874607,2584,904400,10779007,9.16
9828789,9873122,3344,1170400,11043522,11.85
9828791,9860721,2757,964950,10825671,9.79
9828792,9829992,1549,542150,10372142,5.52
9828793,9863588,4045,1415750,11279338,14.35
9828794,9870765,2821,987350,10858115,10.00
9828795,9876024,3892,1362200,11238224,13.79
9828796,9879001,3049,1067150,10946151,10.80
9828797,9895424,2486,870100,10765524,8.79
9828798,9900280,3516,1230600,11130880,12.43
9828799,9887800,1372,480200,10368000,4.86
9828800,9882577,3140,1099000,10981577,11.12
9828801,9902488,3176,1111600,11014088,11.23
9828802,9907188,2033,711550,10618738,7.18
9828803,9911275,2073,725550,10636825,7.32
9828804,9913798,2789,976150,10889948,9.85
9828805,9898267,8536,2987600,12885867,30.18
9828806,9896250,1688,590800,10487050,5.97
9828807,9892002,3839,1343650,11235652,13.58
9828808,9908902,2469,864150,10773052,8.72
9828809,9894047,2661,931350,10825397,9.41
9828810,9893639,3158,1105300,10998939,11.17
9828811,9895307,3094,1082900,10978207,10.94
9828812,9894778,5447,1906450,11801228,19.27
9828813,9901894,3015,1055250,10957144,10.66
9828814,9911478,3658,1280300,11191778,12.92
9828815,9916122,3088,1080800,10996922,10.90
9828816,9936510,3039,1063650,11000160,10.70
9828817,9923446,3235,1132250,11055696,11.41
9828818,9441518,1559,545650,9987168,5.78
9828819,9907814,2757,964950,10872764,9.74
9828820,9923740,2684,939400,10863140,9.47
9828821,9907612,2941,1029350,10936962,10.39
9828822,9921768,3959,1385650,11307418,13.97
9828823,9932436,3403,1191050,11123486,11.99
9828824,9905525,2827,989450,10894975,9.99
9828825,9913230,5503,1926050,11839280,19.43
9828826,9916226,2100,735000,10651226,7.41
9828827,9920051,4175,1461250,11381301,14.73
9828828,9932584,2907,1017450,10950034,10.24
9828829,9928460,4235,1482250,11410710,14.93
9828830,9922089,4684,1639400,11561489,16.52
9828831,9922392,2718,951300,10873692,9.59
9828832,9911465,3818,1336300,11247765,13.48
9828833,9924966,1246,436100,10361066,4.39
9828834,9934861,2274,795900,10730761,8.01
9828835,9936444,4258,1490300,11426744,15.00
9828836,9933973,3179,1112650,11046623,11.20
9828837,6410992,188,65800,6476792,1.03
9828838,9964042,3424,1198400,11162442,12.03
9828839,1199567,387,135450,1335017,11.29
9828840,9943372,4134,1446900,11390272,14.55
9828841,9949943,3848,1346800,11296743,13.54
9828842,9953359,2486,870100,10823459,8.74
9828843,9928879,5806,2032100,11960979,20.47
9828844,9863208,4323,1513050,11376258,15.34
9828845,9950003,4983,1744050,11694053,17.53
9828846,9959947,3006,1052100,11012047,10.56
9828847,9970983,3903,1366050,11337033,13.70
9828848,9971685,4436,1552600,11524285,15.57
9828849,9983785,5427,1899450,11883235,19.03
9828850,9984528,2321,812350,10796878,8.14
9828852,8442146,6098,2134300,10576446,25.28
9828853,9988206,3626,1269100,11257306,12.71
9828854,9991195,4286,1500100,11491295,15.01
9828855,9388109,6038,2113300,11501409,22.51
9828856,9984775,3082,1078700,11063475,10.80
9828857,9994225,3845,1345750,11339975,13.47
9828858,9994011,3973,1390550,11384561,13.91
9828859,9246558,7334,2566900,11813458,27.76
9828860,9993502,3158,1105300,11098802,11.06
9828861,9977812,7572,2650200,12628012,26.56
9828862,9977844,5239,1833650,11811494,18.38
9828863,9979861,4101,1435350,11415211,14.38
9828864,9977541,5392,1887200,11864741,18.91
9828865,9966145,3915,1370250,11336395,13.75
9828866,9945004,4234,1481900,11426904,14.90
9828867,9965378,3275,1146250,11111628,11.50
9828868,2877311,2080,728000,3605311,25.30
9828869,3395580,1114,389900,3785480,11.48
9828870,9936912,3559,1245650,11182562,12.54
9828871,9945174,4089,1431150,11376324,14.39
9828872,9962601,5898,2064300,12026901,20.72
9828873,9960036,2489,871150,10831186,8.75
9828874,9888127,4659,1630650,11518777,16.49
9828875,9983006,2832,991200,10974206,9.93
9828876,9970910,2665,932750,10903660,9.35
9828877,9996671,3977,1391950,11388621,13.92
9828879,9960989,4209,1473150,11434139,14.79
9828880,9976215,4573,1600550,11576765,16.04
9828881,9969494,1459,510650,10480144,5.12
9828882,9992108,5406,1892100,11884208,18.94
9828883,9982561,3926,1374100,11356661,13.77
9828884,9980496,3834,1341900,11322396,13.45
9828885,9986698,2670,934500,10921198,9.36
9828886,9799485,4570,1599500,11398985,16.32
9828887,9982061,2753,963550,10945611,9.65
9828888,9982785,5598,1959300,11942085,19.63
9828889,2447428,541,189350,2636778,7.74
9828890,9965997,1832,641200,10607197,6.43
9828891,9981319,4033,1411550,11392869,14.14
9828892,9986042,6097,2133950,12119992,21.37
9828893,9980545,3325,1163750,11144295,11.66
9828894,1715252,717,250950,1966202,14.63
9828895,9974926,5467,1913450,11888376,19.18
9828896,9995511,4123,1443050,11438561,14.44
9828897,9987671,5741,2009350,11997021,20.12
9828898,1708254,1661,581350,2289604,34.03
9828899,9855981,4068,1423800,11279781,14.45
9828900,9968842,3345,1170750,11139592,11.74
9828901,9981108,4431,1550850,11531958,15.54
9828902,9989012,5200,1820000,11809012,18.22
9828903,9964854,4144,1450400,11415254,14.56
9828904,8251726,3381,1183350,9435076,14.34
9828905,9990990,5654,1978900,11969890,19.81
9828906,9991922,6149,2152150,12144072,21.54
9828907,7507161,1861,651350,8158511,8.68
9828908,9976440,5072,1775200,11751640,17.79
9828909,1390798,646,226100,1616898,16.26
9828910,9957055,3228,1129800,11086855,11.35
9828911,9971649,3310,1158500,11130149,11.62
9828912,9983963,3141,1099350,11083313,11.01
9828913,9977831,5945,2080750,12058581,20.85
9828914,9982489,5656,1979600,11962089,19.83
9828915,9982132,4962,1736700,11718832,17.40
9828916,9979247,4136,1447600,11426847,14.51
9828917,9984872,2793,977550,10962422,9.79
9828918,9987390,3667,1283450,11270840,12.85
9828919,9983859,3138,1098300,11082159,11.00
9828920,9676802,911,318850,9995652,3.29
9828921,9988396,5336,1867600,11855996,18.70
9828922,9569591,3091,1081850,10651441,11.31
9828923,9109816,3597,1258950,10368766,13.82
9828924,9990804,5203,1821050,11811854,18.23
9828925,9976485,4374,1530900,11507385,15.35
9828926,9958294,4424,1548400,11506694,15.55
9828927,9980043,4226,1479100,11459143,14.82
9828928,9983854,5502,1925700,11909554,19.29
9828929,9986241,4939,1728650,11714891,17.31
9828930,9997776,4871,1704850,11702626,17.05
9828931,9977861,3899,1364650,11342511,13.68
9828932,9988554,2155,754250,10742804,7.55
9828933,9973740,4225,1478750,11452490,14.83
9828934,9976233,3791,1326850,11303083,13.30
9828935,9975735,3735,1307250,11282985,13.10
9828936,9973349,3207,1122450,11095799,11.25
9828937,9984428,4444,1555400,11539828,15.58
9828938,9980938,5131,1795850,11776788,17.99
9828939,9883593,3385,1184750,11068343,11.99
9828940,9968479,4621,1617350,11585829,16.22
9828941,9863584,4580,1603000,11466584,16.25
9828942,9966598,3816,1335600,11302198,13.40
9828943,9971909,5273,1845550,11817459,18.51
9828944,9996290,4559,1595650,11591940,15.96
9828945,9972623,3514,1229900,11202523,12.33
9828946,9991831,3226,1129100,11120931,11.30
9828947,5656565,1320,462000,6118565,8.17
9828949,9994966,4928,1724800,11719766,17.26
9828950,9982881,5188,1815800,11798681,18.19
9828951,9983297,4622,1617700,11600997,16.20
9828952,9980659,3660,1281000,11261659,12.83
9828953,9942975,70,24500,9967475,0.25
9828954,9977477,3372,1180200,11157677,11.83
9828955,9995057,1666,583100,10578157,5.83
9828956,6693383,2294,802900,7496283,12.00
9828957,9989883,3588,1255800,11245683,12.57
9828958,9979570,4787,1675450,11655020,16.79
9828959,9990415,2258,790300,10780715,7.91
9828960,9978232,3845,1345750,11323982,13.49
9828961,9993699,4010,1403500,11397199,14.04
9828962,9981503,3582,1253700,11235203,12.56
9828963,9988450,4153,1453550,11442000,14.55
9828964,9985000,2585,904750,10889750,9.06
9828965,9986677,2015,705250,10691927,7.06
9828966,9981257,3811,1333850,11315107,13.36
9828967,9993953,1883,659050,10653003,6.59
9828968,9973938,3745,1310750,11284688,13.14
9828969,9978045,3551,1242850,11220895,12.46
9828970,9986102,4347,1521450,11507552,15.24
9828971,9988419,1565,547750,10536169,5.48
9828972,9995942,3419,1196650,11192592,11.97
9828973,9999975,3718,1301300,11301275,13.01
9828974,8454081,2286,800100,9254181,9.46
9828975,5811117,1315,460250,6271367,7.92
9828976,9988218,3893,1362550,11350768,13.64
9828977,9982523,5504,1926400,11908923,19.30
9828978,9995095,4780,1673000,11668095,16.74
9828979,9969244,4360,1526000,11495244,15.31
9828980,9980465,2346,821100,10801565,8.23
9828981,9996717,4599,1609650,11606367,16.10
9828982,9980899,3438,1203300,11184199,12.06
9828983,9992056,2486,870100,10862156,8.71
9828984,9984033,3693,1292550,11276583,12.95
9828985,9887538,2320,812000,10699538,8.21
9828986,9988475,3889,1361150,11349625,13.63
9828987,9998842,4770,1669500,11668342,16.70
9828988,9987709,4489,1571150,11558859,15.73
9828989,6456988,2396,838600,7295588,12.99
9828990,9983441,3914,1369900,11353341,13.72
9828991,9990637,5111,1788850,11779487,17.91
9828992,9985449,5766,2018100,12003549,20.21
9828993,9995102,2013,704550,10699652,7.05
9828994,9981710,82,28700,10010410,0.29
9828995,9975976,3604,1261400,11237376,12.64
9828996,9979793,3769,1319150,11298943,13.22
9828997,9958442,4958,1735300,11693742,17.43
9828998,9967820,4259,1490650,11458470,14.95
9828999,9972911,4081,1428350,11401261,14.32
9829000,9988869,4815,1685250,11674119,16.87
9829001,9975004,5960,2086000,12061004,20.91
9829002,9986276,5360,1876000,11862276,18.79
9829003,9979746,4961,1736350,11716096,17.40
9829004,9989105,4990,1746500,11735605,17.48
9829005,9982700,4998,1749300,11732000,17.52
9829006,9969632,5603,1961050,11930682,19.67
9829007,9985606,3424,1198400,11184006,12.00
9829008,9968666,5413,1894550,11863216,19.01
9829009,9979976,7293,2552550,12532526,25.58
9829010,9965766,6864,2402400,12368166,24.11
9829011,9967135,3074,1075900,11043035,10.79
9829012,9964514,3740,1309000,11273514,13.14
9829013,9959590,3807,1332450,11292040,13.38
9829014,9950641,4790,1676500,11627141,16.85
9829015,9947043,3310,1158500,11105543,11.65
9829016,9968473,4589,1606150,11574623,16.11
9829017,9962612,3693,1292550,11255162,12.97
9829018,9969480,4483,1569050,11538530,15.74
9829019,9986613,5482,1918700,11905313,19.21
9829020,9949091,5690,1991500,11940591,20.02
9829021,9985840,4104,1436400,11422240,14.38
9829022,9983934,6290,2201500,12185434,22.05
9829023,2456237,1811,633850,3090087,25.81
9829024,9983696,6334,2216900,12200596,22.21
9829025,9981962,5744,2010400,11992362,20.14
9829026,9994215,5558,1945300,11939515,19.46
9829027,9970813,6042,2114700,12085513,21.21
9829028,9979542,4941,1729350,11708892,17.33
9829030,9989909,54,18900,10008809,0.19
9829031,9986319,3586,1255100,11241419,12.57
9829032,9976471,6408,2242800,12219271,22.48
9829033,9982175,3191,1116850,11099025,11.19
9829034,9994405,3649,1277150,11271555,12.78
9829035,9973655,3251,1137850,11111505,11.41
9829036,5873425,4471,1564850,7438275,26.64
9829037,9980925,4717,1650950,11631875,16.54
9829038,9992419,5648,1976800,11969219,19.78
9829039,9981182,4181,1463350,11444532,14.66
9829040,9974262,4718,1651300,11625562,16.56
9829041,4667360,1935,677250,5344610,14.51
9829042,9970919,2673,935550,10906469,9.38
9829043,9995887,4171,1459850,11455737,14.60
9829044,9978710,3255,1139250,11117960,11.42
9829045,9976393,5716,2000600,11976993,20.05
9829046,9959323,5434,1901900,11861223,19.10
9829047,9965714,3132,1096200,11061914,11.00
9829048,9966149,4467,1563450,11529599,15.69
9829049,9987754,3767,1318450,11306204,13.20
9829050,9991480,4618,1616300,11607780,16.18
9829051,9981764,3472,1215200,11196964,12.17
9829052,7657377,931,325850,7983227,4.26
9829054,9802352,5180,1813000,11615352,18.50
9829055,9995357,3193,1117550,11112907,11.18
9829056,1673814,806,282100,1955914,16.85
9829057,9969034,3316,1160600,11129634,11.64
9829058,9986480,2554,893900,10880380,8.95
9829059,9987466,5827,2039450,12026916,20.42
9829060,9991623,5171,1809850,11801473,18.11
9829061,9985069,2966,1038100,11023169,10.40
9829062,9981804,3713,1299550,11281354,13.02
9829063,9995582,2519,881650,10877232,8.82
9829064,9979843,4888,1710800,11690643,17.14
9829066,9952824,3558,1245300,11198124,12.51
9829067,9948028,4797,1678950,11626978,16.88
9829068,9959359,3491,1221850,11181209,12.27
9829069,9955538,1659,580650,10536188,5.83
9829070,9936650,5360,1876000,11812650,18.88
9829071,9928737,4309,1508150,11436887,15.19
9829072,9941208,3642,1274700,11215908,12.82
9829073,9918656,3592,1257200,11175856,12.68
9829074,9950254,4346,1521100,11471354,15.29
9829075,3609069,2925,1023750,4632819,28.37
9829076,9940913,4454,1558900,11499813,15.68
9829077,9973787,3773,1320550,11294337,13.24
9829078,9962361,2136,747600,10709961,7.50
9829079,9965102,2905,1016750,10981852,10.20
9829080,9977304,3841,1344350,11321654,13.47
9829081,9989932,2921,1022350,11012282,10.23
9829082,6016157,1382,483700,6499857,8.04
9829083,9986853,6023,2108050,12094903,21.11
9829084,9993149,3967,1388450,11381599,13.89
9829085,9970375,4199,1469650,11440025,14.74
9829086,9974872,4343,1520050,11494922,15.24
9829087,9982412,3394,1187900,11170312,11.90
9829088,9976846,4422,1547700,11524546,15.51
9829089,9962785,5844,2045400,12008185,20.53
9829090,5936982,1657,579950,6516932,9.77
9829091,9961022,5720,2002000,11963022,20.10
9829092,1409395,1085,379750,1789145,26.94
9829093,9965582,4002,1400700,11366282,14.06
9829094,9958920,4467,1563450,11522370,15.70
9829096,9974831,4403,1541050,11515881,15.45
9829097,9976993,4826,1689100,11666093,16.93
9829098,9987747,5138,1798300,11786047,18.01
9829099,9976396,3502,1225700,11202096,12.29
9829100,9996281,5554,1943900,11940181,19.45
9829101,9997101,4300,1505000,11502101,15.05
9829102,9982559,4686,1640100,11622659,16.43
9829103,9998556,2961,1036350,11034906,10.36
9829104,9992532,2221,777350,10769882,7.78
9829105,9981562,4365,1527750,11509312,15.31
9829106,9982653,5801,2030350,12013003,20.34
9829107,9991839,4021,1407350,11399189,14.08
9829108,9986641,2034,711900,10698541,7.13
9829109,9984185,1814,634900,10619085,6.36
9829110,9984325,4129,1445150,11429475,14.47
9829113,9976493,61,21350,9997843,0.21
9829114,9971384,2321,812350,10783734,8.15
9829115,9989587,2402,840700,10830287,8.42
9829116,9995148,5792,2027200,12022348,20.28
9829117,9993878,4084,1429400,11423278,14.30
9829118,9973893,4445,1555750,11529643,15.60
9829119,9989510,2531,885850,10875360,8.87
9829120,9993219,4858,1700300,11693519,17.01
9829121,9986875,3395,1188250,11175125,11.90
9829122,2769786,2747,961450,3731236,34.71
9829123,9972314,4613,1614550,11586864,16.19
9829124,9973344,3183,1114050,11087394,11.17
9829125,9972844,3177,1111950,11084794,11.15
9829126,9949803,4588,1605800,11555603,16.14
9829127,8963478,2320,812000,9775478,9.06
9829128,9972993,3210,1123500,11096493,11.27
9829129,9961266,5504,1926400,11887666,19.34
9829130,9942573,4016,1405600,11348173,14.14
9829131,9948368,4497,1573950,11522318,15.82
9829132,9441537,4048,1416800,10858337,15.01
9829133,9940917,2896,1013600,10954517,10.20
9829134,9923347,3581,1253350,11176697,12.63
9829135,9922860,3640,1274000,11196860,12.84
9829136,9921579,3974,1390900,11312479,14.02
9829137,9923532,3481,1218350,11141882,12.28
9829138,9920464,5220,1827000,11747464,18.42
9829139,9940526,4357,1524950,11465476,15.34
9829140,9939620,2670,934500,10874120,9.40
9829141,9962599,5725,2003750,11966349,20.11
9829142,9820394,5607,1962450,11782844,19.98
9829143,9967652,6268,2193800,12161452,22.01
9829144,9964684,3574,1250900,11215584,12.55
9829145,9982602,5894,2062900,12045502,20.66
9829146,9984073,4794,1677900,11661973,16.81
9829147,9976153,3623,1268050,11244203,12.71
9829148,9986612,5058,1770300,11756912,17.73
9829149,9973826,5051,1767850,11741676,17.72
9829150,9950059,2774,970900,10920959,9.76
9829151,9954725,4069,1424150,11378875,14.31
9829152,9957960,5914,2069900,12027860,20.79
9829153,9962703,3635,1272250,11234953,12.77
9829154,9752993,3357,1174950,10927943,12.05
9829156,9954905,5878,2057300,12012205,20.67
9829157,9975339,7720,2702000,12677339,27.09
9829158,9982891,4274,1495900,11478791,14.98
9829159,9991429,6060,2121000,12112429,21.23
9829160,3491680,1401,490350,3982030,14.04
9829161,9987621,2475,866250,10853871,8.67
9829162,5776605,2040,714000,6490605,12.36
9829163,9977880,4262,1491700,11469580,14.95
9829164,2787314,1801,630350,3417664,22.61
9829165,9983481,5707,1997450,11980931,20.01
9829166,9992888,4013,1404550,11397438,14.06
9829167,9992161,3794,1327900,11320061,13.29
9829168,9580254,3383,1184050,10764304,12.36
9829169,9974089,5884,2059400,12033489,20.65
9829170,9980044,5120,1792000,11772044,17.96
9829171,9980243,5526,1934100,11914343,19.38
9829172,9982191,3278,1147300,11129491,11.49
9829173,9984856,5329,1865150,11850006,18.68
9829174,9996855,4087,1430450,11427305,14.31
9829175,9993448,6251,2187850,12181298,21.89
9829176,9989481,4425,1548750,11538231,15.50
9829177,9979742,2739,958650,10938392,9.61
9829178,9958963,3259,1140650,11099613,11.45
9829179,9842077,5061,1771350,11613427,18.00
9829180,9712637,1204,421400,10134037,4.34
9829181,9981867,3677,1286950,11268817,12.89
9829182,9972259,4925,1723750,11696009,17.29
9829183,9985949,4776,1671600,11657549,16.74
9829184,9982568,2775,971250,10953818,9.73
9829185,9996448,2723,953050,10949498,9.53
9829186,9839508,3738,1308300,11147808,13.30
9829187,9979550,7431,2600850,12580400,26.06
9829188,9986267,3295,1153250,11139517,11.55
9829189,9988959,5714,1999900,11988859,20.02
9829190,9984648,3623,1268050,11252698,12.70
9829191,9999909,3216,1125600,11125509,11.26
9829192,9988937,4071,1424850,11413787,14.26
9829193,9973509,3771,1319850,11293359,13.23
9829194,9974262,5920,2072000,12046262,20.77
9829195,9993997,4680,1638000,11631997,16.39
9829196,9993901,2595,908250,10902151,9.09
9829197,9988790,2913,1019550,11008340,10.21
9829198,9986371,4216,1475600,11461971,14.78
9829199,9984392,5263,1842050,11826442,18.45
9829200,9996453,3967,1388450,11384903,13.89
9829202,9983206,4843,1695050,11678256,16.98
9829203,9994716,8192,2867200,12861916,28.69
9829204,9996588,2911,1018850,11015438,10.19
9829205,9976823,5202,1820700,11797523,18.25
9829206,9970751,2990,1046500,11017251,10.50
9829207,9978753,3653,1278550,11257303,12.81
9829208,9980845,4296,1503600,11484445,15.06
9829209,3084630,1658,580300,3664930,18.81
9829210,9972823,4971,1739850,11712673,17.45
9829211,9961549,4053,1418550,11380099,14.24
9829212,9954006,4775,1671250,11625256,16.79
9829213,9991959,4508,1577800,11569759,15.79
9829214,9981555,3017,1055950,11037505,10.58
9829215,9996880,3401,1190350,11187230,11.91
9829217,9979524,5373,1880550,11860074,18.84
9829218,9644543,3734,1306900,10951443,13.55
9829219,9988590,4334,1516900,11505490,15.19
9829220,9978764,5655,1979250,11958014,19.83
9829221,9978146,6541,2289350,12267496,22.94
9829222,9985331,3792,1327200,11312531,13.29
9829223,9984959,2815,985250,10970209,9.87
9829224,9985362,2421,847350,10832712,8.49
9829225,9961220,4459,1560650,11521870,15.67
9829226,7060779,2815,985250,8046029,13.95
9829227,9994022,2785,974750,10968772,9.75
9829228,9982174,2841,994350,10976524,9.96
9829229,9982250,3864,1352400,11334650,13.55
9829230,9986468,3426,1199100,11185568,12.01
9829231,9992266,3620,1267000,11259266,12.68
9829232,9981934,1999,699650,10681584,7.01
9829233,9996141,3838,1343300,11339441,13.44
9829234,9983406,1990,696500,10679906,6.98
9829235,9988552,2913,1019550,11008102,10.21
9829236,9983314,3801,1330350,11313664,13.33
9829237,9994997,4892,1712200,11707197,17.13
9829238,9981958,4405,1541750,11523708,15.45
9829239,9980301,3924,1373400,11353701,13.76
9829240,9976052,4269,1494150,11470202,14.98
9829241,9992151,3014,1054900,11047051,10.56
9829242,9987909,5641,1974350,11962259,19.77
9829243,9981688,3454,1208900,11190588,12.11
9829245,9968422,3789,1326150,11294572,13.30
9829246,9739509,4797,1678950,11418459,17.24
9829248,1323747,500,175000,1498747,13.22
9829249,9975550,3020,1057000,11032550,10.60
9829250,9974042,3295,1153250,11127292,11.56
9829251,9986716,5218,1826300,11813016,18.29
9829252,9979102,6026,2109100,12088202,21.14
9829253,9976406,4896,1713600,11690006,17.18
9829254,3989527,2996,1048600,5038127,26.28
9829255,9985617,4578,1602300,11587917,16.05
9829256,9982981,4004,1401400,11384381,14.04
9829257,1793041,931,325850,2118891,18.17
9829258,9988521,4320,1512000,11500521,15.14
9829259,9991673,5220,1827000,11818673,18.29
9829260,9985933,5116,1790600,11776533,17.93
9829261,9976212,4460,1561000,11537212,15.65
9829262,9986260,3213,1124550,11110810,11.26
9829263,9956475,5768,2018800,11975275,20.28
9829264,9999266,4262,1491700,11490966,14.92
9829265,9981700,3075,1076250,11057950,10.78
9829266,4092811,2304,806400,4899211,19.70
9829267,9979059,2945,1030750,11009809,10.33
9829268,5770427,4017,1405950,7176377,24.36
9829269,9978290,2990,1046500,11024790,10.49
9829270,9975235,3493,1222550,11197785,12.26
9829271,9993721,2039,713650,10707371,7.14
9829272,9988795,4325,1513750,11502545,15.15
9829273,9987112,2247,786450,10773562,7.87
9829274,9971817,3145,1100750,11072567,11.04
9829275,9977722,4306,1507100,11484822,15.10
9829276,9977858,1734,606900,10584758,6.08
9829277,9968775,1762,616700,10585475,6.19
9829278,9967522,4383,1534050,11501572,15.39
9829279,9963032,5058,1770300,11733332,17.77
9829280,9986204,3807,1332450,11318654,13.34
9829281,9978658,4085,1429750,11408408,14.33
9829282,9961919,3458,1210300,11172219,12.15
9829283,9955194,4452,1558200,11513394,15.65
9829284,9949620,3118,1091300,11040920,10.97
9829285,9961042,2590,906500,10867542,9.10
9829286,9865299,4263,1492050,11357349,15.12
9829287,8081692,1449,507150,8588842,6.28
9829288,9931311,2572,900200,10831511,9.06
9829289,9925357,1929,675150,10600507,6.80
9829290,9945240,1653,578550,10523790,5.82
9829291,9921910,3042,1064700,10986610,10.73
9829292,9845946,3762,1316700,11162646,13.37
9829293,9924623,4445,1555750,11480373,15.68
9829294,9941791,5149,1802150,11743941,18.13
9829295,9937007,6004,2101400,12038407,21.15
9829296,9958646,5912,2069200,12027846,20.78
9829297,9956339,426,149100,10105439,1.50
9829298,9949024,1124,393400,10342424,3.95
9829299,9942661,1954,683900,10626561,6.88
9829300,1240691,465,162750,1403441,13.12
9829301,9958441,1382,483700,10442141,4.86
9829302,9928942,4518,1581300,11510242,15.93
9829303,9958429,5313,1859550,11817979,18.67
9829304,6446503,3310,1158500,7605003,17.97
9829305,9957235,3948,1381800,11339035,13.88
9829306,9969172,5215,1825250,11794422,18.31
9829307,9976945,1910,668500,10645445,6.70
9829308,6424972,3686,1290100,7715072,20.08
9829309,9986450,1768,618800,10605250,6.20
9829310,9981069,2596,908600,10889669,9.10
9829311,9974759,4332,1516200,11490959,15.20
9829312,9979281,4089,1431150,11410431,14.34
9829313,9979082,2087,730450,10709532,7.32
9829314,6578561,3745,1310750,7889311,19.92
9829315,9988725,4967,1738450,11727175,17.40
9829316,9969173,4428,1549800,11518973,15.55
9829317,9975882,2634,921900,10897782,9.24
9829318,1040152,484,169400,1209552,16.29
9829319,9959890,5182,1813700,11773590,18.21
9829320,9955029,3721,1302350,11257379,13.08
9829321,9960602,2949,1032150,10992752,10.36
9829322,9968083,3603,1261050,11229133,12.65
9829323,9201623,1494,522900,9724523,5.68
9829324,9937027,4000,1400000,11337027,14.09
9829325,9944979,4803,1681050,11626029,16.90
9829326,9949379,4337,1517950,11467329,15.26
9829327,7859545,1980,693000,8552545,8.82
9829328,6272974,839,293650,6566624,4.68
9829329,6320991,1687,590450,6911441,9.34
9829330,5445985,1682,588700,6034685,10.81
9829331,681384,463,162050,843434,23.78
9829332,9964449,3228,1129800,11094249,11.34
9829333,9948827,2357,824950,10773777,8.29
9829334,9959740,3786,1325100,11284840,13.30
9829335,9961896,2326,814100,10775996,8.17
9829336,9956887,4451,1557850,11514737,15.65
9829337,9971905,3683,1289050,11260955,12.93
9829338,9976478,2197,768950,10745428,7.71
9829339,9965822,3117,1090950,11056772,10.95
9829340,9985713,4311,1508850,11494563,15.11
9829342,9986119,5048,1766800,11752919,17.69
9829343,9984479,2918,1021300,11005779,10.23
9829344,9968791,3918,1371300,11340091,13.76
9829345,9960176,3839,1343650,11303826,13.49
9829346,9967487,5253,1838550,11806037,18.45
9829347,9964457,3290,1151500,11115957,11.56
9829348,9973525,1775,621250,10594775,6.23
9829349,9461722,4141,1449350,10911072,15.32
9829350,9956526,1119,391650,10348176,3.93
9829351,9969742,3872,1355200,11324942,13.59
9829352,9155770,3313,1159550,10315320,12.66
9829353,9973471,1295,453250,10426721,4.54
9829354,4986012,2189,766150,5752162,15.37
9829355,9967842,4172,1460200,11428042,14.65
9829356,9979663,1766,618100,10597763,6.19
9829357,9982092,2800,980000,10962092,9.82
9829358,9997933,3691,1291850,11289783,12.92
9829359,9984658,3258,1140300,11124958,11.42
9829360,9976987,4648,1626800,11603787,16.31
9829361,9989895,1072,375200,10365095,3.76
9829363,9987895,1784,624400,10612295,6.25
9829364,9996457,1545,540750,10537207,5.41
9829365,9998073,3543,1240050,11238123,12.40
9829366,9976890,3457,1209950,11186840,12.13
9829367,9987706,2174,760900,10748606,7.62
9829368,9978361,2036,712600,10690961,7.14
9829369,9997585,2213,774550,10772135,7.75
9829370,9990841,2861,1001350,10992191,10.02
9829371,8792871,2480,868000,9660871,9.87
9829372,1066730,540,189000,1255730,17.72
9829373,2958174,1416,495600,3453774,16.75
9829374,9957540,3986,1395100,11352640,14.01
9829375,9968413,3203,1121050,11089463,11.25
9829376,9956144,2518,881300,10837444,8.85
9829377,9935027,1352,473200,10408227,4.76
9829378,9954571,3858,1350300,11304871,13.56
9829379,8927184,4478,1567300,10494484,17.56
9829380,9973518,3270,1144500,11118018,11.48
9829381,9967376,5933,2076550,12043926,20.83
9829382,5082884,2421,847350,5930234,16.67
9829383,9965531,1421,497350,10462881,4.99
9829384,7214671,1820,637000,7851671,8.83
9829385,9979747,3731,1305850,11285597,13.09
9829386,9986610,1718,601300,10587910,6.02
9829387,9986277,1382,483700,10469977,4.84
9829388,9994112,1282,448700,10442812,4.49
9829389,3191579,870,304500,3496079,9.54
9829390,9978135,2442,854700,10832835,8.57
9829391,9981315,6778,2372300,12353615,23.77
9829392,9973337,5244,1835400,11808737,18.40
9829393,9979280,2429,850150,10829430,8.52
9829394,9967749,4512,1579200,11546949,15.84
9829395,9976507,5656,1979600,11956107,19.84
9829396,9987040,5115,1790250,11777290,17.93
9829397,6671138,1529,535150,7206288,8.02
9829398,9993642,2482,868700,10862342,8.69
9829399,9990699,6173,2160550,12151249,21.63
9829400,9980774,2546,891100,10871874,8.93
9829401,9984419,4250,1487500,11471919,14.90
9829402,9972138,1958,685300,10657438,6.87
9829403,9998626,2463,862050,10860676,8.62
9829404,9989713,3545,1240750,11230463,12.42
9829405,9993509,2279,797650,10791159,7.98
9829406,9974487,2653,928550,10903037,9.31
9829407,9592938,3422,1197700,10790638,12.49
9829408,9962680,3277,1146950,11109630,11.51
9829409,9960407,3876,1356600,11317007,13.62
9829410,9971140,2606,912100,10883240,9.15
9829411,9965062,4548,1591800,11556862,15.97
9829412,2440623,883,309050,2749673,12.66
9829414,9956846,2924,1023400,10980246,10.28
9829415,9963212,2795,978250,10941462,9.82
9829416,9967437,3176,1111600,11079037,11.15
9829417,9960270,3196,1118600,11078870,11.23
9829418,9970694,5107,1787450,11758144,17.93
9829419,9986754,2962,1036700,11023454,10.38
9829420,9984871,3810,1333500,11318371,13.36
9829421,9983161,2459,860650,10843811,8.62
9829422,4114239,2024,708400,4822639,17.22
9829423,9977002,4737,1657950,11634952,16.62
9829424,9987055,3400,1190000,11177055,11.92
9829425,9732652,4559,1595650,11328302,16.39
9829426,9999645,4523,1583050,11582695,15.83
9829427,9988912,4276,1496600,11485512,14.98
9829428,9955598,2702,945700,10901298,9.50
9829429,9968334,4256,1489600,11457934,14.94
9829430,9968103,3285,1149750,11117853,11.53
9829431,9965717,4225,1478750,11444467,14.84
9829432,1422656,569,199150,1621806,14.00
9829433,9705967,3722,1302700,11008667,13.42
9829434,9979384,5291,1851850,11831234,18.56
9829435,245940,185,64750,310690,26.33
9829436,9979654,4051,1417850,11397504,14.21
9829437,9983191,2722,952700,10935891,9.54
9829438,9978384,3362,1176700,11155084,11.79
9829439,9965859,3282,1148700,11114559,11.53
9829440,9987970,1236,432600,10420570,4.33
9829441,606143,237,82950,689093,13.68
9829442,9991310,2289,801150,10792460,8.02
9829443,9986652,6114,2139900,12126552,21.43
9829444,9974927,3706,1297100,11272027,13.00
9829445,9973822,3491,1221850,11195672,12.25
9829446,5218475,878,307300,5525775,5.89
9829447,8959401,3824,1338400,10297801,14.94
9829448,9983540,3642,1274700,11258240,12.77
9829449,9991337,3975,1391250,11382587,13.92
9829450,9987558,5105,1786750,11774308,17.89
9829451,9980299,3962,1386700,11366999,13.89
9829453,9971376,1153,403550,10374926,4.05
9829454,3418420,1061,371350,3789770,10.86
9829455,9974197,5100,1785000,11759197,17.90
9829456,9983061,3990,1396500,11379561,13.99
9829457,9964866,3865,1352750,11317616,13.58
9829458,9978546,3201,1120350,11098896,11.23
9829459,9978575,3128,1094800,11073375,10.97
9829460,9990416,2114,739900,10730316,7.41
9829461,9981159,4316,1510600,11491759,15.13
9829462,9976015,3330,1165500,11141515,11.68
9829463,1110740,426,149100,1259840,13.42
9829464,9959765,3406,1192100,11151865,11.97
9829465,9960047,6129,2145150,12105197,21.54
9829467,9966024,3667,1283450,11249474,12.88
9829468,9972065,4466,1563100,11535165,15.67
9829469,9967134,3302,1155700,11122834,11.60
9829470,9976054,3501,1225350,11201404,12.28
9829471,9982562,3409,1193150,11175712,11.95
9829472,9998335,2727,954450,10952785,9.55
9829473,9987709,3867,1353450,11341159,13.55
9829474,9995049,3159,1105650,11100699,11.06
9829475,123176,21,7350,130526,5.97
9829476,2294247,785,274750,2568997,11.98
9829477,4084448,1675,586250,4670698,14.35
9829478,9977651,3017,1055950,11033601,10.58
9829479,9827916,5289,1851150,11679066,18.84
9829480,9986679,2715,950250,10936929,9.52
9829481,9999416,1955,684250,10683666,6.84
9829482,9988665,6907,2417450,12406115,24.20
9829483,9982288,3492,1222200,11204488,12.24
9829484,9970755,3142,1099700,11070455,11.03
9829485,9983162,3673,1285550,11268712,12.88
9829486,9969690,5598,1959300,11928990,19.65
9829487,9983761,3442,1204700,11188461,12.07
9829488,9973786,3848,1346800,11320586,13.50
9829489,9989092,5267,1843450,11832542,18.45
9829490,9982921,4707,1647450,11630371,16.50
9829491,9993179,3844,1345400,11338579,13.46
9829492,9699795,4812,1684200,11383995,17.36
9829493,9995438,3253,1138550,11133988,11.39
9829494,9983066,4742,1659700,11642766,16.63
9829495,9987552,3719,1301650,11289202,13.03
9829496,9974260,4776,1671600,11645860,16.76
9829497,9994875,4815,1685250,11680125,16.86
9829498,9979429,5792,2027200,12006629,20.31
9829499,9996319,2530,885500,10881819,8.86
9829500,4937850,1765,617750,5555600,12.51
9829501,9995912,3666,1283100,11279012,12.84
9829502,9953771,4288,1500800,11454571,15.08
9829503,9994553,3405,1191750,11186303,11.92
9829505,9959828,4268,1493800,11453628,15.00
9829506,9982215,3249,1137150,11119365,11.39
9829507,9982912,5088,1780800,11763712,17.84
9829508,922309,300,105000,1027309,11.38
9829509,9723835,4613,1614550,11338385,16.60
9829510,9985384,3115,1090250,11075634,10.92
9829511,9987810,2329,815150,10802960,8.16
9829512,9999813,582,203700,10203513,2.04
9829513,9993221,6754,2363900,12357121,23.66
9829514,9998649,5966,2088100,12086749,20.88
9829515,9966890,2930,1025500,10992390,10.29
9829516,9974192,5177,1811950,11786142,18.17
9829517,7749562,2552,893200,8642762,11.53
9829518,9992695,3773,1320550,11313245,13.22
9829519,9974692,3110,1088500,11063192,10.91
9829520,9988038,3808,1332800,11320838,13.34
9829521,7326050,2048,716800,8042850,9.78
9829522,9984478,4477,1566950,11551428,15.69
9829523,9981208,2508,877800,10859008,8.79
9829524,9988962,2961,1036350,11025312,10.37
9829526,5287447,1258,440300,5727747,8.33
9829527,9982517,2988,1045800,11028317,10.48
9829528,9986424,4063,1422050,11408474,14.24
9829529,9981769,3979,1392650,11374419,13.95
9829530,1680303,2007,702450,2382753,41.80
9829531,9971438,4394,1537900,11509338,15.42
9829532,9985772,7155,2504250,12490022,25.08
9829533,9987390,2331,815850,10803240,8.17
9829534,9989285,2301,805350,10794635,8.06
9829535,9989722,5147,1801450,11791172,18.03
9829536,8883602,4523,1583050,10466652,17.82
9829538,9980069,4799,1679650,11659719,16.83
9829539,9976194,5759,2015650,11991844,20.20
9829540,9987813,2118,741300,10729113,7.42
9829541,9998851,2153,753550,10752401,7.54
9829542,9997859,1492,522200,10520059,5.22
9829543,9988331,1518,531300,10519631,5.32
9829544,9961290,3000,1050000,11011290,10.54
9829545,8871109,3988,1395800,10266909,15.73
9829546,9985191,3585,1254750,11239941,12.57
9829547,9980799,3153,1103550,11084349,11.06
9829548,9979017,4053,1418550,11397567,14.22
9829549,9983691,2475,866250,10849941,8.68
9829550,9994112,3294,1152900,11147012,11.54
9829551,9989404,439,153650,10143054,1.54
9829552,9985599,847,296450,10282049,2.97
9829553,4998908,1872,655200,5654108,13.11
9829554,9992562,2942,1029700,11022262,10.30
9829555,9997080,5141,1799350,11796430,18.00
9829556,9971139,3394,1187900,11159039,11.91
9829557,9964247,3851,1347850,11312097,13.53
9829558,9989865,5639,1973650,11963515,19.76
9829559,9979156,4609,1613150,11592306,16.17
9829560,9999225,3965,1387750,11386975,13.88
9829561,9974533,4450,1557500,11532033,15.61
9829562,6027369,2446,856100,6883469,14.20
9829563,9952830,4465,1562750,11515580,15.70
9829564,9979504,5297,1853950,11833454,18.58
9829565,9908376,3091,1081850,10990226,10.92
9829566,9989931,3627,1269450,11259381,12.71
9829567,9980446,3636,1272600,11253046,12.75
9829568,9976541,4909,1718150,11694691,17.22
9829569,9997592,4282,1498700,11496292,14.99
9829570,9981461,3289,1151150,11132611,11.53
9829571,9977522,1801,630350,10607872,6.32
9829572,9976946,2859,1000650,10977596,10.03
9829573,9994903,3375,1181250,11176153,11.82
9829574,9999620,5731,2005850,12005470,20.06
9829575,9987610,5027,1759450,11747060,17.62
9829576,9985382,3284,1149400,11134782,11.51
9829577,9975595,2235,782250,10757845,7.84
9829578,9976595,2327,814450,10791045,8.16
9829579,1776208,794,277900,2054108,15.65
9829580,9980022,3562,1246700,11226722,12.49
9829581,3781909,1860,651000,4432909,17.21
9829582,9967170,4965,1737750,11704920,17.43
9829583,9973070,2962,1036700,11009770,10.39
9829584,9979504,3286,1150100,11129604,11.52
9829585,7002695,1334,466900,7469595,6.67
9829586,9989749,1688,590800,10580549,5.91
9829587,9993145,1957,684950,10678095,6.85
9829588,9976633,3709,1298150,11274783,13.01
9829589,9988450,2202,770700,10759150,7.72
9829590,9986175,3308,1157800,11143975,11.59
9829591,9977981,4776,1671600,11649581,16.75
9829592,9979493,2287,800450,10779943,8.02
9829593,7635441,1038,363300,7998741,4.76
9829594,9974522,1506,527100,10501622,5.28
9829595,9971563,4908,1717800,11689363,17.23
9829596,9999981,4412,1544200,11544181,15.44
9829597,9978096,4637,1622950,11601046,16.27
9829598,9987072,2767,968450,10955522,9.70
9829599,9989763,3223,1128050,11117813,11.29
9829600,9985921,4974,1740900,11726821,17.43
9829601,9990744,2165,757750,10748494,7.58
9829602,9985123,2150,752500,10737623,7.54
9829603,9988675,2678,937300,10925975,9.38
9829604,5730976,2973,1040550,6771526,18.16
9829606,3404744,1010,353500,3758244,10.38
9829607,9960051,4354,1523900,11483951,15.30
9829608,9982005,4007,1402450,11384455,14.05
9829609,9981938,3600,1260000,11241938,12.62
9829610,9959435,3976,1391600,11351035,13.97
9829611,9968633,2862,1001700,10970333,10.05
9829612,832861,273,95550,928411,11.47
9829613,9735529,2543,890050,10625579,9.14
9829614,1082304,249,87150,1169454,8.05
9829615,9957905,5118,1791300,11749205,17.99
9829616,9965092,3222,1127700,11092792,11.32
9829617,359834,71,24850,384684,6.91
9829618,9955567,3179,1112650,11068217,11.18
9829619,9978596,3469,1214150,11192746,12.17
9829620,2389172,1474,515900,2905072,21.59
9829621,9975069,5629,1970150,11945219,19.75
9829622,9987071,3267,1143450,11130521,11.45
9829623,9993061,3401,1190350,11183411,11.91
9829624,9974185,2698,944300,10918485,9.47
9829625,9975524,1867,653450,10628974,6.55
9829626,1793323,651,227850,2021173,12.71
9829627,9973803,2383,834050,10807853,8.36
9829628,9975390,2337,817950,10793340,8.20
9829629,7449286,1663,582050,8031336,7.81
9829630,9993814,5158,1805300,11799114,18.06
9829631,9984554,5528,1934800,11919354,19.38
9829632,9933144,4699,1644650,11577794,16.56
9829633,9996239,3402,1190700,11186939,11.91
9829634,9986691,4434,1551900,11538591,15.54
9829635,9974230,3127,1094450,11068680,10.97
9829636,9956550,5295,1853250,11809800,18.61
9829637,9961395,326,114100,10075495,1.15
9829638,9967236,2413,844550,10811786,8.47
9829639,9982876,1845,645750,10628626,6.47
9829640,9978372,4186,1465100,11443472,14.68
9829641,9975033,4059,1420650,11395683,14.24
9829642,9998986,2696,943600,10942586,9.44
9829643,9998204,2741,959350,10957554,9.60
9829644,9978453,7187,2515450,12493903,25.21
9829645,9981503,3153,1103550,11085053,11.06
9829646,9984223,867,303450,10287673,3.04
9829647,9980513,3836,1342600,11323113,13.45
9829648,9981840,2317,810950,10792790,8.12
9829649,9833498,1692,592200,10425698,6.02
9829650,9977534,1236,432600,10410134,4.34
9829651,9987579,3102,1085700,11073279,10.87
9829652,9974835,1572,550200,10525035,5.52
9829653,9982314,1017,355950,10338264,3.57
9829654,9979570,705,246750,10226320,2.47
9829655,9987147,4066,1423100,11410247,14.25
9829656,9979022,1583,554050,10533072,5.55
9829657,9986080,947,331450,10317530,3.32
9829658,9983752,428,149800,10133552,1.50
9829659,8985477,4066,1423100,10408577,15.84
9829660,9975980,2701,945350,10921330,9.48
9829661,9969038,931,325850,10294888,3.27
9829662,9943782,741,259350,10203132,2.61
9829663,9970924,1098,384300,10355224,3.85
9829664,9989161,2566,898100,10887261,8.99
9829665,9989413,3372,1180200,11169613,11.81
9829666,9995804,2227,779450,10775254,7.80
9829667,9993918,4617,1615950,11609868,16.17
9829668,9999358,4284,1499400,11498758,14.99
9829669,1445441,458,160300,1605741,11.09
9829670,280426,150,52500,332926,18.72
9829671,9930658,1140,399000,10329658,4.02
9829672,1319041,607,212450,1531491,16.11
9829673,9965575,1414,494900,10460475,4.97
9829674,9961778,4775,1671250,11633028,16.78
9829675,9948096,556,194600,10142696,1.96
9829676,9970700,3184,1114400,11085100,11.18
9829677,9947197,2555,894250,10841447,8.99
9829678,9962348,3412,1194200,11156548,11.99
9829679,9951077,4413,1544550,11495627,15.52
9829680,7684157,4380,1533000,9217157,19.95
9829681,9939380,3635,1272250,11211630,12.80
9829682,5838929,3098,1084300,6923229,18.57
9829683,9974103,2968,1038800,11012903,10.41
9829684,9969570,3474,1215900,11185470,12.20
9829685,9972856,2376,831600,10804456,8.34
9829686,9972170,5290,1851500,11823670,18.57
9829687,8412455,2649,927150,9339605,11.02
9829688,9986740,4171,1459850,11446590,14.62
9829689,9980763,4375,1531250,11512013,15.34
9829690,9973083,2945,1030750,11003833,10.34
9829691,9985499,6399,2239650,12225149,22.43
9829693,2359642,2117,740950,3100592,31.40
9829694,9932144,5190,1816500,11748644,18.29
9829695,9930707,4912,1719200,11649907,17.31
9829696,1071001,516,180600,1251601,16.86
9829697,9960805,4384,1534400,11495205,15.40
9829698,9983986,2987,1045450,11029436,10.47
9829699,9985997,2564,897400,10883397,8.99
9829700,9996864,3358,1175300,11172164,11.76
9829701,7667426,3010,1053500,8720926,13.74
9829702,9971763,2715,950250,10922013,9.53
9829703,9997434,3618,1266300,11263734,12.67
9829704,9985633,5281,1848350,11833983,18.51
9829705,9936320,4580,1603000,11539320,16.13
9829706,9980125,2940,1029000,11009125,10.31
9829707,2509991,895,313250,2823241,12.48
9829709,4685687,1341,469350,5155037,10.02
9829710,9958440,3237,1132950,11091390,11.38
9829711,9955990,2520,882000,10837990,8.86
9829712,9960720,1906,667100,10627820,6.70
9829713,9932066,5785,2024750,11956816,20.39
9829714,9941955,6914,2419900,12361855,24.34
9829715,9946454,4148,1451800,11398254,14.60
9829716,9967200,5840,2044000,12011200,20.51
9829717,9963660,4553,1593550,11557210,15.99
9829718,9969880,4485,1569750,11539630,15.74
9829719,9962575,3254,1138900,11101475,11.43
9829720,9971774,4226,1479100,11450874,14.83
9829721,9977784,3437,1202950,11180734,12.06
9829722,9902556,3363,1177050,11079606,11.89
9829723,9968569,3545,1240750,11209319,12.45
9829724,5619964,1167,408450,6028414,7.27
9829725,9991638,3677,1286950,11278588,12.88
9829726,7569171,1029,360150,7929321,4.76
9829727,9966898,4026,1409100,11375998,14.14
9829728,9973618,3580,1253000,11226618,12.56
9829729,9982782,3182,1113700,11096482,11.16
9829730,9973711,2325,813750,10787461,8.16
9829731,9975141,3067,1073450,11048591,10.76
9829732,9975764,5331,1865850,11841614,18.70
9829733,9968478,5033,1761550,11730028,17.67
9829734,9987332,4063,1422050,11409382,14.24
9829735,3480045,2049,717150,4197195,20.61
9829736,1786091,1407,492450,2278541,27.57
9829737,9978049,3960,1386000,11364049,13.89
9829738,9953705,3582,1253700,11207405,12.60
9829739,9970340,3264,1142400,11112740,11.46
9829741,9985799,2722,952700,10938499,9.54
9829742,9967375,3698,1294300,11261675,12.99
9829743,1204941,600,210000,1414941,17.43
9829744,9945595,2722,952700,10898295,9.58
9829745,9953400,3620,1267000,11220400,12.73
9829746,9951667,2432,851200,10802867,8.55
9829747,9947230,5886,2060100,12007330,20.71
9829748,6012273,3473,1215550,7227823,20.22
9829749,9948770,4601,1610350,11559120,16.19
9829750,9939588,4184,1464400,11403988,14.73
9829751,9941549,5352,1873200,11814749,18.84
9829752,9951938,4110,1438500,11390438,14.45
9829753,2446118,2246,786100,3232218,32.14
9829754,9982592,5601,1960350,11942942,19.64
9829755,9980558,3995,1398250,11378808,14.01
9829756,4252992,2547,891450,5144442,20.96
9829757,9974346,4832,1691200,11665546,16.96
9829758,9975129,1901,665350,10640479,6.67
9829759,9965158,2881,1008350,10973508,10.12
9829760,9980349,3493,1222550,11202899,12.25
9829762,9974696,3466,1213100,11187796,12.16
9829763,9903703,1486,520100,10423803,5.25
9829764,9983630,2809,983150,10966780,9.85
9829765,9994098,5637,1972950,11967048,19.74
9829767,9983318,3269,1144150,11127468,11.46
9829768,9981171,2464,862400,10843571,8.64
9829769,3390557,978,342300,3732857,10.10
9829770,9999030,3907,1367450,11366480,13.68
9829771,9992574,4765,1667750,11660324,16.69
9829772,9981369,1934,676900,10658269,6.78
9829773,2772242,1041,364350,3136592,13.14
9829774,9988275,2965,1037750,11026025,10.39
9829776,9965879,5549,1942150,11908029,19.49
9829777,9959793,4489,1571150,11530943,15.77
9829778,9957179,3557,1244950,11202129,12.50
9829779,9954043,4076,1426600,11380643,14.33
9829780,9954579,5239,1833650,11788229,18.42
9829781,9962767,3439,1203650,11166417,12.08
9829782,9970779,3054,1068900,11039679,10.72
9829783,9993430,3882,1358700,11352130,13.60
9829784,9994330,3615,1265250,11259580,12.66
9829785,7708809,2008,702800,8411609,9.12
9829786,9994146,3596,1258600,11252746,12.59
9829787,9992931,4043,1415050,11407981,14.16
9829788,9988570,2832,991200,10979770,9.92
9829789,4341756,1314,459900,4801656,10.59
9829790,9996547,3425,1198750,11195297,11.99
9829791,9987990,4673,1635550,11623540,16.38
9829792,2318049,437,152950,2470999,6.60
9829793,9979169,4912,1719200,11698369,17.23
9829794,9939283,2927,1024450,10963733,10.31
9829795,9322908,1689,591150,9914058,6.34
9829796,9989353,3504,1226400,11215753,12.28
9829798,9998871,5281,1848350,11847221,18.49
9829799,9973737,4007,1402450,11376187,14.06
9829800,9977398,4334,1516900,11494298,15.20
9829801,9988028,4696,1643600,11631628,16.46
9829802,6672775,2496,873600,7546375,13.09
9829803,9985568,5049,1767150,11752718,17.70
9829804,9967186,5472,1915200,11882386,19.22
9829805,9952381,5175,1811250,11763631,18.20
9829806,9990069,2558,895300,10885369,8.96
9829808,9977563,4375,1531250,11508813,15.35
9829809,9900069,3566,1248100,11148169,12.61
9829810,9978648,4429,1550150,11528798,15.53
9829811,9999123,3618,1266300,11265423,12.66
9829812,9994420,4418,1546300,11540720,15.47
9829813,9992537,5645,1975750,11968287,19.77
9829814,9996406,6837,2392950,12389356,23.94
9829815,9995257,4032,1411200,11406457,14.12
9829816,9982569,3745,1310750,11293319,13.13
9829817,9987838,4770,1669500,11657338,16.72
9829818,9966326,2750,962500,10928826,9.66
9829819,9986242,3461,1211350,11197592,12.13
9829820,9992676,4468,1563800,11556476,15.65
9829821,9992191,4015,1405250,11397441,14.06
9829822,9980966,4190,1466500,11447466,14.69
9829823,9982259,2843,995050,10977309,9.97
9829824,2652517,1377,481950,3134467,18.17
9829825,9091398,3705,1296750,10388148,14.26
9829826,9984440,2562,896700,10881140,8.98
9829827,9980088,3344,1170400,11150488,11.73
9829828,9979244,4795,1678250,11657494,16.82
9829829,9985086,3768,1318800,11303886,13.21
9829830,9984278,4572,1600200,11584478,16.03
9829831,9960218,3235,1132250,11092468,11.37
9829832,9177848,4353,1523550,10701398,16.60
9829833,1364447,368,128800,1493247,9.44
9829834,9980997,3793,1327550,11308547,13.30
9829835,3355851,664,232400,3588251,6.93
9829836,442694,224,78400,521094,17.71
9829837,9962700,4037,1412950,11375650,14.18
9829838,9973431,3257,1139950,11113381,11.43
9829839,9972109,2144,750400,10722509,7.52
9829840,9972999,3269,1144150,11117149,11.47
9829841,9965080,5198,1819300,11784380,18.26
9829842,9988202,3100,1085000,11073202,10.86
9829843,8975848,2915,1020250,9996098,11.37
9829844,9970057,3862,1351700,11321757,13.56
9829845,3933984,540,189000,4122984,4.80
9829846,1477608,901,315350,1792958,21.34
9829847,9869541,3545,1240750,11110291,12.57
9829848,9980212,2862,1001700,10981912,10.04
9829849,9971659,3499,1224650,11196309,12.28
9829850,9990528,4993,1747550,11738078,17.49
9829851,703250,257,89950,793200,12.79
9829852,9963559,2443,855050,10818609,8.58
9829853,9959256,1472,515200,10474456,5.17
9829854,1313712,477,166950,1480662,12.71
9829855,9892153,3632,1271200,11163353,12.85
9829856,9912212,2872,1005200,10917412,10.14
9829857,9955608,2424,848400,10804008,8.52
9829858,4810875,1261,441350,5252225,9.17
9829859,9940623,3283,1149050,11089673,11.56
9829860,9949672,4839,1693650,11643322,17.02
9829861,9954585,3005,1051750,11006335,10.57
9829862,9961646,2896,1013600,10975246,10.18
9829863,9969815,3387,1185450,11155265,11.89
9829864,9984705,2260,791000,10775705,7.92
9829865,4001734,697,243950,4245684,6.10
9829866,9985122,2371,829850,10814972,8.31
9829867,9956103,2229,780150,10736253,7.84
9829869,9979515,3093,1082550,11062065,10.85
9829870,9965753,3566,1248100,11213853,12.52
9829871,9977793,3623,1268050,11245843,12.71
9829873,9978331,3825,1338750,11317081,13.42
9829874,9980755,3995,1398250,11379005,14.01
9829875,9961674,2723,953050,10914724,9.57
9829876,9977090,2777,971950,10949040,9.74
9829877,9986713,5825,2038750,12025463,20.41
9829878,9992741,3685,1289750,11282491,12.91
9829879,9993044,2070,724500,10717544,7.25
9829880,8703947,1005,351750,9055697,4.04
9829881,9980503,3720,1302000,11282503,13.05
9829882,9984667,2277,796950,10781617,7.98
9829883,2592252,571,199850,2792102,7.71
9829884,9977760,3127,1094450,11072210,10.97
9829885,5802835,4534,1586900,7389735,27.35
9829886,9995264,4681,1638350,11633614,16.39
9829887,9988161,5017,1755950,11744111,17.58
9829889,9989485,3883,1359050,11348535,13.60
9829890,9989578,4683,1639050,11628628,16.41
9829891,9977788,3467,1213450,11191238,12.16
9829892,9968387,1678,587300,10555687,5.89
9829893,9998840,4708,1647800,11646640,16.48
9829894,9975122,1475,516250,10491372,5.18
9829895,9997675,3523,1233050,11230725,12.33
9829896,9983902,1991,696850,10680752,6.98
9829897,9980151,3234,1131900,11112051,11.34
9829898,9980593,1756,614600,10595193,6.16
9829899,9989484,2001,700350,10689834,7.01
9829900,9975879,4137,1447950,11423829,14.51
9829901,9979248,4855,1699250,11678498,17.03
9829902,9985974,4055,1419250,11405224,14.21
9829903,9980004,3690,1291500,11271504,12.94
9829904,9973540,4092,1432200,11405740,14.36
9829905,2950327,440,154000,3104327,5.22
9829907,9953742,3587,1255450,11209192,12.61
9829908,9963403,3707,1297450,11260853,13.02
9829909,9956895,2206,772100,10728995,7.75
9829911,9937115,3281,1148350,11085465,11.56
9829912,9942808,4490,1571500,11514308,15.81
9829913,9936291,1404,491400,10427691,4.95
9829914,9954456,3374,1180900,11135356,11.86
9829915,2342818,944,330400,2673218,14.10
9829916,9935427,2013,704550,10639977,7.09
9829917,9943572,3324,1163400,11106972,11.70
9829918,9925895,2879,1007650,10933545,10.15
9829919,3876970,1724,603400,4480370,15.56
9829920,9904521,3529,1235150,11139671,12.47
9829921,9844388,2661,931350,10775738,9.46
9829922,9524299,1816,635600,10159899,6.67
9829923,9920063,3440,1204000,11124063,12.14
9829924,9914463,2684,939400,10853863,9.48
9829925,9908084,3167,1108450,11016534,11.19
9829926,9925867,2865,1002750,10928617,10.10
9829927,9929237,5138,1798300,11727537,18.11
9829928,9910458,3122,1092700,11003158,11.03
9829929,9932364,3870,1354500,11286864,13.64
9829930,9932526,3320,1162000,11094526,11.70
9829931,9930619,2804,981400,10912019,9.88
9829932,9809148,4991,1746850,11555998,17.81
9829934,1456323,746,261100,1717423,17.93
9829935,9949492,4105,1436750,11386242,14.44
9829936,9968504,2343,820050,10788554,8.23
9829937,9975742,4811,1683850,11659592,16.88
9829938,405917,196,68600,474517,16.90
9829939,9941550,3573,1250550,11192100,12.58
9829940,1585453,118,41300,1626753,2.60
9829941,9945414,8228,2879800,12825214,28.96
9829942,8276083,3209,1123150,9399233,13.57
9829943,9963925,1159,405650,10369575,4.07
9829944,9958327,2428,849800,10808127,8.53
9829945,9966007,3692,1292200,11258207,12.97
9829946,9989443,4039,1413650,11403093,14.15
9829947,9977892,4570,1599500,11577392,16.03
9829948,9984500,3745,1310750,11295250,13.13
9829949,9998247,3608,1262800,11261047,12.63
9829950,9985537,1293,452550,10438087,4.53
9829951,9968710,4803,1681050,11649760,16.86
9829952,9976320,4487,1570450,11546770,15.74
9829953,1153856,140,49000,1202856,4.25
9829954,8044337,363,127050,8171387,1.58
9829955,9961135,3045,1065750,11026885,10.70
9829956,9972601,3575,1251250,11223851,12.55
9829957,9964495,2620,917000,10881495,9.20
9829958,9964396,2363,827050,10791446,8.30
9829959,9981355,3322,1162700,11144055,11.65
9829960,9973425,4948,1731800,11705225,17.36
9829961,9637790,2187,765450,10403240,7.94
9829962,9899230,5793,2027550,11926780,20.48
9829963,9984443,3828,1339800,11324243,13.42
9829964,9958133,4085,1429750,11387883,14.36
9829965,9987352,2983,1044050,11031402,10.45
9829966,9975642,4730,1655500,11631142,16.60
9829967,9621471,4087,1430450,11051921,14.87
9829968,1479589,406,142100,1621689,9.60
9829969,9968214,3163,1107050,11075264,11.11
9829970,9920830,4939,1728650,11649480,17.42
9829971,9961416,4077,1426950,11388366,14.32
9829972,9975356,1645,575750,10551106,5.77
9829973,9974491,4325,1513750,11488241,15.18
9829974,9971792,4230,1480500,11452292,14.85
9829975,9958189,3188,1115800,11073989,11.20
9829976,9949193,3477,1216950,11166143,12.23
9829977,9944596,3063,1072050,11016646,10.78
9829978,9945823,2893,1012550,10958373,10.18
9829979,9966740,1585,554750,10521490,5.57
9829980,9955629,2469,864150,10819779,8.68
9829981,9965652,4600,1610000,11575652,16.16
9829982,9978860,2376,831600,10810460,8.33
9829983,9985645,2954,1033900,11019545,10.35
9829984,9971799,3273,1145550,11117349,11.49
9829985,9978639,6234,2181900,12160539,21.87
9829986,9980590,3855,1349250,11329840,13.52
9829987,9916387,3159,1105650,11022037,11.15
9829988,9997226,4797,1678950,11676176,16.79
9829989,9980169,2395,838250,10818419,8.40
9829990,9980843,1234,431900,10412743,4.33
9829991,8142563,2404,841400,8983963,10.33
9829992,9969680,4994,1747900,11717580,17.53
9829993,9975765,4235,1482250,11458015,14.86
9829994,9974082,5204,1821400,11795482,18.26
9829995,9974132,3777,1321950,11296082,13.25
9829996,9979167,3551,1242850,11222017,12.45
9829997,9971965,3244,1135400,11107365,11.39
9829998,3078470,1096,383600,3462070,12.46
9829999,9976752,1360,476000,10452752,4.77
9830000,9974089,2382,833700,10807789,8.36
9830001,9968473,3259,1140650,11109123,11.44
9830002,403690,157,54950,458640,13.61
9830003,9950273,5777,2021950,11972223,20.32
9830004,9950518,3787,1325450,11275968,13.32
9830005,9979680,2369,829150,10808830,8.31
9830006,9970534,2590,906500,10877034,9.09
9830007,9989989,3010,1053500,11043489,10.55
9830008,9986796,2767,968450,10955246,9.70
9830009,9995912,4441,1554350,11550262,15.55
9830010,9977414,4857,1699950,11677364,17.04
9830011,9481701,5102,1785700,11267401,18.83
9830012,9984756,3558,1245300,11230056,12.47
9830013,9979542,3507,1227450,11206992,12.30
9830014,9968730,2323,813050,10781780,8.16
9830015,6932246,1093,382550,7314796,5.52
9830016,9960903,2235,782250,10743153,7.85
9830017,9958101,3179,1112650,11070751,11.17
9830018,9948297,2635,922250,10870547,9.27
9830019,9960297,3372,1180200,11140497,11.85
9830020,9950353,4126,1444100,11394453,14.51
9830021,9973080,3750,1312500,11285580,13.16
9830022,9975549,6897,2413950,12389499,24.20
9830023,9981592,4840,1694000,11675592,16.97
9830024,9992916,4392,1537200,11530116,15.38
9830025,9998600,6702,2345700,12344300,23.46
9830026,9988321,4734,1656900,11645221,16.59
9830027,9824779,3993,1397550,11222329,14.22
9830028,9984615,1496,523600,10508215,5.24
9830029,9928083,2530,885500,10813583,8.92
9830030,9962854,2458,860300,10823154,8.64
9830031,9949956,3170,1109500,11059456,11.15
9830032,9936247,2926,1024100,10960347,10.31
9830033,9957642,2829,990150,10947792,9.94
9830034,9959398,3490,1221500,11180898,12.26
9830035,9962953,2593,907550,10870503,9.11
9830036,9948072,3357,1174950,11123022,11.81
9830037,9950415,3594,1257900,11208315,12.64
9830038,9935385,4245,1485750,11421135,14.95
9830039,9959052,3882,1358700,11317752,13.64
9830040,9970322,4672,1635200,11605522,16.40
9830041,9963989,3645,1275750,11239739,12.80
9830042,9979729,3583,1254050,11233779,12.57
9830043,9968924,5699,1994650,11963574,20.01
9830044,9968325,3204,1121400,11089725,11.25
9830045,9989918,7027,2459450,12449368,24.62
9830046,9991979,3255,1139250,11131229,11.40
9830047,8809074,2300,805000,9614074,9.14
9830048,9989351,2397,838950,10828301,8.40
9830049,9977590,3609,1263150,11240740,12.66
9830050,9994058,1637,572950,10567008,5.73
9830051,3460016,489,171150,3631166,4.95
9830052,9977988,3685,1289750,11267738,12.93
9830053,9978377,3729,1305150,11283527,13.08
9830054,9989809,4039,1413650,11403459,14.15
9830055,9998905,3349,1172150,11171055,11.72
9830056,9943037,2380,833000,10776037,8.38
9830057,9983143,2993,1047550,11030693,10.49
9830058,9981194,2157,754950,10736144,7.56
9830059,9970666,4978,1742300,11712966,17.47
9830060,9959010,4188,1465800,11424810,14.72
9830061,9971930,2276,796600,10768530,7.99
9830063,9986046,3117,1090950,11076996,10.92
9830064,9986910,3997,1398950,11385860,14.01
9830065,9985360,4453,1558550,11543910,15.61
9830066,9983377,5657,1979950,11963327,19.83
9830067,9988261,2677,936950,10925211,9.38
9830068,9984617,4914,1719900,11704517,17.23
9830069,9454145,3342,1169700,10623845,12.37
9830070,9952318,3031,1060850,11013168,10.66
9830071,1875499,382,133700,2009199,7.13
9830072,9967543,3920,1372000,11339543,13.76
9830073,9947530,4413,1544550,11492080,15.53
9830074,9638146,1982,693700,10331846,7.20
9830075,9950290,2140,749000,10699290,7.53
9830076,9965052,3108,1087800,11052852,10.92
9830077,9968560,4920,1722000,11690560,17.27
9830078,9963732,1923,673050,10636782,6.75
9830079,9956125,4872,1705200,11661325,17.13
9830080,1577782,166,58100,1635882,3.68
9830081,9941040,3875,1356250,11297290,13.64
9830082,9945986,5988,2095800,12041786,21.07
9830083,9964585,2825,988750,10953335,9.92
9830084,9941129,4105,1436750,11377879,14.45
9830085,2704561,307,107450,2812011,3.97
9830086,9937771,2983,1044050,10981821,10.51
9830088,9926908,4522,1582700,11509608,15.94
9830089,6391530,2703,946050,7337580,14.80
9830090,9938992,2484,869400,10808392,8.75
9830091,9812245,4195,1468250,11280495,14.96
9830092,1402124,340,119000,1521124,8.49
9830093,9942733,4270,1494500,11437233,15.03
9830094,9948492,4988,1745800,11694292,17.55
9830095,9960685,3575,1251250,11211935,12.56
9830096,9930494,2613,914550,10845044,9.21
9830097,9944694,6099,2134650,12079344,21.47
9830098,9945962,4262,1491700,11437662,15.00
9830099,9954064,3041,1064350,11018414,10.69
9830100,656735,357,124950,781685,19.03
9830101,9942050,2726,954100,10896150,9.60
9830102,9928704,3661,1281350,11210054,12.91
9830103,9952005,1244,435400,10387405,4.37
9830105,9912538,2336,817600,10730138,8.25
9830106,9920278,3375,1181250,11101528,11.91
9830107,9939618,3053,1068550,11008168,10.75
9830108,9939319,3186,1115100,11054419,11.22
9830109,646231,341,119350,765581,18.47
9830110,3826217,846,296100,4122317,7.74
9830111,9926370,2548,891800,10818170,8.98
9830112,9925920,3970,1389500,11315420,14.00
9830113,5347587,1281,448350,5795937,8.38
9830114,9930434,2888,1010800,10941234,10.18
9830115,9923104,3117,1090950,11014054,10.99
9830116,9932995,2373,830550,10763545,8.36
9830117,9942028,5198,1819300,11761328,18.30
9830118,9942833,3321,1162350,11105183,11.69
9830119,9819366,3552,1243200,11062566,12.66
9830120,9944342,3255,1139250,11083592,11.46
9830121,9931677,3743,1310050,11241727,13.19
9830122,9940842,3494,1222900,11163742,12.30
9830123,9487291,4878,1707300,11194591,18.00
9830124,9971804,4237,1482950,11454754,14.87
9830126,187554,66,23100,210654,12.32
9830127,9948854,3581,1253350,11202204,12.60
9830128,9938067,2966,1038100,10976167,10.45
9830129,9244102,4293,1502550,10746652,16.25
9830130,9949170,3270,1144500,11093670,11.50
9830131,9956059,3067,1073450,11029509,10.78
9830132,274823,69,24150,298973,8.79
9830133,9944449,3866,1353100,11297549,13.61
9830134,7258656,1940,679000,7937656,9.35
9830135,9971445,5869,2054150,12025595,20.60
9830136,4683681,1255,439250,5122931,9.38
9830137,9158445,4672,1635200,10793645,17.85
9830138,9928693,5016,1755600,11684293,17.68
9830139,8975580,2858,1000300,9975880,11.14
9830140,9972445,3070,1074500,11046945,10.77
9830142,9990316,2958,1035300,11025616,10.36
9830143,9983496,2689,941150,10924646,9.43
9830144,1871679,782,273700,2145379,14.62
9830146,9954426,1731,605850,10560276,6.09
9830147,6603679,2052,718200,7321879,10.88
9830148,2067162,1354,473900,2541062,22.93
9830149,315391,66,23100,338491,7.32
9830150,1446860,701,245350,1692210,16.96
9830151,9966362,1391,486850,10453212,4.88
9830152,9988728,1936,677600,10666328,6.78
9830153,9979449,2646,926100,10905549,9.28
9830154,9982073,1466,513100,10495173,5.14
9830155,9980639,1632,571200,10551839,5.72
9830156,9985568,527,184450,10170018,1.85
9830158,9968236,2961,1036350,11004586,10.40
9830159,9974166,4067,1423450,11397616,14.27
9830160,9960791,7271,2544850,12505641,25.55
9830161,9977490,3022,1057700,11035190,10.60
9830163,9996811,1464,512400,10509211,5.13
9830164,9978574,4092,1432200,11410774,14.35
9830165,9997819,3296,1153600,11151419,11.54
9830166,9988046,4526,1584100,11572146,15.86
9830167,9969884,3907,1367450,11337334,13.72
9830168,9979873,3864,1352400,11332273,13.55
9830169,9973382,2764,967400,10940782,9.70
9830171,9983266,2244,785400,10768666,7.87
9830172,9795420,3443,1205050,11000470,12.30
9830174,9985544,4947,1731450,11716994,17.34
9830175,9421988,5278,1847300,11269288,19.61
9830176,9290387,5356,1874600,11164987,20.18
9830177,9976378,1877,656950,10633328,6.59
9830178,9982962,1932,676200,10659162,6.77
9830179,9988098,5746,2011100,11999198,20.13
9830180,9981436,3853,1348550,11329986,13.51
9830181,9988006,3109,1088150,11076156,10.89
9830182,9986144,3275,1146250,11132394,11.48
9830183,9985599,2775,971250,10956849,9.73
9830184,9975067,5857,2049950,12025017,20.55
9830185,9988559,4280,1498000,11486559,15.00
9830186,9977272,3182,1113700,11090972,11.16
9830187,9989503,2954,1033900,11023403,10.35
9830188,8393801,4034,1411900,9805701,16.82
9830189,9949835,3680,1288000,11237835,12.94
9830190,9993320,4368,1528800,11522120,15.30
9830191,9234328,4512,1579200,10813528,17.10
9830192,9990867,2726,954100,10944967,9.55
9830193,9983185,4609,1613150,11596335,16.16
9830194,9974179,4716,1650600,11624779,16.55
9830195,9974797,3567,1248450,11223247,12.52
9830196,9986245,2490,871500,10857745,8.73
9830197,9994488,2987,1045450,11039938,10.46
9830198,9984831,3989,1396150,11380981,13.98
9830199,9990707,2257,789950,10780657,7.91
9830200,9979458,5439,1903650,11883108,19.08
9830201,9981258,3821,1337350,11318608,13.40
9830202,9995870,4679,1637650,11633520,16.38
9830203,9989405,3030,1060500,11049905,10.62
9830204,9989873,3808,1332800,11322673,13.34
9830205,9997889,3421,1197350,11195239,11.98
9830206,9982721,4199,1469650,11452371,14.72
9830207,9999571,2704,946400,10945971,9.46
9830208,9991239,2778,972300,10963539,9.73
9830209,9989452,3537,1237950,11227402,12.39
9830210,9989163,5321,1862350,11851513,18.64
9830211,9979049,4267,1493450,11472499,14.97
9830212,9963039,4076,1426600,11389639,14.32
9830213,9963561,2536,887600,10851161,8.91
9830214,9945061,3165,1107750,11052811,11.14
9830215,9962982,1973,690550,10653532,6.93
9830216,1729273,414,144900,1874173,8.38
9830217,1279583,417,145950,1425533,11.41
9830218,9954923,3422,1197700,11152623,12.03
9830219,9961464,4862,1701700,11663164,17.08
9830220,9952896,3207,1122450,11075346,11.28
9830221,9905015,2734,956900,10861915,9.66
9830222,9925549,3524,1233400,11158949,12.43
9830223,9936268,1977,691950,10628218,6.96
9830224,9946496,2629,920150,10866646,9.25
9830225,9938304,5402,1890700,11829004,19.02
9830226,9956102,5126,1794100,11750202,18.02
9830227,9969404,2838,993300,10962704,9.96
9830228,9965082,4576,1601600,11566682,16.07
9830229,9970725,3772,1320200,11290925,13.24
9830230,1206204,997,348950,1555154,28.93
9830231,9980757,2840,994000,10974757,9.96
9830232,9969496,6605,2311750,12281246,23.19
9830233,9984405,2157,754950,10739355,7.56
9830235,9991194,2409,843150,10834344,8.44
9830236,9978390,4395,1538250,11516640,15.42
9830237,9980195,3630,1270500,11250695,12.73
9830238,9971523,2303,806050,10777573,8.08
9830239,7352646,1885,659750,8012396,8.97
9830240,9951751,3157,1104950,11056701,11.10
9830241,9970184,4864,1702400,11672584,17.07
9830242,9950198,3393,1187550,11137748,11.93
9830243,9944169,1814,634900,10579069,6.38
9830244,9971532,3572,1250200,11221732,12.54
9830245,9991921,4537,1587950,11579871,15.89
9830246,1757575,998,349300,2106875,19.87
9830247,9958869,4822,1687700,11646569,16.95
9830248,9983036,2734,956900,10939936,9.59
9830249,685179,327,114450,799629,16.70
9830250,4833324,1335,467250,5300574,9.67
9830251,9890093,3522,1232700,11122793,12.46
9830252,4167305,2243,785050,4952355,18.84
9830253,4725064,1769,619150,5344214,13.10
9830254,3728961,1009,353150,4082111,9.47
9830255,2232719,1047,366450,2599169,16.41
9830256,9909336,5020,1757000,11666336,17.73
9830257,9903639,4382,1533700,11437339,15.49
9830258,9916116,3977,1391950,11308066,14.04
9830259,9894274,3733,1306550,11200824,13.21
9830260,9925700,3154,1103900,11029600,11.12
9830261,9908746,4612,1614200,11522946,16.29
9830262,220467,78,27300,247767,12.38
9830263,9394421,2844,995400,10389821,10.60
9830264,9923972,3677,1286950,11210922,12.97
9830265,9933593,3685,1289750,11223343,12.98
9830266,2844963,3592,1257200,4102163,44.19
9830267,5893641,2499,874650,6768291,14.84
9830268,9951923,2396,838600,10790523,8.43
9830269,9965610,4086,1430100,11395710,14.35
9830270,9943394,2478,867300,10810694,8.72
9830271,9965901,4081,1428350,11394251,14.33
9830272,9965499,4218,1476300,11441799,14.81
9830273,9968898,3767,1318450,11287348,13.23
9830274,9968186,4562,1596700,11564886,16.02
9830275,9969368,3320,1162000,11131368,11.66
9830276,9972731,3318,1161300,11134031,11.64
9830277,9995963,4261,1491350,11487313,14.92
9830278,9996752,3318,1161300,11158052,11.62
9830279,610374,313,109550,719924,17.95
9830281,9981202,5172,1810200,11791402,18.14
9830282,9966076,2913,1019550,10985626,10.23
9830284,9985173,4529,1585150,11570323,15.88
9830285,9988111,4376,1531600,11519711,15.33
9830286,8962219,2842,994700,9956919,11.10
9830287,9984259,2008,702800,10687059,7.04
9830288,9980425,6069,2124150,12104575,21.28
9830289,9989713,5475,1916250,11905963,19.18
9830290,9979603,4025,1408750,11388353,14.12
9830291,9982060,2491,871850,10853910,8.73
9830292,9982874,5764,2017400,12000274,20.21
9830293,9820789,3253,1138550,10959339,11.59
9830294,9978397,3632,1271200,11249597,12.74
9830295,9988287,6343,2220050,12208337,22.23
9830296,9987858,4310,1508500,11496358,15.10
9830297,1272017,545,190750,1462767,15.00
9830298,9976128,4766,1668100,11644228,16.72
9830299,626577,335,117250,743827,18.71
9830301,9956870,3752,1313200,11270070,13.19
9830302,9946751,5215,1825250,11772001,18.35
9830303,9938317,1412,494200,10432517,4.97
9830304,8040625,3208,1122800,9163425,13.96
9830305,9974284,1352,473200,10447484,4.74
9830306,9984365,2414,844900,10829265,8.46
9830307,9942469,3385,1184750,11127219,11.92
9830308,9970443,2308,807800,10778243,8.10
9830309,9995442,3291,1151850,11147292,11.52
9830310,6354562,773,270550,6625112,4.26
9830311,8507270,2290,801500,9308770,9.42
9830312,9981335,4476,1566600,11547935,15.70
9830313,9968852,4588,1605800,11574652,16.11
9830314,9981165,4577,1601950,11583115,16.05
9830315,3891999,700,245000,4136999,6.29
9830316,2201315,869,304150,2505465,13.82
9830317,9953885,3256,1139600,11093485,11.45
9830318,9944851,5797,2028950,11973801,20.40
9830319,9934399,3571,1249850,11184249,12.58
9830320,9936581,3649,1277150,11213731,12.85
9830321,9931483,3757,1314950,11246433,13.24
9830323,965306,223,78050,1043356,8.09
9830325,9899515,5376,1881600,11781115,19.01
9830326,9905659,3910,1368500,11274159,13.82
9830327,9892447,2572,900200,10792647,9.10
9830328,9889157,1620,567000,10456157,5.73
9830329,9900213,3804,1331400,11231613,13.45
9830330,9921161,3405,1191750,11112911,12.01
9830331,9916979,3798,1329300,11246279,13.40
9830332,9936063,1750,612500,10548563,6.16
9830333,9933935,4059,1420650,11354585,14.30
9830334,9936335,4954,1733900,11670235,17.45
9830335,9925920,2687,940450,10866370,9.47
9830336,9929177,4462,1561700,11490877,15.73
9830337,9938185,2704,946400,10884585,9.52
9830338,9945316,4476,1566600,11511916,15.75
9830339,9939105,4026,1409100,11348205,14.18
9830340,9913655,4610,1613500,11527155,16.28
9830341,9951535,4285,1499750,11451285,15.07
9830342,9953215,4170,1459500,11412715,14.66
9830343,9957652,4325,1513750,11471402,15.20
9830344,9972907,3850,1347500,11320407,13.51
9830345,235752,64,22400,258152,9.50
9830346,9962040,3463,1212050,11174090,12.17
9830347,9467955,3956,1384600,10852555,14.62
9830348,9981065,1512,529200,10510265,5.30
9830349,9958761,3694,1292900,11251661,12.98
9830350,9980457,4284,1499400,11479857,15.02
9830351,9981553,4766,1668100,11649653,16.71
9830352,9994513,4686,1640100,11634613,16.41
9830353,9991848,4195,1468250,11460098,14.69
9830354,9985038,4286,1500100,11485138,15.02
9830355,9994687,1515,530250,10524937,5.31
9830356,9982779,3831,1340850,11323629,13.43
9830357,9973180,4623,1618050,11591230,16.22
9830358,2778588,1552,543200,3321788,19.55
9830359,9975402,2723,953050,10928452,9.55
9830360,7567588,2585,904750,8472338,11.96
9830361,9975766,2738,958300,10934066,9.61
9830362,3528817,531,185850,3714667,5.27
9830363,9984280,4115,1440250,11424530,14.43
9830364,9990878,2730,955500,10946378,9.56
9830365,8406822,5048,1766800,10173622,21.02
9830366,2355894,413,144550,2500444,6.14
9830367,9982479,3926,1374100,11356579,13.77
9830368,9996702,3780,1323000,11319702,13.23
9830369,9996634,3851,1347850,11344484,13.48
9830371,9992465,1384,484400,10476865,4.85
9830372,9994830,3072,1075200,11070030,10.76
9830373,7261813,2939,1028650,8290463,14.17
9830374,9970746,3567,1248450,11219196,12.52
9830375,9903442,2885,1009750,10913192,10.20
9830376,9998841,5950,2082500,12081341,20.83
9830377,9985455,1534,536900,10522355,5.38
9830378,9976022,1542,539700,10515722,5.41
9830379,9969746,2187,765450,10735196,7.68
9830380,9988720,2467,863450,10852170,8.64
9830381,9138800,2134,746900,9885700,8.17
9830382,9984422,2582,903700,10888122,9.05
9830383,6029862,1119,391650,6421512,6.50
9830384,9951636,4885,1709750,11661386,17.18
9830385,9972570,3953,1383550,11356120,13.87
9830386,1360855,287,100450,1461305,7.38
9830387,9946099,2479,867650,10813749,8.72
9830388,9954412,3198,1119300,11073712,11.24
9830389,9975434,2440,854000,10829434,8.56
9830390,9973199,1968,688800,10661999,6.91
9830391,9975325,3152,1103200,11078525,11.06
9830392,3181108,950,332500,3513608,10.45
9830393,9968389,1848,646800,10615189,6.49
9830394,9969791,2758,965300,10935091,9.68
9830395,5703735,2250,787500,6491235,13.81
9830396,9919022,4670,1634500,11553522,16.48
9830397,9983373,3524,1233400,11216773,12.35
9830398,9982312,1261,441350,10423662,4.42
9830399,9986373,2327,814450,10800823,8.16
9830400,9974252,3353,1173550,11147802,11.77
9830401,9975556,2509,878150,10853706,8.80
9830402,9965707,2194,767900,10733607,7.71
9830403,9941065,3093,1082550,11023615,10.89
9830404,9941162,1951,682850,10624012,6.87
9830405,9940350,3647,1276450,11216800,12.84
9830406,1777119,313,109550,1886669,6.16
9830407,9918877,1929,675150,10594027,6.81
9830408,9945577,4256,1489600,11435177,14.98
9830409,9949786,2868,1003800,10953586,10.09
9830410,9962112,2753,963550,10925662,9.67
9830411,9951007,3012,1054200,11005207,10.59
9830412,9938026,3141,1099350,11037376,11.06
9830413,9958840,751,262850,10221690,2.64
9830414,9759119,3533,1236550,10995669,12.67
9830415,9959029,3486,1220100,11179129,12.25
9830416,9972387,3893,1362550,11334937,13.66
9830417,9976423,2958,1035300,11011723,10.38
9830418,9650603,5203,1821050,11471653,18.87
9830420,9183328,3065,1072750,10256078,11.68
9830421,9982807,2672,935200,10918007,9.37
9830422,9985388,3152,1103200,11088588,11.05
9830423,9987899,1597,558950,10546849,5.60
9830424,9486772,3082,1078700,10565472,11.37
9830425,9987194,3147,1101450,11088644,11.03
9830426,9988606,4079,1427650,11416256,14.29
9830427,9994509,2124,743400,10737909,7.44
9830428,9977699,3970,1389500,11367199,13.93
9830430,9992313,4037,1412950,11405263,14.14
9830431,9976472,3077,1076950,11053422,10.79
9830432,9968043,3250,1137500,11105543,11.41
9830433,9973364,3119,1091650,11065014,10.95
9830434,9783683,2270,794500,10578183,8.12
9830435,9978599,3600,1260000,11238599,12.63
9830436,9979769,4880,1708000,11687769,17.11
9830437,9997538,1304,456400,10453938,4.57
9830438,9993004,3996,1398600,11391604,14.00
9830439,9848827,3634,1271900,11120727,12.91
9830441,9973522,3389,1186150,11159672,11.89
9830442,9960602,3036,1062600,11023202,10.67
9830443,9973847,1178,412300,10386147,4.13
9830444,9956826,3264,1142400,11099226,11.47
9830445,9978030,4140,1449000,11427030,14.52
9830446,9960028,4881,1708350,11668378,17.15
9830447,9979072,1483,519050,10498122,5.20
9830448,9998495,2051,717850,10716345,7.18
9830449,9971844,2964,1037400,11009244,10.40
9830450,9979222,3497,1223950,11203172,12.26
9830451,9979801,2737,957950,10937751,9.60
9830452,9981792,3232,1131200,11112992,11.33
9830453,9994020,2067,723450,10717470,7.24
9830454,9988446,2561,896350,10884796,8.97
9830455,9980462,3692,1292200,11272662,12.95
9830456,9991436,4627,1619450,11610886,16.21
9830457,9979339,3586,1255100,11234439,12.58
9830458,9298730,1266,443100,9741830,4.77
9830459,9975839,4524,1583400,11559239,15.87
9830460,1907091,1811,633850,2540941,33.24
9830461,8155727,3060,1071000,9226727,13.13
9830462,9968139,4138,1448300,11416439,14.53
9830463,9979992,2431,850850,10830842,8.53
9830464,9986717,5809,2033150,12019867,20.36
9830465,5128238,1246,436100,5564338,8.50
9830466,9976342,4234,1481900,11458242,14.85
9830467,9978108,3090,1081500,11059608,10.84
9830468,9994376,3526,1234100,11228476,12.35
9830469,9986929,816,285600,10272529,2.86
9830470,9983978,1394,487900,10471878,4.89
9830471,9994814,5321,1862350,11857164,18.63
9830472,9974262,2826,989100,10963362,9.92
9830473,9980775,1661,581350,10562125,5.82
9830474,9996092,1524,533400,10529492,5.34
9830475,9029642,3762,1316700,10346342,14.58
9830476,9972908,4088,1430800,11403708,14.35
9830477,9976724,4371,1529850,11506574,15.33
9830478,9985155,2239,783650,10768805,7.85
9830479,4268471,1145,400750,4669221,9.39
9830480,9984035,3562,1246700,11230735,12.49
9830481,9996824,4525,1583750,11580574,15.84
9830482,9987461,3381,1183350,11170811,11.85
9830484,5799132,2340,819000,6618132,14.12
9830485,9987459,3936,1377600,11365059,13.79
9830486,9975771,4090,1431500,11407271,14.35
9830487,9956490,3678,1287300,11243790,12.93
9830488,9989336,3455,1209250,11198586,12.11
9830489,9978479,2027,709450,10687929,7.11
9830490,8299263,3864,1352400,9651663,16.30
9830491,9988348,3065,1072750,11061098,10.74
9830492,9994329,4646,1626100,11620429,16.27
9830493,9984061,3709,1298150,11282211,13.00
9830494,9992861,5601,1960350,11953211,19.62
9830495,9979447,3017,1055950,11035397,10.58
9830496,9992896,2517,880950,10873846,8.82
9830497,9995708,3561,1246350,11242058,12.47
9830498,9679088,3237,1132950,10812038,11.71
9830499,9984453,3904,1366400,11350853,13.69
9830500,9997858,3169,1109150,11107008,11.09
9830501,9989250,3968,1388800,11378050,13.90
9830502,6760373,1443,505050,7265423,7.47
9830503,9984895,3857,1349950,11334845,13.52
9830504,9986706,2078,727300,10714006,7.28
9830505,9964698,6238,2183300,12147998,21.91
9830506,9972058,3889,1361150,11333208,13.65
9830507,9990346,4978,1742300,11732646,17.44
9830508,9972196,3228,1129800,11101996,11.33
9830509,9469898,5896,2063600,11533498,21.79
9830510,9979804,4418,1546300,11526104,15.49
9830511,9494864,3335,1167250,10662114,12.29
9830512,9989883,3224,1128400,11118283,11.30
9830513,9972130,4544,1590400,11562530,15.95
9830514,7249931,1833,641550,7891481,8.85
9830515,9977940,5562,1946700,11924640,19.51
9830516,9980029,5004,1751400,11731429,17.55
9830517,9993722,1726,604100,10597822,6.04
9830518,3542175,1177,411950,3954125,11.63
9830519,52064,17,5950,58014,11.43
9830520,3547181,1820,637000,4184181,17.96
9830521,9985447,2990,1046500,11031947,10.48
9830522,9977070,4831,1690850,11667920,16.95
9830523,9984508,2711,948850,10933358,9.50
9830524,9984466,5223,1828050,11812516,18.31
9830525,9990985,4002,1400700,11391685,14.02
9830526,9960837,3471,1214850,11175687,12.20
9830527,9999152,2862,1001700,11000852,10.02
9830528,9992496,5182,1813700,11806196,18.15
9830529,9677262,3825,1338750,11016012,13.83
9830530,9992325,4292,1502200,11494525,15.03
9830531,9967391,3186,1115100,11082491,11.19
9830532,9998125,3022,1057700,11055825,10.58
9830533,9997630,3830,1340500,11338130,13.41
9830534,9990109,3062,1071700,11061809,10.73
9830535,9752672,2837,992950,10745622,10.18
9830536,9980238,4986,1745100,11725338,17.49
9830537,9983391,3757,1314950,11298341,13.17
9830538,9977724,2547,891450,10869174,8.93
9830539,9990857,3421,1197350,11188207,11.98
9830540,9977562,2984,1044400,11021962,10.47
9830541,9981737,2838,993300,10975037,9.95
9830542,9999607,1695,593250,10592857,5.93
9830543,9986332,4665,1632750,11619082,16.35
9830544,9990650,3083,1079050,11069700,10.80
9830546,9679642,2842,994700,10674342,10.28
9830547,9988890,4268,1493800,11482690,14.95
9830548,8942024,1992,697200,9639224,7.80
9830549,9982786,5551,1942850,11925636,19.46
9830550,9983701,3297,1153950,11137651,11.56
9830551,9996966,5177,1811950,11808916,18.12
9830552,9977499,2520,882000,10859499,8.84
9830553,9981639,4304,1506400,11488039,15.09
9830554,9777605,3282,1148700,10926305,11.75
9830555,9985360,3359,1175650,11161010,11.77
9830556,9979802,3683,1289050,11268852,12.92
9830557,9559087,3579,1252650,10811737,13.10
9830558,9992500,3532,1236200,11228700,12.37
9830559,8984341,2747,961450,9945791,10.70
9830560,9960647,1430,500500,10461147,5.02
9830561,9970192,3925,1373750,11343942,13.78
9830562,9989013,2535,887250,10876263,8.88
9830564,9981586,3597,1258950,11240536,12.61
9830565,9988123,2860,1001000,10989123,10.02
9830566,9999271,3411,1193850,11193121,11.94
9830567,9984043,3914,1369900,11353943,13.72
9830568,9989291,2088,730800,10720091,7.32
9830570,9972061,1535,537250,10509311,5.39
9830571,9948740,2964,1037400,10986140,10.43
9830572,9998054,2602,910700,10908754,9.11
9830573,4132695,530,185500,4318195,4.49
9830575,9970226,2763,967050,10937276,9.70
9830576,9976060,1392,487200,10463260,4.88
9830577,9978971,3427,1199450,11178421,12.02
9830578,9977822,1854,648900,10626722,6.50
9830579,9982843,2278,797300,10780143,7.99
9830580,9993286,3469,1214150,11207436,12.15
9830581,9968496,4067,1423450,11391946,14.28
9830582,1942011,215,75250,2017261,3.87
9830583,9970357,3647,1276450,11246807,12.80
9830584,9994270,3623,1268050,11262320,12.69
9830585,9987124,3138,1098300,11085424,11.00
9830586,9953454,2306,807100,10760554,8.11
9830587,9982841,1583,554050,10536891,5.55
9830588,9992897,3324,1163400,11156297,11.64
9830589,9983609,3320,1162000,11145609,11.64
9830590,9979238,3079,1077650,11056888,10.80
9830591,9985465,2850,997500,10982965,9.99
9830592,9834116,226,79100,9913216,0.80
9830593,9984656,2547,891450,10876106,8.93
9830594,7964331,1662,581700,8546031,7.30
9830595,9991464,3912,1369200,11360664,13.70
9830596,881653,154,53900,935553,6.11
9830597,9991326,2383,834050,10825376,8.35
9830598,9983557,1977,691950,10675507,6.93
9830599,9965645,2369,829150,10794795,8.32
9830600,9982397,3316,1160600,11142997,11.63
9830601,9976406,5524,1933400,11909806,19.38
9830602,9993801,1964,687400,10681201,6.88
9830603,9994297,2415,845250,10839547,8.46
9830604,9997469,3584,1254400,11251869,12.55
9830605,9989417,3751,1312850,11302267,13.14
9830606,9979096,2464,862400,10841496,8.64
9830607,9982421,2207,772450,10754871,7.74
9830608,9991704,1408,492800,10484504,4.93
9830609,9984182,2257,789950,10774132,7.91
9830610,9976790,1348,471800,10448590,4.73
9830611,9989898,2154,753900,10743798,7.55
9830612,9974821,222,77700,10052521,0.78
9830613,9962680,1407,492450,10455130,4.94
9830614,9979408,767,268450,10247858,2.69
9830615,9969302,2984,1044400,11013702,10.48
9830616,9972440,6992,2447200,12419640,24.54
9830617,9979250,2195,768250,10747500,7.70
9830618,9963249,2620,917000,10880249,9.20
9830619,9959528,2986,1045100,11004628,10.49
9830620,9946128,3078,1077300,11023428,10.83
9830621,9952956,3017,1055950,11008906,10.61
9830622,9941226,3730,1305500,11246726,13.13
9830623,9945662,1356,474600,10420262,4.77
9830624,9964307,1382,483700,10448007,4.85
9830625,9958402,1341,469350,10427752,4.71
9830626,9971063,3046,1066100,11037163,10.69
9830627,9305352,1915,670250,9975602,7.20
9830628,9992639,3905,1366750,11359389,13.68
9830629,9983435,2504,876400,10859835,8.78
9830630,9975484,4746,1661100,11636584,16.65
9830631,9982380,3039,1063650,11046030,10.66
9830632,9977501,1896,663600,10641101,6.65
9830633,9994070,2185,764750,10758820,7.65
9830634,5180014,3293,1152550,6332564,22.25
9830635,9974740,3551,1242850,11217590,12.46
9830636,9954135,4872,1705200,11659335,17.13
9830637,9965975,1841,644350,10610325,6.47
9830638,9962619,3996,1398600,11361219,14.04
9830639,9966791,3847,1346450,11313241,13.51
9830640,9975876,3724,1303400,11279276,13.07
9830641,9967392,4006,1402100,11369492,14.07
9830642,9946658,2096,733600,10680258,7.38
9830643,9953900,2177,761950,10715850,7.65
9830644,9964441,2199,769650,10734091,7.72
9830645,9961238,2527,884450,10845688,8.88
9830646,9977803,3028,1059800,11037603,10.62
9830647,9952971,3022,1057700,11010671,10.63
9830648,9941372,4747,1661450,11602822,16.71
9830650,9960010,2621,917350,10877360,9.21
9830652,9954915,3233,1131550,11086465,11.37
9830653,9949935,3340,1169000,11118935,11.75
9830654,9955279,2655,929250,10884529,9.33
9830655,9961495,4015,1405250,11366745,14.11
9830656,9962553,4047,1416450,11379003,14.22
9830657,8333572,4167,1458450,9792022,17.50
9830658,9970124,3231,1130850,11100974,11.34
9830659,9970991,3242,1134700,11105691,11.38
9830661,9966489,3605,1261750,11228239,12.66
9830662,9985205,3182,1113700,11098905,11.15
9830663,9999138,3619,1266650,11265788,12.67
9830664,9979943,2896,1013600,10993543,10.16
9830665,9992368,1317,460950,10453318,4.61
9830666,9970780,4567,1598450,11569230,16.03
9830667,9971151,2334,816900,10788051,8.19
9830668,9983481,3193,1117550,11101031,11.19
9830669,9992964,3086,1080100,11073064,10.81
9830670,9975029,2820,987000,10962029,9.89
9830671,9982177,1888,660800,10642977,6.62
9830672,9983861,3037,1062950,11046811,10.65
9830673,9989660,3014,1054900,11044560,10.56
9830674,9985926,1817,635950,10621876,6.37
9830675,9996172,4296,1503600,11499772,15.04
9830676,9998849,9057,3169950,13168799,31.70
9830677,9955805,2818,986300,10942105,9.91
9830678,9985926,2182,763700,10749626,7.65
9830679,9988026,4860,1701000,11689026,17.03
9830680,9983547,2529,885150,10868697,8.87
9830681,9978606,1293,452550,10431156,4.54
9830682,9979699,2701,945350,10925049,9.47
9830683,9983336,3595,1258250,11241586,12.60
9830684,9974532,3089,1081150,11055682,10.84
9830685,9973303,871,304850,10278153,3.06
9830686,9956726,4288,1500800,11457526,15.07
9830687,9967173,2815,985250,10952423,9.88
9830688,9986444,2575,901250,10887694,9.02
9830689,9978128,2296,803600,10781728,8.05
9830690,9995454,2190,766500,10761954,7.67
9830691,9988318,4627,1619450,11607768,16.21
9830692,9996937,3974,1390900,11387837,13.91
9830693,9977714,4145,1450750,11428464,14.54
9830694,9994963,2440,854000,10848963,8.54
9830695,9988587,2599,909650,10898237,9.11
9830696,9985612,3263,1142050,11127662,11.44
9830697,9992936,3911,1368850,11361786,13.70
9830698,9722752,3970,1389500,11112252,14.29
9830699,9978526,5092,1782200,11760726,17.86
9830700,9963102,2806,982100,10945202,9.86
9830701,9971102,3386,1185100,11156202,11.89
9830702,9790971,4579,1602650,11393621,16.37
9830703,9799023,3646,1276100,11075123,13.02
9830704,9974763,1230,430500,10405263,4.32
9830705,9982228,2978,1042300,11024528,10.44
9830706,9976452,2176,761600,10738052,7.63
9830707,9994148,3720,1302000,11296148,13.03
9830708,9982216,2201,770350,10752566,7.72
9830710,9966867,3784,1324400,11291267,13.29
9830711,9958422,3310,1158500,11116922,11.63
9830712,9955842,4064,1422400,11378242,14.29
9830713,9957621,2907,1017450,10975071,10.22
9830714,9965798,4590,1606500,11572298,16.12
9830715,9968162,3536,1237600,11205762,12.42
9830716,9970027,2710,948500,10918527,9.51
9830717,9989379,5485,1919750,11909129,19.22
9830718,9952664,2996,1048600,11001264,10.54
9830719,9974914,3139,1098650,11073564,11.01
9830720,9974649,5275,1846250,11820899,18.51
9830721,9985945,2944,1030400,11016345,10.32
9830722,9984995,3257,1139950,11124945,11.42
9830723,9969020,2907,1017450,10986470,10.21
9830724,9956512,3800,1330000,11286512,13.36
9830725,9975216,3086,1080100,11055316,10.83
9830726,9983059,3634,1271900,11254959,12.74
9830727,9974713,3227,1129450,11104163,11.32
9830728,9998834,4920,1722000,11720834,17.22
9830729,9979165,3787,1325450,11304615,13.28
9830730,9989722,4254,1488900,11478622,14.90
9830731,9982118,2282,798700,10780818,8.00
9830732,9976301,2919,1021650,10997951,10.24
9830733,9421166,3637,1272950,10694116,13.51
9830734,9983718,3440,1204000,11187718,12.06
9830735,9969217,4368,1528800,11498017,15.34
9830736,9955249,3626,1269100,11224349,12.75
9830737,9969852,2533,886550,10856402,8.89
9830738,9980780,3427,1199450,11180230,12.02
9830739,9992527,3928,1374800,11367327,13.76
9830740,9880137,3815,1335250,11215387,13.51
9830741,9994713,3801,1330350,11325063,13.31
9830742,9974279,1778,622300,10596579,6.24
9830743,9968238,3376,1181600,11149838,11.85
9830744,2948590,1384,484400,3432990,16.43
9830745,9967244,3621,1267350,11234594,12.72
9830746,9975706,2572,900200,10875906,9.02
9830747,4278276,1309,458150,4736426,10.71
9830748,9984815,2672,935200,10920015,9.37
9830749,9970960,4692,1642200,11613160,16.47
9830750,9989347,2718,951300,10940647,9.52
9830751,9997749,3259,1140650,11138399,11.41
9830752,9979360,2460,861000,10840360,8.63
9830753,9984014,3568,1248800,11232814,12.51
9830754,9968316,2615,915250,10883566,9.18
9830755,9993393,3683,1289050,11282443,12.90
9830756,9991929,4714,1649900,11641829,16.51
9830757,9986155,3046,1066100,11052255,10.68
9830758,9482385,4785,1674750,11157135,17.66
9830760,9982118,4734,1656900,11639018,16.60
9830761,9981249,2995,1048250,11029499,10.50
9830762,9999200,4631,1620850,11620050,16.21
9830763,9991790,5706,1997100,11988890,19.99
9830764,9988089,3573,1250550,11238639,12.52
9830765,9697499,5439,1903650,11601149,19.63
9830766,2406557,927,324450,2731007,13.48
9830767,5472474,1501,525350,5997824,9.60
9830768,9989591,3175,1111250,11100841,11.12
9830769,9982602,3065,1072750,11055352,10.75
9830770,9981600,2744,960400,10942000,9.62
9830771,9955667,1715,600250,10555917,6.03
9830772,9958272,4038,1413300,11371572,14.19
9830773,9966549,3071,1074850,11041399,10.78
9830774,9983299,1790,626500,10609799,6.28
9830775,9986736,2726,954100,10940836,9.55
9830776,9990051,3872,1355200,11345251,13.57
9830777,9979622,2240,784000,10763622,7.86
9830778,9966952,4370,1529500,11496452,15.35
9830779,9978277,4170,1459500,11437777,14.63
9830780,9956925,4554,1593900,11550825,16.01
9830781,9952895,3211,1123850,11076745,11.29
9830782,9968055,3936,1377600,11345655,13.82
9830783,9963623,3999,1399650,11363273,14.05
9830784,9981223,4062,1421700,11402923,14.24
9830785,9975082,2894,1012900,10987982,10.15
9830786,9974324,3726,1304100,11278424,13.07
9830787,9987533,3972,1390200,11377733,13.92
9830788,9977982,4146,1451100,11429082,14.54
9830789,9970249,2488,870800,10841049,8.73
9830790,9970017,2012,704200,10674217,7.06
9830791,9965201,4343,1520050,11485251,15.25
9830792,9978361,2587,905450,10883811,9.07
9830793,9979049,3963,1387050,11366099,13.90
9830794,6756779,1352,473200,7229979,7.00
9830795,9989544,2079,727650,10717194,7.28
9830796,9909953,3158,1105300,11015253,11.15
9830797,9999270,2842,994700,10993970,9.95
9830798,9997847,3773,1320550,11318397,13.21
9830799,9983430,3260,1141000,11124430,11.43
9830800,9988702,3605,1261750,11250452,12.63
9830801,9974842,3681,1288350,11263192,12.92
9830802,9997757,3349,1172150,11169907,11.72
9830803,9986092,3827,1339450,11325542,13.41
9830804,9984008,2937,1027950,11011958,10.30
9830805,9972508,5010,1753500,11726008,17.58
9830806,9991361,3069,1074150,11065511,10.75
9830807,9997107,2168,758800,10755907,7.59
9830808,9968232,3652,1278200,11246432,12.82
9830809,9988203,4907,1717450,11705653,17.19
9830810,9988260,3623,1268050,11256310,12.70
9830811,9980721,3043,1065050,11045771,10.67
9830812,9985361,5710,1998500,11983861,20.01
9830813,9985601,3568,1248800,11234401,12.51
9830814,9980694,5124,1793400,11774094,17.97
9830815,9993924,3190,1116500,11110424,11.17
9830816,9975018,2982,1043700,11018718,10.46
9830817,9978371,2433,851550,10829921,8.53
9830818,9983535,2822,987700,10971235,9.89
9830819,9995441,3223,1128050,11123491,11.29
9830820,9977251,2914,1019900,10997151,10.22
9830821,9990662,3206,1122100,11112762,11.23
9830822,9983737,4314,1509900,11493637,15.12
9830823,9900220,3484,1219400,11119620,12.32
9830824,9991258,3408,1192800,11184058,11.94
9830825,9906934,4164,1457400,11364334,14.71
9830826,9408263,3706,1297100,10705363,13.79
9830827,9997265,3222,1127700,11124965,11.28
9830828,9971722,2954,1033900,11005622,10.37
9830829,2203252,525,183750,2387002,8.34
9830830,9977681,2612,914200,10891881,9.16
9830831,9983160,4390,1536500,11519660,15.39
9830832,713994,697,243950,957944,34.17
9830833,9977338,1405,491750,10469088,4.93
9830834,9993198,3531,1235850,11229048,12.37
9830835,9987877,3348,1171800,11159677,11.73
9830836,9949100,3065,1072750,11021850,10.78
9830837,9985968,2567,898450,10884418,9.00
9830838,9985979,3324,1163400,11149379,11.65
9830839,9997997,2480,868000,10865997,8.68
9830841,9969296,2017,705950,10675246,7.08
9830843,9978508,2483,869050,10847558,8.71
9830844,9971289,3679,1287650,11258939,12.91
9830845,9966661,3064,1072400,11039061,10.76
9830846,4349939,1900,665000,5014939,15.29
9830847,9959415,3133,1096550,11055965,11.01
9830848,9964611,4610,1613500,11578111,16.19
9830849,5037696,1973,690550,5728246,13.71
9830850,9963316,2535,887250,10850566,8.91
9830851,9978837,4483,1569050,11547887,15.72
9830852,9931735,5669,1984150,11915885,19.98
9830853,9964308,3404,1191400,11155708,11.96
9830854,9976089,3037,1062950,11039039,10.65
9830855,9978396,2397,838950,10817346,8.41
9830856,9992955,1466,513100,10506055,5.13
9830858,9974427,3588,1255800,11230227,12.59
9830859,9973084,3014,1054900,11027984,10.58
9830860,9981102,2759,965650,10946752,9.67
9830862,9963841,3692,1292200,11256041,12.97
9830863,9958169,2823,988050,10946219,9.92
9830864,9965054,3790,1326500,11291554,13.31
9830865,9987031,5432,1901200,11888231,19.04
9830866,9980769,2613,914550,10895319,9.16
9830867,7770790,3179,1112650,8883440,14.32
9830868,9981204,1692,592200,10573404,5.93
9830869,9991944,4059,1420650,11412594,14.22
9830870,9970582,3011,1053850,11024432,10.57
9830871,9973160,3734,1306900,11280060,13.10
9830872,9993057,3861,1351350,11344407,13.52
9830873,9989174,4195,1468250,11457424,14.70
9830874,9983300,5122,1792700,11776000,17.96
9830875,9994513,2648,926800,10921313,9.27
9830876,9994824,2744,960400,10955224,9.61
9830877,7834819,2159,755650,8590469,9.64
9830878,9971376,3523,1233050,11204426,12.37
9830879,9961575,3722,1302700,11264275,13.08
9830880,9969736,4964,1737400,11707136,17.43
9830881,9959257,4236,1482600,11441857,14.89
9830882,9966550,3913,1369550,11336100,13.74
9830883,9945009,2951,1032850,10977859,10.39
9830884,9960141,2632,921200,10881341,9.25
9830885,9979704,2720,952000,10931704,9.54
9830886,9971724,3701,1295350,11267074,12.99
9830887,9973429,3925,1373750,11347179,13.77
9830888,9964904,3325,1163750,11128654,11.68
9830890,9969850,3022,1057700,11027550,10.61
9830891,9970074,2315,810250,10780324,8.13
9830892,9957885,4003,1401050,11358935,14.07
9830893,9957629,2747,961450,10919079,9.66
9830894,9980053,3107,1087450,11067503,10.90
9830895,9982117,3163,1107050,11089167,11.09
9830896,9990425,4112,1439200,11429625,14.41
9830897,9994646,3864,1352400,11347046,13.53
9830898,9980536,3556,1244600,11225136,12.47
9830899,9930324,4070,1424500,11354824,14.34
9830900,9969698,2318,811300,10780998,8.14
9830901,9988784,2774,970900,10959684,9.72
9830902,9976670,5730,2005500,11982170,20.10
9830903,3717674,2146,751100,4468774,20.20
9830904,9990596,2361,826350,10816946,8.27
9830905,9985597,3856,1349600,11335197,13.52
9830906,9986413,3751,1312850,11299263,13.15
9830907,9983403,2892,1012200,10995603,10.14
9830908,9982412,3500,1225000,11207412,12.27
9830909,9992849,3171,1109850,11102699,11.11
9830910,9980591,4565,1597750,11578341,16.01
9830911,9994701,3779,1322650,11317351,13.23
9830912,9989903,2688,940800,10930703,9.42
9830913,8987449,2033,711550,9698999,7.92
9830914,9979858,4356,1524600,11504458,15.28
9830915,9985091,3776,1321600,11306691,13.24
9830916,9997491,1981,693350,10690841,6.94
9830917,9981821,3219,1126650,11108471,11.29
9830918,9984528,3815,1335250,11319778,13.37
9830919,2952814,1835,642250,3595064,21.75
9830920,9974237,4316,1510600,11484837,15.15
9830921,6750230,3195,1118250,7868480,16.57
9830922,9979181,3933,1376550,11355731,13.79
9830923,9998409,2589,906150,10904559,9.06
9830925,9987450,6177,2161950,12149400,21.65
9830926,9994254,3038,1063300,11057554,10.64
9830927,9980350,4584,1604400,11584750,16.08
9830928,9974570,3087,1080450,11055020,10.83
9830929,9977934,2302,805700,10783634,8.07
9830930,9980115,4134,1446900,11427015,14.50
9830931,9984346,2473,865550,10849896,8.67
9830932,9987094,2446,856100,10843194,8.57
9830933,9990183,3193,1117550,11107733,11.19
9830934,9984384,3664,1282400,11266784,12.84
9830935,9987777,3283,1149050,11136827,11.50
9830936,9972264,2231,780850,10753114,7.83
9830937,9951025,1604,561400,10512425,5.64
9830938,9967525,5332,1866200,11833725,18.72
9830939,9982193,3252,1138200,11120393,11.40
9830940,9973151,4029,1410150,11383301,14.14
9830941,9992586,3881,1358350,11350936,13.59
9830942,9973479,4020,1407000,11380479,14.11
9830943,9988314,2814,984900,10973214,9.86
9830944,9968934,3615,1265250,11234184,12.69
9830945,9986746,2926,1024100,11010846,10.25
9830946,9982339,3962,1386700,11369039,13.89
9830947,9979701,3146,1101100,11080801,11.03
9830948,9979619,1984,694400,10674019,6.96
9830949,9974863,1957,684950,10659813,6.87
9830950,9975674,3460,1211000,11186674,12.14
9830951,9970884,1006,352100,10322984,3.53
9830952,9952198,3110,1088500,11040698,10.94
9830954,9947330,3236,1132600,11079930,11.39
9830955,9954109,2321,812350,10766459,8.16
9830956,9975147,3773,1320550,11295697,13.24
9830957,9973352,2841,994350,10967702,9.97
9830958,9986148,4350,1522500,11508648,15.25
9830959,3345411,839,293650,3639061,8.78
9830960,9980367,3661,1281350,11261717,12.84
9830961,9985897,3688,1290800,11276697,12.93
9830962,9985478,5399,1889650,11875128,18.92
9830963,9960988,2901,1015350,10976338,10.19
9830964,9980612,4652,1628200,11608812,16.31
9830965,9987853,3553,1243550,11231403,12.45
9830966,9987412,3275,1146250,11133662,11.48
9830967,9995207,1576,551600,10546807,5.52
9830968,9976867,3702,1295700,11272567,12.99
9830969,9992330,3529,1235150,11227480,12.36
9830970,9990575,5520,1932000,11922575,19.34
9830971,9976995,2768,968800,10945795,9.71
9830972,9997798,5297,1853950,11851748,18.54
9830973,9990173,2810,983500,10973673,9.84
9830974,9964860,3973,1390550,11355410,13.95
9830975,9981027,2740,959000,10940027,9.61
9830976,9981745,629,220150,10201895,2.21
9830977,9988824,3312,1159200,11148024,11.60
9830978,9983660,3511,1228850,11212510,12.31
9830979,9913101,4710,1648500,11561601,16.63
9830980,9909809,3051,1067850,10977659,10.78
9830981,9977240,2016,705600,10682840,7.07
9830982,9996588,3255,1139250,11135838,11.40
9830983,9977387,4488,1570800,11548187,15.74
9830984,9990352,4027,1409450,11399802,14.11
9830985,9969897,2062,721700,10691597,7.24
9830986,9972223,3779,1322650,11294873,13.26
9830987,9958220,2853,998550,10956770,10.03
9830988,9969099,2316,810600,10779699,8.13
9830989,9964373,3417,1195950,11160323,12.00
9830990,9976852,4652,1628200,11605052,16.32
9830991,9751920,1428,499800,10251720,5.13
9830992,5767966,1779,622650,6390616,10.79
9830993,9978959,3729,1305150,11284109,13.08
9830994,9972077,3981,1393350,11365427,13.97
9830995,9978983,4250,1487500,11466483,14.91
9830996,9962719,2619,916650,10879369,9.20
9830997,9988464,3483,1219050,11207514,12.20
9830998,9981225,4180,1463000,11444225,14.66
9830999,9981294,3604,1261400,11242694,12.64
9831000,9968199,3279,1147650,11115849,11.51
9831001,9982383,4536,1587600,11569983,15.90
9831002,9980521,2628,919800,10900321,9.22
9831003,9987409,2632,921200,10908609,9.22
9831004,9970174,5338,1868300,11838474,18.74
9831005,9863476,2218,776300,10639776,7.87
9831006,9980031,3580,1253000,11233031,12.56
9831007,9989059,3392,1187200,11176259,11.89
9831008,9982659,3523,1233050,11215709,12.35
9831009,9998017,2162,756700,10754717,7.57
9831010,9977320,3861,1351350,11328670,13.54
9831011,3348384,1447,506450,3854834,15.13
9831012,9619300,4486,1570100,11189400,16.32
9831013,9962469,5407,1892450,11854919,19.00
9831014,9983914,959,335650,10319564,3.36
9831015,9189355,3282,1148700,10338055,12.50
9831016,4268155,1367,478450,4746605,11.21
9831017,8888397,5014,1754900,10643297,19.74
9831018,9987992,3551,1242850,11230842,12.44
9831019,9980379,4594,1607900,11588279,16.11
9831020,9980423,3340,1169000,11149423,11.71
9831021,9974594,5565,1947750,11922344,19.53
9831022,9995905,2987,1045450,11041355,10.46
9831023,4617635,1514,529900,5147535,11.48
9831024,9995084,4349,1522150,11517234,15.23
9831025,9988108,1766,618100,10606208,6.19
9831026,9795252,4045,1415750,11211002,14.45
9831027,2371422,1196,418600,2790022,17.65
9831028,9961816,4862,1701700,11663516,17.08
9831029,9988598,3594,1257900,11246498,12.59
9831030,9983159,4283,1499050,11482209,15.02
9831031,179679,94,32900,212579,18.31
9831032,9961109,3551,1242850,11203959,12.48
9831033,9962769,4185,1464750,11427519,14.70
9831034,9425912,2577,901950,10327862,9.57
9831035,9982446,3116,1090600,11073046,10.93
9831036,6657113,2475,866250,7523363,13.01
9831037,9970346,3559,1245650,11215996,12.49
9831038,9951333,4856,1699600,11650933,17.08
9831039,9961312,2422,847700,10809012,8.51
9831040,9955003,4974,1740900,11695903,17.49
9831041,5893626,2466,863100,6756726,14.64
9831042,1060514,607,212450,1272964,20.03
9831043,9972991,4500,1575000,11547991,15.79
9831044,9912802,3641,1274350,11187152,12.86
9831045,9962225,4916,1720600,11682825,17.27
9831046,9968370,3860,1351000,11319370,13.55
9831047,9980644,3227,1129450,11110094,11.32
9831048,9985904,3927,1374450,11360354,13.76
9831049,9978204,3551,1242850,11221054,12.46
9831050,9991230,4179,1462650,11453880,14.64
9831051,9986530,2528,884800,10871330,8.86
9831052,1390689,1103,386050,1776739,27.76
9831053,9989444,7447,2606450,12595894,26.09
9831054,9980780,4480,1568000,11548780,15.71
9831055,9980313,5151,1802850,11783163,18.06
9831056,9975827,3388,1185800,11161627,11.89
9831057,9987150,2294,802900,10790050,8.04
9831058,9964277,1071,374850,10339127,3.76
9831059,9735657,3606,1262100,10997757,12.96
9831060,9988951,5366,1878100,11867051,18.80
9831061,2069691,1618,566300,2635991,27.36
9831062,9984382,3732,1306200,11290582,13.08
9831063,9983709,6395,2238250,12221959,22.42
9831064,9985089,2615,915250,10900339,9.17
9831065,1467618,1053,368550,1836168,25.11
9831066,9971910,5237,1832950,11804860,18.38
9831067,9964307,4687,1640450,11604757,16.46
9831068,9446805,2770,969500,10416305,10.26
9831069,9948865,6291,2201850,12150715,22.13
9831070,9960145,5230,1830500,11790645,18.38
9831071,9955659,5561,1946350,11902009,19.55
9831072,9961884,3702,1295700,11257584,13.01
9831073,9981839,3743,1310050,11291889,13.12
9831074,9973878,2965,1037750,11011628,10.40
9831075,9988477,4167,1458450,11446927,14.60
9831076,9982339,4284,1499400,11481739,15.02
9831077,9985581,4537,1587950,11573531,15.90
9831078,6840357,3808,1332800,8173157,19.48
9831079,9983136,2116,740600,10723736,7.42
9831080,9985689,3017,1055950,11041639,10.57
9831081,9968600,3675,1286250,11254850,12.90
9831082,9991705,4424,1548400,11540105,15.50
9831083,9980349,3872,1355200,11335549,13.58
9831084,9954177,320,112000,10066177,1.13
9831085,9974802,4501,1575350,11550152,15.79
9831086,9955244,1777,621950,10577194,6.25
9831087,9973151,3803,1331050,11304201,13.35
9831088,9976677,3766,1318100,11294777,13.21
9831089,9980321,4886,1710100,11690421,17.13
9831090,9971969,4989,1746150,11718119,17.51
9831091,9474718,4658,1630300,11105018,17.21
9831092,9995268,5045,1765750,11761018,17.67
9831093,9865136,7190,2516500,12381636,25.51
9831094,9797756,3115,1090250,10888006,11.13
9831095,4828195,3167,1108450,5936645,22.96
9831096,9965828,3842,1344700,11310528,13.49
9831097,9981279,5243,1835050,11816329,18.38
9831098,9965456,2978,1042300,11007756,10.46
9831099,9964366,4585,1604750,11569116,16.10
9831100,9970806,3421,1197350,11168156,12.01
9831101,9967311,3518,1231300,11198611,12.35
9831102,4838233,1371,479850,5318083,9.92
9831103,9935325,3903,1366050,11301375,13.75
9831104,9937299,3305,1156750,11094049,11.64
9831105,9934220,2854,998900,10933120,10.06
9831106,9943203,4275,1496250,11439453,15.05
9831107,9954269,3551,1242850,11197119,12.49
9831108,9851316,5875,2056250,11907566,20.87
9831110,9967433,3075,1076250,11043683,10.80
9831111,9969606,4530,1585500,11555106,15.90
9831112,9363394,2532,886200,10249594,9.46
9831113,9963115,2350,822500,10785615,8.26
9831114,1486850,409,143150,1630000,9.63
9831115,9972792,2604,911400,10884192,9.14
9831116,9965875,2054,718900,10684775,7.21
9831118,9946023,3886,1360100,11306123,13.67
9831119,9940826,4291,1501850,11442676,15.11
9831120,9602767,4752,1663200,11265967,17.32
9831121,9689691,4041,1414350,11104041,14.60
9831122,8723811,2198,769300,9493111,8.82
9831123,9933598,1645,575750,10509348,5.80
9831124,9945360,1549,542150,10487510,5.45
9831125,9949846,5502,1925700,11875546,19.35
9831126,9923852,2831,990850,10914702,9.98
9831127,9931233,2975,1041250,10972483,10.48
9831128,9958292,3911,1368850,11327142,13.75
9831129,9966483,3190,1116500,11082983,11.20
9831130,9978177,4621,1617350,11595527,16.21
9831131,8871583,4515,1580250,10451833,17.81
9831132,9968962,3095,1083250,11052212,10.87
9831133,9970578,6921,2422350,12392928,24.29
9831134,9998904,3211,1123850,11122754,11.24
9831135,5644606,317,110950,5755556,1.97
9831136,9989030,5260,1841000,11830030,18.43
9831137,9980934,3376,1181600,11162534,11.84
9831138,9993391,2627,919450,10912841,9.20
9831139,9985120,3672,1285200,11270320,12.87
9831140,9992327,2405,841750,10834077,8.42
9831141,9996560,1945,680750,10677310,6.81
9831142,9982255,4018,1406300,11388555,14.09
9831143,9979334,3063,1072050,11051384,10.74
9831144,9970215,3792,1327200,11297415,13.31
9831145,9976543,2341,819350,10795893,8.21
9831146,9978897,5446,1906100,11884997,19.10
9831147,9979176,2997,1048950,11028126,10.51
9831148,9997687,3778,1322300,11319987,13.23
9831149,9982214,3863,1352050,11334264,13.54
9831150,9995981,3316,1160600,11156581,11.61
9831151,9986940,2618,916300,10903240,9.17
9831152,9991237,4311,1508850,11500087,15.10
9831153,9998446,2480,868000,10866446,8.68
9831154,9974859,1961,686350,10661209,6.88
9831155,9993050,5100,1785000,11778050,17.86
9831156,9986019,4086,1430100,11416119,14.32
9831157,9977067,3521,1232350,11209417,12.35
9831158,9987731,6226,2179100,12166831,21.82
9831159,9973872,4048,1416800,11390672,14.21
9831160,9960066,2815,985250,10945316,9.89
9831161,9981002,3227,1129450,11110452,11.32
9831163,9976365,4419,1546650,11523015,15.50
9831164,9983791,4958,1735300,11719091,17.38
9831165,9981104,4778,1672300,11653404,16.75
9831166,9988412,3991,1396850,11385262,13.98
9831167,6091038,1889,661150,6752188,10.85
9831168,9980051,2571,899850,10879901,9.02
9831169,9989716,4965,1737750,11727466,17.40
9831170,9988601,6004,2101400,12090001,21.04
9831171,9980514,3632,1271200,11251714,12.74
9831172,9984189,4999,1749650,11733839,17.52
9831173,9991545,2100,735000,10726545,7.36
9831174,9984575,2763,967050,10951625,9.69
9831175,9492079,4595,1608250,11100329,16.94
9831176,819386,370,129500,948886,15.80
9831177,4329343,2160,756000,5085343,17.46
9831178,9986482,4013,1404550,11391032,14.06
9831179,9978614,3108,1087800,11066414,10.90
9831180,9978889,5230,1830500,11809389,18.34
9831181,9983390,2245,785750,10769140,7.87
9831182,9980977,3395,1188250,11169227,11.91
9831183,9984582,2458,860300,10844882,8.62
9831184,9982228,4188,1465800,11448028,14.68
9831185,9976285,4516,1580600,11556885,15.84
9831186,8491362,2414,844900,9336262,9.95
9831187,9993092,5103,1786050,11779142,17.87
9831188,9993936,5917,2070950,12064886,20.72
9831190,9975484,2023,708050,10683534,7.10
9831191,9980508,4972,1740200,11720708,17.44
9831192,4723451,1532,536200,5259651,11.35
9831193,9962297,2858,1000300,10962597,10.04
9831194,9984027,3945,1380750,11364777,13.83
9831195,1030939,459,160650,1191589,15.58
9831196,9986774,6484,2269400,12256174,22.72
9831197,9969798,3509,1228150,11197948,12.32
9831198,9971160,3217,1125950,11097110,11.29
9831199,6718731,3193,1117550,7836281,16.63
9831200,9983743,3613,1264550,11248293,12.67
9831201,9979759,2117,740950,10720709,7.42
9831202,9993487,5676,1986600,11980087,19.88
9831203,9999872,4739,1658650,11658522,16.59
9831204,9999827,1967,688450,10688277,6.88
9831205,9980828,4464,1562400,11543228,15.65
9831206,2264505,2954,1033900,3298405,45.66
9831207,9979497,5496,1923600,11903097,19.28
9831208,9986071,3593,1257550,11243621,12.59
9831209,9981727,1620,567000,10548727,5.68
9831210,9984342,1184,414400,10398742,4.15
9831211,9985533,4869,1704150,11689683,17.07
9831212,9983740,3276,1146600,11130340,11.48
9831213,9982549,3169,1109150,11091699,11.11
9831214,9988440,2857,999950,10988390,10.01
9831215,9967660,4598,1609300,11576960,16.15
9831216,9982838,3931,1375850,11358688,13.78
9831218,9980782,2770,969500,10950282,9.71
9831219,9973393,1069,374150,10347543,3.75
9831220,9964437,4062,1421700,11386137,14.27
9831221,9971835,1659,580650,10552485,5.82
9831222,9934482,4129,1445150,11379632,14.55
9831223,9991929,4118,1441300,11433229,14.42
9831224,9946913,3329,1165150,11112063,11.71
9831225,9975423,4485,1569750,11545173,15.74
9831226,9967371,3922,1372700,11340071,13.77
9831227,9882414,3377,1181950,11064364,11.96
9831228,9969974,2669,934150,10904124,9.37
9831229,9975112,4951,1732850,11707962,17.37
9831230,9974231,3353,1173550,11147781,11.77
9831231,9988066,4150,1452500,11440566,14.54
9831232,9986996,2640,924000,10910996,9.25
9831233,9962965,5135,1797250,11760215,18.04
9831234,9962770,2638,923300,10886070,9.27
9831235,9971338,4422,1547700,11519038,15.52
9831236,9980105,3831,1340850,11320955,13.44
9831237,6173935,2592,907200,7081135,14.69
9831238,9959608,3548,1241800,11201408,12.47
9831239,9949192,4641,1624350,11573542,16.33
9831240,9953801,3646,1276100,11229901,12.82
9831241,9949605,3624,1268400,11218005,12.75
9831242,9657542,5259,1840650,11498192,19.06
9831243,9964147,6157,2154950,12119097,21.63
9831244,9969676,2462,861700,10831376,8.64
9831245,4584492,2765,967750,5552242,21.11
9831246,9964163,3777,1321950,11286113,13.27
9831247,9969908,2373,830550,10800458,8.33
9831248,9969807,2749,962150,10931957,9.65
9831250,9997425,4880,1708000,11705425,17.08
9831251,9991850,2264,792400,10784250,7.93
9831252,9972377,3885,1359750,11332127,13.64
9831253,9639750,4863,1702050,11341800,17.66
9831254,9984634,3677,1286950,11271584,12.89
9831255,9989458,3796,1328600,11318058,13.30
9831256,9986673,2796,978600,10965273,9.80
9831257,9987900,3183,1114050,11101950,11.15
9831258,2684819,2002,700700,3385519,26.10
9831259,9969930,3224,1128400,11098330,11.32
9831260,9969578,3706,1297100,11266678,13.01
9831261,9970047,1986,695100,10665147,6.97
9831262,9966475,3671,1284850,11251325,12.89
9831263,2223123,435,152250,2375373,6.85
9831264,9999016,2037,712950,10711966,7.13
9831265,9987828,1793,627550,10615378,6.28
9831266,9994532,3429,1200150,11194682,12.01
9831267,9979313,2905,1016750,10996063,10.19
9831268,9970689,3139,1098650,11069339,11.02
9831269,9986497,3649,1277150,11263647,12.79
9831270,9974383,3896,1363600,11337983,13.67
9831271,9984895,3385,1184750,11169645,11.87
9831272,9978024,6766,2368100,12346124,23.73
9831273,9972563,3106,1087100,11059663,10.90
9831274,9977543,2460,861000,10838543,8.63
9831275,9990984,2328,814800,10805784,8.16
9831276,9763761,4156,1454600,11218361,14.90
9831277,9986641,1899,664650,10651291,6.66
9831278,9976643,4682,1638700,11615343,16.43
9831279,9958239,2206,772100,10730339,7.75
9831280,9959127,5785,2024750,11983877,20.33
9831281,9966016,5052,1768200,11734216,17.74
9831282,9950139,3563,1247050,11197189,12.53
9831283,9948968,3994,1397900,11346868,14.05
9831284,9960960,2828,989800,10950760,9.94
9831285,9940631,4378,1532300,11472931,15.41
9831286,9982962,3943,1380050,11363012,13.82
9831287,9991305,4536,1587600,11578905,15.89
9831288,9992970,3546,1241100,11234070,12.42
9831289,891777,1020,357000,1248777,40.03
9831290,9989618,3008,1052800,11042418,10.54
9831291,9912719,4538,1588300,11501019,16.02
9831292,9983533,1511,528850,10512383,5.30
9831293,9995425,2928,1024800,11020225,10.25
9831294,1149343,405,141750,1291093,12.33
9831295,9986482,3898,1364300,11350782,13.66
9831296,2329303,1389,486150,2815453,20.87
9831299,9960057,6055,2119250,12079307,21.28
9831300,9953468,4950,1732500,11685968,17.41
9831301,9960805,7677,2686950,12647755,26.98
9831302,1013317,263,92050,1105367,9.08
9831303,5272754,1424,498400,5771154,9.45
9831304,2628300,1318,461300,3089600,17.55
9831305,9606460,4845,1695750,11302210,17.65
9831306,9949747,5021,1757350,11707097,17.66
9831307,9947541,3813,1334550,11282091,13.42
9831308,9941696,3060,1071000,11012696,10.77
9831309,9899026,4778,1672300,11571326,16.89
9831310,9946125,3405,1191750,11137875,11.98
9831311,9941795,3057,1069950,11011745,10.76
9831312,9956993,2198,769300,10726293,7.73
9831313,9937159,3055,1069250,11006409,10.76
9831314,9958505,2916,1020600,10979105,10.25
9831315,9938492,4021,1407350,11345842,14.16
9831316,9926554,3391,1186850,11113404,11.96
9831317,434518,201,70350,504868,16.19
9831318,9928573,5379,1882650,11811223,18.96
9831319,9933322,3175,1111250,11044572,11.19
9831320,1358677,942,329700,1688377,24.27
9831321,9933790,4129,1445150,11378940,14.55
9831322,9936229,3475,1216250,11152479,12.24
9831323,9927506,4006,1402100,11329606,14.12
9831324,9921904,3522,1232700,11154604,12.42
9831325,5827241,2383,834050,6661291,14.31
9831326,9928040,4581,1603350,11531390,16.15
9831327,9921089,2835,992250,10913339,10.00
9831328,9935685,3763,1317050,11252735,13.26
9831329,9920196,3947,1381450,11301646,13.93
9831330,9928706,2564,897400,10826106,9.04
9831331,9929973,4511,1578850,11508823,15.90
9831332,9934180,3190,1116500,11050680,11.24
9831333,9554470,4171,1459850,11014320,15.28
9831334,9912426,3321,1162350,11074776,11.73
9831335,3169327,1709,598150,3767477,18.87
9831336,9910416,3109,1088150,10998566,10.98
9831337,9912236,5382,1883700,11795936,19.00
9831338,9923086,2855,999250,10922336,10.07
9831339,9928344,5223,1828050,11756394,18.41
9831340,2122295,161,56350,2178645,2.66
9831341,9921540,3777,1321950,11243490,13.32
9831342,9929556,3439,1203650,11133206,12.12
9831343,9926705,3154,1103900,11030605,11.12
9831344,2122143,898,314300,2436443,14.81
9831345,9929118,4730,1655500,11584618,16.67
9831346,9925403,3820,1337000,11262403,13.47
9831347,272454,319,111650,384104,40.98
9831348,9948073,3248,1136800,11084873,11.43
9831349,9948417,3712,1299200,11247617,13.06
9831350,9944367,2174,760900,10705267,7.65
9831352,9977324,3763,1317050,11294374,13.20
9831353,9958599,891,311850,10270449,3.13
9831354,9956790,3340,1169000,11125790,11.74
9831355,9980239,3921,1372350,11352589,13.75
9831356,225693,130,45500,271193,20.16
9831357,9966861,1783,624050,10590911,6.26
9831358,9987981,2946,1031100,11019081,10.32
9831359,9990793,4462,1561700,11552493,15.63
9831360,1480093,1450,507500,1987593,34.29
9831361,6640573,3433,1201550,7842123,18.09
9831362,9975984,2938,1028300,11004284,10.31
9831363,9975726,3265,1142750,11118476,11.46
9831364,9980783,3022,1057700,11038483,10.60
9831366,9989201,3103,1086050,11075251,10.87
9831368,6960291,4491,1571850,8532141,22.58
9831369,5852421,1929,675150,6527571,11.54
9831370,9965008,4081,1428350,11393358,14.33
9831371,1380519,728,254800,1635319,18.46
9831373,9962203,4636,1622600,11584803,16.29
9831374,9954367,3548,1241800,11196167,12.47
9831375,9873477,3097,1083950,10957427,10.98
9831376,9954641,4034,1411900,11366541,14.18
9831377,9972069,3666,1283100,11255169,12.87
9831378,9983638,3928,1374800,11358438,13.77
9831379,9989933,737,257950,10247883,2.58
9831380,9977560,4120,1442000,11419560,14.45
9831381,9968126,3198,1119300,11087426,11.23
9831382,9975859,4027,1409450,11385309,14.13
9831383,9976439,3884,1359400,11335839,13.63
9831384,9982347,4026,1409100,11391447,14.12
9831386,9984983,3626,1269100,11254083,12.71
9831387,9973224,3834,1341900,11315124,13.46
9831388,9967359,2236,782600,10749959,7.85
9831389,9964946,2613,914550,10879496,9.18
9831390,9961997,2942,1029700,10991697,10.34
9831391,9828500,1187,415450,10243950,4.23
9831392,9685912,1259,440650,10126562,4.55
9831393,9255767,345,120750,9376517,1.30
9831394,9979523,3392,1187200,11166723,11.90
9831395,9979950,4740,1659000,11638950,16.62
9831396,9999295,4010,1403500,11402795,14.04
9831397,9983868,3669,1284150,11268018,12.86
9831398,2106158,1353,473550,2579708,22.48
9831399,9981184,3143,1100050,11081234,11.02
9831400,9986417,2920,1022000,11008417,10.23
9831401,9978818,892,312200,10291018,3.13
9831402,9974679,3595,1258250,11232929,12.61
9831405,9987720,5598,1959300,11947020,19.62
9831406,1257782,572,200200,1457982,15.92
9831407,9949509,3150,1102500,11052009,11.08
9831408,9985564,3349,1172150,11157714,11.74
9831409,9990722,2951,1032850,11023572,10.34
9831410,1442052,777,271950,1714002,18.86
9831411,8991058,3447,1206450,10197508,13.42
9831412,9967114,3212,1124200,11091314,11.28
9831413,9984378,2464,862400,10846778,8.64
9831414,9978768,2269,794150,10772918,7.96
9831415,7883595,2416,845600,8729195,10.73
9831416,8985205,3149,1102150,10087355,12.27
9831417,9564863,3647,1276450,10841313,13.35
9831418,9970635,3754,1313900,11284535,13.18
9831419,9977658,2578,902300,10879958,9.04
9831420,9924586,4018,1406300,11330886,14.17
9831421,9984403,5399,1889650,11874053,18.93
9831422,9352822,3929,1375150,10727972,14.70
9831423,9984637,4529,1585150,11569787,15.88
9831424,9968125,2905,1016750,10984875,10.20
9831425,1863686,1616,565600,2429286,30.35
9831426,9947693,3768,1318800,11266493,13.26
9831427,9954218,2455,859250,10813468,8.63
9831428,9944705,5662,1981700,11926405,19.93
9831429,9950582,3805,1331750,11282332,13.38
9831430,9953386,4654,1628900,11582286,16.37
9831431,9957528,4742,1659700,11617228,16.67
9831432,9956999,5039,1763650,11720649,17.71
9831433,9981422,4613,1614550,11595972,16.18
9831434,618453,228,79800,698253,12.90
9831435,9967091,4470,1564500,11531591,15.70
9831437,9956855,2197,768950,10725805,7.72
9831438,9450254,3553,1243550,10693804,13.16
9831439,9954689,3070,1074500,11029189,10.79
9831440,9953181,3181,1113350,11066531,11.19
9831441,9957939,6596,2308600,12266539,23.18
9831442,9977281,5178,1812300,11789581,18.16
9831443,9537346,4151,1452850,10990196,15.23
9831444,9958420,3841,1344350,11302770,13.50
9831445,9716228,2513,879550,10595778,9.05
9831446,9899200,3639,1273650,11172850,12.87
9831447,9978254,4070,1424500,11402754,14.28
9831448,9971802,2834,991900,10963702,9.95
9831449,5845291,2005,701750,6547041,12.01
9831450,1119728,287,100450,1220178,8.97
9831451,188969,136,47600,236569,25.19
9831452,576256,229,80150,656406,13.91
9831453,9968170,3867,1353450,11321620,13.58
9831454,9979151,4681,1638350,11617501,16.42
9831455,9975703,4886,1710100,11685803,17.14
9831456,9972898,2857,999950,10972848,10.03
9831457,4230121,1702,595700,4825821,14.08
9831458,9956339,4127,1444450,11400789,14.51
9831459,9977334,4551,1592850,11570184,15.96
9831460,1697166,1014,354900,2052066,20.91
9831461,9841451,5116,1790600,11632051,18.19
9831462,9982367,3765,1317750,11300117,13.20
9831463,9974581,5641,1974350,11948931,19.79
9831464,727403,124,43400,770803,5.97
9831465,9966898,229,80150,10047048,0.80
9831466,8972200,4867,1703450,10675650,18.99
9831467,4696880,2587,905450,5602330,19.28
9831468,9960091,4738,1658300,11618391,16.65
9831469,9959538,2757,964950,10924488,9.69
9831470,9399613,3918,1371300,10770913,14.59
9831471,9957337,2719,951650,10908987,9.56
9831472,9944808,4721,1652350,11597158,16.62
9831473,2756510,1425,498750,3255260,18.09
9831475,3171564,1209,423150,3594714,13.34
9831476,9366337,3243,1135050,10501387,12.12
9831477,9930759,3007,1052450,10983209,10.60
9831478,9927528,2350,822500,10750028,8.29
9831479,9927810,2512,879200,10807010,8.86
9831480,9930655,5098,1784300,11714955,17.97
9831481,9943674,3728,1304800,11248474,13.12
9831482,9954122,2817,985950,10940072,9.90
9831483,9959575,4417,1545950,11505525,15.52
9831485,9949865,4370,1529500,11479365,15.37
9831486,9966464,4683,1639050,11605514,16.45
9831487,9960704,4132,1446200,11406904,14.52
9831488,9971655,1936,677600,10649255,6.80
9831489,9984635,1289,451150,10435785,4.52
9831490,3716459,1105,386750,4103209,10.41
9831491,9959145,4079,1427650,11386795,14.34
9831492,5071997,3643,1275050,6347047,25.14
9831493,9970502,2457,859950,10830452,8.62
9831494,9964420,2697,943950,10908370,9.47
9831495,9970097,3119,1091650,11061747,10.95
9831496,9983485,2817,985950,10969435,9.88
9831497,9978687,3410,1193500,11172187,11.96
9831498,9975507,4943,1730050,11705557,17.34
9831499,9914922,8520,2982000,12896922,30.08
9831500,9973788,4809,1683150,11656938,16.88
9831501,9973843,6243,2185050,12158893,21.91
9831502,1628988,618,216300,1845288,13.28
9831503,9977383,2814,984900,10962283,9.87
9831504,9997785,2618,916300,10914085,9.17
9831505,9989034,1937,677950,10666984,6.79
9831506,9689090,3107,1087450,10776540,11.22
9831507,9998198,3185,1114750,11112948,11.15
9831508,9983348,2928,1024800,11008148,10.27
9831509,9999538,3788,1325800,11325338,13.26
9831510,9992365,3854,1348900,11341265,13.50
9831511,9981848,3785,1324750,11306598,13.27
9831512,9985150,4726,1654100,11639250,16.57
9831513,9997750,5166,1808100,11805850,18.09
9831514,9986592,5007,1752450,11739042,17.55
9831515,9974297,3881,1358350,11332647,13.62
9831517,7640978,5693,1992550,9633528,26.08
9831518,9990088,5869,2054150,12044238,20.56
9831519,9978211,4094,1432900,11411111,14.36
9831520,9984680,3907,1367450,11352130,13.70
9831521,9917692,3113,1089550,11007242,10.99
9831522,9985453,3722,1302700,11288153,13.05
9831523,9988467,2888,1010800,10999267,10.12
9831524,9975341,4523,1583050,11558391,15.87
9831525,9960291,1985,694750,10655041,6.98
9831526,9970280,2224,778400,10748680,7.81
9831527,9977604,2687,940450,10918054,9.43
9831528,9999388,4589,1606150,11605538,16.06
9831529,9984346,3396,1188600,11172946,11.90
9831530,9990338,3910,1368500,11358838,13.70
9831531,9988383,3986,1395100,11383483,13.97
9831532,9990541,3885,1359750,11350291,13.61
9831533,9990737,6757,2364950,12355687,23.67
9831534,9993549,6550,2292500,12286049,22.94
9831535,9989129,4972,1740200,11729329,17.42
9831536,9969605,4904,1716400,11686005,17.22
9831537,2672746,563,197050,2869796,7.37
9831538,9959980,5311,1858850,11818830,18.66
9831539,9977641,5085,1779750,11757391,17.84
9831540,1590558,1141,399350,1989908,25.11
9831541,89374,70,24500,113874,27.41
9831542,9986127,3828,1339800,11325927,13.42
9831543,9197156,3006,1052100,10249256,11.44
9831544,5729581,3341,1169350,6898931,20.41
9831545,9954957,2219,776650,10731607,7.80
9831546,9947068,2961,1036350,10983418,10.42
9831547,9350495,3531,1235850,10586345,13.22
9831548,9943603,1172,410200,10353803,4.13
9831549,9960884,4375,1531250,11492134,15.37
9831550,9961546,3360,1176000,11137546,11.81
9831551,9919098,4179,1462650,11381748,14.75
9831552,9902949,4145,1450750,11353699,14.65
9831553,9908682,3263,1142050,11050732,11.53
9831554,9987246,2297,803950,10791196,8.05
9831555,9520195,3694,1292900,10813095,13.58
9831556,9983976,3660,1281000,11264976,12.83
9831557,9977426,4581,1603350,11580776,16.07
9831558,9986406,3653,1278550,11264956,12.80
9831559,9974462,4653,1628550,11603012,16.33
9831560,9981472,2439,853650,10835122,8.55
9831561,9992983,2118,741300,10734283,7.42
9831562,9994635,4188,1465800,11460435,14.67
9831563,9977645,4586,1605100,11582745,16.09
9831564,9979322,4704,1646400,11625722,16.50
9831565,9955895,4006,1402100,11357995,14.08
9831566,9973032,4081,1428350,11401382,14.32
9831567,9967727,5943,2080050,12047777,20.87
9831568,9976829,2710,948500,10925329,9.51
9831569,1553928,491,171850,1725778,11.06
9831570,9986409,2889,1011150,10997559,10.13
9831571,9931652,2769,969150,10900802,9.76
9831572,9991901,3806,1332100,11324001,13.33
9831573,9973483,4918,1721300,11694783,17.26
9831574,9993548,5275,1846250,11839798,18.47
9831575,9994112,1748,611800,10605912,6.12
9831577,4434662,1506,527100,4961762,11.89
9831578,7984732,3516,1230600,9215332,15.41
9831579,3333152,777,271950,3605102,8.16
9831580,9970332,2733,956550,10926882,9.59
9831581,9942149,3795,1328250,11270399,13.36
9831582,9955327,4512,1579200,11534527,15.86
9831583,9967068,2335,817250,10784318,8.20
9831584,9982465,1721,602350,10584815,6.03
9831585,9974316,3226,1129100,11103416,11.32
9831586,9966771,2689,941150,10907921,9.44
9831587,9974425,4882,1708700,11683125,17.13
9831588,9972476,1943,680050,10652526,6.82
9831589,9989289,3729,1305150,11294439,13.07
9831590,9610828,1289,451150,10061978,4.69
9831591,9975495,3183,1114050,11089545,11.17
9831592,522445,203,71050,593495,13.60
9831593,9962814,3114,1089900,11052714,10.94
9831594,9962958,3770,1319500,11282458,13.24
9831596,9967864,3592,1257200,11225064,12.61
9831597,9971150,838,293300,10264450,2.94
9831598,9974997,2353,823550,10798547,8.26
9831599,9983749,4867,1703450,11687199,17.06
9831600,9990369,6238,2183300,12173669,21.85
9831601,588016,260,91000,679016,15.48
9831602,9977766,4586,1605100,11582866,16.09
9831603,9980364,3898,1364300,11344664,13.67
9831604,9983233,2341,819350,10802583,8.21
9831606,9921680,3281,1148350,11070030,11.57
9831607,1256897,763,267050,1523947,21.25
9831608,9977589,4259,1490650,11468239,14.94
9831609,445893,201,70350,516243,15.78
9831610,9421092,3349,1172150,10593242,12.44
9831611,898184,309,108150,1006334,12.04
9831612,9953182,4669,1634150,11587332,16.42
9831613,9948577,4254,1488900,11437477,14.97
9831614,9962649,2148,751800,10714449,7.55
9831615,9942747,3245,1135750,11078497,11.42
9831616,9944631,5199,1819650,11764281,18.30
9831617,9941223,2027,709450,10650673,7.14
9831618,9938544,3393,1187550,11126094,11.95
9831619,9924446,2559,895650,10820096,9.02
9831620,6058461,2622,917700,6976161,15.15
9831621,9937701,2328,814800,10752501,8.20
9831622,9942045,2865,1002750,10944795,10.09
9831623,9936767,2211,773850,10710617,7.79
9831624,9937958,2919,1021650,10959608,10.28
9831625,9956230,3377,1181950,11138180,11.87
9831627,9965859,3255,1139250,11105109,11.43
9831628,9971842,2457,859950,10831792,8.62
9831629,9967440,904,316400,10283840,3.17
9831630,9966934,4018,1406300,11373234,14.11
9831631,9970433,4799,1679650,11650083,16.85
9831632,9961670,3070,1074500,11036170,10.79
9831633,8759050,1859,650650,9409700,7.43
9831634,9983613,3882,1358700,11342313,13.61
9831635,9979383,2368,828800,10808183,8.31
9831636,9031740,2234,781900,9813640,8.66
9831637,9988459,2991,1046850,11035309,10.48
9831638,9988027,3172,1110200,11098227,11.12
9831639,9960294,3092,1082200,11042494,10.87
9831640,9984319,3410,1193500,11177819,11.95
9831641,9978099,3304,1156400,11134499,11.59
9831642,9992161,3144,1100400,11092561,11.01
9831643,9980177,3232,1131200,11111377,11.33
9831644,6133460,2414,844900,6978360,13.78
9831645,9997195,2961,1036350,11033545,10.37
9831646,9984703,2250,787500,10772203,7.89
9831647,9992536,2459,860650,10853186,8.61
9831648,9967771,5033,1761550,11729321,17.67
9831649,9998233,2712,949200,10947433,9.49
9831650,9998721,4733,1656550,11655271,16.57
9831651,9994036,3321,1162350,11156386,11.63
9831652,9985334,2459,860650,10845984,8.62
9831653,9983266,3595,1258250,11241516,12.60
9831654,9904708,4389,1536150,11440858,15.51
9831655,5275040,2855,999250,6274290,18.94
9831656,9992410,2872,1005200,10997610,10.06
9831657,9990979,5159,1805650,11796629,18.07
9831658,9971940,3565,1247750,11219690,12.51
9831659,9994428,3375,1181250,11175678,11.82
9831660,9980363,3551,1242850,11223213,12.45
9831661,2737537,775,271250,3008787,9.91
9831662,9969631,4160,1456000,11425631,14.60
9831663,9954656,4247,1486450,11441106,14.93
9831664,9969505,2160,756000,10725505,7.58
9831665,9984616,3916,1370600,11355216,13.73
9831666,9995851,2075,726250,10722101,7.27
9831667,9946449,3648,1276800,11223249,12.84
9831668,9989521,4846,1696100,11685621,16.98
9831669,9984654,4236,1482600,11467254,14.85
9831670,9982854,3162,1106700,11089554,11.09
9831671,9982166,4241,1484350,11466516,14.87
9831672,9994355,1522,532700,10527055,5.33
9831673,9972809,1926,674100,10646909,6.76
9831674,9975725,2275,796250,10771975,7.98
9831675,9951024,2313,809550,10760574,8.14
9831676,9965026,3296,1153600,11118626,11.58
9831677,9977255,3334,1166900,11144155,11.70
9831678,9996304,2897,1013950,11010254,10.14
9831679,9991957,4310,1508500,11500457,15.10
9831680,9992326,2164,757400,10749726,7.58
9831681,9971848,2391,836850,10808698,8.39
9831682,9978278,2791,976850,10955128,9.79
9831683,9971612,2679,937650,10909262,9.40
9831684,9956126,3043,1065050,11021176,10.70
9831685,9740630,4166,1458100,11198730,14.97
9831686,9977032,4909,1718150,11695182,17.22
9831687,9986414,4355,1524250,11510664,15.26
9831688,9996681,5308,1857800,11854481,18.58
9831689,9980071,3024,1058400,11038471,10.61
9831690,9988158,3864,1352400,11340558,13.54
9831691,9929996,4221,1477350,11407346,14.88
9831692,9982060,4782,1673700,11655760,16.77
9831693,9987857,4423,1548050,11535907,15.50
9831694,9876050,5827,2039450,11915500,20.65
9831695,9964990,4181,1463350,11428340,14.68
9831696,9970516,2765,967750,10938266,9.71
9831697,9974853,3731,1305850,11280703,13.09
9831698,9975721,3534,1236900,11212621,12.40
9831699,9973045,3054,1068900,11041945,10.72
9831700,9978523,3854,1348900,11327423,13.52
9831701,9988960,3420,1197000,11185960,11.98
9831702,9984708,3889,1361150,11345858,13.63
9831704,9972692,3549,1242150,11214842,12.46
9831705,9982399,3399,1189650,11172049,11.92
9831706,9995260,2662,931700,10926960,9.32
9831707,9997080,4707,1647450,11644530,16.48
9831709,9987847,4356,1524600,11512447,15.26
9831710,7045566,1475,516250,7561816,7.33
9831711,1421888,419,146650,1568538,10.31
9831712,9980718,3949,1382150,11362868,13.85
9831713,9980080,3529,1235150,11215230,12.38
9831714,9978219,4255,1489250,11467469,14.93
9831715,9742518,3720,1302000,11044518,13.36
9831716,9995618,4322,1512700,11508318,15.13
9831717,9997644,2373,830550,10828194,8.31
9831718,9989736,4247,1486450,11476186,14.88
9831719,9981473,1368,478800,10460273,4.80
9831721,9977560,3344,1170400,11147960,11.73
9831722,9974213,3055,1069250,11043463,10.72
9831723,9966465,3067,1073450,11039915,10.77
9831724,9985381,3159,1105650,11091031,11.07
9831725,9988419,2957,1034950,11023369,10.36
9831726,9999157,5115,1790250,11789407,17.90
9831728,9979714,4653,1628550,11608264,16.32
9831729,9962455,5408,1892800,11855255,19.00
9831730,9958631,3373,1180550,11139181,11.85
9831731,9986407,2338,818300,10804707,8.19
9831732,9999226,2556,894600,10893826,8.95
9831733,9975755,5887,2060450,12036205,20.65
9831734,9898018,3516,1230600,11128618,12.43
9831735,9984689,4160,1456000,11440689,14.58
9831736,9988369,4385,1534750,11523119,15.37
9831737,9995299,4332,1516200,11511499,15.17
9831738,9971937,2884,1009400,10981337,10.12
9831739,9991327,5075,1776250,11767577,17.78
9831740,9978394,4029,1410150,11388544,14.13
9831741,9998677,3897,1363950,11362627,13.64
9831742,9987875,2357,824950,10812825,8.26
9831743,9998609,3903,1366050,11364659,13.66
9831744,9989206,4600,1610000,11599206,16.12
9831745,9977432,3803,1331050,11308482,13.34
9831746,9986459,4390,1536500,11522959,15.39
9831747,9990798,4574,1600900,11591698,16.02
9831748,9972493,3177,1111950,11084443,11.15
9831749,2130724,646,226100,2356824,10.61
9831750,9968099,3778,1322300,11290399,13.27
9831751,2785960,1438,503300,3289260,18.07
9831752,9959920,3315,1160250,11120170,11.65
9831753,9974116,4658,1630300,11604416,16.35
9831754,9988129,2750,962500,10950629,9.64
9831755,9985124,4676,1636600,11621724,16.39
9831756,9995179,3027,1059450,11054629,10.60
9831757,5052677,1112,389200,5441877,7.70
9831758,5159667,2729,955150,6114817,18.51
9831759,9982985,2725,953750,10936735,9.55
9831760,9993974,3796,1328600,11322574,13.29
9831761,9967649,4006,1402100,11369749,14.07
9831763,9973901,3373,1180550,11154451,11.84
9831764,9971727,3968,1388800,11360527,13.93
9831765,9973792,3188,1115800,11089592,11.19
9831766,9982235,1402,490700,10472935,4.92
9831767,9962393,3709,1298150,11260543,13.03
9831768,9960347,4366,1528100,11488447,15.34
9831769,9967300,3813,1334550,11301850,13.39
9831770,9892755,4379,1532650,11425405,15.49
9831771,9985908,3685,1289750,11275658,12.92
9831773,9964014,3992,1397200,11361214,14.02
9831774,9866284,2405,841750,10708034,8.53
9831775,9978746,3065,1072750,11051496,10.75
9831776,9987274,3640,1274000,11261274,12.76
9831777,9979884,1933,676550,10656434,6.78
9831778,7144672,1463,512050,7656722,7.17
9831779,9967062,4187,1465450,11432512,14.70
9831780,9841655,5799,2029650,11871305,20.62
9831781,9971951,2923,1023050,10995001,10.26
9831782,9922207,3421,1197350,11119557,12.07
9831783,9972122,1962,686700,10658822,6.89
9831784,3613100,1231,430850,4043950,11.92
9831785,9945209,2474,865900,10811109,8.71
9831786,9422462,4176,1461600,10884062,15.51
9831787,9980540,3086,1080100,11060640,10.82
9831788,8245310,1404,491400,8736710,5.96
9831789,9967735,3492,1222200,11189935,12.26
9831790,9967174,3788,1325800,11292974,13.30
9831791,9961677,2062,721700,10683377,7.24
9831792,9949475,4977,1741950,11691425,17.51
9831793,9963679,1880,658000,10621679,6.60
9831794,9951757,4005,1401750,11353507,14.09
9831795,9968570,3753,1313550,11282120,13.18
9831796,9990533,3959,1385650,11376183,13.87
9831797,9974291,2868,1003800,10978091,10.06
9831798,9957872,4583,1604050,11561922,16.11
9831799,9974004,3698,1294300,11268304,12.98
9831800,9946804,3525,1233750,11180554,12.40
9831801,5584197,2208,772800,6356997,13.84
9831802,9990085,2612,914200,10904285,9.15
9831803,9996671,3559,1245650,11242321,12.46
9831804,1105909,999,349650,1455559,31.62
9831805,9976097,4248,1486800,11462897,14.90
9831806,9979686,2322,812700,10792386,8.14
9831807,9995860,4204,1471400,11467260,14.72
9831808,9971833,3774,1320900,11292733,13.25
9831809,1867732,1043,365050,2232782,19.55
9831810,9970896,5479,1917650,11888546,19.23
9831811,6531976,2308,807800,7339776,12.37
9831812,9968784,1827,639450,10608234,6.41
9831813,9975295,3974,1390900,11366195,13.94
9831814,6140379,2589,906150,7046529,14.76
9831815,9981568,5000,1750000,11731568,17.53
9831816,5337254,2532,886200,6223454,16.60
9831817,9988061,5188,1815800,11803861,18.18
9831818,9998970,6808,2382800,12381770,23.83
9831819,9986678,3080,1078000,11064678,10.79
9831820,641040,212,74200,715240,11.57
9831821,9971596,4625,1618750,11590346,16.23
9831822,3209024,1676,586600,3795624,18.28
9831823,9947748,3808,1332800,11280548,13.40
9831824,9947426,3839,1343650,11291076,13.51
9831825,9946092,3747,1311450,11257542,13.19
9831826,9947706,3140,1099000,11046706,11.05
9831827,9941954,2490,871500,10813454,8.77
9831828,8955442,1574,550900,9506342,6.15
9831829,3262733,1648,576800,3839533,17.68
9831830,5637388,4991,1746850,7384238,30.99
9831831,4772196,3197,1118950,5891146,23.45
9831832,9934010,4655,1629250,11563260,16.40
9831833,9915988,2237,782950,10698938,7.90
9831834,5816468,2481,868350,6684818,14.93
9831835,9916851,3240,1134000,11050851,11.44
9831836,9891835,4892,1712200,11604035,17.31
9831837,9931491,4922,1722700,11654191,17.35
9831838,9918567,2676,936600,10855167,9.44
9831839,9918193,3752,1313200,11231393,13.24
9831840,9329873,1904,666400,9996273,7.14
9831841,9896352,4934,1726900,11623252,17.45
9831842,9913501,3959,1385650,11299151,13.98
9831843,9772380,4543,1590050,11362430,16.27
9831844,9937071,3898,1364300,11301371,13.73
9831845,9926452,3976,1391600,11318052,14.02
9831846,9934421,4482,1568700,11503121,15.79
9831847,9906190,4572,1600200,11506390,16.15
9831848,9921666,5774,2020900,11942566,20.37
9831849,9915373,3855,1349250,11264623,13.61
9831850,9913639,3382,1183700,11097339,11.94
9831851,9934174,4502,1575700,11509874,15.86
9831852,9926677,4084,1429400,11356077,14.40
9831853,9932233,4158,1455300,11387533,14.65
9831854,9936001,4073,1425550,11361551,14.35
9831855,9926008,5301,1855350,11781358,18.69
9831856,9937806,1617,565950,10503756,5.69
9831857,9962820,5014,1754900,11717720,17.61
9831858,9952069,2607,912450,10864519,9.17
9831859,9952640,3757,1314950,11267590,13.21
9831860,9950994,3106,1087100,11038094,10.92
9831861,9879589,4752,1663200,11542789,16.83
9831862,9950092,3823,1338050,11288142,13.45
9831863,9943301,3966,1388100,11331401,13.96
9831864,9953344,4170,1459500,11412844,14.66
9831865,9962523,3188,1115800,11078323,11.20
9831866,9964912,4083,1429050,11393962,14.34
9831867,9957134,3569,1249150,11206284,12.55
9831868,9945987,4005,1401750,11347737,14.09
9831869,9952552,2735,957250,10909802,9.62
9831870,9959195,3126,1094100,11053295,10.99
9831871,9973759,5313,1859550,11833309,18.64
9831872,9965954,3511,1228850,11194804,12.33
9831873,9978189,3808,1332800,11310989,13.36
9831874,9968015,3665,1282750,11250765,12.87
9831876,9951814,2041,714350,10666164,7.18
9831877,9963095,3423,1198050,11161145,12.02
9831878,9954993,3655,1279250,11234243,12.85
9831879,9841059,5183,1814050,11655109,18.43
9831880,9981932,3259,1140650,11122582,11.43
9831881,9997207,4225,1478750,11475957,14.79
9831882,9988215,3912,1369200,11357415,13.71
9831883,9987284,5023,1758050,11745334,17.60
9831884,9992681,3077,1076950,11069631,10.78
9831885,9988374,4950,1732500,11720874,17.35
9831886,9995037,4962,1736700,11731737,17.38
9831887,9990466,4127,1444450,11434916,14.46
9831888,7158769,2697,943950,8102719,13.19
9831889,9960092,2866,1003100,10963192,10.07
9831890,9998851,4048,1416800,11415651,14.17
9831891,9973323,3795,1328250,11301573,13.32
9831892,9983101,1952,683200,10666301,6.84
9831893,9970428,4417,1545950,11516378,15.51
9831894,9988138,2680,938000,10926138,9.39
9831895,9988390,3074,1075900,11064290,10.77
9831896,9992481,5999,2099650,12092131,21.01
9831897,9895640,3379,1182650,11078290,11.95
9831898,9312393,2562,896700,10209093,9.63
9831899,9989750,3759,1315650,11305400,13.17
9831900,9962588,2983,1044050,11006638,10.48
9831901,9934055,2215,775250,10709305,7.80
9831902,9967948,5245,1835750,11803698,18.42
9831903,9926989,2675,936250,10863239,9.43
9831904,9974447,2887,1010450,10984897,10.13
9831905,9979503,4374,1530900,11510403,15.34
9831906,9988922,4451,1557850,11546772,15.60
9831907,9972442,3746,1311100,11283542,13.15
9831908,9984380,4544,1590400,11574780,15.93
9831909,9973356,3930,1375500,11348856,13.79
9831910,9973755,5958,2085300,12059055,20.91
9831911,9984013,5569,1949150,11933163,19.52
9831912,9993211,3787,1325450,11318661,13.26
9831913,9983176,6211,2173850,12157026,21.78
9831914,9999125,4594,1607900,11607025,16.08
9831915,9986023,4905,1716750,11702773,17.19
9831916,9979068,6089,2131150,12110218,21.36
9831917,9971831,6081,2128350,12100181,21.34
9831918,9744445,4101,1435350,11179795,14.73
9831919,3617126,1927,674450,4291576,18.65
9831920,9990407,3087,1080450,11070857,10.81
9831921,9979115,3813,1334550,11313665,13.37
9831922,9989234,3218,1126300,11115534,11.28
9831923,9984542,5019,1756650,11741192,17.59
9831924,1517183,1016,355600,1872783,23.44
9831925,9967850,4764,1667400,11635250,16.73
9831926,9977048,4365,1527750,11504798,15.31
9831927,9955519,4427,1549450,11504969,15.56
9831928,9974495,4009,1403150,11377645,14.07
9831929,9972810,2248,786800,10759610,7.89
9831930,9822393,5232,1831200,11653593,18.64
9831931,9997458,3136,1097600,11095058,10.98
9831932,9972943,3821,1337350,11310293,13.41
9831933,9992654,3254,1138900,11131554,11.40
9831934,9966983,5396,1888600,11855583,18.95
9831935,9982196,3603,1261050,11243246,12.63
9831936,9975400,3998,1399300,11374700,14.03
9831937,9969850,5177,1811950,11781800,18.17
9831938,9981732,5562,1946700,11928432,19.50
9831939,9989558,2774,970900,10960458,9.72
9831940,8009374,2119,741650,8751024,9.26
9831941,4032819,1346,471100,4503919,11.68
9831942,9959875,5150,1802500,11762375,18.10
9831943,9962644,2552,893200,10855844,8.97
9831944,9964825,4023,1408050,11372875,14.13
9831945,8730094,2843,995050,9725144,11.40
9831946,6124679,2613,914550,7039229,14.93
9831947,9997536,5108,1787800,11785336,17.88
9831948,9869283,3686,1290100,11159383,13.07
9831949,2109429,769,269150,2378579,12.76
9831950,9682737,4470,1564500,11247237,16.16
9831951,9995127,4569,1599150,11594277,16.00
9831952,7544653,2844,995400,8540053,13.19
9831953,9977595,2660,931000,10908595,9.33
9831954,9966544,5115,1790250,11756794,17.96
9831956,9962468,3797,1328950,11291418,13.34
9831957,9941269,2624,918400,10859669,9.24
9831958,9774468,2199,769650,10544118,7.87
9831959,9958787,4504,1576400,11535187,15.83
9831960,9951672,5378,1882300,11833972,18.91
9831961,9962060,4617,1615950,11578010,16.22
9831962,9970898,1311,458850,10429748,4.60
9831963,9949814,4220,1477000,11426814,14.84
9831964,9957476,2098,734300,10691776,7.37
9831966,9950421,4209,1473150,11423571,14.80
9831967,9963081,3524,1233400,11196481,12.38
9831968,9914892,2435,852250,10767142,8.60
9831969,9964535,4048,1416800,11381335,14.22
9831970,8501971,2739,958650,9460621,11.28
9831971,9614409,3797,1328950,10943359,13.82
9831972,9974746,5576,1951600,11926346,19.57
9831973,9979363,5906,2067100,12046463,20.71
9831974,9984094,3222,1127700,11111794,11.29
9831975,9979460,2755,964250,10943710,9.66
9831976,9985814,4673,1635550,11621364,16.38
9831977,9965776,4578,1602300,11568076,16.08
9831978,9977794,4506,1577100,11554894,15.81
9831979,182594,167,58450,241044,32.01
9831980,9968898,2665,932750,10901648,9.36
9831981,2413262,1653,578550,2991812,23.97
9831982,9979240,2648,926800,10906040,9.29
9831983,9975444,3968,1388800,11364244,13.92
9831984,9988619,3165,1107750,11096369,11.09
9831985,9981321,4696,1643600,11624921,16.47
9831986,9993942,5319,1861650,11855592,18.63
9831987,9994784,3760,1316000,11310784,13.17
9831988,9981663,3577,1251950,11233613,12.54
9831989,9982755,3713,1299550,11282305,13.02
9831990,9969209,1974,690900,10660109,6.93
9831991,9849556,2600,910000,10759556,9.24
9831992,9980057,4507,1577450,11557507,15.81
9831993,9962197,5495,1923250,11885447,19.31
9831994,9984557,3270,1144500,11129057,11.46
9831995,9991394,1405,491750,10483144,4.92
9831996,9991586,3501,1225350,11216936,12.26
9831997,9995598,4699,1644650,11640248,16.45
9831998,9984020,5458,1910300,11894320,19.13
9831999,9990429,4914,1719900,11710329,17.22
9832000,7058766,2919,1021650,8080416,14.47
9832001,9990768,5521,1932350,11923118,19.34
9832002,2803439,1321,462350,3265789,16.49
9832003,5647257,3098,1084300,6731557,19.20
9832004,9943421,5879,2057650,12001071,20.69
9832005,9966626,3777,1321950,11288576,13.26
9832006,3222811,1241,434350,3657161,13.48
9832007,9957071,3170,1109500,11066571,11.14
9832009,9853977,3637,1272950,11126927,12.92
9832010,9922199,3867,1353450,11275649,13.64
9832011,9921574,5702,1995700,11917274,20.11
9832012,9933667,4200,1470000,11403667,14.80
9832013,9930828,4297,1503950,11434778,15.14
9832014,3635911,3316,1160600,4796511,31.92
9832015,9942854,3440,1204000,11146854,12.11
9832016,9755460,6700,2345000,12100460,24.04
9832017,5358489,3013,1054550,6413039,19.68
9832018,9935497,6843,2395050,12330547,24.11
9832019,9929741,4611,1613850,11543591,16.25
9832020,9946216,7035,2462250,12408466,24.76
9832021,9955767,4587,1605450,11561217,16.13
9832022,9961486,3962,1386700,11348186,13.92
9832023,9952614,5977,2091950,12044564,21.02
9832025,9957475,8349,2922150,12879625,29.35
9832026,9961703,7458,2610300,12572003,26.20
9832028,9869207,4726,1654100,11523307,16.76
9832029,9978499,2804,981400,10959899,9.84
9832030,9970689,7606,2662100,12632789,26.70
9832031,9978064,5573,1950550,11928614,19.55
9832032,9983630,3843,1345050,11328680,13.47
9832033,9960478,3233,1131550,11092028,11.36
9832034,9969679,6116,2140600,12110279,21.47
9832035,9972801,4371,1529850,11502651,15.34
9832036,9965472,4970,1739500,11704972,17.46
9832037,9976717,5219,1826650,11803367,18.31
9832038,9976189,5036,1762600,11738789,17.67
9832039,9997035,3560,1246000,11243035,12.46
9832040,9987192,4463,1562050,11549242,15.64
9832041,9985946,4082,1428700,11414646,14.31
9832042,9981850,3538,1238300,11220150,12.41
9832043,9978636,5697,1993950,11972586,19.98
9832044,9976754,3896,1363600,11340354,13.67
9832045,9980842,3044,1065400,11046242,10.67
9832046,526598,490,171500,698098,32.57
9832047,9975249,2567,898450,10873699,9.01
9832048,9985252,5174,1810900,11796152,18.14
9832049,9971026,4081,1428350,11399376,14.33
9832051,9964568,5204,1821400,11785968,18.28
9832052,9962908,2488,870800,10833708,8.74
9832053,9967604,3386,1185100,11152704,11.89
9832054,9974748,2960,1036000,11010748,10.39
9832055,9985996,4753,1663550,11649546,16.66
9832056,9972948,6635,2322250,12295198,23.29
9832057,9965193,2292,802200,10767393,8.05
9832058,9967453,7048,2466800,12434253,24.75
9832059,8338439,4680,1638000,9976439,19.64
9832060,9924638,2780,973000,10897638,9.80
9832061,9988462,2704,946400,10934862,9.47
9832062,9984445,4856,1699600,11684045,17.02
9832063,9975377,3125,1093750,11069127,10.96
9832064,9985581,3556,1244600,11230181,12.46
9832065,9982634,3568,1248800,11231434,12.51
9832066,9977447,4903,1716050,11693497,17.20
9832067,9982045,6643,2325050,12307095,23.29
9832068,9990215,3029,1060150,11050365,10.61
9832069,9987121,2908,1017800,11004921,10.19
9832070,9968908,1519,531650,10500558,5.33
9832071,9974698,1810,633500,10608198,6.35
9832072,9989987,4564,1597400,11587387,15.99
9832073,9992324,2468,863800,10856124,8.64
9832074,9989503,2043,715050,10704553,7.16
9832075,9972616,3021,1057350,11029966,10.60
9832076,9975832,2569,899150,10874982,9.01
9832077,9979982,3605,1261750,11241732,12.64
9832078,9958899,2251,787850,10746749,7.91
9832079,9969492,4287,1500450,11469942,15.05
9832080,4078316,1696,593600,4671916,14.56
9832081,2195326,489,171150,2366476,7.80
9832082,9983700,3375,1181250,11164950,11.83
9832083,1697118,1076,376600,2073718,22.19
9832084,4070431,1738,608300,4678731,14.94
9832085,9996191,3575,1251250,11247441,12.52
9832086,8154582,2259,790650,8945232,9.70
9832087,9976597,5184,1814400,11790997,18.19
9832088,4171215,3970,1389500,5560715,33.31
9832089,9964382,2183,764050,10728432,7.67
9832090,9970948,2528,884800,10855748,8.87
9832091,9960440,4416,1545600,11506040,15.52
9832092,9900423,3480,1218000,11118423,12.30
9832093,9973891,3709,1298150,11272041,13.02
9832094,9894996,4941,1729350,11624346,17.48
9832096,9998417,3365,1177750,11176167,11.78
9832097,9985824,3694,1292900,11278724,12.95
9832098,9988441,4037,1412950,11401391,14.15
9832099,9980277,4175,1461250,11441527,14.64
9832100,9989786,2839,993650,10983436,9.95
9832101,9972510,3885,1359750,11332260,13.63
9832102,9990267,2709,948150,10938417,9.49
9832103,4173650,1881,658350,4832000,15.77
9832104,9972779,2337,817950,10790729,8.20
9832105,9903214,3301,1155350,11058564,11.67
9832106,9983311,4201,1470350,11453661,14.73
9832107,9979812,6024,2108400,12088212,21.13
9832108,9995809,4282,1498700,11494509,14.99
9832109,9973779,4480,1568000,11541779,15.72
9832110,9984004,4079,1427650,11411654,14.30
9832112,1927688,455,159250,2086938,8.26
9832113,9956545,3783,1324050,11280595,13.30
9832114,9964741,3722,1302700,11267441,13.07
9832115,9982600,4201,1470350,11452950,14.73
9832116,3223609,1621,567350,3790959,17.60
9832117,9981702,4129,1445150,11426852,14.48
9832118,9962146,2105,736750,10698896,7.40
9832119,9985957,4141,1449350,11435307,14.51
9832120,9966034,5095,1783250,11749284,17.89
9832121,9978071,4741,1659350,11637421,16.63
9832122,9987823,3616,1265600,11253423,12.67
9832123,9929207,5266,1843100,11772307,18.56
9832124,9968098,4427,1549450,11517548,15.54
9832125,9984015,4416,1545600,11529615,15.48
9832126,9905130,3677,1286950,11192080,12.99
9832127,4325887,2652,928200,5254087,21.46
9832128,960058,194,67900,1027958,7.07
9832129,9974482,5936,2077600,12052082,20.83
9832130,693783,403,141050,834833,20.33
9832131,9951676,5048,1766800,11718476,17.75
9832132,9941844,3145,1100750,11042594,11.07
9832133,9960426,2683,939050,10899476,9.43
9832134,9979141,4118,1441300,11420441,14.44
9832135,9980576,4687,1640450,11621026,16.44
9832136,9963900,3398,1189300,11153200,11.94
9832137,9986790,6148,2151800,12138590,21.55
9832138,9990771,3786,1325100,11315871,13.26
9832139,9987103,4507,1577450,11564553,15.79
9832140,9964627,2373,830550,10795177,8.33
9832141,9964608,1893,662550,10627158,6.65
9832142,9894765,4600,1610000,11504765,16.27
9832143,5465527,1832,641200,6106727,11.73
9832144,9975791,3480,1218000,11193791,12.21
9832145,9983711,4353,1523550,11507261,15.26
9832146,9982599,3130,1095500,11078099,10.97
9832147,9481753,3819,1336650,10818403,14.10
9832148,9980765,3918,1371300,11352065,13.74
9832149,9977778,2215,775250,10753028,7.77
9832150,9982724,2488,870800,10853524,8.72
9832151,9988323,5526,1934100,11922423,19.36
9832152,9989340,4901,1715350,11704690,17.17
9832153,9984327,2877,1006950,10991277,10.09
9832154,9977171,4297,1503950,11481121,15.07
9832155,9968577,3005,1051750,11020327,10.55
9832156,9986757,5403,1891050,11877807,18.94
9832157,3151477,978,342300,3493777,10.86
9832158,9985937,4713,1649550,11635487,16.52
9832159,9987049,3790,1326500,11313549,13.28
9832160,9977907,1728,604800,10582707,6.06
9832161,9979934,2688,940800,10920734,9.43
9832162,9972264,2785,974750,10947014,9.77
9832163,9977220,4219,1476650,11453870,14.80
9832164,9975937,1826,639100,10615037,6.41
9832165,9980126,3675,1286250,11266376,12.89
9832166,9965113,4378,1532300,11497413,15.38
9832167,9965857,2459,860650,10826507,8.64
9832168,9974664,2235,782250,10756914,7.84
9832169,9992863,5052,1768200,11761063,17.69
9832170,9975772,3160,1106000,11081772,11.09
9832171,9985272,2973,1040550,11025822,10.42
9832172,9870474,3289,1151150,11021624,11.66
9832173,9956403,3299,1154650,11111053,11.60
9832174,9978908,4163,1457050,11435958,14.60
9832175,9975632,4458,1560300,11535932,15.64
9832176,9996319,4339,1518650,11514969,15.19
9832177,9967723,4256,1489600,11457323,14.94
9832178,9917387,2681,938350,10855737,9.46
9832179,9976988,3257,1139950,11116938,11.43
9832180,1855555,900,315000,2170555,16.98
9832181,9955629,4307,1507450,11463079,15.14
9832182,9953894,1957,684950,10638844,6.88
9832183,9975859,3555,1244250,11220109,12.47
9832184,9973868,3109,1088150,11062018,10.91
9832185,9962365,4118,1441300,11403665,14.47
9832186,4758752,3122,1092700,5851452,22.96
9832187,9973013,3398,1189300,11162313,11.93
9832188,9989522,5291,1851850,11841372,18.54
9832189,7055216,2869,1004150,8059366,14.23
9832190,9996693,3378,1182300,11178993,11.83
9832191,9972316,3674,1285900,11258216,12.89
9832192,9990045,4131,1445850,11435895,14.47
9832193,9987637,3186,1115100,11102737,11.16
9832194,9991672,4056,1419600,11411272,14.21
9832195,9999579,3907,1367450,11367029,13.68
9832196,9992536,3552,1243200,11235736,12.44
9832197,9918438,3424,1198400,11116838,12.08
9832198,9997194,3503,1226050,11223244,12.26
9832199,9489833,4623,1618050,11107883,17.05
9832200,9970708,2785,974750,10945458,9.78
9832201,1391923,72,25200,1417123,1.81
9832202,9962318,4337,1517950,11480268,15.24
9832203,9976878,2629,920150,10897028,9.22
9832204,9973492,6121,2142350,12115842,21.48
9832205,9995068,2763,967050,10962118,9.68
9832206,9996278,4008,1402800,11399078,14.03
9832207,9999571,1545,540750,10540321,5.41
9832208,9760126,4167,1458450,11218576,14.94
9832209,9973194,3782,1323700,11296894,13.27
9832210,9963141,2261,791350,10754491,7.94
9832211,9940311,3919,1371650,11311961,13.80
9832212,9958533,3854,1348900,11307433,13.55
9832213,9958239,3530,1235500,11193739,12.41
9832214,6061899,3569,1249150,7311049,20.61
9832215,9965235,2723,953050,10918285,9.56
9832216,9957179,1904,666400,10623579,6.69
9832217,9979501,4197,1468950,11448451,14.72
9832218,9984059,3439,1203650,11187709,12.06
9832219,9982835,4131,1445850,11428685,14.48
9832220,9984980,4096,1433600,11418580,14.36
9832221,9996138,3835,1342250,11338388,13.43
9832222,9970806,2480,868000,10838806,8.71
9832223,9993178,3755,1314250,11307428,13.15
9832224,9996821,5151,1802850,11799671,18.03
9832225,9977706,2531,885850,10863556,8.88
9832226,9962899,2591,906850,10869749,9.10
9832227,9981868,3705,1296750,11278618,12.99
9832228,9961354,2736,957600,10918954,9.61
9832229,9960606,3168,1108800,11069406,11.13
9832230,9970114,4052,1418200,11388314,14.22
9832231,9969945,4191,1466850,11436795,14.71
9832232,9955291,4158,1455300,11410591,14.62
9832233,9968603,3942,1379700,11348303,13.84
9832234,9951391,2790,976500,10927891,9.81
9832235,5956839,2553,893550,6850389,15.00
9832236,9957447,4016,1405600,11363047,14.12
9832237,9965177,4130,1445500,11410677,14.51
9832238,9964490,3268,1143800,11108290,11.48
9832239,9959568,4660,1631000,11590568,16.38
9832240,9972232,2179,762650,10734882,7.65
9832241,9984473,3831,1340850,11325323,13.43
9832242,9981612,2388,835800,10817412,8.37
9832243,9988515,2527,884450,10872965,8.85
9832244,9963613,3806,1332100,11295713,13.37
9832245,9970783,3983,1394050,11364833,13.98
9832247,9976895,1584,554400,10531295,5.56
9832248,9983846,3084,1079400,11063246,10.81
9832249,9780916,3511,1228850,11009766,12.56
9832250,9976854,4206,1472100,11448954,14.76
9832251,9987483,3646,1276100,11263583,12.78
9832252,9985207,3475,1216250,11201457,12.18
9832253,9990772,4657,1629950,11620722,16.31
9832254,9981072,6563,2297050,12278122,23.01
9832255,9988244,4320,1512000,11500244,15.14
9832256,9960926,4732,1656200,11617126,16.63
9832257,9979622,5553,1943550,11923172,19.48
9832258,9968793,2794,977900,10946693,9.81
9832259,9966352,4380,1533000,11499352,15.38
9832260,9941098,6560,2296000,12237098,23.10
9832261,9964888,4029,1410150,11375038,14.15
9832262,9967177,3776,1321600,11288777,13.26
9832263,9974150,4009,1403150,11377300,14.07
9832264,9982874,4485,1569750,11552624,15.72
9832266,9984285,3424,1198400,11182685,12.00
9832267,9951619,4715,1650250,11601869,16.58
9832268,9970705,3583,1254050,11224755,12.58
9832269,9956330,3274,1145900,11102230,11.51
9832270,9964729,5025,1758750,11723479,17.65
9832271,9951902,6144,2150400,12102302,21.61
9832272,9966155,4645,1625750,11591905,16.31
9832273,9959211,5204,1821400,11780611,18.29
9832274,9950449,4418,1546300,11496749,15.54
9832275,8951161,4003,1401050,10352211,15.65
9832276,9947206,3639,1273650,11220856,12.80
9832278,9951186,5117,1790950,11742136,18.00
9832279,3493465,2052,718200,4211665,20.56
9832280,9942550,5872,2055200,11997750,20.67
9832281,5662793,3452,1208200,6870993,21.34
9832282,1458624,1040,364000,1822624,24.96
9832283,9911980,3993,1397550,11309530,14.10
9832284,9892140,4202,1470700,11362840,14.87
9832285,4002752,710,248500,4251252,6.21
9832286,9883324,3648,1276800,11160124,12.92
9832287,9869742,2501,875350,10745092,8.87
9832288,9856277,6460,2261000,12117277,22.94
9832289,9848954,4090,1431500,11280454,14.53
9832290,9848837,2854,998900,10847737,10.14
9832291,2068192,1911,668850,2737042,32.34
9832292,9834748,3812,1334200,11168948,13.57
9832293,9833779,4075,1426250,11260029,14.50
9832294,9822951,3710,1298500,11121451,13.22
9832295,9816648,5300,1855000,11671648,18.90
9832296,9823281,4826,1689100,11512381,17.19
9832297,9805495,5725,2003750,11809245,20.43
9832298,9833704,2450,857500,10691204,8.72
9832299,9829477,3279,1147650,10977127,11.68
9832300,9843997,4274,1495900,11339897,15.20
9832301,9854878,5956,2084600,11939478,21.15
9832302,3351066,1931,675850,4026916,20.17
9832303,9842998,1259,440650,10283648,4.48
9832304,9860649,4668,1633800,11494449,16.57
9832305,6537599,3204,1121400,7658999,17.15
9832306,9851481,3669,1284150,11135631,13.04
9832307,1988249,2058,720300,2708549,36.23
9832308,9846287,3908,1367800,11214087,13.89
9832309,9849357,4063,1422050,11271407,14.44
9832310,9836252,2170,759500,10595752,7.72
9832311,9833068,3760,1316000,11149068,13.38
9832312,9834297,2902,1015700,10849997,10.33
9832313,9825606,3794,1327900,11153506,13.51
9832314,9819037,2637,922950,10741987,9.40
9832315,9833815,2628,919800,10753615,9.35
9832318,9836567,2108,737800,10574367,7.50
9832319,9771037,4285,1499750,11270787,15.35
9832321,9792672,2832,991200,10783872,10.12
9832322,9808495,2996,1048600,10857095,10.69
9832323,9797645,1200,420000,10217645,4.29
9832324,9777822,1892,662200,10440022,6.77
9832325,9775618,3729,1305150,11080768,13.35
9832326,9774393,2591,906850,10681243,9.28
9832327,9769020,5264,1842400,11611420,18.86
9832328,9769947,2490,871500,10641447,8.92
9832329,9764048,3619,1266650,11030698,12.97
9832330,9757453,3369,1179150,10936603,12.08
9832331,9750216,3717,1300950,11051166,13.34
9832332,9762739,2633,921550,10684289,9.44
9832333,9760517,2368,828800,10589317,8.49
9832334,9774353,3902,1365700,11140053,13.97
9832335,9781800,2934,1026900,10808700,10.50
9832336,9778529,3870,1354500,11133029,13.85
9832337,9794396,3354,1173900,10968296,11.99
9832338,9288672,4781,1673350,10962022,18.01
9832339,8077286,929,325150,8402436,4.03
9832340,9774302,4328,1514800,11289102,15.50
9832341,9789485,4508,1577800,11367285,16.12
9832342,9796533,5543,1940050,11736583,19.80
9832343,9779346,3510,1228500,11007846,12.56
9832344,9802532,5101,1785350,11587882,18.21
9832345,9789113,3168,1108800,10897913,11.33
9832346,9794237,6829,2390150,12184387,24.40
9832347,2721299,1947,681450,3402749,25.04
9832348,9439683,3330,1165500,10605183,12.35
9832349,9770715,2353,823550,10594265,8.43
9832350,9789158,4653,1628550,11417708,16.64
9832351,9698933,4312,1509200,11208133,15.56
9832352,9802926,4473,1565550,11368476,15.97
9832353,9796099,5452,1908200,11704299,19.48
9832354,9811512,5816,2035600,11847112,20.75
9832355,4594952,1837,642950,5237902,13.99
9832356,9804139,3649,1277150,11081289,13.03
9832357,837216,406,142100,979316,16.97
9832358,9785947,5661,1981350,11767297,20.25
9832359,9796650,3214,1124900,10921550,11.48
9832360,9800269,4347,1521450,11321719,15.52
9832361,916435,483,169050,1085485,18.45
9832362,9795997,5128,1794800,11590797,18.32
9832363,9791752,5588,1955800,11747552,19.97
9832364,9800662,3779,1322650,11123312,13.50
9832366,3526304,2520,882000,4408304,25.01
9832367,9826873,5033,1761550,11588423,17.93
9832368,1096550,475,166250,1262800,15.16
9832369,9825081,5154,1803900,11628981,18.36
9832370,9819141,4421,1547350,11366491,15.76
9832371,9811185,4859,1700650,11511835,17.33
9832372,9817565,4292,1502200,11319765,15.30
9832373,9840356,4865,1702750,11543106,17.30
9832374,9829690,4924,1723400,11553090,17.53
9832375,9836678,2459,860650,10697328,8.75
9832376,9526090,3711,1298850,10824940,13.63
9832377,9801173,3317,1160950,10962123,11.85
9832378,9824463,6259,2190650,12015113,22.30
9832379,9824347,2191,766850,10591197,7.81
9832380,9840622,3689,1291150,11131772,13.12
9832382,9829258,2763,967050,10796308,9.84
9832383,9836534,4334,1516900,11353434,15.42
9832384,9829211,1759,615650,10444861,6.26
9832385,9835907,5156,1804600,11640507,18.35
9832387,9819279,4025,1408750,11228029,14.35
9832388,3201444,2011,703850,3905294,21.99
9832390,9825695,4774,1670900,11496595,17.01
9832391,9833380,1680,588000,10421380,5.98
9832392,9848619,2814,984900,10833519,10.00
9832393,1373557,651,227850,1601407,16.59
9832394,3966572,1508,527800,4494372,13.31
9832395,2840631,1252,438200,3278831,15.43
9832396,9843509,4047,1416450,11259959,14.39
9832397,9840494,2393,837550,10678044,8.51
9832398,299271,60,21000,320271,7.02
9832399,9839151,4833,1691550,11530701,17.19
9832400,9848291,4475,1566250,11414541,15.90
9832401,9849993,3389,1186150,11036143,12.04
9832402,1679307,906,317100,1996407,18.88
9832403,4760795,3527,1234450,5995245,25.93
9832404,9877169,4718,1651300,11528469,16.72
9832405,9883296,4264,1492400,11375696,15.10
9832406,2790482,1305,456750,3247232,16.37
9832407,9881619,3613,1264550,11146169,12.80
9832408,9888922,3852,1348200,11237122,13.63
9832409,3746657,1542,539700,4286357,14.40
9832410,9904399,5633,1971550,11875949,19.91
9832411,9911214,4424,1548400,11459614,15.62
9832412,9913646,5339,1868650,11782296,18.85
9832413,4124984,1012,354200,4479184,8.59
9832414,9917103,3778,1322300,11239403,13.33
9832415,9921855,3923,1373050,11294905,13.84
9832416,7503177,3192,1117200,8620377,14.89
9832417,9938577,4334,1516900,11455477,15.26
9832418,9131882,5089,1781150,10913032,19.50
9832419,9962218,5183,1814050,11776268,18.21
9832420,2536504,2272,795200,3331704,31.35
9832421,9971549,4104,1436400,11407949,14.40
9832422,9974399,3835,1342250,11316649,13.46
9832423,3110068,1179,412650,3522718,13.27
9832424,9983358,5040,1764000,11747358,17.67
9832425,9434224,5937,2077950,11512174,22.03
9832426,9977049,5121,1792350,11769399,17.96
9832428,9986050,3699,1294650,11280700,12.96
9832429,5740696,2346,821100,6561796,14.30
9832430,1686479,1010,353500,2039979,20.96
9832431,1525787,574,200900,1726687,13.17
9832432,9978054,4324,1513400,11491454,15.17
9832433,9986476,3997,1398950,11385426,14.01
9832434,9973773,2280,798000,10771773,8.00
9832435,9979825,4299,1504650,11484475,15.08
9832436,9987301,4263,1492050,11479351,14.94
9832437,9983658,2589,906150,10889808,9.08
9832438,9400536,1480,518000,9918536,5.51
9832439,9969716,5687,1990450,11960166,19.96
9832440,9975731,5837,2042950,12018681,20.48
9832441,9979673,911,318850,10298523,3.19
9832442,9976748,988,345800,10322548,3.47
9832443,9959807,3435,1202250,11162057,12.07
9832444,9969033,1995,698250,10667283,7.00
9832445,9976710,4250,1487500,11464210,14.91
9832446,9983996,3733,1306550,11290546,13.09
9832447,1251053,601,210350,1461403,16.81
9832448,9972775,2560,896000,10868775,8.98
9832449,9977990,3171,1109850,11087840,11.12
9832450,9980549,3770,1319500,11300049,13.22
9832451,9975463,4334,1516900,11492363,15.21
9832452,9993648,5249,1837150,11830798,18.38
9832454,9975136,4237,1482950,11458086,14.87
9832455,9979210,1725,603750,10582960,6.05
9832456,9980416,4149,1452150,11432566,14.55
9832457,9951206,3797,1328950,11280156,13.35
9832458,9981746,1189,416150,10397896,4.17
9832459,9973116,2801,980350,10953466,9.83
9832460,9976831,2900,1015000,10991831,10.17
9832461,9977290,1918,671300,10648590,6.73
9832462,9986006,1955,684250,10670256,6.85
9832463,9952976,2096,733600,10686576,7.37
9832464,9977521,2292,802200,10779721,8.04
9832465,9650551,736,257600,9908151,2.67
9832466,9988685,3982,1393700,11382385,13.95
9832467,9990997,2141,749350,10740347,7.50
9832468,9979392,4317,1510950,11490342,15.14
9832469,9983268,1015,355250,10338518,3.56
9832470,9994344,2505,876750,10871094,8.77
9832471,9979219,3016,1055600,11034819,10.58
9832472,9983591,3058,1070300,11053891,10.72
9832473,1179422,288,100800,1280222,8.55
9832474,9962572,2609,913150,10875722,9.17
9832475,319869,177,61950,381819,19.37
9832476,9957910,1814,634900,10592810,6.38
9832477,9155563,1011,353850,9509413,3.86
9832478,9291318,3721,1302350,10593668,14.02
9832479,9968045,2489,871150,10839195,8.74
9832480,9972750,2519,881650,10854400,8.84
9832481,9983850,1765,617750,10601600,6.19
9832482,9984084,1723,603050,10587134,6.04
9832483,630422,248,86800,717222,13.77
9832484,9951942,1891,661850,10613792,6.65
9832485,9972237,1771,619850,10592087,6.22
9832486,9964188,3742,1309700,11273888,13.14
9832487,9970461,1748,611800,10582261,6.14
9832488,9917110,4125,1443750,11360860,14.56
9832489,9940295,3304,1156400,11096695,11.63
9832490,9949427,3015,1055250,11004677,10.61
9832491,9959009,3341,1169350,11128359,11.74
9832492,9971771,2075,726250,10698021,7.28
9832493,9889438,2034,711900,10601338,7.20
9832494,9960681,119,41650,10002331,0.42
9832495,9961716,1659,580650,10542366,5.83
9832496,9979981,3246,1136100,11116081,11.38
9832497,9973008,5373,1880550,11853558,18.86
9832498,9974555,3787,1325450,11300005,13.29
9832499,9991464,6269,2194150,12185614,21.96
9832500,9999434,3659,1280650,11280084,12.81
9832501,9618604,5981,2093350,11711954,21.76
9832502,9969831,6712,2349200,12319031,23.56
9832503,9974169,3634,1271900,11246069,12.75
9832504,9988825,3086,1080100,11068925,10.81
9832505,3676390,2366,828100,4504490,22.52
9832506,9975950,3008,1052800,11028750,10.55
9832507,9975791,1796,628600,10604391,6.30
9832508,9879720,2402,840700,10720420,8.51
9832510,9987571,1633,571550,10559121,5.72
9832511,9971624,2459,860650,10832274,8.63
9832512,9982875,4406,1542100,11524975,15.45
9832513,9989896,2175,761250,10751146,7.62
9832514,9984078,2388,835800,10819878,8.37
9832515,9997608,1988,695800,10693408,6.96
9832516,9984932,3154,1103900,11088832,11.06
9832517,9988065,3654,1278900,11266965,12.80
9832518,9998897,3259,1140650,11139547,11.41
9832519,9978196,4515,1580250,11558446,15.84
9832520,9979915,4504,1576400,11556315,15.80
9832521,9984191,2493,872550,10856741,8.74
9832522,9966208,3890,1361500,11327708,13.66
9832523,9989472,2877,1006950,10996422,10.08
9832524,9983979,3988,1395800,11379779,13.98
9832525,1787568,424,148400,1935968,8.30
9832526,9987690,2128,744800,10732490,7.46
9832527,9987992,2822,987700,10975692,9.89
9832528,9981583,2874,1005900,10987483,10.08
9832529,9994560,3476,1216600,11211160,12.17
9832530,9999906,5055,1769250,11769156,17.69
9832531,9987038,1494,522900,10509938,5.24
9832532,9959588,3878,1357300,11316888,13.63
9832533,9976659,1952,683200,10659859,6.85
9832534,9968428,4680,1638000,11606428,16.43
9832535,9979137,4668,1633800,11612937,16.37
9832536,9984267,2865,1002750,10987017,10.04
9832537,9989334,3146,1101100,11090434,11.02
9832538,9981092,2757,964950,10946042,9.67
9832539,9998339,688,240800,10239139,2.41
9832540,9987970,3852,1348200,11336170,13.50
9832541,9980479,4043,1415050,11395529,14.18
9832542,9994214,3490,1221500,11215714,12.22
9832543,9982992,3800,1330000,11312992,13.32
9832544,9981996,3743,1310050,11292046,13.12
9832545,3020395,1421,497350,3517745,16.47
9832546,9977009,3223,1128050,11105059,11.31
9832547,9985804,3580,1253000,11238804,12.55
9832548,9970933,1311,458850,10429783,4.60
9832549,9969224,3805,1331750,11300974,13.36
9832550,9972747,4673,1635550,11608297,16.40
9832551,1344830,603,211050,1555880,15.69
9832552,9943871,4272,1495200,11439071,15.04
9832553,9955745,3829,1340150,11295895,13.46
9832555,9976159,3972,1390200,11366359,13.94
9832556,9971710,4112,1439200,11410910,14.43
9832557,9962753,3797,1328950,11291703,13.34
9832558,9970774,4110,1438500,11409274,14.43
9832559,9986030,3107,1087450,11073480,10.89
9832560,9488647,1641,574350,10062997,6.05
9832561,9502935,2461,861350,10364285,9.06
9832563,9988513,2904,1016400,11004913,10.18
9832564,9970432,1883,659050,10629482,6.61
9832565,9976613,2826,989100,10965713,9.91
9832566,8968659,3212,1124200,10092859,12.53
9832567,1919607,666,233100,2152707,12.14
9832568,9989600,3494,1222900,11212500,12.24
9832569,9987881,2972,1040200,11028081,10.41
9832570,9978678,1512,529200,10507878,5.30
9832571,9979508,4227,1479450,11458958,14.82
9832572,9984920,4252,1488200,11473120,14.90
9832573,9983889,4469,1564150,11548039,15.67
9832574,9999484,3044,1065400,11064884,10.65
9832575,9985750,2661,931350,10917100,9.33
9832576,9980211,1945,680750,10660961,6.82
9832577,9991486,2390,836500,10827986,8.37
9832578,9971926,4268,1493800,11465726,14.98
9832579,9966086,1259,440650,10406736,4.42
9832580,65973,30,10500,76473,15.92
9832581,9974119,2947,1031450,11005569,10.34
9832582,9965554,3583,1254050,11219604,12.58
9832583,9969985,3536,1237600,11207585,12.41
9832584,9977178,2160,756000,10733178,7.58
9832585,9986743,3176,1111600,11098343,11.13
9832586,9980332,4824,1688400,11668732,16.92
9832587,9980329,4345,1520750,11501079,15.24
9832588,9974880,2019,706650,10681530,7.08
9832589,9957968,2457,859950,10817918,8.64
9832590,9965843,1645,575750,10541593,5.78
9832591,9961161,2849,997150,10958311,10.01
9832593,9958048,3246,1136100,11094148,11.41
9832594,9955952,3696,1293600,11249552,12.99
9832595,9982422,1990,696500,10678922,6.98
9832596,9976607,3610,1263500,11240107,12.66
9832597,9991864,3255,1139250,11131114,11.40
9832598,9950040,2013,704550,10654590,7.08
9832599,9988171,1722,602700,10590871,6.03
9832600,9989539,4367,1528450,11517989,15.30
9832601,9989944,1503,526050,10515994,5.27
9832602,9993394,3522,1232700,11226094,12.34
9832603,9981114,5457,1909950,11891064,19.14
9832604,9986043,3388,1185800,11171843,11.87
9832605,9984033,3701,1295350,11279383,12.97
9832606,9973798,1771,619850,10593648,6.21
9832607,9989324,5294,1852900,11842224,18.55
9832608,9985582,3371,1179850,11165432,11.82
9832609,9974226,2064,722400,10696626,7.24
9832610,9984536,2482,868700,10853236,8.70
9832611,9986482,2180,763000,10749482,7.64
9832612,9985177,3501,1225350,11210527,12.27
9832613,9996094,4342,1519700,11515794,15.20
9832614,9981136,3890,1361500,11342636,13.64
9832615,9964452,2204,771400,10735852,7.74
9832616,9981623,3757,1314950,11296573,13.17
9832617,9979894,1858,650300,10630194,6.52
9832618,9986341,3835,1342250,11328591,13.44
9832619,9981275,1831,640850,10622125,6.42
9832620,9988769,3523,1233050,11221819,12.34
9832621,9985813,3518,1231300,11217113,12.33
9832622,9969307,1673,585550,10554857,5.87
9832623,9993176,2813,984550,10977726,9.85
9832624,9976828,2835,992250,10969078,9.95
9832626,9974899,3964,1387400,11362299,13.91
9832627,9984934,4267,1493450,11478384,14.96
9832628,9996849,4135,1447250,11444099,14.48
9832629,2145696,541,189350,2335046,8.82
9832630,9978771,2526,884100,10862871,8.86
9832631,9974166,4296,1503600,11477766,15.07
9832632,9964033,2068,723800,10687833,7.26
9832633,9981991,1467,513450,10495441,5.14
9832634,1052033,182,63700,1115733,6.05
9832635,9969374,3179,1112650,11082024,11.16
9832636,9970391,1622,567700,10538091,5.69
9832637,9946721,1790,626500,10573221,6.30
9832638,9945309,404,141400,10086709,1.42
9832639,9961558,2229,780150,10741708,7.83
9832640,9941756,1084,379400,10321156,3.82
9832641,9948377,2660,931000,10879377,9.36
9832642,9941131,1524,533400,10474531,5.37
9832643,9950263,2542,889700,10839963,8.94
9832644,9957976,3290,1151500,11109476,11.56
9832645,9967015,4727,1654450,11621465,16.60
9832646,9969620,1664,582400,10552020,5.84
9832647,9950358,3692,1292200,11242558,12.99
9832648,9930359,4412,1544200,11474559,15.55
9832649,9951997,2815,985250,10937247,9.90
9832650,9931089,1563,547050,10478139,5.51
9832651,9938607,5379,1882650,11821257,18.94
9832652,342675,254,88900,431575,25.94
9832653,9932515,4506,1577100,11509615,15.88
9832654,9940412,3808,1332800,11273212,13.41
9832655,4271328,1442,504700,4776028,11.82
9832656,9937066,3006,1052100,10989166,10.59
9832657,9915990,4232,1481200,11397190,14.94
9832658,9926317,1500,525000,10451317,5.29
9832659,9911008,1786,625100,10536108,6.31
9832660,9929746,3627,1269450,11199196,12.78
9832661,9916807,5894,2062900,11979707,20.80
9832662,9914907,2103,736050,10650957,7.42
9832663,9916761,2578,902300,10819061,9.10
9832664,9925106,4309,1508150,11433256,15.20
9832665,9922278,2683,939050,10861328,9.46
9832666,9936602,3649,1277150,11213752,12.85
9832667,9938354,2357,824950,10763304,8.30
9832668,9936308,917,320950,10257258,3.23
9832669,9953375,1599,559650,10513025,5.62
9832670,9938016,5418,1896300,11834316,19.08
9832671,9946176,3263,1142050,11088226,11.48
9832672,9969152,2518,881300,10850452,8.84
9832673,9968885,4105,1436750,11405635,14.41
9832674,9968482,1813,634550,10603032,6.37
9832675,9978248,4052,1418200,11396448,14.21
9832676,9976389,4608,1612800,11589189,16.17
9832677,9974731,3567,1248450,11223181,12.52
9832678,9975972,1323,463050,10439022,4.64
9832679,9955723,2868,1003800,10959523,10.08
9832680,9975715,7199,2519650,12495365,25.26
9832681,9988235,3330,1165500,11153735,11.67
9832682,9999150,3773,1320550,11319700,13.21
9832683,9989289,4779,1672650,11661939,16.74
9832684,9979657,4585,1604750,11584407,16.08
9832686,9995202,6192,2167200,12162402,21.68
9832687,9998952,2837,992950,10991902,9.93
9832688,9982396,1555,544250,10526646,5.45
9832689,2352069,837,292950,2645019,12.45
9832690,9986394,3235,1132250,11118644,11.34
9832691,9955721,1789,626150,10581871,6.29
9832692,9980109,1761,616350,10596459,6.18
9832693,9997333,4615,1615250,11612583,16.16
9832694,9981550,3612,1264200,11245750,12.67
9832695,9964484,3866,1353100,11317584,13.58
9832696,3948342,884,309400,4257742,7.84
9832697,9987140,1620,567000,10554140,5.68
9832698,9986079,5574,1950900,11936979,19.54
9832699,9987825,4030,1410500,11398325,14.12
9832700,9965543,1693,592550,10558093,5.95
9832701,9965998,1639,573650,10539648,5.76
9832702,9963117,3392,1187200,11150317,11.92
9832703,9980031,698,244300,10224331,2.45
9832704,9980265,2481,868350,10848615,8.70
9832705,9968126,1594,557900,10526026,5.60
9832706,9969644,1929,675150,10644794,6.77
9832707,9942249,4994,1747900,11690149,17.58
9832708,9959792,2967,1038450,10998242,10.43
9832709,9967504,3005,1051750,11019254,10.55
9832710,9964396,4297,1503950,11468346,15.09
9832711,9969862,478,167300,10137162,1.68
9832712,9748645,3331,1165850,10914495,11.96
9832713,9983176,2075,726250,10709426,7.27
9832714,9984424,2425,848750,10833174,8.50
9832715,9989782,2019,706650,10696432,7.07
9832716,9980593,4550,1592500,11573093,15.96
9832717,9993788,3416,1195600,11189388,11.96
9832718,9981620,3333,1166550,11148170,11.69
9832719,9971402,2028,709800,10681202,7.12
9832720,9986067,1218,426300,10412367,4.27
9832721,9976550,1291,451850,10428400,4.53
9832722,9968870,1823,638050,10606920,6.40
9832723,9979898,2271,794850,10774748,7.96
9832725,9984125,1676,586600,10570725,5.88
9832726,9956504,1949,682150,10638654,6.85
9832727,9958398,5784,2024400,11982798,20.33
9832728,9340307,5358,1875300,11215607,20.08
9832729,9944347,4353,1523550,11467897,15.32
9832730,9954730,1821,637350,10592080,6.40
9832731,9960063,4129,1445150,11405213,14.51
9832732,9950596,1780,623000,10573596,6.26
9832733,9963175,4835,1692250,11655425,16.99
9832734,9964980,4456,1559600,11524580,15.65
9832735,9962290,6084,2129400,12091690,21.37
9832736,9913893,3760,1316000,11229893,13.27
9832737,9981568,3037,1062950,11044518,10.65
9832738,9980763,2378,832300,10813063,8.34
9832739,9984304,4775,1671250,11655554,16.74
9832740,9998355,3275,1146250,11144605,11.46
9832742,9970374,1079,377650,10348024,3.79
9832743,9976598,1556,544600,10521198,5.46
9832744,9991685,398,139300,10130985,1.39
9832745,9987360,3431,1200850,11188210,12.02
9832746,9978176,3666,1283100,11261276,12.86
9832747,9987032,2034,711900,10698932,7.13
9832748,9972204,2561,896350,10868554,8.99
9832749,9981141,2181,763350,10744491,7.65
9832750,8982808,2875,1006250,9989058,11.20
9832751,2840486,1948,681800,3522286,24.00
9832752,9988439,5525,1933750,11922189,19.36
9832753,9991401,1933,676550,10667951,6.77
9832754,9995903,3909,1368150,11364053,13.69
9832755,3435086,532,186200,3621286,5.42
9832756,9981503,3997,1398950,11380453,14.02
9832757,9984676,2463,862050,10846726,8.63
9832758,9973030,3522,1232700,11205730,12.36
9832759,9969077,4716,1650600,11619677,16.56
9832760,9994464,3284,1149400,11143864,11.50
9832761,9972797,3044,1065400,11038197,10.68
9832762,9972863,3689,1291150,11264013,12.95
9832763,9947242,1916,670600,10617842,6.74
9832764,9950247,1845,645750,10595997,6.49
9832765,9975621,2116,740600,10716221,7.42
9832766,9976512,3260,1141000,11117512,11.44
9832767,9983327,1788,625800,10609127,6.27
9832768,9980483,3060,1071000,11051483,10.73
9832769,9979630,2772,970200,10949830,9.72
9832770,9988696,2329,815150,10803846,8.16
9832771,9981344,2638,923300,10904644,9.25
9832772,9890004,5074,1775900,11665904,17.96
9832773,9986724,3414,1194900,11181624,11.96
9832774,9983461,2839,993650,10977111,9.95
9832775,9990580,2689,941150,10931730,9.42
9832776,9980581,2352,823200,10803781,8.25
9832777,9980323,4172,1460200,11440523,14.63
9832778,9983496,1084,379400,10362896,3.80
9832779,9973065,1346,471100,10444165,4.72
9832780,9967992,1741,609350,10577342,6.11
9832781,9984060,3835,1342250,11326310,13.44
9832782,9969811,5771,2019850,11989661,20.26
9832783,9956017,3234,1131900,11087917,11.37
9832784,9963008,1849,647150,10610158,6.50
9832785,9962239,2586,905100,10867339,9.09
9832786,9957691,3354,1173900,11131591,11.79
9832787,9960066,1396,488600,10448666,4.91
9832788,9960254,2212,774200,10734454,7.77
9832789,9978486,2267,793450,10771936,7.95
9832790,9979543,811,283850,10263393,2.84
9832791,9950935,2088,730800,10681735,7.34
9832792,9985087,1606,562100,10547187,5.63
9832793,9975048,3410,1193500,11168548,11.96
9832794,9964184,1198,419300,10383484,4.21
9832795,9960561,3070,1074500,11035061,10.79
9832796,9978001,1323,463050,10441051,4.64
9832797,9987486,2344,820400,10807886,8.21
9832798,9966957,1853,648550,10615507,6.51
9832799,9968548,3513,1229550,11198098,12.33
9832801,9960870,3510,1228500,11189370,12.33
9832802,9948616,3396,1188600,11137216,11.95
9832803,9959772,3199,1119650,11079422,11.24
9832804,9953318,1339,468650,10421968,4.71
9832805,9946759,3969,1389150,11335909,13.97
9832806,9952936,4931,1725850,11678786,17.34
9832807,9963065,5230,1830500,11793565,18.37
9832808,9970371,732,256200,10226571,2.57
9832809,9965100,910,318500,10283600,3.20
9832810,9970259,4615,1615250,11585509,16.20
9832811,9981248,2258,790300,10771548,7.92
9832812,9981721,3378,1182300,11164021,11.84
9832813,9989161,1970,689500,10678661,6.90
9832814,9991568,4399,1539650,11531218,15.41
9832815,9971082,2296,803600,10774682,8.06
9832816,9969700,3674,1285900,11255600,12.90
9832817,9981963,1408,492800,10474763,4.94
9832818,9981536,1657,579950,10561486,5.81
9832819,9989182,1033,361550,10350732,3.62
9832820,9962224,2629,920150,10882374,9.24
9832821,9997803,4303,1506050,11503853,15.06
9832822,9986338,3731,1305850,11292188,13.08
9832823,9979331,2018,706300,10685631,7.08
9832824,9988697,3443,1205050,11193747,12.06
9832825,9987161,1666,583100,10570261,5.84
9832826,9973868,2221,777350,10751218,7.79
9832827,9977643,5274,1845900,11823543,18.50
9832828,9985049,1937,677950,10662999,6.79
9832829,9995015,4656,1629600,11624615,16.30
9832830,9991285,4583,1604050,11595335,16.05
9832831,9988983,3269,1144150,11133133,11.45
9832832,9981666,2579,902650,10884316,9.04
9832833,9977737,3535,1237250,11214987,12.40
9832834,9980391,2419,846650,10827041,8.48
9832835,9988324,1035,362250,10350574,3.63
9832836,9986666,3444,1205400,11192066,12.07
9832837,9985690,5252,1838200,11823890,18.41
9832838,9983633,2717,950950,10934583,9.53
9832839,9986818,2681,938350,10925168,9.40
9832840,9973482,1937,677950,10651432,6.80
9832841,9999002,3663,1282050,11281052,12.82
9832842,9971450,1746,611100,10582550,6.13
9832843,9995287,3199,1119650,11114937,11.20
9832844,9984823,1143,400050,10384873,4.01
9832845,9993021,2054,718900,10711921,7.19
9832846,9985089,1667,583450,10568539,5.84
9832847,9991183,3028,1059800,11050983,10.61
9832848,9995229,4811,1683850,11679079,16.85
9832849,9951819,4377,1531950,11483769,15.39
9832850,9970835,2837,992950,10963785,9.96
9832851,9902549,3893,1362550,11265099,13.76
9832852,9965804,1645,575750,10541554,5.78
9832853,2217875,793,277550,2495425,12.51
9832854,9958848,6757,2364950,12323798,23.75
9832855,9964030,3205,1121750,11085780,11.26
9832856,9973069,2322,812700,10785769,8.15
9832857,9973368,5577,1951950,11925318,19.57
9832859,9991564,3182,1113700,11105264,11.15
9832860,9985964,1085,379750,10365714,3.80
9832861,3253064,1674,585900,3838964,18.01
9832862,9998592,3334,1166900,11165492,11.67
9832863,9987719,1864,652400,10640119,6.53
9832864,9977433,4493,1572550,11549983,15.76
9832865,9983867,3412,1194200,11178067,11.96
9832866,9998709,2224,778400,10777109,7.79
9832867,9976793,3582,1253700,11230493,12.57
9832868,9986430,4776,1671600,11658030,16.74
9832869,9986578,1670,584500,10571078,5.85
9832870,9992689,3648,1276800,11269489,12.78
9832871,9983156,3254,1138900,11122056,11.41
9832872,9994016,3835,1342250,11336266,13.43
9832873,9996358,1534,536900,10533258,5.37
9832874,9977933,1139,398650,10376583,4.00
9832875,9737269,1255,439250,10176519,4.51
9832876,9973058,676,236600,10209658,2.37
9832877,9974112,4385,1534750,11508862,15.39
9832878,9986498,1563,547050,10533548,5.48
9832879,9979009,2062,721700,10700709,7.23
9832880,9982893,827,289450,10272343,2.90
9832881,9983731,1065,372750,10356481,3.73
9832882,9983681,1579,552650,10536331,5.54
9832883,9977844,1669,584150,10561994,5.85
9832884,9986647,2179,762650,10749297,7.64
9832885,9975627,3503,1226050,11201677,12.29
9832886,1740778,1153,403550,2144328,23.18
9832888,9964316,5240,1834000,11798316,18.41
9832889,9985554,4963,1737050,11722604,17.40
9832890,9980774,1639,573650,10554424,5.75
9832891,9970533,1412,494200,10464733,4.96
9832892,9980032,1060,371000,10351032,3.72
9832893,9991322,1922,672700,10664022,6.73
9832894,9966949,1555,544250,10511199,5.46
9832895,9974948,470,164500,10139448,1.65
9832896,9984745,2544,890400,10875145,8.92
9832897,9976781,1404,491400,10468181,4.93
9832898,9981222,2960,1036000,11017222,10.38
9832899,9979900,3802,1330700,11310600,13.33
9832900,9981898,3798,1329300,11311198,13.32
9832901,9977625,525,183750,10161375,1.84
9832902,9956111,4983,1744050,11700161,17.52
9832903,9957675,3438,1203300,11160975,12.08
9832904,9953807,3308,1157800,11111607,11.63
9832905,9944378,617,215950,10160328,2.17
9832906,9956107,2446,856100,10812207,8.60
9832907,9952305,1100,385000,10337305,3.87
9832908,9957462,4511,1578850,11536312,15.86
9832909,9960379,4401,1540350,11500729,15.46
9832910,9952057,2281,798350,10750407,8.02
9832911,9117085,2091,731850,9848935,8.03
9832912,9963972,4158,1455300,11419272,14.61
9832913,9956504,4652,1628200,11584704,16.35
9832914,3635183,1173,410550,4045733,11.29
9832916,9964568,2395,838250,10802818,8.41
9832917,9938905,1701,595350,10534255,5.99
9832918,9960631,1407,492450,10453081,4.94
9832919,9954338,1373,480550,10434888,4.83
9832920,9955366,1515,530250,10485616,5.33
9832921,9943662,676,236600,10180262,2.38
9832922,9970126,3465,1212750,11182876,12.16
9832923,9972310,3275,1146250,11118560,11.49
9832924,9954136,265,92750,10046886,0.93
9832925,9954218,759,265650,10219868,2.67
9832926,9958217,1334,466900,10425117,4.69
9832927,9967171,682,238700,10205871,2.39
9832928,9970318,2244,785400,10755718,7.88
9832929,9965418,1551,542850,10508268,5.45
9832930,9976965,1440,504000,10480965,5.05
9832931,9989621,1210,423500,10413121,4.24
9832932,9968411,1448,506800,10475211,5.08
9832933,9967663,1446,506100,10473763,5.08
9832934,9902451,3418,1196300,11098751,12.08
9832935,9910133,299,104650,10014783,1.06
9832936,9982178,469,164150,10146328,1.64
9832937,9968479,1966,688100,10656579,6.90
9832938,9972484,4593,1607550,11580034,16.12
9832939,9967797,854,298900,10266697,3.00
9832940,9959744,2176,761600,10721344,7.65
9832941,9968337,5005,1751750,11720087,17.57
9832942,614568,239,83650,698218,13.61
9832943,9973098,1100,385000,10358098,3.86
9832945,9956227,5283,1849050,11805277,18.57
9832946,9892014,1190,416500,10308514,4.21
9832947,9977508,3135,1097250,11074758,11.00
9832948,9973959,3003,1051050,11025009,10.54
9832949,9986471,2523,883050,10869521,8.84
9832950,9989280,4920,1722000,11711280,17.24
9832951,9988842,3192,1117200,11106042,11.18
9832952,9975587,3588,1255800,11231387,12.59
9832953,9987420,3333,1166550,11153970,11.68
9832954,9979068,4824,1688400,11667468,16.92
9832955,9996596,3915,1370250,11366846,13.71
9832956,9970538,2580,903000,10873538,9.06
9832957,9972783,3449,1207150,11179933,12.10
9832958,9975137,943,330050,10305187,3.31
9832959,9954821,3810,1333500,11288321,13.40
9832960,9964128,4755,1664250,11628378,16.70
9832961,9973313,1546,541100,10514413,5.43
9832962,9986424,3242,1134700,11121124,11.36
9832963,9998525,1796,628600,10627125,6.29
9832964,9982287,5566,1948100,11930387,19.52
9832965,9989338,5709,1998150,11987488,20.00
9832966,9980711,1852,648200,10628911,6.49
9832967,9953335,4138,1448300,11401635,14.55
9832968,9982881,4138,1448300,11431181,14.51
9832969,9960926,3686,1290100,11251026,12.95
9832970,9962508,2368,828800,10791308,8.32
9832971,9969329,3392,1187200,11156529,11.91
9832972,9960974,5260,1841000,11801974,18.48
9832973,9936099,3870,1354500,11290599,13.63
9832975,9960073,3977,1391950,11352023,13.98
9832977,9959574,3812,1334200,11293774,13.40
9832978,9857026,4140,1449000,11306026,14.70
9832980,9856395,2001,700350,10556745,7.11
9832981,9949646,2468,863800,10813446,8.68
9832982,9932864,2814,984900,10917764,9.92
9832983,9953082,2361,826350,10779432,8.30
9832984,9954631,3205,1121750,11076381,11.27
9832985,9935954,1329,465150,10401104,4.68
9832986,9941721,2928,1024800,10966521,10.31
9832987,9961281,2188,765800,10727081,7.69
9832988,9965139,1415,495250,10460389,4.97
9832989,9959028,4450,1557500,11516528,15.64
9832990,9952703,2825,988750,10941453,9.93
9832991,9971904,4163,1457050,11428954,14.61
9832992,9982399,2179,762650,10745049,7.64
9832993,9904717,2648,926800,10831517,9.36
9832994,9998067,2787,975450,10973517,9.76
9832995,8981074,4440,1554000,10535074,17.30
9832996,9989874,2711,948850,10938724,9.50
9832997,9965943,2383,834050,10799993,8.37
9832998,1565223,531,185850,1751073,11.87
9832999,9966225,3210,1123500,11089725,11.27
9833000,9971286,5522,1932700,11903986,19.38
9833001,9986522,3153,1103550,11090072,11.05
9833002,9994649,4423,1548050,11542699,15.49
9833003,9981502,1615,565250,10546752,5.66
9833004,9386675,4007,1402450,10789125,14.94
9833005,9979717,1245,435750,10415467,4.37
9833006,9994701,2918,1021300,11016001,10.22
9833007,9983869,5281,1848350,11832219,18.51
9833008,9969811,3283,1149050,11118861,11.53
9833009,9972849,2720,952000,10924849,9.55
9833010,9982626,4454,1558900,11541526,15.62
9833011,9964654,3197,1118950,11083604,11.23
9833012,9991359,3458,1210300,11201659,12.11
9833013,9798749,4379,1532650,11331399,15.64
9833014,9976467,1161,406350,10382817,4.07
9833015,9997615,1749,612150,10609765,6.12
9833016,9783929,2628,919800,10703729,9.40
9833017,9999211,2526,884100,10883311,8.84
9833018,9985313,1278,447300,10432613,4.48
9833019,9993796,3539,1238650,11232446,12.39
9833020,9993508,2498,874300,10867808,8.75
9833021,9982638,5286,1850100,11832738,18.53
9833022,9977635,3294,1152900,11130535,11.55
9833024,9971612,1621,567350,10538962,5.69
9833025,9968406,4137,1447950,11416356,14.53
9833026,9975234,3542,1239700,11214934,12.43
9833027,9988904,2205,771750,10760654,7.73
9833028,9993836,1616,565600,10559436,5.66
9833029,9992444,995,348250,10340694,3.49
9833030,9984283,2140,749000,10733283,7.50
9833031,435687,244,85400,521087,19.60
9833032,9975719,1417,495950,10471669,4.97
9833033,8896669,2646,926100,9822769,10.41
9833034,9977878,4681,1638350,11616228,16.42
9833035,9974388,2015,705250,10679638,7.07
9833036,9984948,3294,1152900,11137848,11.55
9833037,9975200,4385,1534750,11509950,15.39
9833038,9977438,2427,849450,10826888,8.51
9833039,8980192,4221,1477350,10457542,16.45
9833040,9966048,3614,1264900,11230948,12.69
9833041,9981534,1536,537600,10519134,5.39
9833042,9979484,4278,1497300,11476784,15.00
9833043,9982451,4308,1507800,11490251,15.10
9833044,9960040,6068,2123800,12083840,21.32
9833045,9970760,3962,1386700,11357460,13.91
9833046,9980417,3393,1187550,11167967,11.90
9833047,9972314,2554,893900,10866214,8.96
9833048,9980101,3764,1317400,11297501,13.20
9833049,9994737,3544,1240400,11235137,12.41
9833050,9974307,4299,1504650,11478957,15.09
9833051,9988668,4086,1430100,11418768,14.32
9833052,9977781,1098,384300,10362081,3.85
9833053,9996771,2717,950950,10947721,9.51
9833054,9988073,2417,845950,10834023,8.47
9833055,9987462,5935,2077250,12064712,20.80
9833056,9988884,2638,923300,10912184,9.24
9833057,9983927,1669,584150,10568077,5.85
9833058,9998971,2453,858550,10857521,8.59
9833059,9935482,1858,650300,10585782,6.55
9833060,9980246,5183,1814050,11794296,18.18
9833061,9997375,3131,1095850,11093225,10.96
9833062,9262296,2031,710850,9973146,7.67
9833063,9978974,4409,1543150,11522124,15.46
9833064,9989320,2201,770350,10759670,7.71
9833065,9981036,2052,718200,10699236,7.20
9833066,9985940,1113,389550,10375490,3.90
9833067,9884356,1118,391300,10275656,3.96
9833068,9992245,2267,793450,10785695,7.94
9833069,9917508,2082,728700,10646208,7.35
9833070,9992592,3530,1235500,11228092,12.36
9833071,9975743,2577,901950,10877693,9.04
9833072,9391391,3867,1353450,10744841,14.41
9833073,9993289,4334,1516900,11510189,15.18
9833074,7677627,1709,598150,8275777,7.79
9833075,8494429,789,276150,8770579,3.25
9833076,9990699,2169,759150,10749849,7.60
9833077,9988046,3821,1337350,11325396,13.39
9833078,9997814,5893,2062550,12060364,20.63
9833079,9990691,1277,446950,10437641,4.47
9833080,2184931,2267,793450,2978381,36.31
9833081,9985915,2720,952000,10937915,9.53
9833082,9975536,5543,1940050,11915586,19.45
9833083,9984308,2873,1005550,10989858,10.07
9833084,9984350,2953,1033550,11017900,10.35
9833085,9942140,1877,656950,10599090,6.61
9833086,9989315,1770,619500,10608815,6.20
9833087,9604771,793,277550,9882321,2.89
9833088,9990149,4139,1448650,11438799,14.50
9833089,9974762,6709,2348150,12322912,23.54
9833090,9966583,2033,711550,10678133,7.14
9833091,819491,189,66150,885641,8.07
9833092,9970430,3300,1155000,11125430,11.58
9833093,9937908,5313,1859550,11797458,18.71
9833095,9964214,2449,857150,10821364,8.60
9833096,9950752,2952,1033200,10983952,10.38
9833097,9967096,4368,1528800,11495896,15.34
9833098,9973956,5493,1922550,11896506,19.28
9833100,9964600,4815,1685250,11649850,16.91
9833101,9979634,6286,2200100,12179734,22.05
9833102,9280996,4754,1663900,10944896,17.93
9833103,9687761,2454,858900,10546661,8.87
9833104,9984654,3657,1279950,11264604,12.82
9833105,9967194,4084,1429400,11396594,14.34
9833106,3244958,588,205800,3450758,6.34
9833107,9905279,5878,2057300,11962579,20.77
9833108,9981747,3351,1172850,11154597,11.75
9833109,8339777,3753,1313550,9653327,15.75
9833110,9950215,3633,1271550,11221765,12.78
9833111,9997469,5064,1772400,11769869,17.73
9833112,588566,589,206150,794716,35.03
9833113,9995748,4416,1545600,11541348,15.46
9833114,266127,224,78400,344527,29.46
9833115,9974673,4997,1748950,11723623,17.53
9833117,9957335,6696,2343600,12300935,23.54
9833118,9963655,3955,1384250,11347905,13.89
9833119,8625380,2749,962150,9587530,11.15
9833120,9979111,6970,2439500,12418611,24.45
9833121,9982072,3226,1129100,11111172,11.31
9833123,9991462,2950,1032500,11023962,10.33
9833124,9989304,5529,1935150,11924454,19.37
9833125,658802,268,93800,752602,14.24
9833126,7068120,1616,565600,7633720,8.00
9833127,9976040,5653,1978550,11954590,19.83
9833128,9979854,3508,1227800,11207654,12.30
9833129,9378862,3272,1145200,10524062,12.21
9833130,9972805,5327,1864450,11837255,18.70
9833132,9960778,5286,1850100,11810878,18.57
9833133,9974511,5473,1915550,11890061,19.20
9833134,9966015,6010,2103500,12069515,21.11
9833135,9970031,6369,2229150,12199181,22.36
9833136,9978838,5817,2035950,12014788,20.40
9833137,7442258,4408,1542800,8985058,20.73
9833138,955098,554,193900,1148998,20.30
9833139,9987789,4271,1494850,11482639,14.97
9833140,9954410,6143,2150050,12104460,21.60
9833141,9878848,3678,1287300,11166148,13.03
9833142,9985150,5522,1932700,11917850,19.36
9833143,9713808,4125,1443750,11157558,14.86
9833144,9967085,6655,2329250,12296335,23.37
9833145,9977950,4121,1442350,11420300,14.46
9833146,9975709,4817,1685950,11661659,16.90
9833147,9960617,4959,1735650,11696267,17.43
9833148,9968932,6537,2287950,12256882,22.95
9833149,8179147,4399,1539650,9718797,18.82
9833150,9958987,4453,1558550,11517537,15.65
9833151,8968119,4500,1575000,10543119,17.56
9833152,9984522,5044,1765400,11749922,17.68
9833153,1390591,628,219800,1610391,15.81
9833154,9987569,4221,1477350,11464919,14.79
9833155,958099,234,81900,1039999,8.55
9833156,9976510,4218,1476300,11452810,14.80
9833158,9959902,5736,2007600,11967502,20.16
9833159,9981118,6384,2234400,12215518,22.39
9833160,7908033,3303,1156050,9064083,14.62
9833161,9978408,5794,2027900,12006308,20.32
9833162,1454030,460,161000,1615030,11.07
9833163,1446100,1578,552300,1998400,38.19
9833164,9970239,4519,1581650,11551889,15.86
9833165,1908389,980,343000,2251389,17.97
9833166,9962920,4768,1668800,11631720,16.75
9833167,9966111,4635,1622250,11588361,16.28
9833168,9954443,6783,2374050,12328493,23.85
9833169,9962898,3934,1376900,11339798,13.82
9833170,9961733,5392,1887200,11848933,18.94
9833171,9068120,3547,1241450,10309570,13.69
9833172,9972770,5443,1905050,11877820,19.10
9833173,9975279,5571,1949850,11925129,19.55
9833174,9974280,4843,1695050,11669330,16.99
9833175,9961651,5027,1759450,11721101,17.66
9833176,9998538,8435,2952250,12950788,29.53
9833177,9880461,4728,1654800,11535261,16.75
9833178,804039,626,219100,1023139,27.25
9833179,9982418,5392,1887200,11869618,18.91
9833180,9980724,4766,1668100,11648824,16.71
9833181,9945949,3257,1139950,11085899,11.46
9833182,9984047,2337,817950,10801997,8.19
9833183,9995351,2840,994000,10989351,9.94
9833184,9991964,2048,716800,10708764,7.17
9833185,857832,354,123900,981732,14.44
9833186,9960321,4886,1710100,11670421,17.17
9833187,9977942,2722,952700,10930642,9.55
9833188,9976860,911,318850,10295710,3.20
9833189,9960797,3425,1198750,11159547,12.03
9833190,9983346,4444,1555400,11538746,15.58
9833191,9984737,240,84000,10068737,0.84
9833192,9987252,5794,2027900,12015152,20.30
9833193,9990204,5334,1866900,11857104,18.69
9833194,9987552,2948,1031800,11019352,10.33
9833195,9969447,1999,699650,10669097,7.02
9833196,9974414,1625,568750,10543164,5.70
9833197,567338,203,71050,638388,12.52
9833198,9986655,6724,2353400,12340055,23.57
9833199,2255091,1517,530950,2786041,23.54
9833200,9935369,4502,1575700,11511069,15.86
9833201,9982871,4267,1493450,11476321,14.96
9833202,9993105,3468,1213800,11206905,12.15
9833203,9981878,2923,1023050,11004928,10.25
9833204,9968565,1892,662200,10630765,6.64
9833205,9974460,3911,1368850,11343310,13.72
9833206,3537911,1653,578550,4116461,16.35
9833207,233993,232,81200,315193,34.70
9833208,9946438,5087,1780450,11726888,17.90
9833209,9949827,3735,1307250,11257077,13.14
9833210,9962483,1542,539700,10502183,5.42
9833211,4608801,2716,950600,5559401,20.63
9833212,9945112,3197,1118950,11064062,11.25
9833213,9960372,4856,1699600,11659972,17.06
9833214,452000,180,63000,515000,13.94
9833215,9937810,4487,1570450,11508260,15.80
9833216,348767,86,30100,378867,8.63
9833217,1980004,725,253750,2233754,12.82
9833218,9923975,5835,2042250,11966225,20.58
9833219,9915565,3625,1268750,11184315,12.80
9833220,9925228,2068,723800,10649028,7.29
9833221,9927362,5139,1798650,11726012,18.12
9833222,259384,101,35350,294734,13.63
9833223,7331694,3667,1283450,8615144,17.51
9833224,2540559,1434,501900,3042459,19.76
9833225,9936058,3218,1126300,11062358,11.34
9833226,9949166,1662,581700,10530866,5.85
9833227,9944354,4918,1721300,11665654,17.31
9833228,9957891,3497,1223950,11181841,12.29
9833229,9960236,5477,1916950,11877186,19.25
9833230,9957555,3922,1372700,11330255,13.79
9833231,9964302,2267,793450,10757752,7.96
9833232,9726823,694,242900,9969723,2.50
9833233,9982975,3796,1328600,11311575,13.31
9833234,9709371,5483,1919050,11628421,19.76
9833235,9976123,2751,962850,10938973,9.65
9833236,9976347,3993,1397550,11373897,14.01
9833237,9989095,1618,566300,10555395,5.67
9833238,9987334,3915,1370250,11357584,13.72
9833239,831553,138,48300,879853,5.81
9833240,9970310,5246,1836100,11806410,18.42
9833241,9974609,3973,1390550,11365159,13.94
9833242,2544792,1258,440300,2985092,17.30
9833243,9980131,2470,864500,10844631,8.66
9833244,9978436,3695,1293250,11271686,12.96
9833245,632512,164,57400,689912,9.07
9833246,9959743,4201,1470350,11430093,14.76
9833247,9944981,3516,1230600,11175581,12.37
9833248,9952422,715,250250,10202672,2.51
9833249,9961181,3576,1251600,11212781,12.56
9833250,2361962,927,324450,2686412,13.74
9833251,9990760,1354,473900,10464660,4.74
9833252,9983128,4172,1460200,11443328,14.63
9833253,9992269,3506,1227100,11219369,12.28
9833254,9979905,3491,1221850,11201755,12.24
9833255,9976439,4770,1669500,11645939,16.73
9833256,9995590,4906,1717100,11712690,17.18
9833257,9998429,5303,1856050,11854479,18.56
9833258,9993673,4560,1596000,11589673,15.97
9833259,844200,461,161350,1005550,19.11
9833260,9916383,3166,1108100,11024483,11.17
9833261,9971267,4188,1465800,11437067,14.70
9833262,1600313,1082,378700,1979013,23.66
9833263,9940205,6136,2147600,12087805,21.61
9833264,1505298,809,283150,1788448,18.81
9833265,1547992,506,177100,1725092,11.44
9833266,3407981,2538,888300,4296281,26.07
9833267,9418494,4842,1694700,11113194,17.99
9833268,9978052,2697,943950,10922002,9.46
9833269,9966887,4773,1670550,11637437,16.76
9833270,51924,13,4550,56474,8.76
9833271,9959998,4694,1642900,11602898,16.49
9833272,9924823,3343,1170050,11094873,11.79
9833273,9953630,4600,1610000,11563630,16.18
9833274,3413450,788,275800,3689250,8.08
9833275,9952539,6808,2382800,12335339,23.94
9833276,9968783,2890,1011500,10980283,10.15
9833277,9973308,2939,1028650,11001958,10.31
9833278,5324238,2174,760900,6085138,14.29
9833279,9972745,4291,1501850,11474595,15.06
9833280,9970585,3842,1344700,11315285,13.49
9833281,9974754,4622,1617700,11592454,16.22
9833282,9971281,3959,1385650,11356931,13.90
9833283,9971123,4945,1730750,11701873,17.36
9833284,9984152,4035,1412250,11396402,14.14
9833285,9981745,2665,932750,10914495,9.34
9833286,5868101,873,305550,6173651,5.21
9833287,9984405,4606,1612100,11596505,16.15
9833288,3267933,583,204050,3471983,6.24
9833289,4397089,1615,565250,4962339,12.86
9833290,9745647,4866,1703100,11448747,17.48
9833291,9964423,3940,1379000,11343423,13.84
9833292,9983261,2102,735700,10718961,7.37
9833293,9952708,3642,1274700,11227408,12.81
9833294,9967368,7058,2470300,12437668,24.78
9833295,9977456,4381,1533350,11510806,15.37
9833296,9981051,5553,1943550,11924601,19.47
9833297,1975740,735,257250,2232990,13.02
9833298,9989900,3121,1092350,11082250,10.93
9833300,9938497,4257,1489950,11428447,14.99
9833301,9936118,3776,1321600,11257718,13.30
9833302,9926094,4578,1602300,11528394,16.14
9833303,9952713,5150,1802500,11755213,18.11
9833304,9964457,3686,1290100,11254557,12.95
9833305,9960008,5270,1844500,11804508,18.52
9833306,9676164,2116,740600,10416764,7.65
9833307,9945843,4150,1452500,11398343,14.60
9833308,9959829,4050,1417500,11377329,14.23
9833309,9978562,5299,1854650,11833212,18.59
9833310,9990628,4814,1684900,11675528,16.86
9833311,9992452,5582,1953700,11946152,19.55
9833312,9992914,5910,2068500,12061414,20.70
9833313,3428555,2359,825650,4254205,24.08
9833314,9960643,6050,2117500,12078143,21.26
9833315,5209067,3350,1172500,6381567,22.51
9833316,9974186,4880,1708000,11682186,17.12
9833317,9965578,2773,970550,10936128,9.74
9833318,9959713,5585,1954750,11914463,19.63
9833319,9964706,5610,1963500,11928206,19.70
9833320,9976595,4768,1668800,11645395,16.73
9833321,9986820,2908,1017800,11004620,10.19
9833322,9974234,1835,642250,10616484,6.44
9833323,4203709,2374,830900,5034609,19.77
9833324,9902525,4565,1597750,11500275,16.13
9833327,5221673,3430,1200500,6422173,22.99
9833328,9898727,6026,2109100,12007827,21.31
9833329,9966747,3535,1237250,11203997,12.41
9833330,9980081,4934,1726900,11706981,17.30
9833331,9966304,3159,1105650,11071954,11.09
9833332,9962724,5655,1979250,11941974,19.87
9833333,9988866,6172,2160200,12149066,21.63
9833334,9993537,5188,1815800,11809337,18.17
9833335,9981380,5109,1788150,11769530,17.91
9833336,9989206,4897,1713950,11703156,17.16
9833337,9967319,3846,1346100,11313419,13.51
9833338,1055377,551,192850,1248227,18.27
9833339,9975153,4623,1618050,11593203,16.22
9833340,9987051,4002,1400700,11387751,14.03
9833341,9981964,2975,1041250,11023214,10.43
9833342,2052607,743,260050,2312657,12.67
9833343,9978936,4618,1616300,11595236,16.20
9833344,9972304,5204,1821400,11793704,18.26
9833345,9992143,3136,1097600,11089743,10.98
9833346,9983157,6563,2297050,12280207,23.01
9833347,9994954,4481,1568350,11563304,15.69
9833348,9985475,1146,401100,10386575,4.02
9833349,9990485,2361,826350,10816835,8.27
9833350,9991804,6344,2220400,12212204,22.22
9833351,9989415,2638,923300,10912715,9.24
9833352,188422,148,51800,240222,27.49
9833353,9982116,4488,1570800,11552916,15.74
9833354,555921,551,192850,748771,34.69
9833355,9962405,5584,1954400,11916805,19.62
9833356,9989845,5612,1964200,11954045,19.66
9833357,9979875,3638,1273300,11253175,12.76
9833358,1792903,1716,600600,2393503,33.50
9833359,9968419,6640,2324000,12292419,23.31
9833360,9966335,3697,1293950,11260285,12.98
9833361,9973007,5943,2080050,12053057,20.86
9833362,9986606,6125,2143750,12130356,21.47
9833363,9977036,4479,1567650,11544686,15.71
9833364,9987834,5047,1766450,11754284,17.69
9833365,9986314,4285,1499750,11486064,15.02
9833366,9987965,5228,1829800,11817765,18.32
9833367,9955641,3655,1279250,11234891,12.85
9833368,9991917,3957,1384950,11376867,13.86
9833369,9981781,6574,2300900,12282681,23.05
9833370,9972006,5083,1779050,11751056,17.84
9833371,9980896,4456,1559600,11540496,15.63
9833372,9987315,5060,1771000,11758315,17.73
9833373,9981243,5621,1967350,11948593,19.71
9833374,9992085,3840,1344000,11336085,13.45
9833375,3239079,1756,614600,3853679,18.97
9833376,8311682,3176,1111600,9423282,13.37
9833377,9965081,3451,1207850,11172931,12.12
9833378,9973187,4150,1452500,11425687,14.56
9833380,9994216,3843,1345050,11339266,13.46
9833381,9996082,3876,1356600,11352682,13.57
9833382,9973342,1382,483700,10457042,4.85
9833383,9998356,2588,905800,10904156,9.06
9833384,9979989,1056,369600,10349589,3.70
9833385,9907949,6495,2273250,12181199,22.94
9833386,9995785,1160,406000,10401785,4.06
9833387,9984631,5156,1804600,11789231,18.07
9833388,9988772,6210,2173500,12162272,21.76
9833389,557390,194,67900,625290,12.18
9833390,2395730,1580,553000,2948730,23.08
9833391,1481177,485,169750,1650927,11.46
9833392,9961830,2988,1045800,11007630,10.50
9833393,9968394,2668,933800,10902194,9.37
9833394,9966343,4953,1733550,11699893,17.39
9833395,9974103,1634,571900,10546003,5.73
9833396,1478175,722,252700,1730875,17.10
9833397,9986341,3802,1330700,11317041,13.33
9833398,9974949,5560,1946000,11920949,19.51
9833399,406992,498,174300,581292,42.83
9833400,9971610,3776,1321600,11293210,13.25
9833401,2855620,1546,541100,3396720,18.95
9833402,9950766,5398,1889300,11840066,18.99
9833403,9950726,5895,2063250,12013976,20.73
9833404,1518493,1298,454300,1972793,29.92
9833405,9878067,4434,1551900,11429967,15.71
9833406,9959490,3758,1315300,11274790,13.21
9833407,9959853,3734,1306900,11266753,13.12
9833408,9953256,3800,1330000,11283256,13.36
9833409,9967703,5005,1751750,11719453,17.57
9833410,9967017,3104,1086400,11053417,10.90
9833411,188295,159,55650,243945,29.55
9833412,9944093,5246,1836100,11780193,18.46
9833413,4672576,1321,462350,5134926,9.89
9833414,9962882,4517,1580950,11543832,15.87
9833415,9956392,4201,1470350,11426742,14.77
9833416,9974726,1607,562450,10537176,5.64
9833417,9984205,4739,1658650,11642855,16.61
9833418,9979382,7159,2505650,12485032,25.11
9833419,9966755,3353,1173550,11140305,11.77
9833420,9983138,5398,1889300,11872438,18.92
9833421,1627477,2140,749000,2376477,46.02
9833422,9951504,3213,1124550,11076054,11.30
9833423,9949795,1708,597800,10547595,6.01
9833424,9949000,4787,1675450,11624450,16.84
9833425,9963806,1851,647850,10611656,6.50
9833426,118864,110,38500,157364,32.39
9833427,9949947,4668,1633800,11583747,16.42
9833429,9915907,4400,1540000,11455907,15.53
9833430,9920171,4282,1498700,11418871,15.11
9833431,9916195,3186,1115100,11031295,11.25
9833432,181841,100,35000,216841,19.25
9833433,9927963,2461,861350,10789313,8.68
9833434,9918676,835,292250,10210926,2.95
9833435,9916553,3808,1332800,11249353,13.44
9833436,6775338,3156,1104600,7879938,16.30
9833437,9842924,4590,1606500,11449424,16.32
9833439,9925219,1657,579950,10505169,5.84
9833440,2116431,953,333550,2449981,15.76
9833441,9898874,2224,778400,10677274,7.86
9833442,9898750,1814,634900,10533650,6.41
9833443,9887078,8000,2800000,12687078,28.32
9833444,1280992,586,205100,1486092,16.01
9833445,9892725,5373,1880550,11773275,19.01
9833446,9909515,6003,2101050,12010565,21.20
9833447,56209,42,14700,70909,26.15
9833448,9883108,4538,1588300,11471408,16.07
9833449,8833571,3988,1395800,10229371,15.80
9833450,9905120,4045,1415750,11320870,14.29
9833451,9914498,1994,697900,10612398,7.04
9833453,8204419,5970,2089500,10293919,25.47
9833455,272954,49,17150,290104,6.28
9833456,1249052,689,241150,1490202,19.31
9833457,9867698,4532,1586200,11453898,16.07
9833459,9539365,2921,1022350,10561715,10.72
9833460,3363645,1823,638050,4001695,18.97
9833461,9846486,3319,1161650,11008136,11.80
9833462,1124186,486,170100,1294286,15.13
9833463,9823879,3117,1090950,10914829,11.11
9833464,9862562,2694,942900,10805462,9.56
9833465,1626922,530,185500,1812422,11.40
9833467,9828657,5005,1751750,11580407,17.82
9833468,9837730,3756,1314600,11152330,13.36
9833469,9835813,4115,1440250,11276063,14.64
9833470,829280,1662,581700,1410980,70.15
9833471,1717052,913,319550,2036602,18.61
9833472,9824772,3891,1361850,11186622,13.86
9833473,9835543,6136,2147600,11983143,21.84
9833474,9844223,1729,605150,10449373,6.15
9833475,1875677,832,291200,2166877,15.53
9833476,2042847,580,203000,2245847,9.94
9833477,9865128,4717,1650950,11516078,16.74
9833478,1410951,1666,583100,1994051,41.33
9833479,9861131,4729,1655150,11516281,16.78
9833480,9861771,2212,774200,10635971,7.85
9833481,9860837,2506,877100,10737937,8.89
9833482,127416,15,5250,132666,4.12
9833483,9871780,2769,969150,10840930,9.82
9833484,9871018,1653,578550,10449568,5.86
9833485,9866027,213,74550,9940577,0.76
9833486,9885255,3437,1202950,11088205,12.17
9833487,9875696,4226,1479100,11354796,14.98
9833488,3530630,4135,1447250,4977880,40.99
9833489,9907026,5492,1922200,11829226,19.40
9833490,9890338,3097,1083950,10974288,10.96
9833492,9617172,1703,596050,10213222,6.20
9833493,2109184,2567,898450,3007634,42.60
9833494,9879011,5534,1936900,11815911,19.61
9833495,9913023,641,224350,10137373,2.26
9833496,9908378,4307,1507450,11415828,15.21
9833497,9903721,5029,1760150,11663871,17.77
9833498,1364665,367,128450,1493115,9.41
9833499,4552795,833,291550,4844345,6.40
9833500,9923506,2963,1037050,10960556,10.45
9833501,9933660,1212,424200,10357860,4.27
9833502,9930181,4144,1450400,11380581,14.61
9833503,9934102,1191,416850,10350952,4.20
9833504,9947136,4400,1540000,11487136,15.48
9833505,9958402,4418,1546300,11504702,15.53
9833506,9960868,4256,1489600,11450468,14.95
9833507,9947040,2024,708400,10655440,7.12
9833508,9971356,4804,1681400,11652756,16.86
9833509,9972775,2812,984200,10956975,9.87
9833510,2508240,632,221200,2729440,8.82
9833511,9718840,5678,1987300,11706140,20.45
9833512,1102514,409,143150,1245664,12.98
9833513,9976083,4474,1565900,11541983,15.70
9833514,9968619,4338,1518300,11486919,15.23
9833515,9954844,4669,1634150,11588994,16.42
9833516,3672105,2101,735350,4407455,20.03
9833517,9945185,3071,1074850,11020035,10.81
9833518,9980980,1240,434000,10414980,4.35
9833519,9980265,697,243950,10224215,2.44
9833520,9982935,4542,1589700,11572635,15.92
9833521,9974897,4001,1400350,11375247,14.04
9833522,9967558,3272,1145200,11112758,11.49
9833523,6426560,2346,821100,7247660,12.78
9833524,9969776,2616,915600,10885376,9.18
9833525,9982910,2893,1012550,10995460,10.14
9833526,9987471,3796,1328600,11316071,13.30
9833527,9969238,2406,842100,10811338,8.45
9833528,9989199,3916,1370600,11359799,13.72
9833529,9974203,3293,1152550,11126753,11.56
9833530,9979888,2796,978600,10958488,9.81
9833531,9206113,5356,1874600,11080713,20.36
9833532,9905582,6638,2323300,12228882,23.45
9833533,425739,161,56350,482089,13.24
9833534,9978962,3196,1118600,11097562,11.21
9833535,1988608,1065,372750,2361358,18.74
9833536,9975945,5496,1923600,11899545,19.28
9833537,519788,254,88900,608688,17.10
9833538,9976618,3731,1305850,11282468,13.09
9833539,9987221,6087,2130450,12117671,21.33
9833540,1942465,1573,550550,2493015,28.34
9833541,9994726,4258,1490300,11485026,14.91
9833542,9992188,1941,679350,10671538,6.80
9833543,9943942,3791,1326850,11270792,13.34
9833544,9970466,5845,2045750,12016216,20.52
9833545,2097207,724,253400,2350607,12.08
9833546,9468450,4022,1407700,10876150,14.87
9833547,9988300,3834,1341900,11330200,13.43
9833548,9982990,1390,486500,10469490,4.87
9833549,951264,426,149100,1100364,15.67
9833550,9961237,1825,638750,10599987,6.41
9833551,9972320,2189,766150,10738470,7.68
9833553,9982486,1547,541450,10523936,5.42
9833554,9956579,2891,1011850,10968429,10.16
9833556,9964947,2952,1033200,10998147,10.37
9833557,9955727,4236,1482600,11438327,14.89
9833558,311011,126,44100,355111,14.18
9833559,9908043,2345,820750,10728793,8.28
9833560,9958268,5032,1761200,11719468,17.69
9833561,9959741,4926,1724100,11683841,17.31
9833563,260707,122,42700,303407,16.38
9833564,9994063,4998,1749300,11743363,17.50
9833565,9954154,6821,2387350,12341504,23.98
9833566,1822998,872,305200,2128198,16.74
9833567,9965302,4217,1475950,11441252,14.81
9833568,9972739,3282,1148700,11121439,11.52
9833569,9970232,2098,734300,10704532,7.36
9833570,9970152,1287,450450,10420602,4.52
9833571,9980348,4022,1407700,11388048,14.10
9833572,9983018,1244,435400,10418418,4.36
9833573,9982440,1918,671300,10653740,6.72
9833574,9952389,3492,1222200,11174589,12.28
9833575,9993502,2803,981050,10974552,9.82
9833576,9985750,788,275800,10261550,2.76
9833577,9971010,4239,1483650,11454660,14.88
9833578,9960489,904,316400,10276889,3.18
9833579,9984874,1145,400750,10385624,4.01
9833580,9979283,1332,466200,10445483,4.67
9833581,694254,207,72450,766704,10.44
9833582,9957467,2637,922950,10880417,9.27
9833583,9975102,3565,1247750,11222852,12.51
9833584,9989362,5804,2031400,12020762,20.34
9833585,9970026,6959,2435650,12405676,24.43
9833586,8968938,3414,1194900,10163838,13.32
9833587,534778,329,115150,649928,21.53
9833588,9977404,3721,1302350,11279754,13.05
9833589,9989686,3890,1361500,11351186,13.63
9833590,9987262,4257,1489950,11477212,14.92
9833591,1954720,760,266000,2220720,13.61
9833592,9993236,3500,1225000,11218236,12.26
9833593,9983360,803,281050,10264410,2.82
9833594,9986191,2522,882700,10868891,8.84
9833595,9980271,1214,424900,10405171,4.26
9833596,9938119,8575,3001250,12939369,30.20
9833597,9982162,3838,1343300,11325462,13.46
9833598,9997421,4206,1472100,11469521,14.72
9833599,9961622,4167,1458450,11420072,14.64
9833600,9985624,2226,779100,10764724,7.80
9833601,9990005,528,184800,10174805,1.85
9833602,9998847,4861,1701350,11700197,17.02
9833603,6559265,505,176750,6736015,2.69
9833604,282842,132,46200,329042,16.33
9833605,9980772,2732,956200,10936972,9.58
9833607,1975844,830,290500,2266344,14.70
9833608,9979095,6872,2405200,12384295,24.10
9833609,9989956,4046,1416100,11406056,14.18
9833610,9968101,4711,1648850,11616951,16.54
9833611,9959564,2439,853650,10813214,8.57
9833612,9993217,4924,1723400,11716617,17.25
9833613,9978191,6353,2223550,12201741,22.28
9833614,242853,142,49700,292553,20.47
9833615,1274094,287,100450,1374544,7.88
9833616,9445321,3601,1260350,10705671,13.34
9833617,9729736,2990,1046500,10776236,10.76
9833618,9962704,5422,1897700,11860404,19.05
9833619,9981774,1107,387450,10369224,3.88
9833621,9982127,4196,1468600,11450727,14.71
9833622,9968355,4978,1742300,11710655,17.48
9833623,9976148,884,309400,10285548,3.10
9833624,9985289,1031,360850,10346139,3.61
9833625,9962378,5136,1797600,11759978,18.04
9833626,9993545,2826,989100,10982645,9.90
9833627,151329,74,25900,177229,17.12
9833628,9969037,6301,2205350,12174387,22.12
9833629,9973601,5495,1923250,11896851,19.28
9833630,9986596,5958,2085300,12071896,20.88
9833631,9981983,3242,1134700,11116683,11.37
9833632,9982428,2964,1037400,11019828,10.39
9833633,9970651,1619,566650,10537301,5.68
9833634,9987892,4634,1621900,11609792,16.24
9833635,9973762,4188,1465800,11439562,14.70
9833636,9988457,5143,1800050,11788507,18.02
9833637,1605322,219,76650,1681972,4.77
9833638,2961488,2288,800800,3762288,27.04
9833639,9958631,4709,1648150,11606781,16.55
9833640,9899928,3916,1370600,11270528,13.84
9833641,9986384,2622,917700,10904084,9.19
9833642,9915468,6298,2204300,12119768,22.23
9833643,9994110,3783,1324050,11318160,13.25
9833644,9866883,4808,1682800,11549683,17.06
9833645,9984150,4324,1513400,11497550,15.16
9833646,9996611,1255,439250,10435861,4.39
9833647,1680858,1184,414400,2095258,24.65
9833648,9978348,5051,1767850,11746198,17.72
9833649,9973066,5273,1845550,11818616,18.51
9833650,128722,15,5250,133972,4.08
9833651,9973409,2378,832300,10805709,8.35
9833652,1788344,1511,528850,2317194,29.57
9833653,9987217,3619,1266650,11253867,12.68
9833654,9969776,3128,1094800,11064576,10.98
9833655,9965792,6000,2100000,12065792,21.07
9833656,9955827,781,273350,10229177,2.75
9833657,450206,165,57750,507956,12.83
9833658,9970767,5188,1815800,11786567,18.21
9833659,3142285,1254,438900,3581185,13.97
9833660,9738333,4254,1488900,11227233,15.29
9833661,9965127,4605,1611750,11576877,16.17
9833662,9967074,3035,1062250,11029324,10.66
9833663,9988605,4880,1708000,11696605,17.10
9833664,9996190,4416,1545600,11541790,15.46
9833665,9976023,1140,399000,10375023,4.00
9833666,9928816,4724,1653400,11582216,16.65
9833667,9973605,1544,540400,10514005,5.42
9833668,366257,55,19250,385507,5.26
9833669,1389931,775,271250,1661181,19.52
9833670,9977671,5059,1770650,11748321,17.75
9833671,2623362,1838,643300,3266662,24.52
9833672,9877505,4395,1538250,11415755,15.57
9833673,9961957,3924,1373400,11335357,13.79
9833674,9441100,2696,943600,10384700,9.99
9833675,651208,713,249550,900758,38.32
9833676,9879305,3775,1321250,11200555,13.37
9833677,9951626,2600,910000,10861626,9.14
9833678,9928148,2819,986650,10914798,9.94
9833679,9933213,3444,1205400,11138613,12.14
9833680,9932247,1816,635600,10567847,6.40
9833681,9915022,1284,449400,10364422,4.53
9833682,9938702,3938,1378300,11317002,13.87
9833683,5085518,2634,921900,6007418,18.13
9833684,9945471,4124,1443400,11388871,14.51
9833685,9934998,4271,1494850,11429848,15.05
9833686,458089,236,82600,540689,18.03
9833687,9937023,2428,849800,10786823,8.55
9833688,9957490,1776,621600,10579090,6.24
9833689,9952086,3554,1243900,11195986,12.50
9833690,9454614,4844,1695400,11150014,17.93
9833691,891029,58,20300,911329,2.28
9833692,9960564,749,262150,10222714,2.63
9833693,9952641,2885,1009750,10962391,10.15
9833694,9968368,3977,1391950,11360318,13.96
9833695,9722579,1558,545300,10267879,5.61
9833696,9990079,7125,2493750,12483829,24.96
9833697,9984065,4916,1720600,11704665,17.23
9833698,9976917,5306,1857100,11834017,18.61
9833699,252078,124,43400,295478,17.22
9833700,9998383,6703,2346050,12344433,23.46
9833701,9996742,1320,462000,10458742,4.62
9833703,9971300,4232,1481200,11452500,14.85
9833704,9993147,1537,537950,10531097,5.38
9833705,9985873,774,270900,10256773,2.71
9833706,9704846,3038,1063300,10768146,10.96
9833707,9972220,1260,441000,10413220,4.42
9833708,9988633,5919,2071650,12060283,20.74
9833709,9989245,1241,434350,10423595,4.35
9833710,9994837,838,293300,10288137,2.93
9833711,9982584,1265,442750,10425334,4.44
9833712,9992539,936,327600,10320139,3.28
9833713,9996119,5071,1774850,11770969,17.76
9833714,1074020,280,98000,1172020,9.12
9833715,8976188,4415,1545250,10521438,17.21
9833716,9977987,1729,605150,10583137,6.06
9833717,9481870,4913,1719550,11201420,18.14
9833718,6015730,3032,1061200,7076930,17.64
9833719,9984998,3563,1247050,11232048,12.49
9833720,479717,420,147000,626717,30.64
9833721,9759983,3716,1300600,11060583,13.33
9833722,9954277,4219,1476650,11430927,14.83
9833723,9938638,4751,1662850,11601488,16.73
9833724,9907603,4919,1721650,11629253,17.38
9833725,7431727,3699,1294650,8726377,17.42
9833726,9952944,4643,1625050,11577994,16.33
9833727,9829782,3685,1289750,11119532,13.12
9833728,9700273,3328,1164800,10865073,12.01
9833729,9934632,3620,1267000,11201632,12.75
9833730,9941299,3873,1355550,11296849,13.64
9833732,9936450,4107,1437450,11373900,14.47
9833733,9940221,4845,1695750,11635971,17.06
9833734,9957451,4541,1589350,11546801,15.96
9833735,9366024,5902,2065700,11431724,22.06
9833736,9952775,2319,811650,10764425,8.16
9833737,9976002,1984,694400,10670402,6.96
9833738,9708179,1949,682150,10390329,7.03
9833739,9979952,3993,1397550,11377502,14.00
9833741,9967634,1069,374150,10341784,3.75
9833742,9952243,5930,2075500,12027743,20.85
9833743,9959552,5171,1809850,11769402,18.17
9833744,9813668,2895,1013250,10826918,10.32
9833745,9960246,3922,1372700,11332946,13.78
9833746,9964875,1881,658350,10623225,6.61
9833747,6796102,2109,738150,7534252,10.86
9833748,9945848,4979,1742650,11688498,17.52
9833749,9960130,1804,631400,10591530,6.34
9833750,9958007,1071,374850,10332857,3.76
9833751,541415,195,68250,609665,12.61
9833753,6417989,3388,1185800,7603789,18.48
9833754,9945662,3036,1062600,11008262,10.68
9833755,9950612,4750,1662500,11613112,16.71
9833756,9958123,1360,476000,10434123,4.78
9833757,9931854,2469,864150,10796004,8.70
9833758,9937317,4012,1404200,11341517,14.13
9833760,9970097,6041,2114350,12084447,21.21
9833761,9964687,3778,1322300,11286987,13.27
9833762,3477091,2244,785400,4262491,22.59
9833763,9982897,4555,1594250,11577147,15.97
9833764,9987194,2970,1039500,11026694,10.41
9833765,9939929,3515,1230250,11170179,12.38
9833766,9966077,2272,795200,10761277,7.98
9833767,9974946,5570,1949500,11924446,19.54
9833768,9936530,3361,1176350,11112880,11.84
9833769,3549277,2464,862400,4411677,24.30
9833770,9932424,3670,1284500,11216924,12.93
9833771,9945013,5646,1976100,11921113,19.87
9833772,9951576,3753,1313550,11265126,13.20
9833773,9940615,4805,1681750,11622365,16.92
9833774,9935477,447,156450,10091927,1.57
9833775,9933694,4366,1528100,11461794,15.38
9833776,3288365,806,282100,3570465,8.58
9833777,9948635,3944,1380400,11329035,13.88
9833778,9952733,564,197400,10150133,1.98
9833779,1130203,293,102550,1232753,9.07
9833780,9937976,4080,1428000,11365976,14.37
9833781,9170742,4946,1731100,10901842,18.88
9833782,9950198,4696,1643600,11593798,16.52
9833783,9964046,1853,648550,10612596,6.51
9833784,9965450,1462,511700,10477150,5.13
9833785,9948312,5279,1847650,11795962,18.57
9833786,9975419,847,296450,10271869,2.97
9833787,9964028,924,323400,10287428,3.25
9833788,9976724,1213,424550,10401274,4.26
9833789,9930291,5206,1822100,11752391,18.35
9833791,9879414,3528,1234800,11114214,12.50
9833792,9949234,1601,560350,10509584,5.63
9833793,9724172,2688,940800,10664972,9.67
9833794,9925054,2929,1025150,10950204,10.33
9833795,9972964,3254,1138900,11111864,11.42
9833796,9967078,613,214550,10181628,2.15
9833797,530711,176,61600,592311,11.61
9833798,1410265,1236,432600,1842865,30.68
9833799,9957135,822,287700,10244835,2.89
9833800,9926613,3011,1053850,10980463,10.62
9833801,9982906,994,347900,10330806,3.48
9833802,2900927,2413,844550,3745477,29.11
9833803,7561312,4570,1599500,9160812,21.15
9833804,9621170,403,141050,9762220,1.47
9833805,9971249,1396,488600,10459849,4.90
9833806,9981425,4583,1604050,11585475,16.07
9833807,1981858,1445,505750,2487608,25.52
9833808,9966927,6962,2436700,12403627,24.45
9833809,3840773,1247,436450,4277223,11.36
9833810,9989966,4806,1682100,11672066,16.84
9833811,9990411,5270,1844500,11834911,18.46
9833812,253766,294,102900,356666,40.55
9833813,9970247,5376,1881600,11851847,18.87
9833814,9981047,5817,2035950,12016997,20.40
9833815,9972420,5462,1911700,11884120,19.17
9833816,9987860,4624,1618400,11606260,16.20
9833817,9722361,3019,1056650,10779011,10.87
9833818,9956320,4672,1635200,11591520,16.42
9833819,9971188,4057,1419950,11391138,14.24
9833820,9983206,5763,2017050,12000256,20.20
9833821,9987881,3163,1107050,11094931,11.08
9833822,3838171,2816,985600,4823771,25.68
9833823,9912057,4651,1627850,11539907,16.42
9833824,9998965,6168,2158800,12157765,21.59
9833825,2597550,1852,648200,3245750,24.95
9833826,9979392,4627,1619450,11598842,16.23
9833827,9756959,4978,1742300,11499259,17.86
9833828,9988628,2565,897750,10886378,8.99
9833830,9999487,1931,675850,10675337,6.76
9833831,4735704,3969,1389150,6124854,29.33
9833832,1704387,775,271250,1975637,15.91
9833833,9974871,4153,1453550,11428421,14.57
9833834,9983774,7435,2602250,12586024,26.06
9833836,9984729,4638,1623300,11608029,16.26
9833837,9972224,4534,1586900,11559124,15.91
9833838,9974597,3941,1379350,11353947,13.83
9833839,9995272,1224,428400,10423672,4.29
9833840,9983823,1448,506800,10490623,5.08
9833841,9984417,6527,2284450,12268867,22.88
9833842,9998365,2010,703500,10701865,7.04
9833843,9952749,3375,1181250,11133999,11.87
9833844,9985537,5074,1775900,11761437,17.78
9833845,2907712,1611,563850,3471562,19.39
9833846,9981487,5314,1859900,11841387,18.63
9833847,9982383,5045,1765750,11748133,17.69
9833848,9990545,2810,983500,10974045,9.84
9833849,1010548,489,171150,1181698,16.94
9833850,9967918,6949,2432150,12400068,24.40
9833851,4353864,3288,1150800,5504664,26.43
9833852,9977107,947,331450,10308557,3.32
9833853,9985035,1645,575750,10560785,5.77
9833854,438245,230,80500,518745,18.37
9833855,9964626,1625,568750,10533376,5.71
9833856,9975090,3981,1393350,11368440,13.97
9833857,9955715,2549,892150,10847865,8.96
9833858,9984184,810,283500,10267684,2.84
9833859,9990344,5339,1868650,11858994,18.70
9833860,9980252,3480,1218000,11198252,12.20
9833861,9995689,1695,593250,10588939,5.94
9833862,9979487,4242,1484700,11464187,14.88
9833863,9962935,6618,2316300,12279235,23.25
9833864,9528779,3443,1205050,10733829,12.65
9833865,9983685,5340,1869000,11852685,18.72
9833866,9358601,5587,1955450,11314051,20.89
9833867,9980338,4291,1501850,11482188,15.05
9833868,4978927,3661,1281350,6260277,25.74
9833869,9887321,4586,1605100,11492421,16.23
9833870,9981749,3410,1193500,11175249,11.96
9833871,9897392,4206,1472100,11369492,14.87
9833872,9980699,4101,1435350,11416049,14.38
9833873,9988309,3753,1313550,11301859,13.15
9833874,9982347,3763,1317050,11299397,13.19
9833875,9994649,757,264950,10259599,2.65
9833876,9981025,1378,482300,10463325,4.83
9833877,9997815,1134,396900,10394715,3.97
9833878,9960895,4623,1618050,11578945,16.24
9833879,2262839,1863,652050,2914889,28.82
9833880,9980119,2951,1032850,11012969,10.35
9833881,9980641,3000,1050000,11030641,10.52
9833882,9987078,6819,2386650,12373728,23.90
9833883,9989347,3801,1330350,11319697,13.32
9833884,9483708,5715,2000250,11483958,21.09
9833885,2384683,1507,527450,2912133,22.12
9833886,9967957,4810,1683500,11651457,16.89
9833887,9981341,1161,406350,10387691,4.07
9833888,9963435,1646,576100,10539535,5.78
9833889,1356094,698,244300,1600394,18.01
9833890,9959061,950,332500,10291561,3.34
9833891,4289241,3652,1278200,5567441,29.80
9833892,2896001,1506,527100,3423101,18.20
9833893,9861695,3650,1277500,11139195,12.95
9833894,9924543,5093,1782550,11707093,17.96
9833895,9919964,5671,1984850,11904814,20.01
9833896,9915016,2747,961450,10876466,9.70
9833897,9942370,2194,767900,10710270,7.72
9833898,9924947,988,345800,10270747,3.48
9833899,9936857,4692,1642200,11579057,16.53
9833900,4987102,3183,1114050,6101152,22.34
9833901,9955462,3358,1175300,11130762,11.81
9833902,9960630,3710,1298500,11259130,13.04
9833903,9949772,4308,1507800,11457572,15.15
9833904,9963940,1246,436100,10400040,4.38
9833905,9970681,582,203700,10174381,2.04
9833906,1493580,514,179900,1673480,12.04
9833907,3982333,2546,891100,4873433,22.38
9833909,9974045,1951,682850,10656895,6.85
9833910,9982982,3667,1283450,11266432,12.86
9833911,9986584,2473,865550,10852134,8.67
9833912,9741028,4347,1521450,11262478,15.62
9833913,9984645,3830,1340500,11325145,13.43
9833914,9465323,4767,1668450,11133773,17.63
9833915,9997164,1581,553350,10550514,5.54
9833916,9988407,1666,583100,10571507,5.84
9833917,9995296,4401,1540350,11535646,15.41
9833918,9979409,1148,401800,10381209,4.03
9833919,9967093,2134,746900,10713993,7.49
9833920,9985517,1608,562800,10548317,5.64
9833921,9974305,4995,1748250,11722555,17.53
9833922,9978638,960,336000,10314638,3.37
9833923,3798036,2991,1046850,4844886,27.56
9833924,2803635,1954,683900,3487535,24.39
9833925,9470919,3747,1311450,10782369,13.85
9833926,890551,590,206500,1097051,23.19
9833927,4123299,1864,652400,4775699,15.82
9833928,9938697,5244,1835400,11774097,18.47
9833929,9914151,5382,1883700,11797851,19.00
9833930,4087542,3365,1177750,5265292,28.81
9833931,9926510,3351,1172850,11099360,11.82
9833932,9470040,4477,1566950,11036990,16.55
9833933,748571,225,78750,827321,10.52
9833934,9951665,5161,1806350,11758015,18.15
9833935,9939774,1865,652750,10592524,6.57
9833936,9966896,4715,1650250,11617146,16.56
9833937,9945083,571,199850,10144933,2.01
9833938,9943801,3605,1261750,11205551,12.69
9833939,9944918,4035,1412250,11357168,14.20
9833940,9972953,4187,1465450,11438403,14.69
9833941,9965777,420,147000,10112777,1.48
9833943,1097366,733,256550,1353916,23.38
9833944,9954513,3426,1199100,11153613,12.05
9833945,9947221,1260,441000,10388221,4.43
9833946,9943892,1698,594300,10538192,5.98
9833947,9945360,3196,1118600,11063960,11.25
9833949,9938741,3534,1236900,11175641,12.45
9833950,9943972,922,322700,10266672,3.25
9833951,1198223,778,272300,1470523,22.73
9833952,9933564,4897,1713950,11647514,17.25
9833953,9437578,5325,1863750,11301328,19.75
9833954,9922771,5993,2097550,12020321,21.14
9833955,9925153,1917,670950,10596103,6.76
9833956,9930643,4407,1542450,11473093,15.53
9833957,6278914,2541,889350,7168264,14.16
9833958,2572322,1864,652400,3224722,25.36
9833959,1444277,1844,645400,2089677,44.69
9833960,5918086,3263,1142050,7060136,19.30
9833961,9954480,4459,1560650,11515130,15.68
9833962,9942191,2775,971250,10913441,9.77
9833963,9935523,2510,878500,10814023,8.84
9833964,9946416,3341,1169350,11115766,11.76
9833965,9944047,3536,1237600,11181647,12.45
9833966,9932596,3188,1115800,11048396,11.23
9833967,9963587,3928,1374800,11338387,13.80
9833968,9976502,1449,507150,10483652,5.08
9833969,402868,101,35350,438218,8.77
9833970,9949946,4904,1716400,11666346,17.25
9833971,9957438,4636,1622600,11580038,16.30
9833972,9959066,3680,1288000,11247066,12.93
9833973,9945952,1433,501550,10447502,5.04
9833974,9966903,4099,1434650,11401553,14.39
9833975,9981817,1576,551600,10533417,5.53
9833976,9968683,4021,1407350,11376033,14.12
9833977,9959789,5159,1805650,11765439,18.13
9833978,3011874,1449,507150,3519024,16.84
9833979,9956725,3035,1062250,11018975,10.67
9833980,1878648,1615,565250,2443898,30.09
9833981,9989184,3881,1358350,11347534,13.60
9833982,9834782,2605,911750,10746532,9.27
9833983,9974690,2697,943950,10918640,9.46
9833984,1552830,554,193900,1746730,12.49
9833985,9984270,4660,1631000,11615270,16.34
9833986,9990837,3992,1397200,11388037,13.98
9833987,2203060,1133,396550,2599610,18.00
9833988,9969735,4732,1656200,11625935,16.61
9833989,9977765,5413,1894550,11872315,18.99
9833990,1318760,476,166600,1485360,12.63
9833991,945727,436,152600,1098327,16.14
9833992,9963640,6751,2362850,12326490,23.71
9833993,9973643,2731,955850,10929493,9.58
9833994,3185480,1440,504000,3689480,15.82
9833995,9934560,5874,2055900,11990460,20.69
9833996,9932838,1464,512400,10445238,5.16
9833997,9980814,5244,1835400,11816214,18.39
9833998,329834,181,63350,393184,19.21
9833999,839068,1075,376250,1215318,44.84
9834000,9958611,4299,1504650,11463261,15.11
9834001,9990583,5156,1804600,11795183,18.06
9834002,9964185,4658,1630300,11594485,16.36
9834003,9982132,4918,1721300,11703432,17.24
9834004,9989973,4358,1525300,11515273,15.27
9834005,9992035,1853,648550,10640585,6.49
9834006,9999973,1680,588000,10587973,5.88
9834007,9990836,3775,1321250,11312086,13.22
9834008,9994656,4481,1568350,11563006,15.69
9834009,4484784,3277,1146950,5631734,25.57
9834010,9985677,1456,509600,10495277,5.10
9834011,9986136,1228,429800,10415936,4.30
9834012,9992818,718,251300,10244118,2.51
9834013,1100682,299,104650,1205332,9.51
9834014,9992068,3706,1297100,11289168,12.98
9834015,9999500,7086,2480100,12479600,24.80
9834017,6974666,4388,1535800,8510466,22.02
9834018,9981397,6154,2153900,12135297,21.58
9834019,7539843,3452,1208200,8748043,16.02
9834020,6253749,4722,1652700,7906449,26.43
9834021,9973166,5891,2061850,12035016,20.67
9834022,9975869,5387,1885450,11861319,18.90
9834023,9952516,5975,2091250,12043766,21.01
9834024,9949027,4196,1468600,11417627,14.76
9834025,9968806,2745,960750,10929556,9.64
9834026,9970742,5609,1963150,11933892,19.69
9834027,136603,85,29750,166353,21.78
9834028,9914165,5150,1802500,11716665,18.18
9834029,9970585,5629,1970150,11940735,19.76
9834030,9984236,5501,1925350,11909586,19.28
9834031,9974862,1717,600950,10575812,6.02
9834032,9971017,5324,1863400,11834417,18.69
9834033,9975151,5696,1993600,11968751,19.99
9834034,9989000,3902,1365700,11354700,13.67
9834035,9728221,675,236250,9964471,2.43
9834036,9454760,3848,1346800,10801560,14.24
9834037,9980259,3486,1220100,11200359,12.23
9834038,9984442,4744,1660400,11644842,16.63
9834039,167171,104,36400,203571,21.77
9834040,9996407,7015,2455250,12451657,24.56
9834041,9972246,6045,2115750,12087996,21.22
9834042,9992327,1602,560700,10553027,5.61
9834043,9994880,1204,421400,10416280,4.22
9834044,2979988,2623,918050,3898038,30.81
9834045,9988935,5218,1826300,11815235,18.28
9834046,157940,44,15400,173340,9.75
9834047,9978009,645,225750,10203759,2.26
9834048,9979667,4267,1493450,11473117,14.96
9834049,9987795,3967,1388450,11376245,13.90
9834050,9971007,1427,499450,10470457,5.01
9834051,9956267,1110,388500,10344767,3.90
9834052,9969869,1296,453600,10423469,4.55
9834053,9978966,5834,2041900,12020866,20.46
9834054,9980427,688,240800,10221227,2.41
9834055,9859218,4799,1679650,11538868,17.04
9834056,9993354,3989,1396150,11389504,13.97
9834057,9979374,1310,458500,10437874,4.59
9834059,9988329,5149,1802150,11790479,18.04
9834060,9982294,3780,1323000,11305294,13.25
9834061,1588717,1006,352100,1940817,22.16
9834062,9975656,4260,1491000,11466656,14.95
9834063,9979159,3396,1188600,11167759,11.91
9834064,9947825,3161,1106350,11054175,11.12
9834065,1741252,1091,381850,2123102,21.93
9834066,1861148,692,242200,2103348,13.01
9834067,9985422,5895,2063250,12048672,20.66
9834068,9998317,3406,1192100,11190417,11.92
9834069,4038859,1502,525700,4564559,13.02
9834070,9970116,2594,907900,10878016,9.11
9834071,139406,42,14700,154106,10.54
9834072,9961706,1320,462000,10423706,4.64
9834073,9959273,3262,1141700,11100973,11.46
9834074,9356610,1242,434700,9791310,4.65
9834075,9971606,5217,1825950,11797556,18.31
9834077,9935284,2738,958300,10893584,9.65
9834078,9963549,4972,1740200,11703749,17.47
9834079,4320155,2104,736400,5056555,17.05
9834080,593835,240,84000,677835,14.15
9834081,9951625,2689,941150,10892775,9.46
9834082,9960021,4053,1418550,11378571,14.24
9834083,9963511,4857,1699950,11663461,17.06
9834084,314293,287,100450,414743,31.96
9834085,9942078,5942,2079700,12021778,20.92
9834086,9534558,3145,1100750,10635308,11.54
9834087,9928205,664,232400,10160605,2.34
9834088,9948978,786,275100,10224078,2.77
9834089,9553596,3210,1123500,10677096,11.76
9834090,9963782,6530,2285500,12249282,22.94
9834091,9959810,5226,1829100,11788910,18.36
9834092,1155886,934,326900,1482786,28.28
9834093,9946764,3324,1163400,11110164,11.70
9834094,9877957,6031,2110850,11988807,21.37
9834095,9939655,1249,437150,10376805,4.40
9834096,9964868,2150,752500,10717368,7.55
9834097,9970028,3078,1077300,11047328,10.81
9834098,9970347,4446,1556100,11526447,15.61
9834099,9958256,2304,806400,10764656,8.10
9834100,9960949,5183,1814050,11774999,18.21
9834101,2127818,904,316400,2444218,14.87
9834102,372032,85,29750,401782,8.00
9834103,9945820,4706,1647100,11592920,16.56
9834104,9948901,3896,1363600,11312501,13.71
9834105,9941639,4966,1738100,11679739,17.48
9834106,9940377,2065,722750,10663127,7.27
9834107,9924290,2471,864850,10789140,8.71
9834108,9938498,3885,1359750,11298248,13.68
9834109,3699995,1230,430500,4130495,11.64
9834110,9932874,2585,904750,10837624,9.11
9834111,9950063,2761,966350,10916413,9.71
9834112,9941375,3196,1118600,11059975,11.25
9834113,9924174,3089,1081150,11005324,10.89
9834114,9938805,4604,1611400,11550205,16.21
9834115,9926293,2476,866600,10792893,8.73
9834116,9925772,2255,789250,10715022,7.95
9834117,9940417,2206,772100,10712517,7.77
9834118,9934178,4172,1460200,11394378,14.70
9834119,9950341,2610,913500,10863841,9.18
9834120,9959048,2806,982100,10941148,9.86
9834121,9939780,4241,1484350,11424130,14.93
9834122,2123267,1441,504350,2627617,23.75
9834123,9452175,6294,2202900,11655075,23.31
9834124,9937244,4185,1464750,11401994,14.74
9834125,9966782,3911,1368850,11335632,13.73
9834126,5534041,2589,906150,6440191,16.37
9834127,9954233,3025,1058750,11012983,10.64
9834128,9964457,816,285600,10250057,2.87
9834129,9938779,3838,1343300,11282079,13.52
9834130,9967337,4667,1633450,11600787,16.39
9834131,9954984,5357,1874950,11829934,18.83
9834132,8134092,3012,1054200,9188292,12.96
9834133,5221549,3292,1152200,6373749,22.07
9834134,9985868,320,112000,10097868,1.12
9834135,2814745,968,338800,3153545,12.04
9834136,9972144,3360,1176000,11148144,11.79
9834137,929566,320,112000,1041566,12.05
9834138,9956689,5011,1753850,11710539,17.61
9834139,3822844,2056,719600,4542444,18.82
9834140,9906497,6656,2329600,12236097,23.52
9834142,9990720,5973,2090550,12081270,20.92
9834143,9978746,3750,1312500,11291246,13.15
9834145,2043235,1102,385700,2428935,18.88
9834146,9955040,4066,1423100,11378140,14.30
9834147,9954241,6144,2150400,12104641,21.60
9834148,2215596,531,185850,2401446,8.39
9834149,9953323,4851,1697850,11651173,17.06
9834150,956328,296,103600,1059928,10.83
9834151,9964116,5911,2068850,12032966,20.76
9834152,9987276,4476,1566600,11553876,15.69
9834153,9971860,5026,1759100,11730960,17.64
9834154,657802,253,88550,746352,13.46
9834155,9971208,2987,1045450,11016658,10.48
9834156,356927,133,46550,403477,13.04
9834158,9947182,1729,605150,10552332,6.08
9834159,9944790,3402,1190700,11135490,11.97
9834160,9947085,2050,717500,10664585,7.21
9834161,9955712,1491,521850,10477562,5.24
9834162,115387,58,20300,135687,17.59
9834163,2167002,845,295750,2462752,13.65
9834164,9949279,2989,1046150,10995429,10.51
9834165,9930565,4331,1515850,11446415,15.26
9834166,9983279,3191,1116850,11100129,11.19
9834167,746733,224,78400,825133,10.50
9834168,4359165,2166,758100,5117265,17.39
9834169,9955738,3845,1345750,11301488,13.52
9834170,9969157,6371,2229850,12199007,22.37
9834171,2565841,2920,1022000,3587841,39.83
9834172,9973044,5430,1900500,11873544,19.06
9834173,357055,117,40950,398005,11.47
9834174,9970316,6665,2332750,12303066,23.40
9834175,9939902,5492,1922200,11862102,19.34
9834176,9983783,4745,1660750,11644533,16.63
9834177,9975227,1220,427000,10402227,4.28
9834178,9964894,5535,1937250,11902144,19.44
9834179,9998092,6330,2215500,12213592,22.16
9834180,9974719,4215,1475250,11449969,14.79
9834181,9702243,2398,839300,10541543,8.65
9834182,9993216,6369,2229150,12222366,22.31
9834184,376103,114,39900,416003,10.61
9834185,9989424,4585,1604750,11594174,16.06
9834186,9981186,4651,1627850,11609036,16.31
9834187,9966910,5571,1949850,11916760,19.56
9834188,9986139,5605,1961750,11947889,19.64
9834189,5731416,1872,655200,6386616,11.43
9834190,9873120,2384,834400,10707520,8.45
9834191,9975733,2730,955500,10931233,9.58
9834192,221676,223,78050,299726,35.21
9834194,9933249,1833,641550,10574799,6.46
9834195,9927249,1327,464450,10391699,4.68
9834196,9930258,2710,948500,10878758,9.55
9834197,1786089,626,219100,2005189,12.27
9834198,9936074,4215,1475250,11411324,14.85
9834199,9951760,3556,1244600,11196360,12.51
9834200,9932274,5864,2052400,11984674,20.66
9834201,9945018,5291,1851850,11796868,18.62
9834202,9939841,3875,1356250,11296091,13.64
9834203,9939776,935,327250,10267026,3.29
9834204,1092941,556,194600,1287541,17.81
9834205,9927736,4333,1516550,11444286,15.28
9834206,9922904,2657,929950,10852854,9.37
9834207,4555804,2200,770000,5325804,16.90
9834208,4125638,2123,743050,4868688,18.01
9834209,6850518,4938,1728300,8578818,25.23
9834210,9938970,5051,1767850,11706820,17.79
9834211,9924052,2257,789950,10714002,7.96
9834212,1773842,1036,362600,2136442,20.44
9834213,1835997,1312,459200,2295197,25.01
9834214,9919530,4564,1597400,11516930,16.10
9834215,9918363,5410,1893500,11811863,19.09
9834217,9904254,5313,1859550,11763804,18.78
9834218,135562,150,52500,188062,38.73
9834219,3017755,1023,358050,3375805,11.86
9834220,9900948,4923,1723050,11623998,17.40
9834221,9933791,4658,1630300,11564091,16.41
9834222,1870630,975,341250,2211880,18.24
9834223,9903562,6064,2122400,12025962,21.43
9834224,9929571,5616,1965600,11895171,19.80
9834225,9910717,2237,782950,10693667,7.90
9834226,9912795,3181,1113350,11026145,11.23
9834227,9931228,886,310100,10241328,3.12
9834228,9940247,4400,1540000,11480247,15.49
9834229,9936985,3894,1362900,11299885,13.72
9834230,2362006,2099,734650,3096656,31.10
9834231,9957051,4408,1542800,11499851,15.49
9834232,9962966,5918,2071300,12034266,20.79
9834233,9971578,5045,1765750,11737328,17.71
9834234,787322,909,318150,1105472,40.41
9834235,9976774,4645,1625750,11602524,16.30
9834236,9991184,5473,1915550,11906734,19.17
9834237,9992012,5026,1759100,11751112,17.61
9834238,9998595,3020,1057000,11055595,10.57
9834239,9980579,4855,1699250,11679829,17.03
9834240,9976285,3809,1333150,11309435,13.36
9834241,9984955,5155,1804250,11789205,18.07
9834242,9974645,1775,621250,10595895,6.23
9834243,9992781,5132,1796200,11788981,17.97
9834244,9999674,1576,551600,10551274,5.52
9834245,9991162,1405,491750,10482912,4.92
9834246,9998058,4743,1660050,11658108,16.60
9834247,1977009,2049,717150,2694159,36.27
9834248,9999190,4133,1446550,11445740,14.47
9834249,9984850,1040,364000,10348850,3.65
9834250,9986344,3351,1172850,11159194,11.74
9834251,9999160,3784,1324400,11323560,13.25
9834254,9958848,1519,531650,10490498,5.34
9834255,9961668,5746,2011100,11972768,20.19
9834256,9968763,4634,1621900,11590663,16.27
9834257,845046,282,98700,943746,11.68
9834258,9978664,6205,2171750,12150414,21.76
9834259,9973410,5198,1819300,11792710,18.24
9834260,359600,372,130200,489800,36.21
9834261,406851,229,80150,487001,19.70
9834262,9959761,6950,2432500,12392261,24.42
9834263,9955994,5354,1873900,11829894,18.82
9834264,9971740,5442,1904700,11876440,19.10
9834265,9971326,5223,1828050,11799376,18.33
9834266,9969846,4195,1468250,11438096,14.73
9834267,9994516,1023,358050,10352566,3.58
9834268,1019810,333,116550,1136360,11.43
9834269,9960614,5085,1779750,11740364,17.87
9834270,9977008,4504,1576400,11553408,15.80
9834271,9986828,2689,941150,10927978,9.42
9834272,9809777,4897,1713950,11523727,17.47
9834273,9964259,982,343700,10307959,3.45
9834274,9986770,1167,408450,10395220,4.09
9834275,9972333,1710,598500,10570833,6.00
9834276,9983482,2692,942200,10925682,9.44
9834277,9976401,7153,2503550,12479951,25.09
9834278,9991029,1475,516250,10507279,5.17
9834279,9985943,2895,1013250,10999193,10.15
9834280,9994003,575,201250,10195253,2.01
9834281,9992863,4489,1571150,11564013,15.72
9834282,9988378,6676,2336600,12324978,23.39
9834283,9993458,4150,1452500,11445958,14.53
9834284,9986183,6206,2172100,12158283,21.75
9834285,26209,42,14700,40909,56.09
9834286,9914810,4020,1407000,11321810,14.19
9834287,9983465,4353,1523550,11507015,15.26
9834289,5924281,2902,1015700,6939981,17.14
9834290,9956468,4874,1705900,11662368,17.13
9834291,9979373,607,212450,10191823,2.13
9834292,646512,332,116200,762712,17.97
9834293,9966317,4557,1594950,11561267,16.00
9834294,9959700,7430,2600500,12560200,26.11
9834295,9986996,5372,1880200,11867196,18.83
9834296,1600102,1349,472150,2072252,29.51
9834297,9947985,5506,1927100,11875085,19.37
9834298,9967457,1608,562800,10530257,5.65
9834299,9949981,2798,979300,10929281,9.84
9834300,831066,320,112000,943066,13.48
9834301,9990746,3373,1180550,11171296,11.82
9834302,9987588,3965,1387750,11375338,13.89
9834303,9985558,1324,463400,10448958,4.64
9834305,9988125,4528,1584800,11572925,15.87
9834306,9941460,2049,717150,10658610,7.21
9834307,120709,12,4200,124909,3.48
9834308,9955566,486,170100,10125666,1.71
9834309,654279,237,82950,737229,12.68
9834310,486852,224,78400,565252,16.10
9834311,9937421,4270,1494500,11431921,15.04
9834312,9947571,1413,494550,10442121,4.97
9834313,9952846,1654,578900,10531746,5.82
9834314,9973058,3994,1397900,11370958,14.02
9834315,9980521,3904,1366400,11346921,13.69
9834316,53927,48,16800,70727,31.15
9834318,2065705,1814,634900,2700605,30.74
9834319,9984698,2611,913850,10898548,9.15
9834321,9970085,1779,622650,10592735,6.25
9834322,9975028,3177,1111950,11086978,11.15
9834324,1633165,1076,376600,2009765,23.06
9834325,2754439,1850,647500,3401939,23.51
9834326,9977801,3412,1194200,11172001,11.97
9834327,9986839,4350,1522500,11509339,15.25
9834328,9970383,2230,780500,10750883,7.83
9834329,9957633,4239,1483650,11441283,14.90
9834330,9970958,5678,1987300,11958258,19.93
9834331,9983441,1698,594300,10577741,5.95
9834332,9990684,6396,2238600,12229284,22.41
9834333,2604096,1265,442750,3046846,17.00
9834334,9973740,5806,2032100,12005840,20.37
9834335,9982165,3239,1133650,11115815,11.36
9834336,9972824,5596,1958600,11931424,19.64
9834337,3225029,1317,460950,3685979,14.29
9834338,9981393,4390,1536500,11517893,15.39
9834339,9975089,1281,448350,10423439,4.49
9834340,9971084,1606,562100,10533184,5.64
9834341,9986065,2105,736750,10722815,7.38
9834343,9996017,613,214550,10210567,2.15
9834344,9981012,3928,1374800,11355812,13.77
9834345,9993402,4889,1711150,11704552,17.12
9834346,9985840,4665,1632750,11618590,16.35
9834347,9998896,1937,677950,10676846,6.78
9834348,9995069,1257,439950,10435019,4.40
9834349,9978638,5776,2021600,12000238,20.26
9834350,9965216,4013,1404550,11369766,14.09
9834351,9971767,3163,1107050,11078817,11.10
9834352,9928172,6763,2367050,12295222,23.84
9834354,9962565,3157,1104950,11067515,11.09
9834355,9990207,2803,981050,10971257,9.82
9834356,976080,449,157150,1133230,16.10
9834357,9919204,1148,401800,10321004,4.05
9834358,9975343,6570,2299500,12274843,23.05
9834359,889736,364,127400,1017136,14.32
9834360,365031,57,19950,384981,5.47
9834361,9957900,3769,1319150,11277050,13.25
9834362,9938318,3880,1358000,11296318,13.66
9834363,9961261,5908,2067800,12029061,20.76
9834364,9966184,3473,1215550,11181734,12.20
9834365,9966877,706,247100,10213977,2.48
9834366,9979877,1342,469700,10449577,4.71
9834367,2480031,1988,695800,3175831,28.06
9834368,9984169,3647,1276450,11260619,12.78
9834369,9983330,4070,1424500,11407830,14.27
9834370,9970724,1373,480550,10451274,4.82
9834371,1699809,1205,421750,2121559,24.81
9834372,4744107,2213,774550,5518657,16.33
9834373,9982504,7820,2737000,12719504,27.42
9834375,9297820,4919,1721650,11019470,18.52
9834376,9977264,5598,1959300,11936564,19.64
9834377,9969285,6033,2111550,12080835,21.18
9834378,9978925,4688,1640800,11619725,16.44
9834379,9961587,5488,1920800,11882387,19.28
9834380,9981854,1630,570500,10552354,5.72
9834381,9983308,3777,1321950,11305258,13.24
9834382,9982671,3063,1072050,11054721,10.74
9834383,9989696,2211,773850,10763546,7.75
9834384,9991982,3972,1390200,11382182,13.91
9834385,9985844,6952,2433200,12419044,24.37
9834386,9977043,4242,1484700,11461743,14.88
9834387,9980475,6803,2381050,12361525,23.86
9834388,9982556,4620,1617000,11599556,16.20
9834389,9993297,2215,775250,10768547,7.76
9834390,9988437,2474,865900,10854337,8.67
9834391,7365051,4324,1513400,8878451,20.55
9834392,9969397,6122,2142700,12112097,21.49
9834393,9958994,5108,1787800,11746794,17.95
9834394,2994902,1993,697550,3692452,23.29
9834395,9967518,1909,668150,10635668,6.70
9834396,4630397,2342,819700,5450097,17.70
9834397,9973756,3466,1213100,11186856,12.16
9834398,763312,875,306250,1069562,40.12
9834399,9950825,3058,1070300,11021125,10.76
9834400,9944100,2466,863100,10807200,8.68
9834401,7298720,3641,1274350,8573070,17.46
9834402,9918796,4156,1454600,11373396,14.67
9834403,9942536,5070,1774500,11717036,17.85
9834404,9917950,3283,1149050,11067000,11.59
9834405,9934300,4149,1452150,11386450,14.62
9834406,9932279,3579,1252650,11184929,12.61
9834407,9928276,1728,604800,10533076,6.09
9834408,9933822,1511,528850,10462672,5.32
9834409,275439,315,110250,385689,40.03
9834410,9881788,4084,1429400,11311188,14.46
9834411,9958894,3273,1145550,11104444,11.50
9834413,9973819,5549,1942150,11915969,19.47
9834414,9987377,2857,999950,10987327,10.01
9834415,1183875,733,256550,1440425,21.67
9834416,9976698,1368,478800,10455498,4.80
9834417,9960018,3729,1305150,11265168,13.10
9834418,9980014,1420,497000,10477014,4.98
9834419,9979412,1948,681800,10661212,6.83
9834420,9987913,1830,640500,10628413,6.41
9834421,9997340,3337,1167950,11165290,11.68
9834422,715412,274,95900,811312,13.40
9834423,9980221,6346,2221100,12201321,22.26
9834424,9786590,5278,1847300,11633890,18.88
9834425,9983795,4245,1485750,11469545,14.88
9834426,9975642,5784,2024400,12000042,20.29
9834427,9994099,806,282100,10276199,2.82
9834428,9978088,5644,1975400,11953488,19.80
9834429,1729662,300,105000,1834662,6.07
9834430,9925218,2167,758450,10683668,7.64
9834431,9974763,1399,489650,10464413,4.91
9834432,4308585,3458,1210300,5518885,28.09
9834433,9977064,4653,1628550,11605614,16.32
9834434,9960771,3852,1348200,11308971,13.54
9834435,9955846,644,225400,10181246,2.26
9834436,9973836,3084,1079400,11053236,10.82
9834437,4036911,2059,720650,4757561,17.85
9834438,9976458,1470,514500,10490958,5.16
9834439,9976618,6224,2178400,12155018,21.84
9834440,9981202,4874,1705900,11687102,17.09
9834441,2849457,1402,490700,3340157,17.22
9834442,9979333,2689,941150,10920483,9.43
9834443,9953911,5486,1920100,11874011,19.29
9834444,9968178,4871,1704850,11673028,17.10
9834445,9967194,6053,2118550,12085744,21.26
9834446,9978719,4898,1714300,11693019,17.18
9834447,9986611,5568,1948800,11935411,19.51
9834448,9979217,6093,2132550,12111767,21.37
9834449,5120561,1088,380800,5501361,7.44
9834450,9965269,4306,1507100,11472369,15.12
9834451,9986215,1432,501200,10487415,5.02
9834452,9977181,6189,2166150,12143331,21.71
9834453,9993374,4694,1642900,11636274,16.44
9834454,739463,524,183400,922863,24.80
9834455,9965472,5023,1758050,11723522,17.64
9834456,202422,240,84000,286422,41.50
9834457,9973084,1973,690550,10663634,6.92
9834458,9983405,2973,1040550,11023955,10.42
9834459,938682,637,222950,1161632,23.75
9834460,9983990,4953,1733550,11717540,17.36
9834461,9994202,2905,1016750,11010952,10.17
9834462,9924509,4299,1504650,11429159,15.16
9834463,9978531,1096,383600,10362131,3.84
9834464,9699789,994,347900,10047689,3.59
9834465,9987571,5290,1851500,11839071,18.54
9834466,9851238,3781,1323350,11174588,13.43
9834467,9992263,2979,1042650,11034913,10.43
9834468,9595749,6793,2377550,11973299,24.78
9834469,9991407,5349,1872150,11863557,18.74
9834470,9992854,3221,1127350,11120204,11.28
9834471,9999654,4504,1576400,11576054,15.76
9834472,9983625,5328,1864800,11848425,18.68
9834473,9991256,3780,1323000,11314256,13.24
9834474,9991167,5989,2096150,12087317,20.98
9834475,9971585,4463,1562050,11533635,15.67
9834476,9958489,3919,1371650,11330139,13.77
9834477,8984872,5206,1822100,10806972,20.28
9834478,9978571,4405,1541750,11520321,15.45
9834479,9979194,5000,1750000,11729194,17.54
9834480,9986021,4861,1701350,11687371,17.04
9834481,9978415,727,254450,10232865,2.55
9834482,9975271,1099,384650,10359921,3.86
9834483,9979420,7311,2558850,12538270,25.64
9834484,9982418,872,305200,10287618,3.06
9834485,9979069,6409,2243150,12222219,22.48
9834486,9968190,4739,1658650,11626840,16.64
9834487,9980841,4431,1550850,11531691,15.54
9834488,9983315,5269,1844150,11827465,18.47
9834489,9988136,5436,1902600,11890736,19.05
9834490,9992098,4434,1551900,11543998,15.53
9834491,9982402,3852,1348200,11330602,13.51
9834492,9992254,4132,1446200,11438454,14.47
9834493,9919898,4764,1667400,11587298,16.81
9834494,2617327,1377,481950,3099277,18.41
9834495,9975006,4624,1618400,11593406,16.22
9834496,9978225,5092,1782200,11760425,17.86
9834497,9996421,4930,1725500,11721921,17.26
9834498,9986781,6043,2115050,12101831,21.18
9834499,9994529,5849,2047150,12041679,20.48
9834500,9993928,3824,1338400,11332328,13.39
9834501,9981402,1511,528850,10510252,5.30
9834502,9985471,2009,703150,10688621,7.04
9834503,9968360,5170,1809500,11777860,18.15
9834504,9979431,4481,1568350,11547781,15.72
9834505,7261577,3246,1136100,8397677,15.65
9834506,9978858,5680,1988000,11966858,19.92
9834507,9989248,5490,1921500,11910748,19.24
9834508,9986867,3907,1367450,11354317,13.69
9834509,9984009,703,246050,10230059,2.46
9834510,9912813,943,330050,10242863,3.33
9834511,9986247,434,151900,10138147,1.52
9834512,9978540,3673,1285550,11264090,12.88
9834513,9976911,5871,2054850,12031761,20.60
9834514,9919311,5181,1813350,11732661,18.28
9834515,536814,522,182700,719514,34.03
9834516,9978661,2846,996100,10974761,9.98
9834517,9962118,4502,1575700,11537818,15.82
9834518,9973648,4812,1684200,11657848,16.89
9834519,9906551,1777,621950,10528501,6.28
9834520,9958892,2995,1048250,11007142,10.53
9834521,9963486,3613,1264550,11228036,12.69
9834522,9939670,5363,1877050,11816720,18.88
9834523,9976821,6380,2233000,12209821,22.38
9834524,9989564,4272,1495200,11484764,14.97
9834525,1008457,87,30450,1038907,3.02
9834526,9970989,4163,1457050,11428039,14.61
9834527,204160,60,21000,225160,10.29
9834529,9973695,6853,2398550,12372245,24.05
9834530,9983377,4368,1528800,11512177,15.31
9834531,9973855,3315,1160250,11134105,11.63
9834532,9983283,4434,1551900,11535183,15.54
9834533,131445,90,31500,162945,23.96
9834535,9955017,3411,1193850,11148867,11.99
9834536,9970349,4124,1443400,11413749,14.48
9834537,9715701,4592,1607200,11322901,16.54
9834538,9949759,5654,1978900,11928659,19.89
9834539,8160301,2968,1038800,9199101,12.73
9834540,9943986,5349,1872150,11816136,18.83
9834541,1035812,312,109200,1145012,10.54
9834542,9957586,3787,1325450,11283036,13.31
9834543,9958205,5747,2011450,11969655,20.20
9834544,9970652,4735,1657250,11627902,16.62
9834545,3636692,3024,1058400,4695092,29.10
9834546,5609514,3245,1135750,6745264,20.25
9834547,9986362,4284,1499400,11485762,15.01
9834548,9992345,5042,1764700,11757045,17.66
9834549,4509365,2468,863800,5373165,19.16
9834550,9968228,3377,1181950,11150178,11.86
9834551,9982360,2963,1037050,11019410,10.39
9834552,9992596,3146,1101100,11093696,11.02
9834553,9984767,3072,1075200,11059967,10.77
9834554,9974944,5365,1877750,11852694,18.82
9834555,9957212,4781,1673350,11630562,16.81
9834556,9812416,6655,2329250,12141666,23.74
9834557,255839,133,46550,302389,18.20
9834558,8495012,4335,1517250,10012262,17.86
9834559,9942426,6223,2178050,12120476,21.91
9834560,9955854,962,336700,10292554,3.38
9834561,9954947,3968,1388800,11343747,13.95
9834562,9964795,4949,1732150,11696945,17.38
9834563,9967495,5206,1822100,11789595,18.28
9834564,9974919,4401,1540350,11515269,15.44
9834565,9977508,4333,1516550,11494058,15.20
9834566,9972417,3029,1060150,11032567,10.63
9834567,9965764,4537,1587950,11553714,15.93
9834568,1769578,1061,371350,2140928,20.99
9834569,9814745,4709,1648150,11462895,16.79
9834570,9960511,5373,1880550,11841061,18.88
9834571,8971402,5146,1801100,10772502,20.08
9834572,6111438,4804,1681400,7792838,27.51
9834573,9944764,4655,1629250,11574014,16.38
9834574,7624875,4171,1459850,9084725,19.15
9834575,4912038,3490,1221500,6133538,24.87
9834577,9977596,4161,1456350,11433946,14.60
9834578,9970869,4455,1559250,11530119,15.64
9834579,9985717,4723,1653050,11638767,16.55
9834580,9798428,2918,1021300,10819728,10.42
9834581,9982478,4042,1414700,11397178,14.17
9834582,9915840,4307,1507450,11423290,15.20
9834584,8996159,3420,1197000,10193159,13.31
9834585,9737246,4406,1542100,11279346,15.84
9834586,9972909,5527,1934450,11907359,19.40
9834587,9969957,3741,1309350,11279307,13.13
9834589,9954763,2481,868350,10823113,8.72
9834590,9939291,5910,2068500,12007791,20.81
9834591,9965015,4606,1612100,11577115,16.18
9834592,9955567,6182,2163700,12119267,21.73
9834593,1938133,920,322000,2260133,16.61
9834594,9971739,7077,2476950,12448689,24.84
9834595,9957085,4871,1704850,11661935,17.12
9834597,9947744,1917,670950,10618694,6.74
9834598,5272642,1898,664300,5936942,12.60
9834599,9939562,4167,1458450,11398012,14.67
9834601,9959759,2188,765800,10725559,7.69
9834602,9929655,5913,2069550,11999205,20.84
9834603,8972012,3271,1144850,10116862,12.76
9834604,9973361,3763,1317050,11290411,13.21
9834605,9966721,4568,1598800,11565521,16.04
9834606,9981668,4160,1456000,11437668,14.59
9834607,9975661,1121,392350,10368011,3.93
9834608,9983551,4980,1743000,11726551,17.46
9834609,9969517,5425,1898750,11868267,19.05
9834610,9978649,5732,2006200,11984849,20.10
9834611,8893048,4131,1445850,10338898,16.26
9834612,9930581,4530,1585500,11516081,15.97
9834613,9960150,5982,2093700,12053850,21.02
9834614,2995992,1877,656950,3652942,21.93
9834615,9957045,3972,1390200,11347245,13.96
9834616,9968624,3698,1294300,11262924,12.98
9834617,9949261,3694,1292900,11242161,12.99
9834618,9952769,4740,1659000,11611769,16.67
9834619,9964133,5525,1933750,11897883,19.41
9834620,9979158,5273,1845550,11824708,18.49
9834621,293457,123,43050,336507,14.67
9834622,9981288,3447,1206450,11187738,12.09
9834623,9959166,7324,2563400,12522566,25.74
9834624,9194181,3696,1293600,10487781,14.07
9834626,9994341,5875,2056250,12050591,20.57
9834627,9987108,4493,1572550,11559658,15.75
9834628,4575172,2555,894250,5469422,19.55
9834629,239414,153,53550,292964,22.37
9834630,9952550,4567,1598450,11551000,16.06
9834631,7470143,5427,1899450,9369593,25.43
9834632,4127403,2814,984900,5112303,23.86
9834633,9945057,5937,2077950,12023007,20.89
9834634,9950567,4752,1663200,11613767,16.71
9834635,9969572,4049,1417150,11386722,14.21
9834636,9976218,4291,1501850,11478068,15.05
9834637,9966582,5643,1975050,11941632,19.82
9834638,9960270,4026,1409100,11369370,14.15
9834639,5827461,3982,1393700,7221161,23.92
9834640,9978427,4171,1459850,11438277,14.63
9834641,9959267,3337,1167950,11127217,11.73
9834642,9976523,5292,1852200,11828723,18.57
9834643,920697,520,182000,1102697,19.77
9834644,9967960,4578,1602300,11570260,16.07
9834645,9980832,5647,1976450,11957282,19.80
9834647,9969910,3728,1304800,11274710,13.09
9834648,3011833,2178,762300,3774133,25.31
9834649,9956230,4928,1724800,11681030,17.32
9834650,9967669,1150,402500,10370169,4.04
9834651,9961531,5939,2078650,12040181,20.87
9834652,9949791,2472,865200,10814991,8.70
9834654,9985512,2485,869750,10855262,8.71
9834655,9444044,2410,843500,10287544,8.93
9834656,9970381,2390,836500,10806881,8.39
9834657,9969738,3442,1204700,11174438,12.08
9834658,9977962,5244,1835400,11813362,18.39
9834659,7965680,3319,1161650,9127330,14.58
9834660,9950492,5182,1813700,11764192,18.23
9834661,9966205,3740,1309000,11275205,13.13
9834663,9953956,4276,1496600,11450556,15.04
9834664,8964291,3459,1210650,10174941,13.51
9834665,9941587,4743,1660050,11601637,16.70
9834666,9954597,4253,1488550,11443147,14.95
9834667,9949105,4686,1640100,11589205,16.48
9834668,9954666,2976,1041600,10996266,10.46
9834669,9948653,5261,1841350,11790003,18.51
9834670,9953398,3932,1376200,11329598,13.83
9834671,9954570,3929,1375150,11329720,13.81
9834672,9950604,5703,1996050,11946654,20.06
9834673,9975192,6127,2144450,12119642,21.50
9834674,9982750,8346,2921100,12903850,29.26
9834675,9969442,4927,1724450,11693892,17.30
9834676,9945048,7131,2495850,12440898,25.10
9834677,9967335,4629,1620150,11587485,16.25
9834678,9689967,3127,1094450,10784417,11.29
9834679,9938697,5809,2033150,11971847,20.46
9834680,9957283,7607,2662450,12619733,26.74
9834681,9961581,3287,1150450,11112031,11.55
9834682,9965816,4602,1610700,11576516,16.16
9834683,9963170,4219,1476650,11439820,14.82
9834684,9975205,5373,1880550,11855755,18.85
9834685,5704014,3336,1167600,6871614,20.47
9834686,9950187,5141,1799350,11749537,18.08
9834687,9875021,4580,1603000,11478021,16.23
9834689,9967931,1515,530250,10498181,5.32
9834690,9761019,5860,2051000,11812019,21.01
9834691,9923622,1788,625800,10549422,6.31
9834692,9950010,4295,1503250,11453260,15.11
9834693,9949676,1616,565600,10515276,5.68
9834694,9941849,5671,1984850,11926699,19.96
9834695,9941478,5247,1836450,11777928,18.47
9834696,9855662,4245,1485750,11341412,15.08
9834697,4769154,3568,1248800,6017954,26.18
9834698,9918460,3766,1318100,11236560,13.29
9834699,9928700,2706,947100,10875800,9.54
9834700,9952336,4026,1409100,11361436,14.16
9834701,9944546,6366,2228100,12172646,22.41
9834702,9849906,5439,1903650,11753556,19.33
9834703,9945055,6389,2236150,12181205,22.49
9834704,9958960,3948,1381800,11340760,13.87
9834705,9945906,1515,530250,10476156,5.33
9834706,9962458,5116,1790600,11753058,17.97
9834707,9957990,4838,1693300,11651290,17.00
9834708,9937902,4201,1470350,11408252,14.80
9834709,9942192,5326,1864100,11806292,18.75
9834710,9933577,4646,1626100,11559677,16.37
9834711,9972312,4857,1699950,11672262,17.05
9834712,9967018,3079,1077650,11044668,10.81
9834713,9967911,1086,380100,10348011,3.81
9834714,9990826,3034,1061900,11052726,10.63
9834715,9994346,4991,1746850,11741196,17.48
9834716,9967556,3249,1137150,11104706,11.41
9834717,9977545,5033,1761550,11739095,17.66
9834718,3843729,2366,828100,4671829,21.54
9834719,9964177,7156,2504600,12468777,25.14
9834720,6321385,3517,1230950,7552335,19.47
9834721,9989974,5267,1843450,11833424,18.45
9834722,9977573,2329,815150,10792723,8.17
9834723,1025095,723,253050,1278145,24.69
9834724,9965746,6177,2161950,12127696,21.69
9834725,9949864,4518,1581300,11531164,15.89
9834726,9949931,5532,1936200,11886131,19.46
9834727,9957837,4373,1530550,11488387,15.37
9834728,9969841,5273,1845550,11815391,18.51
9834729,9967249,6498,2274300,12241549,22.82
9834730,9982102,5162,1806700,11788802,18.10
9834731,5390709,2222,777700,6168409,14.43
9834732,9975881,5847,2046450,12022331,20.51
9834733,9978625,4565,1597750,11576375,16.01
9834734,9981526,3758,1315300,11296826,13.18
9834735,9990371,4161,1456350,11446721,14.58
9834736,305905,229,80150,386055,26.20
9834737,9966175,2503,876050,10842225,8.79
9834738,9947835,3624,1268400,11216235,12.75
9834739,9972679,3903,1366050,11338729,13.70
9834740,9963687,1142,399700,10363387,4.01
9834741,9979614,2908,1017800,10997414,10.20
9834742,9953103,4528,1584800,11537903,15.92
9834743,9967237,5487,1920450,11887687,19.27
9834744,9940662,4588,1605800,11546462,16.15
9834745,9962526,5526,1934100,11896626,19.41
9834746,9982662,4472,1565200,11547862,15.68
9834747,9977783,3773,1320550,11298333,13.23
9834748,9951915,4206,1472100,11424015,14.79
9834749,9988770,1606,562100,10550870,5.63
9834750,9986917,4367,1528450,11515367,15.30
9834751,9978663,2240,784000,10762663,7.86
9834752,9980162,1651,577850,10558012,5.79
9834753,9985370,5194,1817900,11803270,18.21
9834754,1509858,893,312550,1822408,20.70
9834755,9985412,4113,1439550,11424962,14.42
9834756,9988222,4515,1580250,11568472,15.82
9834757,9997743,4709,1648150,11645893,16.49
9834758,9980247,4576,1601600,11581847,16.05
9834759,3208445,1616,565600,3774045,17.63
9834760,9984240,3246,1136100,11120340,11.38
9834761,2960677,2865,1002750,3963427,33.87
9834762,9989069,4165,1457750,11446819,14.59
9834763,9990254,5463,1912050,11902304,19.14
9834764,9981430,5242,1834700,11816130,18.38
9834765,9909023,4155,1454250,11363273,14.68
9834766,9983647,308,107800,10091447,1.08
9834767,9994001,1064,372400,10366401,3.73
9834768,9995343,884,309400,10304743,3.10
9834769,9998822,2630,920500,10919322,9.21
9834770,9996074,1381,483350,10479424,4.84
9834771,9972436,333,116550,10088986,1.17
9834772,9975697,2664,932400,10908097,9.35
9834773,9983351,4866,1703100,11686451,17.06
9834774,9987395,5326,1864100,11851495,18.66
9834775,9986218,3214,1124900,11111118,11.26
9834776,9973669,5686,1990100,11963769,19.95
9834777,9981063,2082,728700,10709763,7.30
9834778,9984995,5661,1981350,11966345,19.84
9834779,9721563,3346,1171100,10892663,12.05
9834780,9973941,3721,1302350,11276291,13.06
9834781,9978852,4670,1634500,11613352,16.38
9834782,9969913,5761,2016350,11986263,20.22
9834783,9959324,2378,832300,10791624,8.36
9834784,9975536,1587,555450,10530986,5.57
9834785,2133132,1206,422100,2555232,19.79
9834786,9960605,3054,1068900,11029505,10.73
9834787,5075268,753,263550,5338818,5.19
9834788,9960150,3753,1313550,11273700,13.19
9834789,9966981,4179,1462650,11429631,14.67
9834790,3087522,720,252000,3339522,8.16
9834791,2159891,904,316400,2476291,14.65
9834792,9938088,3818,1336300,11274388,13.45
9834793,9953735,4266,1493100,11446835,15.00
9834794,9948040,4142,1449700,11397740,14.57
9834795,9934167,4819,1686650,11620817,16.98
9834796,9941504,3362,1176700,11118204,11.84
9834797,8953777,3155,1104250,10058027,12.33
9834798,9966315,2788,975800,10942115,9.79
9834799,9975868,4004,1401400,11377268,14.05
9834800,9968134,4828,1689800,11657934,16.95
9834801,9956135,5627,1969450,11925585,19.78
9834802,9952126,2911,1018850,10970976,10.24
9834803,9987936,5579,1952650,11940586,19.55
9834804,9774818,4010,1403500,11178318,14.36
9834805,9962775,5260,1841000,11803775,18.48
9834807,4583975,1652,578200,5162175,12.61
9834808,9972370,3704,1296400,11268770,13.00
9834809,5094643,3178,1112300,6206943,21.83
9834810,9951122,3831,1340850,11291972,13.47
9834811,7933721,2632,921200,8854921,11.61
9834812,9962879,3811,1333850,11296729,13.39
9834813,9625583,3925,1373750,10999333,14.27
9834814,7645356,2783,974050,8619406,12.74
9834815,8528295,3779,1322650,9850945,15.51
9834816,9823567,5137,1797950,11621517,18.30
9834818,9951558,4973,1740550,11692108,17.49
9834820,1440644,1339,468650,1909294,32.53
9834821,9976325,4198,1469300,11445625,14.73
9834822,9399480,3982,1393700,10793180,14.83
9834823,9978836,4832,1691200,11670036,16.95
9834824,9983093,2574,900900,10883993,9.02
9834825,7294169,3308,1157800,8451969,15.87
9834826,668972,344,120400,789372,18.00
9834827,9986227,5221,1827350,11813577,18.30
9834828,9992062,5432,1901200,11893262,19.03
9834829,9982714,5227,1829450,11812164,18.33
9834830,9984363,4182,1463700,11448063,14.66
9834831,9978548,4544,1590400,11568948,15.94
9834832,1163817,1664,582400,1746217,50.04
9834833,9954707,4275,1496250,11450957,15.03
9834834,9965802,3480,1218000,11183802,12.22
9834835,8983327,3497,1223950,10207277,13.62
9834836,9994429,4065,1422750,11417179,14.24
9834837,9983832,5049,1767150,11750982,17.70
9834838,9994082,5351,1872850,11866932,18.74
9834839,9890471,3065,1072750,10963221,10.85
9834840,9991666,4782,1673700,11665366,16.75
9834841,9998636,5292,1852200,11850836,18.52
9834842,970846,634,221900,1192746,22.86
9834843,9966520,2976,1041600,11008120,10.45
9834844,9985260,3757,1314950,11300210,13.17
9834845,9971665,6196,2168600,12140265,21.75
9834846,9983656,5343,1870050,11853706,18.73
9834847,5080767,3843,1345050,6425817,26.47
9834848,9987030,4601,1610350,11597380,16.12
9834849,9967834,5413,1894550,11862384,19.01
9834850,9977186,4714,1649900,11627086,16.54
9834851,9983668,4712,1649200,11632868,16.52
9834852,9981076,2933,1026550,11007626,10.28
9834853,5304527,3728,1304800,6609327,24.60
9834856,9968367,5289,1851150,11819517,18.57
9834857,9961214,5747,2011450,11972664,20.19
9834858,9964701,4310,1508500,11473201,15.14
9834860,9955444,4577,1601950,11557394,16.09
9834861,9973562,3121,1092350,11065912,10.95
9834862,5358666,2926,1024100,6382766,19.11
9834863,9977734,3528,1234800,11212534,12.38
9834864,1147013,662,231700,1378713,20.20
9834865,9969942,3724,1303400,11273342,13.07
9834866,9977033,5680,1988000,11965033,19.93
9834867,3060878,790,276500,3337378,9.03
9834868,9977533,3212,1124200,11101733,11.27
9834869,9981436,2256,789600,10771036,7.91
9834870,116254,147,51450,167704,44.26
9834871,9975769,4629,1620150,11595919,16.24
9834872,9971967,2589,906150,10878117,9.09
9834873,3600420,2075,726250,4326670,20.17
9834874,9992659,5179,1812650,11805309,18.14
9834875,9982273,2399,839650,10821923,8.41
9834876,9992357,3927,1374450,11366807,13.76
9834878,9367044,2234,781900,10148944,8.35
9834879,9962184,2604,911400,10873584,9.15
9834880,9982330,4222,1477700,11460030,14.80
9834881,9986056,4083,1429050,11415106,14.31
9834882,441005,390,136500,577505,30.95
9834883,9969842,2284,799400,10769242,8.02
9834884,9971565,3987,1395450,11367015,13.99
9834885,5060799,4479,1567650,6628449,30.98
9834886,3896040,1581,553350,4449390,14.20
9834887,542228,340,119000,661228,21.95
9834888,6175772,3023,1058050,7233822,17.13
9834889,9974654,4445,1555750,11530404,15.60
9834890,9975563,3140,1099000,11074563,11.02
9834891,9969676,4870,1704500,11674176,17.10
9834892,9963033,5074,1775900,11738933,17.82
9834893,6279606,2182,763700,7043306,12.16
9834894,9974095,3717,1300950,11275045,13.04
9834895,1001731,653,228550,1230281,22.82
9834896,9947026,4571,1599850,11546876,16.08
9834897,9968951,3890,1361500,11330451,13.66
9834898,2341255,915,320250,2661505,13.68
9834899,9938961,3121,1092350,11031311,10.99
9834900,9949960,3960,1386000,11335960,13.93
9834901,6625368,3087,1080450,7705818,16.31
9834902,6218521,3713,1299550,7518071,20.90
9834903,9949874,4886,1710100,11659974,17.19
9834904,9955107,4942,1729700,11684807,17.38
9834905,9948688,3284,1149400,11098088,11.55
9834906,9957980,2637,922950,10880930,9.27
9834907,9977846,6955,2434250,12412096,24.40
9834908,9978539,1028,359800,10338339,3.61
9834909,9974734,143,50050,10024784,0.50
9834910,9978276,3433,1201550,11179826,12.04
9834911,5109296,1936,677600,5786896,13.26
9834912,9984510,3747,1311450,11295960,13.13
9834913,8978236,2809,983150,9961386,10.95
9834914,9985751,1381,483350,10469101,4.84
9834915,9980232,964,337400,10317632,3.38
9834916,9974660,1908,667800,10642460,6.69
9834917,9994527,1550,542500,10537027,5.43
9834918,9995610,3680,1288000,11283610,12.89
9834919,9987823,5208,1822800,11810623,18.25
9834920,9994414,4013,1404550,11398964,14.05
9834921,432547,134,46900,479447,10.84
9834922,9963133,1491,521850,10484983,5.24
9834923,9971182,900,315000,10286182,3.16
9834924,9988322,3195,1118250,11106572,11.20
9834925,9997121,1058,370300,10367421,3.70
9834926,9997950,3263,1142050,11140000,11.42
9834927,9979261,3441,1204350,11183611,12.07
9834928,9974974,743,260050,10235024,2.61
9834929,9988077,1202,420700,10408777,4.21
9834930,9997979,1754,613900,10611879,6.14
9834931,9970479,639,223650,10194129,2.24
9834932,9980069,900,315000,10295069,3.16
9834933,9968210,1957,684950,10653160,6.87
9834935,9991435,2300,805000,10796435,8.06
9834936,9980669,3115,1090250,11070919,10.92
9834937,9970816,2809,983150,10953966,9.86
9834938,9980167,3526,1234100,11214267,12.37
9834939,9969660,2884,1009400,10979060,10.12
9834940,9968422,2787,975450,10943872,9.79
9834941,9966230,3571,1249850,11216080,12.54
9834942,9969375,5383,1884050,11853425,18.90
9834943,9353817,3789,1326150,10679967,14.18
9834944,9991346,5920,2072000,12063346,20.74
9834945,9984555,5753,2013550,11998105,20.17
9834946,9963861,4860,1701000,11664861,17.07
9834947,9988392,5306,1857100,11845492,18.59
9834948,1283411,1262,441700,1725111,34.42
9834949,9965008,4111,1438850,11403858,14.44
9834950,9975347,4458,1560300,11535647,15.64
9834951,5103060,3543,1240050,6343110,24.30
9834952,9970291,7199,2519650,12489941,25.27
9834953,9969324,2516,880600,10849924,8.83
9834954,9999463,5235,1832250,11831713,18.32
9834955,9995974,3669,1284150,11280124,12.85
9834956,9989410,991,346850,10336260,3.47
9834957,9980278,3478,1217300,11197578,12.20
9834958,9990270,2936,1027600,11017870,10.29
9834959,9986498,3460,1211000,11197498,12.13
9834960,9987336,2053,718550,10705886,7.19
9834961,9980378,6663,2332050,12312428,23.37
9834962,9985515,5836,2042600,12028115,20.46
9834963,9983877,2299,804650,10788527,8.06
9834964,9988380,4938,1728300,11716680,17.30
9834965,9997230,6631,2320850,12318080,23.21
9834966,9999979,6193,2167550,12167529,21.68
9834967,9971967,3911,1368850,11340817,13.73
9834968,9972016,5846,2046100,12018116,20.52
9834969,9968718,3510,1228500,11197218,12.32
9834970,9974721,3842,1344700,11319421,13.48
9834971,496096,126,44100,540196,8.89
9834972,9982506,5102,1785700,11768206,17.89
9834973,1376978,686,240100,1617078,17.44
9834974,9913759,4431,1550850,11464609,15.64
9834975,9929164,2147,751450,10680614,7.57
9834976,9998536,2381,833350,10831886,8.33
9834977,9988471,4233,1481550,11470021,14.83
9834979,9993865,2647,926450,10920315,9.27
9834980,9985032,2130,745500,10730532,7.47
9834981,8979882,4035,1412250,10392132,15.73
9834982,9986896,4176,1461600,11448496,14.64
9834983,118406,42,14700,133106,12.41
9834984,9982812,4275,1496250,11479062,14.99
9834985,9988390,3620,1267000,11255390,12.68
9834986,3975800,2391,836850,4812650,21.05
9834987,9976241,3852,1348200,11324441,13.51
9834989,9967353,6576,2301600,12268953,23.09
9834990,9973263,4533,1586550,11559813,15.91
9834991,9974593,4020,1407000,11381593,14.11
9834992,408236,240,84000,492236,20.58
9834993,9956949,3420,1197000,11153949,12.02
9834994,9971458,5965,2087750,12059208,20.94
9834995,9955664,3658,1280300,11235964,12.86
9834996,9968833,5048,1766800,11735633,17.72
9834997,9972205,6557,2294950,12267155,23.01
9834998,9973449,1379,482650,10456099,4.84
9834999,9976793,3153,1103550,11080343,11.06
9835000,9984149,3883,1359050,11343199,13.61
9835001,9981277,3293,1152550,11133827,11.55
9835002,9979379,3697,1293950,11273329,12.97
9835003,3543996,1954,683900,4227896,19.30
9835004,9983700,6383,2234050,12217750,22.38
9835005,9971758,4713,1649550,11621308,16.54
9835006,8820775,4297,1503950,10324725,17.05
9835007,538693,286,100100,638793,18.58
9835008,9998827,3485,1219750,11218577,12.20
9835009,9983736,3317,1160950,11144686,11.63
9835010,9971609,2339,818650,10790259,8.21
9835011,9882229,4389,1536150,11418379,15.54
9835012,9994355,4424,1548400,11542755,15.49
9835013,9997671,2858,1000300,10997971,10.01
9835014,9285381,3777,1321950,10607331,14.24
9835015,9975900,1084,379400,10355300,3.80
9835016,296260,261,91350,387610,30.83
9835017,9957593,5316,1860600,11818193,18.69
9835018,9968614,3429,1200150,11168764,12.04
9835019,2912438,150,52500,2964938,1.80
9835020,9952628,3877,1356950,11309578,13.63
9835021,866043,430,150500,1016543,17.38
9835022,9928173,3851,1347850,11276023,13.58
9835023,9946902,3558,1245300,11192202,12.52
9835024,9951509,2810,983500,10935009,9.88
9835025,9961950,4491,1571850,11533800,15.78
9835026,9968294,2931,1025850,10994144,10.29
9835027,9968241,4323,1513050,11481291,15.18
9835028,9970615,2536,887600,10858215,8.90
9835029,1292233,573,200550,1492783,15.52
9835030,9953927,3303,1156050,11109977,11.61
9835031,9930970,4676,1636600,11567570,16.48
9835032,9952827,1017,355950,10308777,3.58
9835033,9944442,4227,1479450,11423892,14.88
9835034,9958727,5210,1823500,11782227,18.31
9835035,9961824,2174,760900,10722724,7.64
9835036,8983333,3239,1133650,10116983,12.62
9835037,9936532,4486,1570100,11506632,15.80
9835038,9982418,3560,1246000,11228418,12.48
9835039,9991131,3048,1066800,11057931,10.68
9835040,9980293,5768,2018800,11999093,20.23
9835041,9983085,3232,1131200,11114285,11.33
9835042,9975217,4187,1465450,11440667,14.69
9835043,9978966,4545,1590750,11569716,15.94
9835044,9991354,4353,1523550,11514904,15.25
9835045,9999220,1180,413000,10412220,4.13
9835046,9975370,2618,916300,10891670,9.19
9835047,9963520,3723,1303050,11266570,13.08
9835048,9967663,2632,921200,10888863,9.24
9835049,9983837,4143,1450050,11433887,14.52
9835050,9987927,623,218050,10205977,2.18
9835051,9984406,1161,406350,10390756,4.07
9835052,9980488,3207,1122450,11102938,11.25
9835053,6950291,3031,1060850,8011141,15.26
9835054,9874265,4003,1401050,11275315,14.19
9835055,9983694,4057,1419950,11403644,14.22
9835056,5853843,1861,651350,6505193,11.13
9835057,9966206,1216,425600,10391806,4.27
9835058,9959991,2645,925750,10885741,9.29
9835059,1828491,1916,670600,2499091,36.68
9835060,9961673,1808,632800,10594473,6.35
9835061,9968728,4738,1658300,11627028,16.64
9835062,9974516,2709,948150,10922666,9.51
9835063,9993859,937,327950,10321809,3.28
9835064,9982681,2884,1009400,10992081,10.11
9835065,9995045,3834,1341900,11336945,13.43
9835066,9995195,1861,651350,10646545,6.52
9835067,9986445,4230,1480500,11466945,14.83
9835068,9995554,3809,1333150,11328704,13.34
9835070,9479308,3254,1138900,10618208,12.01
9835071,9987134,3702,1295700,11282834,12.97
9835072,9986622,5410,1893500,11880122,18.96
9835073,9981424,4963,1737050,11718474,17.40
9835074,9976183,3671,1284850,11261033,12.88
9835075,9995190,1831,640850,10636040,6.41
9835076,9961516,1316,460600,10422116,4.62
9835077,9986211,1545,540750,10526961,5.41
9835078,9990458,3378,1182300,11172758,11.83
9835079,9980993,3596,1258600,11239593,12.61
9835080,9978948,2502,875700,10854648,8.78
9835081,9972208,912,319200,10291408,3.20
9835083,8630825,3266,1143100,9773925,13.24
9835084,9947257,3492,1222200,11169457,12.29
9835085,3095812,2337,817950,3913762,26.42
9835086,9932288,3294,1152900,11085188,11.61
9835087,9949145,2983,1044050,10993195,10.49
9835088,9936112,4270,1494500,11430612,15.04
9835089,9951217,2735,957250,10908467,9.62
9835090,1307663,1013,354550,1662213,27.11
9835091,9921146,2795,978250,10899396,9.86
9835092,8420624,3669,1284150,9704774,15.25
9835093,9944889,3396,1188600,11133489,11.95
9835094,9948843,3193,1117550,11066393,11.23
9835095,9954335,5314,1859900,11814235,18.68
9835097,9948629,2552,893200,10841829,8.98
9835098,9952715,3010,1053500,11006215,10.59
9835099,9951562,5095,1783250,11734812,17.92
9835100,9965419,4749,1662150,11627569,16.68
9835101,2713093,1257,439950,3153043,16.22
9835102,9937774,3324,1163400,11101174,11.71
9835103,9957492,6409,2243150,12200642,22.53
9835105,9947968,5816,2035600,11983568,20.46
9835106,9945385,3195,1118250,11063635,11.24
9835107,9960157,7065,2472750,12432907,24.83
9835108,9975803,3590,1256500,11232303,12.60
9835109,9975074,3240,1134000,11109074,11.37
9835110,9975151,403,141050,10116201,1.41
9835111,9967761,3721,1302350,11270111,13.07
9835112,9976640,4309,1508150,11484790,15.12
9835113,9508428,5773,2020550,11528978,21.25
9835114,9992976,2797,978950,10971926,9.80
9835115,9983483,2601,910350,10893833,9.12
9835116,9994312,3413,1194550,11188862,11.95
9835117,373056,96,33600,406656,9.01
9835118,9976081,3825,1338750,11314831,13.42
9835119,9965480,3848,1346800,11312280,13.51
9835120,4202726,1813,634550,4837276,15.10
9835121,9984072,3315,1160250,11144322,11.62
9835122,9994470,3297,1153950,11148420,11.55
9835123,9983802,4746,1661100,11644902,16.64
9835124,9973804,4188,1465800,11439604,14.70
9835126,9996183,4003,1401050,11397233,14.02
9835127,9919142,5401,1890350,11809492,19.06
9835128,9989712,2088,730800,10720512,7.32
9835129,9996406,5945,2080750,12077156,20.81
9835130,9979359,3555,1244250,11223609,12.47
9835131,3077575,795,278250,3355825,9.04
9835132,4757026,2096,733600,5490626,15.42
9835133,2524357,792,277200,2801557,10.98
9835134,9977037,2340,819000,10796037,8.21
9835135,9992544,4047,1416450,11408994,14.18
9835136,2108410,538,188300,2296710,8.93
9835137,9965251,3775,1321250,11286501,13.26
9835138,9975413,5917,2070950,12046363,20.76
9835139,9991977,3875,1356250,11348227,13.57
9835140,9990025,2986,1045100,11035125,10.46
9835141,9981651,2957,1034950,11016601,10.37
9835142,9979073,2974,1040900,11019973,10.43
9835143,9981429,3482,1218700,11200129,12.21
9835144,9965763,3823,1338050,11303813,13.43
9835145,9949779,4548,1591800,11541579,16.00
9835146,9953849,3643,1275050,11228899,12.81
9835147,9966908,3626,1269100,11236008,12.73
9835148,9970872,3491,1221850,11192722,12.25
9835149,9997225,3505,1226750,11223975,12.27
9835150,9974861,5367,1878450,11853311,18.83
9835151,621420,262,91700,713120,14.76
9835152,9955626,4273,1495550,11451176,15.02
9835153,9963148,4248,1486800,11449948,14.92
9835154,9970007,3725,1303750,11273757,13.08
9835155,9968208,4134,1446900,11415108,14.52
9835156,1707169,1277,446950,2154119,26.18
9835157,633384,458,160300,793684,25.31
9835158,9953860,4735,1657250,11611110,16.65
9835159,9943390,1280,448000,10391390,4.51
9835160,9959025,1678,587300,10546325,5.90
9835162,9949040,2854,998900,10947940,10.04
9835163,1788457,188,65800,1854257,3.68
9835164,9934268,4093,1432550,11366818,14.42
9835165,9942367,5536,1937600,11879967,19.49
9835166,495897,373,130550,626447,26.33
9835167,9953882,4073,1425550,11379432,14.32
9835169,9942309,7147,2501450,12443759,25.16
9835170,9952216,4028,1409800,11362016,14.17
9835171,1607596,698,244300,1851896,15.20
9835172,9925839,4974,1740900,11666739,17.54
9835173,9939645,2534,886900,10826545,8.92
9835174,9938459,3560,1246000,11184459,12.54
9835175,9936946,3978,1392300,11329246,14.01
9835176,2789966,1574,550900,3340866,19.75
9835177,5072291,1256,439600,5511891,8.67
9835178,823350,376,131600,954950,15.98
9835179,6009730,2680,938000,6947730,15.61
9835180,9931766,3559,1245650,11177416,12.54
9835181,9910997,6388,2235800,12146797,22.56
9835182,9921642,2642,924700,10846342,9.32
9835183,9927345,3981,1393350,11320695,14.04
9835184,9952443,1026,359100,10311543,3.61
9835185,9962506,3316,1160600,11123106,11.65
9835186,1191368,212,74200,1265568,6.23
9835187,9976446,3690,1291500,11267946,12.95
9835188,9968270,1024,358400,10326670,3.60
9835189,9965191,1654,578900,10544091,5.81
9835190,9978158,3526,1234100,11212258,12.37
9835191,9990615,2293,802550,10793165,8.03
9835192,9988138,3086,1080100,11068238,10.81
9835193,9981465,3852,1348200,11329665,13.51
9835194,9986544,2822,987700,10974244,9.89
9835195,9979598,6505,2276750,12256348,22.81
9835197,9974087,5031,1760850,11734937,17.65
9835198,9979960,4497,1573950,11553910,15.77
9835199,9974414,5238,1833300,11807714,18.38
9835200,9980117,5344,1870400,11850517,18.74
9835201,9985324,4096,1433600,11418924,14.36
9835202,536883,265,92750,629633,17.28
9835203,9990609,1275,446250,10436859,4.47
9835204,9975121,2484,869400,10844521,8.72
9835205,9973907,499,174650,10148557,1.75
9835206,9980824,1646,576100,10556924,5.77
9835207,2003220,1682,588700,2591920,29.39
9835208,9963911,1716,600600,10564511,6.03
9835209,9965773,2227,779450,10745223,7.82
9835210,9957010,494,172900,10129910,1.74
9835211,9973970,2262,791700,10765670,7.94
9835212,9990031,5017,1755950,11745981,17.58
9835213,9982058,1197,418950,10401008,4.20
9835214,9940949,1397,488950,10429899,4.92
9835215,9989085,1562,546700,10535785,5.47
9835216,9985967,1968,688800,10674767,6.90
9835217,9982520,1020,357000,10339520,3.58
9835218,9800013,1875,656250,10456263,6.70
9835219,9968301,2424,848400,10816701,8.51
9835220,9956491,2610,913500,10869991,9.17
9835221,9924462,1248,436800,10361262,4.40
9835222,9935927,1013,354550,10290477,3.57
9835223,9925441,2909,1018150,10943591,10.26
9835224,9933034,2887,1010450,10943484,10.17
9835225,9936151,1878,657300,10593451,6.62
9835226,9942083,2592,907200,10849283,9.12
9835227,9958780,943,330050,10288830,3.31
9835228,9823032,932,326200,10149232,3.32
9835229,9945201,684,239400,10184601,2.41
9835230,5144062,1586,555100,5699162,10.79
9835231,7297607,2447,856450,8154057,11.74
9835232,9954701,3461,1211350,11166051,12.17
9835233,9969221,2773,970550,10939771,9.74
9835234,9986278,1305,456750,10443028,4.57
9835235,9983102,3694,1292900,11276002,12.95
9835236,9971562,1257,439950,10411512,4.41
9835238,9964661,854,298900,10263561,3.00
9835239,9979025,1014,354900,10333925,3.56
9835241,9974168,1755,614250,10588418,6.16
9835242,9991812,1828,639800,10631612,6.40
9835244,9972690,836,292600,10265290,2.93
9835245,2230913,1411,493850,2724763,22.14
9835246,9991885,1535,537250,10529135,5.38
9835247,9747881,1734,606900,10354781,6.23
9835248,3832997,1384,484400,4317397,12.64
9835249,9864657,1459,510650,10375307,5.18
9835250,9992711,4496,1573600,11566311,15.75
9835251,9995589,3114,1089900,11085489,10.90
9835252,9992746,985,344750,10337496,3.45
9835253,9980403,3130,1095500,11075903,10.98
9835255,9954480,1294,452900,10407380,4.55
9835256,9967644,2897,1013950,10981594,10.17
9835257,9980284,3222,1127700,11107984,11.30
9835258,9960362,2714,949900,10910262,9.54
9835259,9995033,4741,1659350,11654383,16.60
9835260,9930756,3273,1145550,11076306,11.54
9835261,9987632,1633,571550,10559182,5.72
9835262,9983548,3861,1351350,11334898,13.54
9835263,9987539,1519,531650,10519189,5.32
9835264,9993509,2154,753900,10747409,7.54
9835265,9985258,2070,724500,10709758,7.26
9835266,9975777,3954,1383900,11359677,13.87
9835267,9990945,3252,1138200,11129145,11.39
9835268,558515,486,170100,728615,30.46
9835269,9995567,2906,1017100,11012667,10.18
9835270,9997079,2088,730800,10727879,7.31
9835271,9988846,2467,863450,10852296,8.64
9835272,9973148,516,180600,10153748,1.81
9835273,9990549,5143,1800050,11790599,18.02
9835274,9989098,3094,1082900,11071998,10.84
9835275,9994632,4678,1637300,11631932,16.38
9835276,9982046,1974,690900,10672946,6.92
9835277,9979833,4253,1488550,11468383,14.92
9835278,9991525,3541,1239350,11230875,12.40
9835279,9991172,2144,750400,10741572,7.51
9835280,9997544,2946,1031100,11028644,10.31
9835281,9987629,2021,707350,10694979,7.08
9835282,9974540,2520,882000,10856540,8.84
9835283,9997030,749,262150,10259180,2.62
9835284,9990063,1596,558600,10548663,5.59
9835285,9986721,4375,1531250,11517971,15.33
9835286,9973748,2869,1004150,10977898,10.07
9835287,9985849,1005,351750,10337599,3.52
9835288,9987377,1174,410900,10398277,4.11
9835289,9997346,800,280000,10277346,2.80
9835290,2538225,661,231350,2769575,9.11
9835291,9997768,1021,357350,10355118,3.57
9835292,9976407,2644,925400,10901807,9.28
9835293,9895836,2035,712250,10608086,7.20
9835294,9975207,3379,1182650,11157857,11.86
9835295,9963218,2345,820750,10783968,8.24
9835296,9994391,2811,983850,10978241,9.84
9835297,9984332,4225,1478750,11463082,14.81
9835298,9979046,3870,1354500,11333546,13.57
9835299,9976839,2921,1022350,10999189,10.25
9835300,9964792,2497,873950,10838742,8.77
9835301,9982312,1590,556500,10538812,5.57
9835302,9983897,2957,1034950,11018847,10.37
9835303,9984808,2535,887250,10872058,8.89
9835304,9978904,879,307650,10286554,3.08
9835305,9982352,2356,824600,10806952,8.26
9835306,9727310,1017,355950,10083260,3.66
9835307,9953555,4581,1603350,11556905,16.11
9835308,9967796,1657,579950,10547746,5.82
9835309,9967708,3982,1393700,11361408,13.98
9835310,9595520,3125,1093750,10689270,11.40
9835311,9984496,4692,1642200,11626696,16.45
9835312,9985623,1133,396550,10382173,3.97
9835313,9991104,1590,556500,10547604,5.57
9835314,9987955,1666,583100,10571055,5.84
9835315,9972129,2214,774900,10747029,7.77
9835316,9989818,3217,1125950,11115768,11.27
9835317,9980261,1348,471800,10452061,4.73
9835318,9969724,2715,950250,10919974,9.53
9835319,9993453,2504,876400,10869853,8.77
9835320,9982669,2946,1031100,11013769,10.33
9835321,9856142,546,191100,10047242,1.94
9835322,9987904,2023,708050,10695954,7.09
9835323,9904920,2125,743750,10648670,7.51
9835324,9978646,3525,1233750,11212396,12.36
9835325,9977311,1083,379050,10356361,3.80
9835326,9978545,1370,479500,10458045,4.81
9835327,9970391,1960,686000,10656391,6.88
9835328,2128529,945,330750,2459279,15.54
9835329,9991551,2016,705600,10697151,7.06
9835330,9976280,851,297850,10274130,2.99
9835331,9987025,2382,833700,10820725,8.35
9835332,9993697,1815,635250,10628947,6.36
9835333,9978749,1903,666050,10644799,6.67
9835334,9984570,3701,1295350,11279920,12.97
9835335,2640534,1471,514850,3155384,19.50
9835336,9981289,1439,503650,10484939,5.05
9835338,3599145,2145,750750,4349895,20.86
9835339,9981817,3889,1361150,11342967,13.64
9835340,9983906,1267,443450,10427356,4.44
9835341,9981266,2370,829500,10810766,8.31
9835342,2696742,1462,511700,3208442,18.97
9835343,7099855,3611,1263850,8363705,17.80
9835344,9909223,907,317450,10226673,3.20
9835345,9994936,1864,652400,10647336,6.53
9835346,9987639,1640,574000,10561639,5.75
9835347,9981760,1797,628950,10610710,6.30
9835348,9970631,1909,668150,10638781,6.70
9835349,9988824,2382,833700,10822524,8.35
9835350,9999376,3070,1074500,11073876,10.75
9835351,9982684,903,316050,10298734,3.17
9835353,9979873,3162,1106700,11086573,11.09
9835354,9981960,3318,1161300,11143260,11.63
9835355,9986841,1753,613550,10600391,6.14
9835356,9970398,2635,922250,10892648,9.25
9835357,9965133,2581,903350,10868483,9.07
9835358,6414109,1851,647850,7061959,10.10
9835359,9978125,2900,1015000,10993125,10.17
9835360,9985059,2693,942550,10927609,9.44
9835361,9995220,1760,616000,10611220,6.16
9835362,9964688,3007,1052450,11017138,10.56
9835363,9990868,3591,1256850,11247718,12.58
9835364,9967939,3146,1101100,11069039,11.05
9835365,9985871,1842,644700,10630571,6.46
9835366,9965162,725,253750,10218912,2.55
9835367,9981125,1889,661150,10642275,6.62
9835368,9986343,4296,1503600,11489943,15.06
9835369,9994138,2372,830200,10824338,8.31
9835370,9987392,2076,726600,10713992,7.28
9835371,9990232,1927,674450,10664682,6.75
9835372,9990724,3170,1109500,11100224,11.11
9835373,9981548,1955,684250,10665798,6.86
9835374,3300550,2499,874650,4175200,26.50
9835375,60420,34,11900,72320,19.70
9835376,9966607,1423,498050,10464657,5.00
9835377,9994725,2828,989800,10984525,9.90
9835378,9970018,2306,807100,10777118,8.10
9835379,9965811,1182,413700,10379511,4.15
9835380,9971417,3081,1078350,11049767,10.81
9835381,9970914,3619,1266650,11237564,12.70
9835382,2332865,1224,428400,2761265,18.36
9835383,273595,106,37100,310695,13.56
9835384,8158029,2250,787500,8945529,9.65
9835385,9976932,3277,1146950,11123882,11.50
9835386,9986357,3002,1050700,11037057,10.52
9835387,9414198,3184,1114400,10528598,11.84
9835388,9978544,3950,1382500,11361044,13.85
9835389,9948798,2207,772450,10721248,7.76
9835390,9991531,3161,1106350,11097881,11.07
9835391,9981541,1200,420000,10401541,4.21
9835392,9986178,737,257950,10244128,2.58
9835393,9985208,3150,1102500,11087708,11.04
9835394,9993574,1345,470750,10464324,4.71
9835395,9966754,1680,588000,10554754,5.90
9835396,9975664,3364,1177400,11153064,11.80
9835397,9991554,1684,589400,10580954,5.90
9835398,9985567,2495,873250,10858817,8.75
9835399,9984280,1733,606550,10590830,6.08
9835400,9992834,2988,1045800,11038634,10.47
9835401,9991341,1448,506800,10498141,5.07
9835402,9988200,1805,631750,10619950,6.32
9835403,9999709,857,299950,10299659,3.00
9835404,9979538,1661,581350,10560888,5.83
9835405,9979789,2571,899850,10879639,9.02
9835406,9992315,1869,654150,10646465,6.55
9835407,9977866,4173,1460550,11438416,14.64
9835408,9982126,2762,966700,10948826,9.68
9835409,9983993,4753,1663550,11647543,16.66
9835410,9975281,3718,1301300,11276581,13.05
9835411,9995806,1108,387800,10383606,3.88
9835412,9983025,4197,1468950,11451975,14.71
9835413,9979427,3384,1184400,11163827,11.87
9835414,9985322,3061,1071350,11056672,10.73
9835415,9975339,3227,1129450,11104789,11.32
9835416,9990012,1576,551600,10541612,5.52
9835417,9951240,1176,411600,10362840,4.14
9835418,9985478,1303,456050,10441528,4.57
9835419,9980542,3501,1225350,11205892,12.28
9835420,9994888,2889,1011150,11006038,10.12
9835421,9981667,2891,1011850,10993517,10.14
9835422,9982569,3805,1331750,11314319,13.34
9835423,9975007,544,190400,10165407,1.91
9835424,1161367,1397,488950,1650317,42.10
9835425,9969297,1719,601650,10570947,6.04
9835426,9998695,2946,1031100,11029795,10.31
9835427,9974180,2380,833000,10807180,8.35
9835428,9986233,1376,481600,10467833,4.82
9835429,9997299,4973,1740550,11737849,17.41
9835430,9981106,3260,1141000,11122106,11.43
9835431,9980623,2386,835100,10815723,8.37
9835432,9978966,3322,1162700,11141666,11.65
9835433,9998776,1049,367150,10365926,3.67
9835434,9983782,4635,1622250,11606032,16.25
9835435,9983045,3177,1111950,11094995,11.14
9835436,4282699,3675,1286250,5568949,30.03
9835437,9987050,4799,1679650,11666700,16.82
9835438,9986721,2236,782600,10769321,7.84
9835439,9991020,2971,1039850,11030870,10.41
9835440,9989650,1652,578200,10567850,5.79
9835441,9975279,2859,1000650,10975929,10.03
9835442,9962553,4648,1626800,11589353,16.33
9835443,9998344,2900,1015000,11013344,10.15
9835444,6049162,990,346500,6395662,5.73
9835445,9987372,3651,1277850,11265222,12.79
9835446,288730,150,52500,341230,18.18
9835447,9975997,2668,933800,10909797,9.36
9835448,9990822,4439,1553650,11544472,15.55
9835449,9841865,3289,1151150,10993015,11.70
9835450,1486090,415,145250,1631340,9.77
9835451,9968415,3872,1355200,11323615,13.59
9835452,8438385,1794,627900,9066285,7.44
9835453,7061395,3191,1116850,8178245,15.82
9835454,9967084,4158,1455300,11422384,14.60
9835455,9954346,5492,1922200,11876546,19.31
9835456,9719539,4683,1639050,11358589,16.86
9835457,9958348,3603,1261050,11219398,12.66
9835458,9967131,4293,1502550,11469681,15.08
9835459,9974206,4866,1703100,11677306,17.08
9835460,9998327,2689,941150,10939477,9.41
9835461,9985589,1060,371000,10356589,3.72
9835462,9976909,2019,706650,10683559,7.08
9835464,2371845,901,315350,2687195,13.30
9835465,9465326,2238,783300,10248626,8.28
9835466,9994643,3666,1283100,11277743,12.84
9835468,9987849,3526,1234100,11221949,12.36
9835470,1453271,706,247100,1700371,17.00
9835471,9970714,3595,1258250,11228964,12.62
9835472,9974655,3989,1396150,11370805,14.00
9835473,7964082,2488,870800,8834882,10.93
9835474,9980934,4906,1717100,11698034,17.20
9835475,9971871,4902,1715700,11687571,17.21
9835476,5585731,1568,548800,6134531,9.83
9835477,9971772,3312,1159200,11130972,11.62
9835478,9953738,3601,1260350,11214088,12.66
9835479,9957276,4235,1482250,11439526,14.89
9835480,9957677,4684,1639400,11597077,16.46
9835481,9959727,5416,1895600,11855327,19.03
9835482,9970454,3396,1188600,11159054,11.92
9835483,9948433,3753,1313550,11261983,13.20
9835484,9919457,44,15400,9934857,0.16
9835485,9959083,3641,1274350,11233433,12.80
9835486,9538796,2143,750050,10288846,7.86
9835487,9970200,2214,774900,10745100,7.77
9835488,9953486,4262,1491700,11445186,14.99
9835489,9959475,3684,1289400,11248875,12.95
9835490,9976684,3328,1164800,11141484,11.68
9835491,9951788,3613,1264550,11216338,12.71
9835492,9953683,2714,949900,10903583,9.54
9835493,9965412,1120,392000,10357412,3.93
9835494,9982524,2672,935200,10917724,9.37
9835495,9974384,2077,726950,10701334,7.29
9835496,9965561,2369,829150,10794711,8.32
9835497,9991294,2935,1027250,11018544,10.28
9835498,9980697,3581,1253350,11234047,12.56
9835500,9941533,3275,1146250,11087783,11.53
9835501,9925256,3268,1143800,11069056,11.52
9835502,9963816,4096,1433600,11397416,14.39
9835503,9965078,2061,721350,10686428,7.24
9835504,9984134,3733,1306550,11290684,13.09
9835505,9966040,3044,1065400,11031440,10.69
9835506,9981917,2781,973350,10955267,9.75
9835507,9988579,3733,1306550,11295129,13.08
9835509,9980223,3611,1263850,11244073,12.66
9835510,9989783,2364,827400,10817183,8.28
9835511,9985994,3940,1379000,11364994,13.81
9835512,9980319,3104,1086400,11066719,10.89
9835513,9997699,5381,1883350,11881049,18.84
9835514,9969999,3773,1320550,11290549,13.25
9835515,9983755,3404,1191400,11175155,11.93
9835516,9981307,2363,827050,10808357,8.29
9835517,9987691,3929,1375150,11362841,13.77
9835518,9979305,4927,1724450,11703755,17.28
9835519,9998476,2843,995050,10993526,9.95
9835521,9954558,2444,855400,10809958,8.59
9835522,9985576,4152,1453200,11438776,14.55
9835523,9593680,1806,632100,10225780,6.59
9835524,9985572,4168,1458800,11444372,14.61
9835525,9995052,3967,1388450,11383502,13.89
9835526,9970269,5077,1776950,11747219,17.82
9835527,9994900,2079,727650,10722550,7.28
9835528,9979412,2909,1018150,10997562,10.20
9835529,9999043,3767,1318450,11317493,13.19
9835530,4736028,1192,417200,5153228,8.81
9835531,9973548,3119,1091650,11065198,10.95
9835532,9975767,3083,1079050,11054817,10.82
9835533,9992484,1781,623350,10615834,6.24
9835534,9463830,2283,799050,10262880,8.44
9835535,9983533,3904,1366400,11349933,13.69
9835536,9980257,3607,1262450,11242707,12.65
9835537,9984165,3187,1115450,11099615,11.17
9835538,9983127,2709,948150,10931277,9.50
9835539,8958749,2868,1003800,9962549,11.20
9835540,3495609,912,319200,3814809,9.13
9835541,8959947,4814,1684900,10644847,18.80
9835542,9956366,4975,1741250,11697616,17.49
9835543,9939836,5119,1791650,11731486,18.02
9835544,9930696,4013,1404550,11335246,14.14
9835546,9908984,2172,760200,10669184,7.67
9835547,9684644,2624,918400,10603044,9.48
9835548,9905358,3802,1330700,11236058,13.43
9835549,9423927,2717,950950,10374877,10.09
9835550,9916177,4637,1622950,11539127,16.37
9835551,9929366,2840,994000,10923366,10.01
9835552,9949971,3104,1086400,11036371,10.92
9835553,9943657,5226,1829100,11772757,18.39
9835554,9952381,3442,1204700,11157081,12.10
9835555,9956504,3694,1292900,11249404,12.99
9835556,9959488,3167,1108450,11067938,11.13
9835557,9963921,93,32550,9996471,0.33
9835558,9964291,4179,1462650,11426941,14.68
9835559,9944707,3271,1144850,11089557,11.51
9835560,8833531,4704,1646400,10479931,18.64
9835561,9966189,2862,1001700,10967889,10.05
9835563,9958870,167,58450,10017320,0.59
9835564,9960769,3499,1224650,11185419,12.29
9835565,9970655,5372,1880200,11850855,18.86
9835567,8429284,4656,1629600,10058884,19.33
9835568,9325506,4963,1737050,11062556,18.63
9835569,9984050,3373,1180550,11164600,11.82
9835570,9897929,3891,1361850,11259779,13.76
9835571,9907372,4443,1555050,11462422,15.70
9835572,9963718,4265,1492750,11456468,14.98
9835573,2943352,2453,858550,3801902,29.17
9835574,9964521,3473,1215550,11180071,12.20
9835575,9741357,3271,1144850,10886207,11.75
9835576,9944309,4631,1620850,11565159,16.30
9835577,886222,381,133350,1019572,15.05
9835578,9942222,3397,1188950,11131172,11.96
9835579,9958482,3869,1354150,11312632,13.60
9835580,4218747,2571,899850,5118597,21.33
9835581,9945971,4066,1423100,11369071,14.31
9835582,9968817,3195,1118250,11087067,11.22
9835583,9956568,1846,646100,10602668,6.49
9835584,9948691,2826,989100,10937791,9.94
9835585,6001627,2448,856800,6858427,14.28
9835586,8877207,3282,1148700,10025907,12.94
9835587,232713,111,38850,271563,16.69
9835588,9928993,3278,1147300,11076293,11.56
9835589,9929425,2771,969850,10899275,9.77
9835590,9933665,3608,1262800,11196465,12.71
9835591,392525,190,66500,459025,16.94
9835592,9906565,5268,1843800,11750365,18.61
9835593,9919827,5316,1860600,11780427,18.76
9835594,9935034,2816,985600,10920634,9.92
9835595,9946945,3745,1310750,11257695,13.18
9835596,9962461,2486,870100,10832561,8.73
9835597,9962651,2297,803950,10766601,8.07
9835598,9976000,1349,472150,10448150,4.73
9835599,9977834,2408,842800,10820634,8.45
9835600,9962966,1367,478450,10441416,4.80
9835601,9952416,3733,1306550,11258966,13.13
9835602,9964433,4147,1451450,11415883,14.57
9835603,1899997,1110,388500,2288497,20.45
9835604,7110447,1936,677600,7788047,9.53
9835605,9966817,3621,1267350,11234167,12.72
9835606,9980569,4598,1609300,11589869,16.12
9835607,9986176,1533,536550,10522726,5.37
9835608,3154581,1068,373800,3528381,11.85
9835609,5524172,2699,944650,6468822,17.10
9835610,9963016,4766,1668100,11631116,16.74
9835611,9972876,3273,1145550,11118426,11.49
9835612,9162971,2526,884100,10047071,9.65
9835614,5321612,3287,1150450,6472062,21.62
9835615,9943479,5904,2066400,12009879,20.78
9835616,1083593,836,292600,1376193,27.00
9835617,9961694,5000,1750000,11711694,17.57
9835618,2472558,952,333200,2805758,13.48
9835619,9958117,3402,1190700,11148817,11.96
9835620,9974636,5046,1766100,11740736,17.71
9835621,9972473,4492,1572200,11544673,15.77
9835622,9969989,2826,989100,10959089,9.92
9835623,9967142,2360,826000,10793142,8.29
9835624,9974840,4246,1486100,11460940,14.90
9835625,1240413,794,277900,1518313,22.40
9835626,9968941,1238,433300,10402241,4.35
9835627,9980002,52,18200,9998202,0.18
9835628,9975059,3886,1360100,11335159,13.64
9835629,8252183,430,150500,8402683,1.82
9835630,4172474,1625,568750,4741224,13.63
9835631,9859640,2416,845600,10705240,8.58
9835633,9763723,4450,1557500,11321223,15.95
9835634,9992075,3457,1209950,11202025,12.11
9835635,2388457,660,231000,2619457,9.67
9835636,277369,72,25200,302569,9.09
9835637,9970492,4292,1502200,11472692,15.07
9835638,9986092,2079,727650,10713742,7.29
9835639,9980480,4792,1677200,11657680,16.80
9835640,9971255,3475,1216250,11187505,12.20
9835641,9971510,4989,1746150,11717660,17.51
9835642,9980926,4667,1633450,11614376,16.37
9835643,9975962,6440,2254000,12229962,22.59
9835644,4452603,3370,1179500,5632103,26.49
9835645,9984673,5760,2016000,12000673,20.19
9835646,9975394,5212,1824200,11799594,18.29
9835647,5609790,2800,980000,6589790,17.47
9835648,9977029,5425,1898750,11875779,19.03
9835649,9936571,1780,623000,10559571,6.27
9835650,9954252,2818,986300,10940552,9.91
9835651,9979353,3877,1356950,11336303,13.60
9835652,9965316,5374,1880900,11846216,18.87
9835653,9990514,3132,1096200,11086714,10.97
9835654,9980637,4249,1487150,11467787,14.90
9835655,9988833,4237,1482950,11471783,14.85
9835656,9950431,3637,1272950,11223381,12.79
9835657,9994563,3598,1259300,11253863,12.60
9835658,9977945,3647,1276450,11254395,12.79
9835659,2576327,1126,394100,2970427,15.30
9835660,9973591,4731,1655850,11629441,16.60
9835661,9981154,1744,610400,10591554,6.12
9835662,9971009,1351,472850,10443859,4.74
9835663,9973824,2512,879200,10853024,8.82
9835664,9974782,6947,2431450,12406232,24.38
9835665,9985152,2692,942200,10927352,9.44
9835666,9965326,5579,1952650,11917976,19.59
9835667,9984925,4186,1465100,11450025,14.67
9835668,9974856,2718,951300,10926156,9.54
9835670,9972116,3601,1260350,11232466,12.64
9835671,9973719,2397,838950,10812669,8.41
9835672,9981739,4677,1636950,11618689,16.40
9835673,9969570,4583,1604050,11573620,16.09
9835674,9980734,3936,1377600,11358334,13.80
9835675,9995310,807,282450,10277760,2.83
9835676,9961438,1695,593250,10554688,5.96
9835677,9972890,5463,1912050,11884940,19.17
9835678,9983343,2827,989450,10972793,9.91
9835679,9988423,3963,1387050,11375473,13.89
9835680,2374700,2224,778400,3153100,32.78
9835681,9980629,3808,1332800,11313429,13.35
9835682,7158931,3838,1343300,8502231,18.76
9835683,9981714,3277,1146950,11128664,11.49
9835684,9986141,5246,1836100,11822241,18.39
9835685,9980898,1836,642600,10623498,6.44
9835686,9991800,3098,1084300,11076100,10.85
9835687,9984343,4568,1598800,11583143,16.01
9835688,9996993,5167,1808450,11805443,18.09
9835689,9995010,3456,1209600,11204610,12.10
9835690,9979346,3105,1086750,11066096,10.89
9835691,6812113,2222,777700,7589813,11.42
9835692,9982977,4154,1453900,11436877,14.56
9835693,9979067,3490,1221500,11200567,12.24
9835694,9979358,2262,791700,10771058,7.93
9835695,9866176,918,321300,10187476,3.26
9835696,7850707,641,224350,8075057,2.86
9835697,9994059,4339,1518650,11512709,15.20
9835698,9983278,1741,609350,10592628,6.10
9835699,5054891,1540,539000,5593891,10.66
9835700,557083,232,81200,638283,14.58
9835701,9810805,3719,1301650,11112455,13.27
9835702,8873179,4250,1487500,10360679,16.76
9835703,9990702,3494,1222900,11213602,12.24
9835704,9982188,3526,1234100,11216288,12.36
9835705,9982114,3239,1133650,11115764,11.36
9835706,9981312,4447,1556450,11537762,15.59
9835707,9756654,2903,1016050,10772704,10.41
9835708,9965555,4580,1603000,11568555,16.09
9835709,9985775,4795,1678250,11664025,16.81
9835710,9980764,3503,1226050,11206814,12.28
9835711,1771892,1251,437850,2209742,24.71
9835712,9965095,3341,1169350,11134445,11.73
9835713,9957327,3348,1171800,11129127,11.77
9835714,9965237,6331,2215850,12181087,22.24
9835715,1368974,344,120400,1489374,8.79
9835716,9973141,2656,929600,10902741,9.32
9835717,9970552,2199,769650,10740202,7.72
9835718,9985201,4671,1634850,11620051,16.37
9835719,9992042,3801,1330350,11322392,13.31
9835720,9981086,1446,506100,10487186,5.07
9835721,9979045,4101,1435350,11414395,14.38
9835722,9989667,1270,444500,10434167,4.45
9835723,1133711,470,164500,1298211,14.51
9835724,9980297,3511,1228850,11209147,12.31
9835725,9983672,1651,577850,10561522,5.79
9835726,9984555,3897,1363950,11348505,13.66
9835727,9994705,3942,1379700,11374405,13.80
9835728,9978876,2466,863100,10841976,8.65
9835729,9975077,1275,446250,10421327,4.47
9835730,9984441,4548,1591800,11576241,15.94
9835731,9970017,4163,1457050,11427067,14.61
9835732,5441421,3312,1159200,6600621,21.30
9835733,9963377,3851,1347850,11311227,13.53
9835734,9958789,5343,1870050,11828839,18.78
9835735,2040363,1343,470050,2510413,23.04
9835736,9949191,4341,1519350,11468541,15.27
9835737,9943872,4329,1515150,11459022,15.24
9835738,9948627,2198,769300,10717927,7.73
9835739,9955034,1183,414050,10369084,4.16
9835740,9957810,850,297500,10255310,2.99
9835741,4989198,1712,599200,5588398,12.01
9835742,9940859,3717,1300950,11241809,13.09
9835743,6324836,2416,845600,7170436,13.37
9835744,7712481,4790,1676500,9388981,21.74
9835745,9933125,3225,1128750,11061875,11.36
9835746,9943724,1894,662900,10606624,6.67
9835748,341344,116,40600,381944,11.89
9835749,9926942,2803,981050,10907992,9.88
9835750,7174966,2974,1040900,8215866,14.51
9835751,9930284,4824,1688400,11618684,17.00
9835752,9943389,3521,1232350,11175739,12.39
9835753,9940485,3572,1250200,11190685,12.58
9835754,9918418,4692,1642200,11560618,16.56
9835755,9951281,3059,1070650,11021931,10.76
9835756,9957641,3901,1365350,11322991,13.71
9835757,4994178,1283,449050,5443228,8.99
9835758,9949483,2102,735700,10685183,7.39
9835759,9954961,4473,1565550,11520511,15.73
9835760,9970180,4484,1569400,11539580,15.74
9835761,9953002,4077,1426950,11379952,14.34
9835762,9964222,2652,928200,10892422,9.32
9835763,1960554,1200,420000,2380554,21.42
9835764,9949724,3596,1258600,11208324,12.65
9835765,9958319,2388,835800,10794119,8.39
9835767,2708433,2481,868350,3576783,32.06
9835768,9949617,3084,1079400,11029017,10.85
9835769,9948303,4055,1419250,11367553,14.27
9835770,9963676,2668,933800,10897476,9.37
9835771,9959512,4810,1683500,11643012,16.90
9835772,9959608,5357,1874950,11834558,18.83
9835773,9955645,5036,1762600,11718245,17.70
9835774,9954016,2165,757750,10711766,7.61
9835775,9956729,4637,1622950,11579679,16.30
9835776,9945745,2355,824250,10769995,8.29
9835777,9929210,2124,743400,10672610,7.49
9835778,9933784,1710,598500,10532284,6.02
9835779,9700224,2645,925750,10625974,9.54
9835780,9946653,3899,1364650,11311303,13.72
9835781,9960938,3548,1241800,11202738,12.47
9835782,9968492,2968,1038800,11007292,10.42
9835783,6662945,2158,755300,7418245,11.34
9835784,9969804,3871,1354850,11324654,13.59
9835785,9976205,2354,823900,10800105,8.26
9835786,9989038,4153,1453550,11442588,14.55
9835787,9997311,3611,1263850,11261161,12.64
9835788,9989425,3117,1090950,11080375,10.92
9835789,8877822,3364,1177400,10055222,13.26
9835790,7450947,2682,938700,8389647,12.60
9835791,9742068,3477,1216950,10959018,12.49
9835792,9981691,3926,1374100,11355791,13.77
9835793,9973651,2363,827050,10800701,8.29
9835794,9984559,3665,1282750,11267309,12.85
9835795,9982280,5308,1857800,11840080,18.61
9835796,6407303,1634,571900,6979203,8.93
9835797,9773354,3191,1116850,10890204,11.43
9835798,9932585,3327,1164450,11097035,11.72
9835799,9988200,6784,2374400,12362600,23.77
9835800,9977340,844,295400,10272740,2.96
9835801,9962805,5265,1842750,11805555,18.50
9835802,9970862,4215,1475250,11446112,14.80
9835803,2046597,780,273000,2319597,13.34
9835804,9983799,4744,1660400,11644199,16.63
9835805,7132121,4105,1436750,8568871,20.14
9835806,442637,109,38150,480787,8.62
9835807,9961753,5597,1958950,11920703,19.66
9835808,9975927,3512,1229200,11205127,12.32
9835809,9966273,3906,1367100,11333373,13.72
9835810,9955155,7122,2492700,12447855,25.04
9835811,9972850,4599,1609650,11582500,16.14
9835812,1104122,249,87150,1191272,7.89
9835813,9967096,3502,1225700,11192796,12.30
9835814,9989132,4791,1676850,11665982,16.79
9835815,9986035,4019,1406650,11392685,14.09
9835816,1465381,367,128450,1593831,8.77
9835817,9975949,4117,1440950,11416899,14.44
9835818,3393699,1389,486150,3879849,14.33
9835819,9984834,4542,1589700,11574534,15.92
9835820,9989777,4258,1490300,11480077,14.92
9835821,9972732,3633,1271550,11244282,12.75
9835822,9988802,3513,1229550,11218352,12.31
9835823,9990609,3983,1394050,11384659,13.95
9835824,9995705,5988,2095800,12091505,20.97
9835825,9989695,3461,1211350,11201045,12.13
9835826,9979454,5032,1761200,11740654,17.65
9835827,8373512,4362,1526700,9900212,18.23
9835828,9961369,4330,1515500,11476869,15.21
9835829,9974465,4048,1416800,11391265,14.20
9835830,9981192,4140,1449000,11430192,14.52
9835831,9986700,4268,1493800,11480500,14.96
9835832,9994135,2792,977200,10971335,9.78
9835833,9972822,3844,1345400,11318222,13.49
9835834,9989446,5277,1846950,11836396,18.49
9835835,176797,129,45150,221947,25.54
9835836,9966629,6765,2367750,12334379,23.76
9835837,9949474,5421,1897350,11846824,19.07
9835838,9962382,3657,1279950,11242332,12.85
9835839,9976038,4116,1440600,11416638,14.44
9835840,9586386,4399,1539650,11126036,16.06
9835841,7932970,4225,1478750,9411720,18.64
9835842,9967594,4149,1452150,11419744,14.57
9835843,1470377,864,302400,1772777,20.57
9835844,9954425,3638,1273300,11227725,12.79
9835845,9928209,5726,2004100,11932309,20.19
9835846,9953494,3909,1368150,11321644,13.75
9835847,9953920,3443,1205050,11158970,12.11
9835848,9967431,5049,1767150,11734581,17.73
9835849,6936181,2927,1024450,7960631,14.77
9835850,9979498,3679,1287650,11267148,12.90
9835851,9973361,5239,1833650,11807011,18.39
9835852,9964288,4048,1416800,11381088,14.22
9835853,9982775,2853,998550,10981325,10.00
9835854,9981143,3474,1215900,11197043,12.18
9835855,9984895,3504,1226400,11211295,12.28
9835856,9981248,3981,1393350,11374598,13.96
9835857,9989063,4169,1459150,11448213,14.61
9835859,9963913,2690,941500,10905413,9.45
9835860,9969034,4120,1442000,11411034,14.46
9835861,9972427,6290,2201500,12173927,22.08
9835862,9988724,3971,1389850,11378574,13.91
9835863,9996117,5228,1829800,11825917,18.31
9835865,9969345,3474,1215900,11185245,12.20
9835866,9992907,4285,1499750,11492657,15.01
9835867,9988503,3298,1154300,11142803,11.56
9835868,9998254,4054,1418900,11417154,14.19
9835869,9980733,3727,1304450,11285183,13.07
9835870,9353534,3641,1274350,10627884,13.62
9835871,9994898,3850,1347500,11342398,13.48
9835872,814188,566,198100,1012288,24.33
9835873,9973317,3862,1351700,11325017,13.55
9835874,9980772,3770,1319500,11300272,13.22
9835876,9986657,3228,1129800,11116457,11.31
9835877,9993892,1341,469350,10463242,4.70
9835878,6404807,3032,1061200,7466007,16.57
9835879,9951145,2605,911750,10862895,9.16
9835880,6699976,2119,741650,7441626,11.07
9835881,9974657,3538,1238300,11212957,12.41
9835882,4299836,1649,577150,4876986,13.42
9835883,9986710,3850,1347500,11334210,13.49
9835884,9986240,3280,1148000,11134240,11.50
9835886,9979218,3608,1262800,11242018,12.65
9835887,5807945,1617,565950,6373895,9.74
9835888,773736,553,193550,967286,25.01
9835889,8426990,3771,1319850,9746840,15.66
9835890,9997285,3193,1117550,11114835,11.18
9835892,9972514,5942,2079700,12052214,20.85
9835893,9961772,2387,835450,10797222,8.39
9835894,9946995,5572,1950200,11897195,19.61
9835895,8824604,2730,955500,9780104,10.83
9835896,9976606,1607,562450,10539056,5.64
9835897,9965877,1927,674450,10640327,6.77
9835898,9951451,3845,1345750,11297201,13.52
9835899,9962398,3350,1172500,11134898,11.77
9835900,9965563,3471,1214850,11180413,12.19
9835901,9984200,3148,1101800,11086000,11.04
9835903,9954600,3060,1071000,11025600,10.76
9835904,9963531,4331,1515850,11479381,15.21
9835905,9974787,4672,1635200,11609987,16.39
9835906,9963311,3461,1211350,11174661,12.16
9835907,1583515,596,208600,1792115,13.17
9835908,9978897,2274,795900,10774797,7.98
9835909,9769742,2770,969500,10739242,9.92
9835910,9971843,3665,1282750,11254593,12.86
9835911,9977398,4039,1413650,11391048,14.17
9835912,9973274,3868,1353800,11327074,13.57
9835913,9944467,3167,1108450,11052917,11.15
9835914,9973009,5327,1864450,11837459,18.69
9835915,9969314,2093,732550,10701864,7.35
9835917,9970978,2952,1033200,11004178,10.36
9835918,9961324,4961,1736350,11697674,17.43
9835919,9984810,4344,1520400,11505210,15.23
9835920,3850800,2088,730800,4581600,18.98
9835921,9977593,4578,1602300,11579893,16.06
9835922,9994580,2709,948150,10942730,9.49
9835923,9993010,3641,1274350,11267360,12.75
9835924,2526380,945,330750,2857130,13.09
9835925,2479117,1465,512750,2991867,20.68
9835926,9988932,3461,1211350,11200282,12.13
9835927,9970525,5420,1897000,11867525,19.03
9835928,2656658,1086,380100,3036758,14.31
9835929,8315743,5182,1813700,10129443,21.81
9835930,9988387,2975,1041250,11029637,10.42
9835931,9981070,2222,777700,10758770,7.79
9835932,9994691,3820,1337000,11331691,13.38
9835933,3347117,716,250600,3597717,7.49
9835934,9974201,4029,1410150,11384351,14.14
9835935,9981732,3963,1387050,11368782,13.90
9835936,9984944,3164,1107400,11092344,11.09
9835937,9986633,4461,1561350,11547983,15.63
9835938,9991197,2963,1037050,11028247,10.38
9835939,8213957,2375,831250,9045207,10.12
9835940,9974190,4575,1601250,11575440,16.05
9835941,9984425,3790,1326500,11310925,13.29
9835942,9938093,2729,955150,10893243,9.61
9835943,9988754,3636,1272600,11261354,12.74
9835944,9944973,2934,1026900,10971873,10.33
9835945,9982160,4339,1518650,11500810,15.21
9835946,9981571,2738,958300,10939871,9.60
9835947,9987137,1184,414400,10401537,4.15
9835948,9878558,2829,990150,10868708,10.02
9835949,9969295,1957,684950,10654245,6.87
9835950,9570638,6037,2112950,11683588,22.08
9835951,9976799,3726,1304100,11280899,13.07
9835953,9973248,5843,2045050,12018298,20.51
9835954,9880028,5322,1862700,11742728,18.85
9835955,8676663,5373,1880550,10557213,21.67
9835956,9964297,3943,1380050,11344347,13.85
9835957,9974632,4609,1613150,11587782,16.17
9835958,9979643,2637,922950,10902593,9.25
9835959,9966569,3194,1117900,11084469,11.22
9835960,9983794,3806,1332100,11315894,13.34
9835961,9965317,5592,1957200,11922517,19.64
9835962,9981027,3781,1323350,11304377,13.26
9835963,9983492,2478,867300,10850792,8.69
9835964,9983767,2576,901600,10885367,9.03
9835965,9975913,2269,794150,10770063,7.96
9835966,9976383,2106,737100,10713483,7.39
9835967,5957172,2703,946050,6903222,15.88
9835968,9976135,4346,1521100,11497235,15.25
9835969,9981673,5996,2098600,12080273,21.02
9835970,9988704,4871,1704850,11693554,17.07
9835971,9962844,3740,1309000,11271844,13.14
9835972,9970688,2469,864150,10834838,8.67
9835973,9975661,3032,1061200,11036861,10.64
9835974,7040024,4183,1464050,8504074,20.80
9835975,9975115,3559,1245650,11220765,12.49
9835976,9976440,5860,2051000,12027440,20.56
9835977,9970133,1950,682500,10652633,6.85
9835978,9978526,4540,1589000,11567526,15.92
9835979,9997894,3977,1391950,11389844,13.92
9835980,9986911,2643,925050,10911961,9.26
9835981,9996436,3008,1052800,11049236,10.53
9835982,9978154,3160,1106000,11084154,11.08
9835983,9987529,3908,1367800,11355329,13.70
9835984,1158585,557,194950,1353535,16.83
9835985,9988627,3959,1385650,11374277,13.87
9835986,9999969,4232,1481200,11481169,14.81
9835987,9998439,3291,1151850,11150289,11.52
9835988,9990809,3164,1107400,11098209,11.08
9835989,9992676,2716,950600,10943276,9.51
9835990,9988136,805,281750,10269886,2.82
9835991,9991140,1905,666750,10657890,6.67
9835992,9987416,2462,861700,10849116,8.63
9835993,9990884,2377,831950,10822834,8.33
9835994,9959079,341,119350,10078429,1.20
9835995,9993640,1146,401100,10394740,4.01
9835997,9971060,2859,1000650,10971710,10.04
9835998,9983618,3746,1311100,11294718,13.13
9835999,9985904,5574,1950900,11936804,19.54
9836000,9980266,3801,1330350,11310616,13.33
9836001,9994036,1255,439250,10433286,4.40
9836002,151538,66,23100,174638,15.24
9836003,9960834,2415,845250,10806084,8.49
9836004,9960077,2714,949900,10909977,9.54
9836005,9975762,2295,803250,10779012,8.05
9836006,9964381,1772,620200,10584581,6.22
9836007,9984324,1402,490700,10475024,4.91
9836008,9974681,866,303100,10277781,3.04
9836009,9967305,3584,1254400,11221705,12.59
9836010,623351,295,103250,726601,16.56
9836011,190382,150,52500,242882,27.58
9836012,629511,238,83300,712811,13.23
9836013,9961746,5122,1792700,11754446,18.00
9836014,9943307,4524,1583400,11526707,15.92
9836015,9929548,3896,1363600,11293148,13.73
9836016,1469267,504,176400,1645667,12.01
9836017,9917564,955,334250,10251814,3.37
9836019,9921024,1071,374850,10295874,3.78
9836020,9899209,408,142800,10042009,1.44
9836021,9918999,4562,1596700,11515699,16.10
9836022,3208731,2598,909300,4118031,28.34
9836024,9901776,4442,1554700,11456476,15.70
9836025,1044895,961,336350,1381245,32.19
9836026,9900771,2255,789250,10690021,7.97
9836027,9907542,1661,581350,10488892,5.87
9836028,9907627,3414,1194900,11102527,12.06
9836029,9898663,2191,766850,10665513,7.75
9836030,9904113,3915,1370250,11274363,13.84
9836031,9922797,4005,1401750,11324547,14.13
9836032,9906390,3957,1384950,11291340,13.98
9836033,9920794,3166,1108100,11028894,11.17
9836034,9909375,1708,597800,10507175,6.03
9836035,9902518,3825,1338750,11241268,13.52
9836036,9921567,1636,572600,10494167,5.77
9836037,9908479,2042,714700,10623179,7.21
9836038,9904392,4040,1414000,11318392,14.28
9836040,9909802,1761,616350,10526152,6.22
9836041,9894674,3024,1058400,10953074,10.70
9836042,9890469,3618,1266300,11156769,12.80
9836043,4942194,1237,432950,5375144,8.76
9836044,9894416,3059,1070650,10965066,10.82
9836045,9871712,1973,690550,10562262,7.00
9836046,9885404,3123,1093050,10978454,11.06
9836047,9885506,3427,1199450,11084956,12.13
9836048,2054716,1751,612850,2667566,29.83
9836049,9867243,2656,929600,10796843,9.42
9836050,9891793,1722,602700,10494493,6.09
9836051,9874980,5043,1765050,11640030,17.87
9836052,9862665,4173,1460550,11323215,14.81
9836054,9852869,3244,1135400,10988269,11.52
9836055,9861317,1761,616350,10477667,6.25
9836056,9872879,4084,1429400,11302279,14.48
9836058,9874367,2168,758800,10633167,7.68
9836059,9862413,3826,1339100,11201513,13.58
9836060,9854841,3856,1349600,11204441,13.69
9836061,7798488,3036,1062600,8861088,13.63
9836062,9359472,4491,1571850,10931322,16.79
9836063,8526265,3585,1254750,9781015,14.72
9836064,9885334,3609,1263150,11148484,12.78
9836065,1520500,254,88900,1609400,5.85
9836066,9865082,2301,805350,10670432,8.16
9836067,9871512,7224,2528400,12399912,25.61
9836068,9878555,2902,1015700,10894255,10.28
9836069,9863571,1013,354550,10218121,3.59
9836070,9858159,4175,1461250,11319409,14.82
9836071,9856414,5802,2030700,11887114,20.60
9836072,9863492,1387,485450,10348942,4.92
9836073,9872308,3658,1280300,11152608,12.97
9836074,9887145,2969,1039150,10926295,10.51
9836076,3595445,1051,367850,3963295,10.23
9836077,9879143,4420,1547000,11426143,15.66
9836078,9886581,1271,444850,10331431,4.50
9836079,9890239,3638,1273300,11163539,12.87
9836080,1983795,891,311850,2295645,15.72
9836081,5438870,2192,767200,6206070,14.11
9836082,9888908,4233,1481550,11370458,14.98
9836083,78713,22,7700,86413,9.78
9836084,9891612,1558,545300,10436912,5.51
9836085,9905865,2932,1026200,10932065,10.36
9836086,9893211,4552,1593200,11486411,16.10
9836087,9889396,2442,854700,10744096,8.64
9836088,9911328,2776,971600,10882928,9.80
9836089,9885521,3396,1188600,11074121,12.02
9836090,9892103,2902,1015700,10907803,10.27
9836091,9909098,4591,1606850,11515948,16.22
9836092,2912950,1240,434000,3346950,14.90
9836093,9909878,3855,1349250,11259128,13.62
9836094,9907482,3758,1315300,11222782,13.28
9836095,9611254,4653,1628550,11239804,16.94
9836096,1540334,178,62300,1602634,4.04
9836097,1297768,539,188650,1486418,14.54
9836098,9908479,3438,1203300,11111779,12.14
9836099,9914220,3771,1319850,11234070,13.31
9836100,9921662,3710,1298500,11220162,13.09
9836101,9913029,4007,1402450,11315479,14.15
9836102,5170749,2829,990150,6160899,19.15
9836103,9883306,3881,1358350,11241656,13.74
9836104,9792751,2588,905800,10698551,9.25
9836107,9886474,3566,1248100,11134574,12.62
9836108,5354451,4708,1647800,7002251,30.77
9836109,8547644,3995,1398250,9945894,16.36
9836110,9871030,2838,993300,10864330,10.06
9836111,9462118,3557,1244950,10707068,13.16
9836112,9876058,2147,751450,10627508,7.61
9836113,9879720,3533,1236550,11116270,12.52
9836114,9872282,1702,595700,10467982,6.03
9836115,9873261,3249,1137150,11010411,11.52
9836116,9861150,2460,861000,10722150,8.73
9836117,9857196,2480,868000,10725196,8.81
9836118,9866142,3124,1093400,10959542,11.08
9836119,9843400,2659,930650,10774050,9.45
9836121,9857405,2632,921200,10778605,9.35
9836122,9862856,3705,1296750,11159606,13.15
9836123,9849170,2096,733600,10582770,7.45
9836124,9866771,1613,564550,10431321,5.72
9836125,9687726,6693,2342550,12030276,24.18
9836126,9876163,1601,560350,10436513,5.67
9836127,9880365,959,335650,10216015,3.40
9836128,3198473,1545,540750,3739223,16.91
9836129,9876401,5777,2021950,11898351,20.47
9836130,9894452,786,275100,10169552,2.78
9836132,9865510,3716,1300600,11166110,13.18
9836133,9869609,3618,1266300,11135909,12.83
9836134,9863779,7866,2753100,12616879,27.91
9836135,3397539,231,80850,3478389,2.38
9836136,9865342,4614,1614900,11480242,16.37
9836137,9863524,3778,1322300,11185824,13.41
9836138,1941633,1641,574350,2515983,29.58
9836139,9882511,2888,1010800,10893311,10.23
9836140,9882164,2558,895300,10777464,9.06
9836141,9891140,2671,934850,10825990,9.45
9836142,9880000,2959,1035650,10915650,10.48
9836143,9866329,3828,1339800,11206129,13.58
9836144,8175903,2183,764050,8939953,9.35
9836145,9902864,4363,1527050,11429914,15.42
9836146,9883034,812,284200,10167234,2.88
9836147,9895655,3133,1096550,10992205,11.08
9836148,9905240,1263,442050,10347290,4.46
9836149,9904133,2141,749350,10653483,7.57
9836150,9905809,868,303800,10209609,3.07
9836151,9839075,1196,418600,10257675,4.25
9836152,9924204,1075,376250,10300454,3.79
9836153,9938519,1146,401100,10339619,4.04
9836154,9951538,2071,724850,10676388,7.28
9836155,9956793,492,172200,10128993,1.73
9836156,9911992,3344,1170400,11082392,11.81
9836157,9956589,1347,471450,10428039,4.74
9836158,802666,330,115500,918166,14.39
9836159,9934020,4491,1571850,11505870,15.82
9836160,9955448,2460,861000,10816448,8.65
9836161,9949506,1579,552650,10502156,5.55
9836162,2182118,1409,493150,2675268,22.60
9836163,9975674,1452,508200,10483874,5.09
9836164,9989012,2627,919450,10908462,9.20
9836165,9984613,2293,802550,10787163,8.04
9836166,1318629,495,173250,1491879,13.14
9836167,9947670,1465,512750,10460420,5.15
9836168,9983553,4843,1695050,11678603,16.98
9836169,9990658,4492,1572200,11562858,15.74
9836170,9987937,3224,1128400,11116337,11.30
9836171,1514789,484,169400,1684189,11.18
9836172,9993612,3409,1193150,11186762,11.94
9836173,9981368,2965,1037750,11019118,10.40
9836174,9989360,2731,955850,10945210,9.57
9836175,9996207,3580,1253000,11249207,12.53
9836176,9987088,1945,680750,10667838,6.82
9836177,9999381,3678,1287300,11286681,12.87
9836178,9997656,2976,1041600,11039256,10.42
9836179,9997219,1312,459200,10456419,4.59
9836180,4307060,553,193550,4500610,4.49
9836181,9972253,2984,1044400,11016653,10.47
9836182,9990413,3946,1381100,11371513,13.82
9836183,2693745,992,347200,3040945,12.89
9836184,9974669,5421,1897350,11872019,19.02
9836185,9983174,4233,1481550,11464724,14.84
9836186,9962541,3883,1359050,11321591,13.64
9836187,9998783,5672,1985200,11983983,19.85
9836188,9990363,3652,1278200,11268563,12.79
9836189,9982384,2945,1030750,11013134,10.33
9836190,9982379,3419,1196650,11179029,11.99
9836191,9980642,2498,874300,10854942,8.76
9836192,9987460,3850,1347500,11334960,13.49
9836193,9982891,4606,1612100,11594991,16.15
9836194,9975650,5328,1864800,11840450,18.69
9836195,8518881,3627,1269450,9788331,14.90
9836196,9966404,4464,1562400,11528804,15.68
9836197,9959331,2615,915250,10874581,9.19
9836198,9976395,1341,469350,10445745,4.70
9836199,9985699,2041,714350,10700049,7.15
9836201,4144936,1394,487900,4632836,11.77
9836202,9974344,2559,895650,10869994,8.98
9836203,7095652,2997,1048950,8144602,14.78
9836204,9984677,2357,824950,10809627,8.26
9836205,9968960,4551,1592850,11561810,15.98
9836206,5070773,3779,1322650,6393423,26.08
9836207,9977353,2995,1048250,11025603,10.51
9836208,8130819,2765,967750,9098569,11.90
9836209,9964195,6560,2296000,12260195,23.04
9836210,9958461,4753,1663550,11622011,16.70
9836211,9964942,2678,937300,10902242,9.41
9836212,9980035,2578,902300,10882335,9.04
9836213,9983328,3947,1381450,11364778,13.84
9836214,9975604,2251,787850,10763454,7.90
9836215,9983448,2724,953400,10936848,9.55
9836216,9994639,2807,982450,10977089,9.83
9836217,9905675,4373,1530550,11436225,15.45
9836218,9977165,1872,655200,10632365,6.57
9836219,9973361,4574,1600900,11574261,16.05
9836220,9988869,2950,1032500,11021369,10.34
9836221,9980136,4643,1625050,11605186,16.28
9836222,9987130,1416,495600,10482730,4.96
9836223,9982990,3140,1099000,11081990,11.01
9836224,9998240,3120,1092000,11090240,10.92
9836225,9974148,3420,1197000,11171148,12.00
9836226,9970796,4037,1412950,11383746,14.17
9836227,9983978,3073,1075550,11059528,10.77
9836228,9984710,3686,1290100,11274810,12.92
9836229,8978629,3042,1064700,10043329,11.86
9836230,9979400,3659,1280650,11260050,12.83
9836231,9587607,3223,1128050,10715657,11.77
9836232,9964247,2576,901600,10865847,9.05
9836233,9977336,3604,1261400,11238736,12.64
9836234,9961087,3267,1143450,11104537,11.48
9836235,9978649,3343,1170050,11148699,11.73
9836236,9954834,4824,1688400,11643234,16.96
9836237,6944632,1600,560000,7504632,8.06
9836238,8709204,3656,1279600,9988804,14.69
9836239,9957789,2983,1044050,11001839,10.48
9836240,9964147,1148,401800,10365947,4.03
9836241,9969023,4453,1558550,11527573,15.63
9836242,5782699,1968,688800,6471499,11.91
9836243,9977343,4323,1513050,11490393,15.16
9836245,9984985,1009,353150,10338135,3.54
9836246,9968279,3683,1289050,11257329,12.93
9836247,9963762,2654,928900,10892662,9.32
9836248,9969643,3915,1370250,11339893,13.74
9836249,9969297,2746,961100,10930397,9.64
9836250,9980722,2903,1016050,10996772,10.18
9836251,9964616,2126,744100,10708716,7.47
9836253,3889783,1261,441350,4331133,11.35
9836254,9937644,3877,1356950,11294594,13.65
9836255,9987187,2459,860650,10847837,8.62
9836256,9948327,2167,758450,10706777,7.62
9836257,9960137,660,231000,10191137,2.32
9836258,9973493,3124,1093400,11066893,10.96
9836259,9974755,3092,1082200,11056955,10.85
9836260,5570257,2001,700350,6270607,12.57
9836261,9995227,3032,1061200,11056427,10.62
9836262,9993394,2343,820050,10813444,8.21
9836263,9980624,4351,1522850,11503474,15.26
9836264,9980585,3907,1367450,11348035,13.70
9836265,9989520,1522,532700,10522220,5.33
9836266,1390629,469,164150,1554779,11.80
9836267,9973428,1227,429450,10402878,4.31
9836268,9982343,4611,1613850,11596193,16.17
9836269,9980197,2897,1013950,10994147,10.16
9836270,9951854,4181,1463350,11415204,14.70
9836271,3728091,1106,387100,4115191,10.38
9836272,4699634,2272,795200,5494834,16.92
9836273,9994318,3933,1376550,11370868,13.77
9836274,9976452,2523,883050,10859502,8.85
9836275,9372406,3475,1216250,10588656,12.98
9836276,9971033,3681,1288350,11259383,12.92
9836277,9979936,3123,1093050,11072986,10.95
9836278,9966890,2655,929250,10896140,9.32
9836279,9979307,4886,1710100,11689407,17.14
9836280,9981803,2254,788900,10770703,7.90
9836281,9979792,1639,573650,10553442,5.75
9836282,9983944,3451,1207850,11191794,12.10
9836283,9994491,2241,784350,10778841,7.85
9836284,9980420,3194,1117900,11098320,11.20
9836285,432126,208,72800,504926,16.85
9836286,9969044,2755,964250,10933294,9.67
9836287,9965443,1033,361550,10326993,3.63
9836288,9952984,4884,1709400,11662384,17.17
9836289,9973654,1331,465850,10439504,4.67
9836290,9979875,3100,1085000,11064875,10.87
9836291,9972877,2096,733600,10706477,7.36
9836292,9984554,2272,795200,10779754,7.96
9836293,9997671,2559,895650,10893321,8.96
9836294,9999807,2711,948850,10948657,9.49
9836295,9987936,3194,1117900,11105836,11.19
9836296,9982236,2857,999950,10982186,10.02
9836297,9992851,2716,950600,10943451,9.51
9836298,9992874,2558,895300,10888174,8.96
9836299,8059830,2335,817250,8877080,10.14
9836300,9961128,208,72800,10033928,0.73
9836301,3042680,533,186550,3229230,6.13
9836302,9979502,4534,1586900,11566402,15.90
9836303,9988852,2535,887250,10876102,8.88
9836304,9601505,4085,1429750,11031255,14.89
9836305,9987218,4167,1458450,11445668,14.60
9836306,9990910,1527,534450,10525360,5.35
9836307,9967935,4450,1557500,11525435,15.63
9836308,9963505,3362,1176700,11140205,11.81
9836309,9974152,2394,837900,10812052,8.40
9836310,9981468,3503,1226050,11207518,12.28
9836311,3212673,423,148050,3360723,4.61
9836312,9974123,3084,1079400,11053523,10.82
9836313,9980695,3726,1304100,11284795,13.07
9836314,3037036,1205,421750,3458786,13.89
9836315,9970126,3627,1269450,11239576,12.73
9836316,9979249,946,331100,10310349,3.32
9836317,9972830,3139,1098650,11071480,11.02
9836318,3587021,433,151550,3738571,4.22
9836319,9992195,4038,1413300,11405495,14.14
9836320,9986120,4223,1478050,11464170,14.80
9836321,582731,247,86450,669181,14.84
9836322,9972995,1990,696500,10669495,6.98
9836323,9956427,3232,1131200,11087627,11.36
9836324,9965499,1541,539350,10504849,5.41
9836325,9976470,3440,1204000,11180470,12.07
9836326,9990397,3418,1196300,11186697,11.97
9836327,3123753,1407,492450,3616203,15.76
9836328,4550891,1976,691600,5242491,15.20
9836329,9952756,1798,629300,10582056,6.32
9836330,9976555,4471,1564850,11541405,15.69
9836331,6641936,475,166250,6808186,2.50
9836332,753711,294,102900,856611,13.65
9836333,9946042,2570,899500,10845542,9.04
9836334,9952820,4265,1492750,11445570,15.00
9836335,1597739,441,154350,1752089,9.66
9836336,9936627,571,199850,10136477,2.01
9836337,529424,130,45500,574924,8.59
9836338,1052043,603,211050,1263093,20.06
9836339,9942636,1710,598500,10541136,6.02
9836340,7374525,2674,935900,8310425,12.69
9836341,9943993,1736,607600,10551593,6.11
9836342,4094453,1260,441000,4535453,10.77
9836343,616959,387,135450,752409,21.95
9836344,9956800,3627,1269450,11226250,12.75
9836345,9965276,3615,1265250,11230526,12.70
9836346,9968066,2703,946050,10914116,9.49
9836347,9965650,3185,1114750,11080400,11.19
9836348,9956892,3239,1133650,11090542,11.39
9836349,9975691,3316,1160600,11136291,11.63
9836351,9978523,3612,1264200,11242723,12.67
9836352,4161886,973,340550,4502436,8.18
9836353,9987251,4569,1599150,11586401,16.01
9836354,9980542,3194,1117900,11098442,11.20
9836355,9990692,1431,500850,10491542,5.01
9836356,9982930,2426,849100,10832030,8.51
9836357,9980408,3609,1263150,11243558,12.66
9836358,9986872,2872,1005200,10992072,10.07
9836359,8855115,3487,1220450,10075565,13.78
9836360,2673213,1185,414750,3087963,15.52
9836361,9968736,3319,1161650,11130386,11.65
9836362,9976631,2482,868700,10845331,8.71
9836363,4557465,806,282100,4839565,6.19
9836364,9986559,2929,1025150,11011709,10.27
9836365,3698569,1789,626150,4324719,16.93
9836366,9976941,2440,854000,10830941,8.56
9836367,9982846,3707,1297450,11280296,13.00
9836368,9981852,4257,1489950,11471802,14.93
9836369,9987075,2655,929250,10916325,9.30
9836370,9994218,3483,1219050,11213268,12.20
9836371,9988294,4250,1487500,11475794,14.89
9836372,9990694,3241,1134350,11125044,11.35
9836373,9967428,2164,757400,10724828,7.60
9836374,9983604,1124,393400,10377004,3.94
9836375,9980365,1040,364000,10344365,3.65
9836376,9979587,2590,906500,10886087,9.08
9836377,9982846,3185,1114750,11097596,11.17
9836378,9970885,5586,1955100,11925985,19.61
9836379,9993841,4279,1497650,11491491,14.99
9836380,9599214,5015,1755250,11354464,18.29
9836381,85715,66,23100,108815,26.95
9836382,9966665,2561,896350,10863015,8.99
9836383,2617318,727,254450,2871768,9.72
9836384,9970295,4105,1436750,11407045,14.41
9836385,9979282,1985,694750,10674032,6.96
9836386,1526432,308,107800,1634232,7.06
9836387,9947338,1030,360500,10307838,3.62
9836388,3268767,1069,374150,3642917,11.45
9836389,9949551,2953,1033550,10983101,10.39
9836390,9972372,2432,851200,10823572,8.54
9836391,9973275,552,193200,10166475,1.94
9836392,293570,75,26250,319820,8.94
9836393,3493316,1393,487550,3980866,13.96
9836394,9990008,1687,590450,10580458,5.91
9836395,2110747,759,265650,2376397,12.59
9836396,9973257,2899,1014650,10987907,10.17
9836397,9964847,2603,911050,10875897,9.14
9836398,9977213,2852,998200,10975413,10.00
9836399,9972999,4094,1432900,11405899,14.37
9836400,9974781,2424,848400,10823181,8.51
9836401,3442328,752,263200,3705528,7.65
9836402,9986122,2470,864500,10850622,8.66
9836403,9987838,2792,977200,10965038,9.78
9836404,9967828,4119,1441650,11409478,14.46
9836405,9988111,3079,1077650,11065761,10.79
9836407,9460848,3779,1322650,10783498,13.98
9836408,9983595,2196,768600,10752195,7.70
9836409,9961008,4933,1726550,11687558,17.33
9836410,9969509,3474,1215900,11185409,12.20
9836411,9979778,3846,1346100,11325878,13.49
9836412,1400174,440,154000,1554174,11.00
9836413,6299265,1483,519050,6818315,8.24
9836414,8970245,2973,1040550,10010795,11.60
9836415,9960174,860,301000,10261174,3.02
9836416,9816558,1009,353150,10169708,3.60
9836417,9984462,4203,1471050,11455512,14.73
9836418,9990405,4123,1443050,11433455,14.44
9836419,9993335,2825,988750,10982085,9.89
9836420,9976143,4262,1491700,11467843,14.95
9836422,9970012,3354,1173900,11143912,11.77
9836423,9987556,4239,1483650,11471206,14.85
9836424,2674347,615,215250,2889597,8.05
9836425,9984157,3072,1075200,11059357,10.77
9836426,9997120,4243,1485050,11482170,14.85
9836427,9956175,2250,787500,10743675,7.91
9836428,9994567,2045,715750,10710317,7.16
9836429,9989945,3201,1120350,11110295,11.21
9836430,9980008,2227,779450,10759458,7.81
9836431,9988936,4435,1552250,11541186,15.54
9836432,9976978,2722,952700,10929678,9.55
9836433,9984066,1547,541450,10525516,5.42
9836434,9984841,2856,999600,10984441,10.01
9836435,9992844,4003,1401050,11393894,14.02
9836436,5041314,1701,595350,5636664,11.81
9836437,9984996,3430,1200500,11185496,12.02
9836438,1256769,429,150150,1406919,11.95
9836439,4252621,2453,858550,5111171,20.19
9836440,9965426,2845,995750,10961176,9.99
9836441,9963648,2258,790300,10753948,7.93
9836442,2597531,1350,472500,3070031,18.19
9836443,1550388,480,168000,1718388,10.84
9836444,9948468,2876,1006600,10955068,10.12
9836446,2372268,1550,542500,2914768,22.87
9836447,9989626,2332,816200,10805826,8.17
9836448,9991935,2291,801850,10793785,8.02
9836449,99184,81,28350,127534,28.58
9836450,9948653,2256,789600,10738253,7.94
9836451,465070,128,44800,509870,9.63
9836452,9958186,2499,874650,10832836,8.78
9836453,1077388,324,113400,1190788,10.53
9836454,9950536,3684,1289400,11239936,12.96
9836455,9949489,3714,1299900,11249389,13.06
9836456,7439844,3179,1112650,8552494,14.96
9836458,9983745,2485,869750,10853495,8.71
9836459,390773,221,77350,468123,19.79
9836460,8395170,4022,1407700,9802870,16.77
9836461,9961022,3053,1068550,11029572,10.73
9836462,9980317,1818,636300,10616617,6.38
9836463,9980822,3440,1204000,11184822,12.06
9836465,4976077,2592,907200,5883277,18.23
9836466,9983907,5772,2020200,12004107,20.23
9836467,3834119,1197,418950,4253069,10.93
9836468,5388835,1887,660450,6049285,12.26
9836469,9997253,1215,425250,10422503,4.25
9836470,9984522,4171,1459850,11444372,14.62
9836471,9988677,1978,692300,10680977,6.93
9836472,9728286,3337,1167950,10896236,12.01
9836473,9998714,3819,1336650,11335364,13.37
9836474,9988925,3978,1392300,11381225,13.94
9836475,9974963,4572,1600200,11575163,16.04
9836476,4303942,1915,670250,4974192,15.57
9836477,9953443,4022,1407700,11361143,14.14
9836478,9971220,2818,986300,10957520,9.89
9836479,9977308,4542,1589700,11567008,15.93
9836480,9970625,3629,1270150,11240775,12.74
9836481,288543,257,89950,378493,31.17
9836482,157405,82,28700,186105,18.23
9836483,9975625,2501,875350,10850975,8.77
9836484,9980460,6410,2243500,12223960,22.48
9836485,9983041,3657,1279950,11262991,12.82
9836486,9955051,4224,1478400,11433451,14.85
9836487,2753938,744,260400,3014338,9.46
9836488,9959470,4194,1467900,11427370,14.74
9836489,9975487,3861,1351350,11326837,13.55
9836490,9949728,4771,1669850,11619578,16.78
9836491,9955124,2541,889350,10844474,8.93
9836492,9986593,639,223650,10210243,2.24
9836493,9988522,3699,1294650,11283172,12.96
9836494,9984847,1555,544250,10529097,5.45
9836495,9995380,2552,893200,10888580,8.94
9836496,9978882,3766,1318100,11296982,13.21
9836497,9975332,4046,1416100,11391432,14.20
9836498,9987834,1833,641550,10629384,6.42
9836499,9971314,4077,1426950,11398264,14.31
9836500,9991154,3562,1246700,11237854,12.48
9836501,9993846,3155,1104250,11098096,11.05
9836502,2369959,773,270550,2640509,11.42
9836503,5748836,1542,539700,6288536,9.39
9836504,146169,60,21000,167169,14.37
9836505,9991195,3419,1196650,11187845,11.98
9836506,9987509,5270,1844500,11832009,18.47
9836507,9986276,4653,1628550,11614826,16.31
9836508,9984797,778,272300,10257097,2.73
9836509,164958,122,42700,207658,25.89
9836510,9971642,2993,1047550,11019192,10.51
9836511,9967952,2473,865550,10833502,8.68
9836512,961718,323,113050,1074768,11.76
9836513,9949050,3026,1059100,11008150,10.65
9836514,331029,133,46550,377579,14.06
9836515,9965210,3828,1339800,11305010,13.44
9836516,9972750,4088,1430800,11403550,14.35
9836518,9952973,2433,851550,10804523,8.56
9836519,9961537,3282,1148700,11110237,11.53
9836520,9988121,519,181650,10169771,1.82
9836521,3610305,2217,775950,4386255,21.49
9836522,1658615,570,199500,1858115,12.03
9836523,9981663,6278,2197300,12178963,22.01
9836524,9978010,2775,971250,10949260,9.73
9836525,9979625,1273,445550,10425175,4.46
9836526,516590,218,76300,592890,14.77
9836527,9981277,899,314650,10295927,3.15
9836528,9982255,2153,753550,10735805,7.55
9836529,9981029,4841,1694350,11675379,16.98
9836531,9976351,3404,1191400,11167751,11.94
9836532,9919838,3510,1228500,11148338,12.38
9836533,9966013,3794,1327900,11293913,13.32
9836534,4559045,753,263550,4822595,5.78
9836535,9972239,3657,1279950,11252189,12.84
9836536,9979649,2616,915600,10895249,9.17
9836537,5423022,1730,605500,6028522,11.17
9836538,9980425,3807,1332450,11312875,13.35
9836539,9979241,3755,1314250,11293491,13.17
9836540,9983649,675,236250,10219899,2.37
9836541,9962550,2440,854000,10816550,8.57
9836542,9951659,2784,974400,10926059,9.79
9836543,2009352,1034,361900,2371252,18.01
9836544,9939271,4734,1656900,11596171,16.67
9836545,2786035,1793,627550,3413585,22.52
9836546,9439802,3544,1240400,10680202,13.14
9836547,9929547,3423,1198050,11127597,12.07
9836548,5959073,2886,1010100,6969173,16.95
9836549,9929284,2169,759150,10688434,7.65
9836550,9883326,3863,1352050,11235376,13.68
9836551,9924528,1069,374150,10298678,3.77
9836552,9902732,894,312900,10215632,3.16
9836553,9919346,4292,1502200,11421546,15.14
9836554,9909111,3012,1054200,10963311,10.64
9836555,9912798,4513,1579550,11492348,15.93
9836556,9925544,5389,1886150,11811694,19.00
9836557,9931977,4867,1703450,11635427,17.15
9836558,9929939,4076,1426600,11356539,14.37
9836559,9916824,2965,1037750,10954574,10.46
9836560,872317,327,114450,986767,13.12
9836561,9875497,5368,1878800,11754297,19.02
9836562,9892727,556,194600,10087327,1.97
9836563,9909744,4782,1673700,11583444,16.89
9836564,9914586,4096,1433600,11348186,14.46
9836565,9916007,2276,796600,10712607,8.03
9836566,9916216,4124,1443400,11359616,14.56
9836567,9916747,4468,1563800,11480547,15.77
9836568,1181456,606,212100,1393556,17.95
9836569,9904890,3033,1061550,10966440,10.72
9836570,9668264,4360,1526000,11194264,15.78
9836571,9915156,5458,1910300,11825456,19.27
9836572,614666,450,157500,772166,25.62
9836573,9939598,5216,1825600,11765198,18.37
9836574,133394,42,14700,148094,11.02
9836575,9937996,4068,1423800,11361796,14.33
9836576,9959132,3930,1375500,11334632,13.81
9836577,1797010,929,325150,2122160,18.09
9836578,9913283,3232,1131200,11044483,11.41
9836579,9934768,2683,939050,10873818,9.45
9836580,9961708,2012,704200,10665908,7.07
9836581,6677803,2773,970550,7648353,14.53
9836582,9956660,2505,876750,10833410,8.81
9836583,9972887,2953,1033550,11006437,10.36
9836584,9879015,2904,1016400,10895415,10.29
9836585,238857,229,80150,319007,33.56
9836586,7946853,2199,769650,8716503,9.68
9836587,9986657,4372,1530200,11516857,15.32
9836588,9975205,4329,1515150,11490355,15.19
9836589,9979932,4638,1623300,11603232,16.27
9836590,9999848,1359,475650,10475498,4.76
9836591,9998407,5009,1753150,11751557,17.53
9836592,9974822,4260,1491000,11465822,14.95
9836593,9976178,3708,1297800,11273978,13.01
9836594,9953064,4226,1479100,11432164,14.86
9836595,8141091,4159,1455650,9596741,17.88
9836596,5109018,1661,581350,5690368,11.38
9836597,9990287,4941,1729350,11719637,17.31
9836598,9983873,1055,369250,10353123,3.70
9836599,9974433,2042,714700,10689133,7.17
9836600,9982546,3703,1296050,11278596,12.98
9836601,9978979,3591,1256850,11235829,12.59
9836602,9973060,2608,912800,10885860,9.15
9836603,9959793,3277,1146950,11106743,11.52
9836604,3286515,1064,372400,3658915,11.33
9836605,9958231,3635,1272250,11230481,12.78
9836606,9934419,3053,1068550,11002969,10.76
9836607,9972394,3016,1055600,11027994,10.59
9836608,9965928,1544,540400,10506328,5.42
9836609,9993958,2094,732900,10726858,7.33
9836610,9971721,3459,1210650,11182371,12.14
9836611,9961167,4209,1473150,11434317,14.79
9836612,9969423,4267,1493450,11462873,14.98
9836613,9975060,3500,1225000,11200060,12.28
9836614,9984462,4877,1706950,11691412,17.10
9836615,9973019,3645,1275750,11248769,12.79
9836616,9958363,3804,1331400,11289763,13.37
9836617,1305449,525,183750,1489199,14.08
9836618,9973485,2791,976850,10950335,9.79
9836619,9962525,4614,1614900,11577425,16.21
9836620,9986042,5445,1905750,11891792,19.08
9836621,6055872,2510,878500,6934372,14.51
9836622,9957211,3672,1285200,11242411,12.91
9836623,9959092,2819,986650,10945742,9.91
9836624,9951522,3164,1107400,11058922,11.13
9836626,9964158,4172,1460200,11424358,14.65
9836627,9976633,2728,954800,10931433,9.57
9836628,9979119,3040,1064000,11043119,10.66
9836629,9989145,2796,978600,10967745,9.80
9836630,9982835,2863,1002050,10984885,10.04
9836631,9989829,3538,1238300,11228129,12.40
9836632,1391639,493,172550,1564189,12.40
9836633,9997774,3471,1214850,11212624,12.15
9836634,9981307,2789,976150,10957457,9.78
9836636,9946775,2534,886900,10833675,8.92
9836637,9954958,4614,1614900,11569858,16.22
9836638,9968640,3701,1295350,11263990,12.99
9836639,9970983,2516,880600,10851583,8.83
9836640,7473951,1497,523950,7997901,7.01
9836641,9976303,4950,1732500,11708803,17.37
9836642,8448358,5412,1894200,10342558,22.42
9836643,9977099,3985,1394750,11371849,13.98
9836645,9965488,2184,764400,10729888,7.67
9836646,9962017,3813,1334550,11296567,13.40
9836647,3405875,1013,354550,3760425,10.41
9836648,9943212,1687,590450,10533662,5.94
9836649,9270931,1321,462350,9733281,4.99
9836650,9912455,2504,876400,10788855,8.84
9836651,9924627,3140,1099000,11023627,11.07
9836652,9947127,5283,1849050,11796177,18.59
9836653,9957111,1761,616350,10573461,6.19
9836654,9967001,5515,1930250,11897251,19.37
9836655,9968966,2376,831600,10800566,8.34
9836656,2011093,1553,543550,2554643,27.03
9836657,9987045,3596,1258600,11245645,12.60
9836658,6111164,757,264950,6376114,4.34
9836659,1095685,1100,385000,1480685,35.14
9836660,9971060,1243,435050,10406110,4.36
9836661,9955135,5523,1933050,11888185,19.42
9836662,9973502,1687,590450,10563952,5.92
9836663,9968879,962,336700,10305579,3.38
9836665,3620764,505,176750,3797514,4.88
9836666,9976416,4779,1672650,11649066,16.77
9836667,9965280,2603,911050,10876330,9.14
9836668,9982505,2188,765800,10748305,7.67
9836669,9981642,2676,936600,10918242,9.38
9836671,9984505,2945,1030750,11015255,10.32
9836672,9988169,4072,1425200,11413369,14.27
9836673,9997229,2040,714000,10711229,7.14
9836674,9986644,3357,1174950,11161594,11.77
9836675,9540911,4725,1653750,11194661,17.33
9836676,9965110,3220,1127000,11092110,11.31
9836677,9981658,3799,1329650,11311308,13.32
9836678,9956286,3356,1174600,11130886,11.80
9836679,9961359,3576,1251600,11212959,12.56
9836680,9940512,3232,1131200,11071712,11.38
9836681,1191553,497,173950,1365503,14.60
9836682,3956257,879,307650,4263907,7.78
9836683,8100538,3014,1054900,9155438,13.02
9836684,9951291,3161,1106350,11057641,11.12
9836685,9965916,2596,908600,10874516,9.12
9836686,9974655,3227,1129450,11104105,11.32
9836687,9980666,997,348950,10329616,3.50
9836688,9972626,2576,901600,10874226,9.04
9836689,9985355,3496,1223600,11208955,12.25
9836690,9970148,2614,914900,10885048,9.18
9836691,9983627,4071,1424850,11408477,14.27
9836692,9983281,4137,1447950,11431231,14.50
9836693,1197669,695,243250,1440919,20.31
9836694,9987029,2819,986650,10973679,9.88
9836695,9980614,4351,1522850,11503464,15.26
9836696,2665897,1833,641550,3307447,24.07
9836697,9986690,3798,1329300,11315990,13.31
9836698,1084730,497,173950,1258680,16.04
9836699,9989498,3564,1247400,11236898,12.49
9836700,1430340,718,251300,1681640,17.57
9836701,9958270,3370,1179500,11137770,11.84
9836702,4424805,478,167300,4592105,3.78
9836703,5632220,2309,808150,6440370,14.35
9836704,9963960,3680,1288000,11251960,12.93
9836705,9960372,4162,1456700,11417072,14.62
9836707,9952462,2558,895300,10847762,9.00
9836708,9958621,2071,724850,10683471,7.28
9836709,9953026,2991,1046850,10999876,10.52
9836710,9965414,2961,1036350,11001764,10.40
9836711,9970154,4371,1529850,11500004,15.34
9836712,9977166,2250,787500,10764666,7.89
9836713,1752808,612,214200,1967008,12.22
9836715,9223137,1478,517300,9740437,5.61
9836716,9999241,2529,885150,10884391,8.85
9836717,9991360,2232,781200,10772560,7.82
9836718,9998386,3695,1293250,11291636,12.93
9836720,9972577,1901,665350,10637927,6.67
9836721,9981405,4058,1420300,11401705,14.23
9836722,9997251,3315,1160250,11157501,11.61
9836723,9992249,2631,920850,10913099,9.22
9836724,9434482,4638,1623300,11057782,17.21
9836725,9975860,2471,864850,10840710,8.67
9836726,9988939,1724,603400,10592339,6.04
9836727,9997121,2628,919800,10916921,9.20
9836728,9981056,2773,970550,10951606,9.72
9836729,9978367,2884,1009400,10987767,10.12
9836730,9992423,4516,1580600,11573023,15.82
9836731,9979382,2276,796600,10775982,7.98
9836732,9993180,2002,700700,10693880,7.01
9836733,9995974,3278,1147300,11143274,11.48
9836734,8032541,2926,1024100,9056641,12.75
9836735,9981366,2631,920850,10902216,9.23
9836736,9990520,3431,1200850,11191370,12.02
9836737,9986007,3935,1377250,11363257,13.79
9836738,9990587,2705,946750,10937337,9.48
9836739,9978323,2138,748300,10726623,7.50
9836740,9981116,1577,551950,10533066,5.53
9836741,9975942,2107,737450,10713392,7.39
9836742,9963325,2039,713650,10676975,7.16
9836743,9978099,3026,1059100,11037199,10.61
9836744,9976274,4188,1465800,11442074,14.69
9836745,9917771,4847,1696450,11614221,17.11
9836746,9996515,4322,1512700,11509215,15.13
9836747,9982227,2531,885850,10868077,8.87
9836748,9986859,4961,1736350,11723209,17.39
9836749,9974774,4166,1458100,11432874,14.62
9836750,9961978,3263,1142050,11104028,11.46
9836751,9976054,2670,934500,10910554,9.37
9836752,9984914,2521,882350,10867264,8.84
9836753,9992431,1470,514500,10506931,5.15
9836754,9991445,4778,1672300,11663745,16.74
9836755,9973825,2332,816200,10790025,8.18
9836757,9975506,2678,937300,10912806,9.40
9836758,9985871,3065,1072750,11058621,10.74
9836759,9975262,1207,422450,10397712,4.23
9836760,9967105,3079,1077650,11044755,10.81
9836762,9963225,2909,1018150,10981375,10.22
9836763,9974018,6058,2120300,12094318,21.26
9836764,9969093,5057,1769950,11739043,17.75
9836765,9950293,1868,653800,10604093,6.57
9836766,9942872,3167,1108450,11051322,11.15
9836767,9945006,2186,765100,10710106,7.69
9836768,9960573,1466,513100,10473673,5.15
9836769,9953263,3502,1225700,11178963,12.31
9836770,9263064,2242,784700,10047764,8.47
9836771,9952392,3525,1233750,11186142,12.40
9836772,9966880,4521,1582350,11549230,15.88
9836773,9962093,2845,995750,10957843,10.00
9836774,9959438,4489,1571150,11530588,15.78
9836775,2418808,1910,668500,3087308,27.64
9836776,4795462,733,256550,5052012,5.35
9836777,9979274,3179,1112650,11091924,11.15
9836778,9982901,5196,1818600,11801501,18.22
9836779,9992556,3405,1191750,11184306,11.93
9836780,9980944,1930,675500,10656444,6.77
9836781,7064226,3927,1374450,8438676,19.46
9836782,9983055,3672,1285200,11268255,12.87
9836783,9976019,3632,1271200,11247219,12.74
9836784,9975421,5434,1901900,11877321,19.07
9836785,9996092,2661,931350,10927442,9.32
9836786,9996664,3495,1223250,11219914,12.24
9836787,9971082,4997,1748950,11720032,17.54
9836788,9978242,2565,897750,10875992,9.00
9836789,9979475,2030,710500,10689975,7.12
9836790,9987299,4704,1646400,11633699,16.48
9836791,9985838,3732,1306200,11292038,13.08
9836792,9962071,3532,1236200,11198271,12.41
9836794,9977512,1772,620200,10597712,6.22
9836795,9985017,4204,1471400,11456417,14.74
9836796,9978798,3968,1388800,11367598,13.92
9836797,9971672,5968,2088800,12060472,20.95
9836798,9986083,2652,928200,10914283,9.29
9836799,6361614,2332,816200,7177814,12.83
9836800,9979344,3406,1192100,11171444,11.95
9836801,9987899,5194,1817900,11805799,18.20
9836803,9975463,2251,787850,10763313,7.90
9836804,9986248,4100,1435000,11421248,14.37
9836805,9969959,2769,969150,10939109,9.72
9836806,9942393,3375,1181250,11123643,11.88
9836807,9960261,3169,1109150,11069411,11.14
9836809,4590423,1069,374150,4964573,8.15
9836810,9952183,5176,1811600,11763783,18.20
9836811,2532677,1845,645750,3178427,25.50
9836812,9944455,1642,574700,10519155,5.78
9836813,9944666,6271,2194850,12139516,22.07
9836814,9957800,5212,1824200,11782000,18.32
9836815,1453456,685,239750,1693206,16.50
9836816,9929616,3471,1214850,11144466,12.23
9836817,9946179,2543,890050,10836229,8.95
9836818,9944034,5905,2066750,12010784,20.78
9836819,9950939,3515,1230250,11181189,12.36
9836820,9965127,5507,1927450,11892577,19.34
9836821,9963957,4887,1710450,11674407,17.17
9836822,4256076,1357,474950,4731026,11.16
9836823,9967212,3180,1113000,11080212,11.17
9836824,9980900,1891,661850,10642750,6.63
9836825,9978675,5345,1870750,11849425,18.75
9836826,9970259,4308,1507800,11478059,15.12
9836827,9963331,2728,954800,10918131,9.58
9836828,9963533,2066,723100,10686633,7.26
9836829,9956911,3663,1282050,11238961,12.88
9836830,9964404,6255,2189250,12153654,21.97
9836831,9960439,4759,1665650,11626089,16.72
9836832,5579156,2280,798000,6377156,14.30
9836833,9950527,4888,1710800,11661327,17.19
9836834,9948355,4837,1692950,11641305,17.02
9836835,9949432,5825,2038750,11988182,20.49
9836836,9943969,4486,1570100,11514069,15.79
9836837,9947391,3341,1169350,11116741,11.76
9836838,9964206,4688,1640800,11605006,16.47
9836839,9974886,2566,898100,10872986,9.00
9836840,9985898,4803,1681050,11666948,16.83
9836841,9982971,4533,1586550,11569521,15.89
9836842,9982134,4155,1454250,11436384,14.57
9836843,9985490,2617,915950,10901440,9.17
9836844,9969144,2227,779450,10748594,7.82
9836845,9985030,2771,969850,10954880,9.71
9836846,9983702,2322,812700,10796402,8.14
9836847,9985974,3407,1192450,11178424,11.94
9836848,9993802,4542,1589700,11583502,15.91
9836849,8969452,5403,1891050,10860502,21.08
9836850,9994465,6457,2259950,12254415,22.61
9836851,9982945,5866,2053100,12036045,20.57
9836852,9975944,2147,751450,10727394,7.53
9836853,9994452,2523,883050,10877502,8.84
9836854,8938105,5062,1771700,10709805,19.82
9836855,9981452,3890,1361500,11342952,13.64
9836856,9149632,4780,1673000,10822632,18.28
9836858,9974222,5329,1865150,11839372,18.70
9836859,7861732,4779,1672650,9534382,21.28
9836860,9979543,3542,1239700,11219243,12.42
9836861,9981725,4716,1650600,11632325,16.54
9836862,9978643,4222,1477700,11456343,14.81
9836863,9983190,3899,1364650,11347840,13.67
9836865,9978684,6121,2142350,12121034,21.47
9836866,9962248,3356,1174600,11136848,11.79
9836867,9949702,2036,712600,10662302,7.16
9836869,9951435,3094,1082900,11034335,10.88
9836870,9948113,3845,1345750,11293863,13.53
9836871,9967262,2009,703150,10670412,7.05
9836872,9971735,4436,1552600,11524335,15.57
9836873,9505085,3364,1177400,10682485,12.39
9836874,9975810,3089,1081150,11056960,10.84
9836875,9987551,4672,1635200,11622751,16.37
9836876,9964834,2937,1027950,10992784,10.32
9836877,9954190,3150,1102500,11056690,11.08
9836878,9963216,2556,894600,10857816,8.98
9836879,9959023,3470,1214500,11173523,12.19
9836880,9979663,3744,1310400,11290063,13.13
9836881,9442095,1558,545300,9987395,5.78
9836882,9983235,5097,1783950,11767185,17.87
9836883,9980271,5670,1984500,11964771,19.88
9836884,9974364,3513,1229550,11203914,12.33
9836885,9998896,2972,1040200,11039096,10.40
9836886,9989891,3062,1071700,11061591,10.73
9836887,9990589,5109,1788150,11778739,17.90
9836888,9972197,4862,1701700,11673897,17.06
9836889,9961949,3196,1118600,11080549,11.23
9836890,8995807,2348,821800,9817607,9.14
9836891,9978221,5627,1969450,11947671,19.74
9836892,9979942,1007,352450,10332392,3.53
9836893,9963081,1281,448350,10411431,4.50
9836894,9962005,2955,1034250,10996255,10.38
9836895,9950947,1868,653800,10604747,6.57
9836896,9939997,4163,1457050,11397047,14.66
9836897,9954151,3586,1255100,11209251,12.61
9836898,9963699,4313,1509550,11473249,15.15
9836899,9957989,3421,1197350,11155339,12.02
9836900,9954818,2035,712250,10667068,7.15
9836901,9967686,2281,798350,10766036,8.01
9836902,9954250,4151,1452850,11407100,14.60
9836903,9965767,2698,944300,10910067,9.48
9836904,9975946,1672,585200,10561146,5.87
9836905,9990541,4596,1608600,11599141,16.10
9836906,9994634,1827,639450,10634084,6.40
9836907,9970309,3089,1081150,11051459,10.84
9836908,9986348,3530,1235500,11221848,12.37
9836909,9984745,5474,1915900,11900645,19.19
9836910,9979504,2540,889000,10868504,8.91
9836911,9970307,1921,672350,10642657,6.74
9836912,9959280,2526,884100,10843380,8.88
9836913,9959840,3865,1352750,11312590,13.58
9836914,9953757,3969,1389150,11342907,13.96
9836915,9936505,2915,1020250,10956755,10.27
9836916,9952014,3931,1375850,11327864,13.82
9836917,9959245,2843,995050,10954295,9.99
9836918,9952285,5206,1822100,11774385,18.31
9836919,9939677,697,243950,10183627,2.45
9836921,9928886,3252,1138200,11067086,11.46
9836922,9936674,5372,1880200,11816874,18.92
9836923,9940718,3901,1365350,11306068,13.73
9836924,9948825,2394,837900,10786725,8.42
9836925,9939041,4744,1660400,11599441,16.71
9836926,9936232,3498,1224300,11160532,12.32
9836927,9935379,3385,1184750,11120129,11.92
9836928,9933182,4284,1499400,11432582,15.09
9836930,9414829,4390,1536500,10951329,16.32
9836931,9921890,3247,1136450,11058340,11.45
9836932,9922233,4285,1499750,11421983,15.12
9836934,9937314,4816,1685600,11622914,16.96
9836935,9958076,5061,1771350,11729426,17.79
9836936,9926047,1493,522550,10448597,5.26
9836937,9935967,5138,1798300,11734267,18.10
9836938,9937310,3456,1209600,11146910,12.17
9836939,9941640,2477,866950,10808590,8.72
9836940,9959687,3197,1118950,11078637,11.23
9836941,9949926,3171,1109850,11059776,11.15
9836942,9969276,2083,729050,10698326,7.31
9836943,9945219,2159,755650,10700869,7.60
9836944,9937798,6040,2114000,12051798,21.27
9836945,9856027,4008,1402800,11258827,14.23
9836946,9939897,4380,1533000,11472897,15.42
9836947,9945273,3236,1132600,11077873,11.39
9836948,9939556,3224,1128400,11067956,11.35
9836949,9944992,2249,787150,10732142,7.92
9836950,9948862,1987,695450,10644312,6.99
9836951,9954517,4911,1718850,11673367,17.27
9836952,9973512,2774,970900,10944412,9.73
9836953,9982510,2671,934850,10917360,9.36
9836954,9973469,2840,994000,10967469,9.97
9836955,9980305,5608,1962800,11943105,19.67
9836956,9973103,4646,1626100,11599203,16.30
9836957,9977831,3943,1380050,11357881,13.83
9836958,9974662,3104,1086400,11061062,10.89
9836959,9961034,3993,1397550,11358584,14.03
9836960,9973440,2825,988750,10962190,9.91
9836961,9985648,5297,1853950,11839598,18.57
9836962,9929483,3161,1106350,11035833,11.14
9836963,9971280,3051,1067850,11039130,10.71
9836964,9992189,2192,767200,10759389,7.68
9836965,9964051,2316,810600,10774651,8.14
9836966,9962509,6394,2237900,12200409,22.46
9836967,9959571,2541,889350,10848921,8.93
9836968,9958425,2388,835800,10794225,8.39
9836969,9964590,3392,1187200,11151790,11.91
9836970,9984278,5566,1948100,11932378,19.51
9836971,2303213,986,345100,2648313,14.98
9836972,9987664,3297,1153950,11141614,11.55
9836973,9973345,4337,1517950,11491295,15.22
9836974,9974451,2820,987000,10961451,9.90
9836975,9977331,3457,1209950,11187281,12.13
9836976,9978276,2625,918750,10897026,9.21
9836977,9988506,2919,1021650,11010156,10.23
9836978,9995106,4767,1668450,11663556,16.69
9836979,9998315,3853,1348550,11346865,13.49
9836980,9976543,6101,2135350,12111893,21.40
9836981,9990478,3802,1330700,11321178,13.32
9836982,9960032,3111,1088850,11048882,10.93
9836983,9973024,2279,797650,10770674,8.00
9836984,9970635,3365,1177750,11148385,11.81
9836985,9984057,1014,354900,10338957,3.55
9836986,9978566,4141,1449350,11427916,14.52
9836988,9966973,2981,1043350,11010323,10.47
9836989,9881224,2390,836500,10717724,8.47
9836990,9994365,1589,556150,10550515,5.56
9836991,9997480,4578,1602300,11599780,16.03
9836992,9983319,3413,1194550,11177869,11.97
9836993,9986261,5006,1752100,11738361,17.55
9836994,9975057,5449,1907150,11882207,19.12
9836995,9967545,2434,851900,10819445,8.55
9836996,9979891,3686,1290100,11269991,12.93
9836997,1312448,460,161000,1473448,12.27
9836998,9980122,3455,1209250,11189372,12.12
9836999,9973968,4393,1537550,11511518,15.42
9837000,9981125,2810,983500,10964625,9.85
9837001,9987408,2354,823900,10811308,8.25
9837002,9985180,2174,760900,10746080,7.62
9837003,9997985,1947,681450,10679435,6.82
9837004,9979408,3825,1338750,11318158,13.42
9837006,9979794,2636,922600,10902394,9.24
9837007,9972683,3859,1350650,11323333,13.54
9837008,9971577,3257,1139950,11111527,11.43
9837009,9982145,2856,999600,10981745,10.01
9837010,8958268,1913,669550,9627818,7.47
9837011,9959966,2924,1023400,10983366,10.28
9837012,9983547,4039,1413650,11397197,14.16
9837013,9979912,1307,457450,10437362,4.58
9837014,9980950,4262,1491700,11472650,14.95
9837015,7556191,2580,903000,8459191,11.95
9837016,9991772,4910,1718500,11710272,17.20
9837017,9975525,3730,1305500,11281025,13.09
9837018,9977961,4900,1715000,11692961,17.19
9837019,9982681,2522,882700,10865381,8.84
9837020,9975700,2715,950250,10925950,9.53
9837021,9963161,1903,666050,10629211,6.69
9837022,9984857,4853,1698550,11683407,17.01
9837023,9962632,4090,1431500,11394132,14.37
9837024,9962145,2661,931350,10893495,9.35
9837025,9980250,2608,912800,10893050,9.15
9837026,9957542,2225,778750,10736292,7.82
9837027,9984725,2769,969150,10953875,9.71
9837028,9972867,4693,1642550,11615417,16.47
9837029,9995653,2363,827050,10822703,8.27
9837030,9985506,1489,521150,10506656,5.22
9837031,9999487,2393,837550,10837037,8.38
9837032,9980067,4104,1436400,11416467,14.39
9837033,3263010,1377,481950,3744960,14.77
9837034,9992155,5032,1761200,11753355,17.63
9837035,9972007,2159,755650,10727657,7.58
9837036,9976176,2886,1010100,10986276,10.13
9837037,9972789,4295,1503250,11476039,15.07
9837038,9841181,2906,1017100,10858281,10.34
9837039,9947553,2466,863100,10810653,8.68
9837040,9959603,3915,1370250,11329853,13.76
9837041,9977697,4466,1563100,11540797,15.67
9837043,9968444,3049,1067150,11035594,10.71
9837044,9976401,4471,1564850,11541251,15.69
9837045,9981435,3470,1214500,11195935,12.17
9837046,9976658,4199,1469650,11446308,14.73
9837047,9991766,3243,1135050,11126816,11.36
9837048,9963511,3683,1289050,11252561,12.94
9837049,8414332,2758,965300,9379632,11.47
9837050,9996099,3904,1366400,11362499,13.67
9837051,9974798,2065,722750,10697548,7.25
9837052,6187016,2798,979300,7166316,15.83
9837053,9986669,2695,943250,10929919,9.45
9837054,9980536,3562,1246700,11227236,12.49
9837056,9718797,2500,875000,10593797,9.00
9837057,9779574,2275,796250,10575824,8.14
9837058,9948770,3777,1321950,11270720,13.29
9837059,8841667,3085,1079750,9921417,12.21
9837060,9994972,1370,479500,10474472,4.80
9837062,9971225,2329,815150,10786375,8.18
9837063,9963256,3478,1217300,11180556,12.22
9837064,9972563,2802,980700,10953263,9.83
9837065,9972413,4013,1404550,11376963,14.08
9837066,9994638,5955,2084250,12078888,20.85
9837067,9997521,5021,1757350,11754871,17.58
9837068,9840499,3498,1224300,11064799,12.44
9837069,9981207,4545,1590750,11571957,15.94
9837070,9990668,2925,1023750,11014418,10.25
9837071,3202177,405,141750,3343927,4.43
9837072,9974107,3870,1354500,11328607,13.58
9837073,9995431,3286,1150100,11145531,11.51
9837074,5820927,980,343000,6163927,5.89
9837075,9987447,4099,1434650,11422097,14.36
9837076,9988006,2440,854000,10842006,8.55
9837077,9976775,2543,890050,10866825,8.92
9837078,9965703,5341,1869350,11835053,18.76
9837079,9979569,3515,1230250,11209819,12.33
9837080,9978425,4144,1450400,11428825,14.54
9837081,9976732,4771,1669850,11646582,16.74
9837082,9973323,6172,2160200,12133523,21.66
9837083,9967423,2852,998200,10965623,10.01
9837084,9983407,4422,1547700,11531107,15.50
9837085,9964892,4818,1686300,11651192,16.92
9837086,9964281,3245,1135750,11100031,11.40
9837087,9948607,5520,1932000,11880607,19.42
9837088,9116386,1940,679000,9795386,7.45
9837089,9927112,2717,950950,10878062,9.58
9837090,9940767,4171,1459850,11400617,14.69
9837091,9953550,4299,1504650,11458200,15.12
9837092,9958447,2785,974750,10933197,9.79
9837093,9958658,3861,1351350,11310008,13.57
9837094,9971703,5724,2003400,11975103,20.09
9837095,9949748,3837,1342950,11292698,13.50
9837096,9969094,3001,1050350,11019444,10.54
9837097,9965694,3182,1113700,11079394,11.18
9837098,9954319,2640,924000,10878319,9.28
9837099,9958388,3690,1291500,11249888,12.97
9837100,9947748,3432,1201200,11148948,12.08
9837101,9510167,3331,1165850,10676017,12.26
9837102,9947251,2391,836850,10784101,8.41
9837103,9135891,3954,1383900,10519791,15.15
9837104,9964237,2654,928900,10893137,9.32
9837105,9984899,6665,2332750,12317649,23.36
9837106,9911705,2157,754950,10666655,7.62
9837107,9983090,2171,759850,10742940,7.61
9837108,9987773,3692,1292200,11279973,12.94
9837109,9978090,4804,1681400,11659490,16.85
9837110,9989797,3224,1128400,11118197,11.30
9837111,9980332,3662,1281700,11262032,12.84
9837112,9969517,4767,1668450,11637967,16.74
9837113,9972525,2617,915950,10888475,9.18
9837114,9497304,3858,1350300,10847604,14.22
9837115,8753004,3192,1117200,9870204,12.76
9837116,9986364,4379,1532650,11519014,15.35
9837117,9984337,2894,1012900,10997237,10.14
9837118,9989840,4778,1672300,11662140,16.74
9837119,9974579,2861,1001350,10975929,10.04
9837120,9976109,5368,1878800,11854909,18.83
9837121,9962243,3718,1301300,11263543,13.06
9837122,9973429,4200,1470000,11443429,14.74
9837123,9964984,3951,1382850,11347834,13.88
9837124,9984062,2783,974050,10958112,9.76
9837125,9997587,2998,1049300,11046887,10.50
9837126,9974309,4456,1559600,11533909,15.64
9837127,9998921,3524,1233400,11232321,12.34
9837128,9983922,4753,1663550,11647472,16.66
9837130,9995641,2626,919100,10914741,9.20
9837131,9989976,4264,1492400,11482376,14.94
9837132,9961790,2089,731150,10692940,7.34
9837133,9997739,4550,1592500,11590239,15.93
9837134,9983099,3712,1299200,11282299,13.01
9837135,3448354,954,333900,3782254,9.68
9837136,9958806,4388,1535800,11494606,15.42
9837137,9965512,2808,982800,10948312,9.86
9837138,9930167,4775,1671250,11601417,16.83
9837140,9936829,2339,818650,10755479,8.24
9837142,9930604,3266,1143100,11073704,11.51
9837143,8964367,2287,800450,9764817,8.93
9837144,5279939,3735,1307250,6587189,24.76
9837145,9915043,3482,1218700,11133743,12.29
9837146,9917418,1929,675150,10592568,6.81
9837147,9873377,4595,1608250,11481627,16.29
9837148,9901647,3972,1390200,11291847,14.04
9837149,9915822,2535,887250,10803072,8.95
9837150,9929174,4786,1675100,11604274,16.87
9837151,9907257,4861,1701350,11608607,17.17
9837152,9902583,2444,855400,10757983,8.64
9837153,9782280,3305,1156750,10939030,11.82
9837154,9896950,4013,1404550,11301500,14.19
9837155,9921143,2646,926100,10847243,9.33
9837156,9819265,2883,1009050,10828315,10.28
9837157,9934146,4433,1551550,11485696,15.62
9837158,9922929,3021,1057350,10980279,10.66
9837159,9932771,3562,1246700,11179471,12.55
9837160,9926136,5143,1800050,11726186,18.13
9837161,9928941,3532,1236200,11165141,12.45
9837162,9920362,2220,777000,10697362,7.83
9837163,9479136,3403,1191050,10670186,12.56
9837164,9893507,2836,992600,10886107,10.03
9837165,9913459,6162,2156700,12070159,21.76
9837166,9935893,1948,681800,10617693,6.86
9837168,9921895,3453,1208550,11130445,12.18
9837170,9921934,2934,1026900,10948834,10.35
9837171,9932117,4989,1746150,11678267,17.58
9837172,1446304,617,215950,1662254,14.93
9837173,9922455,2279,797650,10720105,8.04
9837174,1717578,588,205800,1923378,11.98
9837175,9922851,3176,1111600,11034451,11.20
9837176,9936008,3637,1272950,11208958,12.81
9837177,9929671,2257,789950,10719621,7.96
9837178,9911154,1656,579600,10490754,5.85
9837179,8809742,3091,1081850,9891592,12.28
9837180,9933735,5572,1950200,11883935,19.63
9837181,9938901,3555,1244250,11183151,12.52
9837183,9840830,3159,1105650,10946480,11.24
9837184,9932553,3067,1073450,11006003,10.81
9837185,9928584,2910,1018500,10947084,10.26
9837186,9935008,331,115850,10050858,1.17
9837187,9934153,2738,958300,10892453,9.65
9837188,9953680,3555,1244250,11197930,12.50
9837189,9966422,3904,1366400,11332822,13.71
9837190,8503677,1266,443100,8946777,5.21
9837191,9976692,6615,2315250,12291942,23.21
9837192,9989830,5553,1943550,11933380,19.46
9837193,9469261,3287,1150450,10619711,12.15
9837194,9894820,2210,773500,10668320,7.82
9837195,9415560,4405,1541750,10957310,16.37
9837196,9963059,3866,1353100,11316159,13.58
9837197,9962779,3232,1131200,11093979,11.35
9837198,9966304,2923,1023050,10989354,10.27
9837199,9971946,3441,1204350,11176296,12.08
9837201,9972660,5318,1861300,11833960,18.66
9837202,9989289,4613,1614550,11603839,16.16
9837203,9986044,3596,1258600,11244644,12.60
9837204,9998954,3066,1073100,11072054,10.73
9837205,1615593,245,85750,1701343,5.31
9837206,9972779,3708,1297800,11270579,13.01
9837207,9978797,3864,1352400,11331197,13.55
9837208,9983404,2879,1007650,10991054,10.09
9837209,9975343,4980,1743000,11718343,17.47
9837210,9994191,4399,1539650,11533841,15.41
9837211,9896053,6055,2119250,12015303,21.42
9837212,9973636,4111,1438850,11412486,14.43
9837213,9962523,4647,1626450,11588973,16.33
9837214,9954480,2898,1014300,10968780,10.19
9837215,8475552,4600,1610000,10085552,19.00
9837216,9987002,3724,1303400,11290402,13.05
9837217,9980294,2236,782600,10762894,7.84
9837218,9986022,4572,1600200,11586222,16.02
9837219,9992988,4738,1658300,11651288,16.59
9837220,9972150,3241,1134350,11106500,11.38
9837221,9985912,3676,1286600,11272512,12.88
9837222,9997866,4277,1496950,11494816,14.97
9837223,9972598,3353,1173550,11146148,11.77
9837224,9987078,3490,1221500,11208578,12.23
9837225,9968715,3388,1185800,11154515,11.90
9837226,9911001,4369,1529150,11440151,15.43
9837227,9991398,4789,1676150,11667548,16.78
9837228,9971506,2265,792750,10764256,7.95
9837229,2255507,1430,500500,2756007,22.19
9837230,6764907,2161,756350,7521257,11.18
9837231,9980753,3509,1228150,11208903,12.31
9837232,9987674,3127,1094450,11082124,10.96
9837233,9998238,6166,2158100,12156338,21.58
9837235,9980455,2181,763350,10743805,7.65
9837236,9971299,3562,1246700,11217999,12.50
9837237,9975681,3452,1208200,11183881,12.11
9837238,9967297,2511,878850,10846147,8.82
9837239,9963822,3292,1152200,11116022,11.56
9837240,9972317,5100,1785000,11757317,17.90
9837241,9971819,3127,1094450,11066269,10.98
9837242,9972049,3891,1361850,11333899,13.66
9837243,9969070,3195,1118250,11087320,11.22
9837244,9959061,1852,648200,10607261,6.51
9837245,9966215,3565,1247750,11213965,12.52
9837246,9977879,5282,1848700,11826579,18.53
9837247,9520176,4336,1517600,11037776,15.94
9837248,9991407,2925,1023750,11015157,10.25
9837249,9984618,3059,1070650,11055268,10.72
9837250,9989118,4477,1566950,11556068,15.69
9837251,9894442,4591,1606850,11501292,16.24
9837253,9718178,2468,863800,10581978,8.89
9837255,9962438,3632,1271200,11233638,12.76
9837256,9984694,5267,1843450,11828144,18.46
9837257,9975402,2527,884450,10859852,8.87
9837258,9972923,5317,1860950,11833873,18.66
9837259,9949974,4339,1518650,11468624,15.26
9837260,9941131,3718,1301300,11242431,13.09
9837261,9954994,2234,781900,10736894,7.85
9837262,9970030,1681,588350,10558380,5.90
9837263,9949092,2713,949550,10898642,9.54
9837264,9867791,1367,478450,10346241,4.85
9837265,9977585,5029,1760150,11737735,17.64
9837266,9979785,2800,980000,10959785,9.82
9837267,9985444,2362,826700,10812144,8.28
9837268,9997964,2754,963900,10961864,9.64
9837269,9992120,2572,900200,10892320,9.01
9837270,9983660,3841,1344350,11328010,13.47
9837271,9992596,3201,1120350,11112946,11.21
9837272,9944102,4376,1531600,11475702,15.40
9837273,9989611,6232,2181200,12170811,21.83
9837274,9971836,4944,1730400,11702236,17.35
9837275,9979829,2628,919800,10899629,9.22
9837276,9955885,2729,955150,10911035,9.59
9837277,9979007,4704,1646400,11625407,16.50
9837278,9988662,3077,1076950,11065612,10.78
9837279,9994539,3385,1184750,11179289,11.85
9837280,9978132,4261,1491350,11469482,14.95
9837282,3042628,1534,536900,3579528,17.65
9837283,8985143,2689,941150,9926293,10.47
9837284,9982699,3233,1131550,11114249,11.34
9837285,9972454,1975,691250,10663704,6.93
9837286,9981601,3330,1165500,11147101,11.68
9837287,9988601,2983,1044050,11032651,10.45
9837288,9971716,5235,1832250,11803966,18.37
9837289,9975087,2797,978950,10954037,9.81
9837290,9988617,2412,844200,10832817,8.45
9837291,9972679,5158,1805300,11777979,18.10
9837292,9881194,1461,511350,10392544,5.17
9837293,9976728,4948,1731800,11708528,17.36
9837294,9980102,3887,1360450,11340552,13.63
9837295,9979160,5032,1761200,11740360,17.65
9837296,9983913,5170,1809500,11793413,18.12
9837297,9993587,4000,1400000,11393587,14.01
9837298,9972503,2862,1001700,10974203,10.04
9837299,9907307,4374,1530900,11438207,15.45
9837300,9982630,3765,1317750,11300380,13.20
9837301,9984119,2876,1006600,10990719,10.08
9837302,9980520,3262,1141700,11122220,11.44
9837303,9986295,4544,1590400,11576695,15.93
9837305,2800475,496,173600,2974075,6.20
9837306,1855716,1873,655550,2511266,35.33
9837307,9966857,5103,1786050,11752907,17.92
9837308,2542879,2308,807800,3350679,31.77
9837309,9234257,1552,543200,9777457,5.88
9837310,9983401,3009,1053150,11036551,10.55
9837311,9690687,1892,662200,10352887,6.83
9837312,9969009,2079,727650,10696659,7.30
9837313,9991186,2869,1004150,10995336,10.05
9837314,9983850,4063,1422050,11405900,14.24
9837315,9980390,3353,1173550,11153940,11.76
9837316,9976551,3585,1254750,11231301,12.58
9837317,9990474,2785,974750,10965224,9.76
9837318,9983003,2818,986300,10969303,9.88
9837319,9990682,5474,1915900,11906582,19.18
9837320,9972038,3254,1138900,11110938,11.42
9837321,9984166,3984,1394400,11378566,13.97
9837322,9986287,5528,1934800,11921087,19.37
9837323,9991556,3980,1393000,11384556,13.94
9837324,885511,518,181300,1066811,20.47
9837325,9987102,4691,1641850,11628952,16.44
9837326,9984993,4655,1629250,11614243,16.32
9837327,9981850,4160,1456000,11437850,14.59
9837328,9988887,3966,1388100,11376987,13.90
9837329,9961014,2536,887600,10848614,8.91
9837330,9990234,4382,1533700,11523934,15.35
9837331,9969789,4082,1428700,11398489,14.33
9837332,9991366,3338,1168300,11159666,11.69
9837333,9976398,4453,1558550,11534948,15.62
9837334,9980909,3459,1210650,11191559,12.13
9837335,9973734,4870,1704500,11678234,17.09
9837336,9983292,2406,842100,10825392,8.44
9837337,9985298,3167,1108450,11093748,11.10
9837338,9983071,2960,1036000,11019071,10.38
9837339,9989113,1436,502600,10491713,5.03
9837340,9970662,2280,798000,10768662,8.00
9837341,9992676,6794,2377900,12370576,23.80
9837342,9989662,3093,1082550,11072212,10.84
9837343,9970162,3273,1145550,11115712,11.49
9837344,9982824,4450,1557500,11540324,15.60
9837345,9980905,4444,1555400,11536305,15.58
9837346,9987447,4170,1459500,11446947,14.61
9837347,3486214,1282,448700,3934914,12.87
9837348,9984168,3405,1191750,11175918,11.94
9837349,9985410,2448,856800,10842210,8.58
9837350,9987278,2240,784000,10771278,7.85
9837351,9999522,3548,1241800,11241322,12.42
9837352,9972599,3277,1146950,11119549,11.50
9837353,9984260,6355,2224250,12208510,22.28
9837354,9987745,3548,1241800,11229545,12.43
9837355,9980708,4182,1463700,11444408,14.67
9837357,9995913,4151,1452850,11448763,14.53
9837358,9977150,2369,829150,10806300,8.31
9837359,9967368,6448,2256800,12224168,22.64
9837360,9980751,6025,2108750,12089501,21.13
9837361,9491724,4611,1613850,11105574,17.00
9837362,9995817,3988,1395800,11391617,13.96
9837363,9988839,5408,1892800,11881639,18.95
9837364,9950445,3991,1396850,11347295,14.04
9837365,9981026,2321,812350,10793376,8.14
9837366,9999187,3647,1276450,11275637,12.77
9837367,4817381,2197,768950,5586331,15.96
9837368,9981676,2617,915950,10897626,9.18
9837369,9989547,2362,826700,10816247,8.28
9837370,9981695,3405,1191750,11173445,11.94
9837371,9988206,4386,1535100,11523306,15.37
9837372,648625,218,76300,724925,11.76
9837373,9978467,5595,1958250,11936717,19.62
9837374,9969641,2208,772800,10742441,7.75
9837375,9974132,5353,1873550,11847682,18.78
9837376,9969815,4050,1417500,11387315,14.22
9837377,9433106,3971,1389850,10822956,14.73
9837378,9997878,5550,1942500,11940378,19.43
9837379,9989401,4079,1427650,11417051,14.29
9837380,9990036,3577,1251950,11241986,12.53
9837381,9970572,2756,964600,10935172,9.67
9837382,9991647,4994,1747900,11739547,17.49
9837383,9983390,4032,1411200,11394590,14.14
9837384,9993955,2188,765800,10759755,7.66
9837385,2787966,1902,665700,3453666,23.88
9837386,9968831,4413,1544550,11513381,15.49
9837387,9983974,1884,659400,10643374,6.60
9837388,9970001,2925,1023750,10993751,10.27
9837389,9977615,3107,1087450,11065065,10.90
9837390,9980722,5195,1818250,11798972,18.22
9837391,9986002,5237,1832950,11818952,18.36
9837392,9997368,6881,2408350,12405718,24.09
9837393,9984099,3174,1110900,11094999,11.13
9837394,9981106,4345,1520750,11501856,15.24
9837395,6077317,2761,966350,7043667,15.90
9837396,9996277,6768,2368800,12365077,23.70
9837397,9979480,3041,1064350,11043830,10.67
9837398,679393,107,37450,716843,5.51
9837399,9981433,3474,1215900,11197333,12.18
9837400,3046530,845,295750,3342280,9.71
9837401,9983575,5541,1939350,11922925,19.43
9837402,9967098,3206,1122100,11089198,11.26
9837403,9993780,4666,1633100,11626880,16.34
9837404,9969322,5455,1909250,11878572,19.15
9837405,9974764,3853,1348550,11323314,13.52
9837406,9982221,3257,1139950,11122171,11.42
9837407,9984663,4571,1599850,11584513,16.02
9837408,9995267,1447,506450,10501717,5.07
9837409,9973191,2990,1046500,11019691,10.49
9837410,9987901,3318,1161300,11149201,11.63
9837411,9985719,2243,785050,10770769,7.86
9837413,9975036,4032,1411200,11386236,14.15
9837414,9990224,3356,1174600,11164824,11.76
9837415,9992933,3961,1386350,11379283,13.87
9837416,9980465,3390,1186500,11166965,11.89
9837417,9889719,4752,1663200,11552919,16.82
9837418,9991035,3403,1191050,11182085,11.92
9837419,9984292,5044,1765400,11749692,17.68
9837420,9983186,4292,1502200,11485386,15.05
9837421,9994645,4450,1557500,11552145,15.58
9837423,9997460,3391,1186850,11184310,11.87
9837424,9986448,3778,1322300,11308748,13.24
9837425,9986230,3861,1351350,11337580,13.53
9837426,9988174,2737,957950,10946124,9.59
9837427,9975014,4199,1469650,11444664,14.73
9837428,9968364,3387,1185450,11153814,11.89
9837429,9969741,3122,1092700,11062441,10.96
9837430,9989366,1883,659050,10648416,6.60
9837431,9932043,5490,1921500,11853543,19.35
9837432,9979624,3170,1109500,11089124,11.12
9837433,9975259,4987,1745450,11720709,17.50
9837434,9965139,4148,1451800,11416939,14.57
9837435,9988942,2744,960400,10949342,9.61
9837436,8976514,5050,1767500,10744014,19.69
9837437,9976220,5119,1791650,11767870,17.96
9837438,9977785,2855,999250,10977035,10.01
9837439,9994314,3504,1226400,11220714,12.27
9837440,9989062,2299,804650,10793712,8.06
9837441,9971599,2736,957600,10929199,9.60
9837442,9984558,5758,2015300,11999858,20.18
9837443,9974038,2387,835450,10809488,8.38
9837444,9982497,1581,553350,10535847,5.54
9837445,9997046,1874,655900,10652946,6.56
9837446,9998446,4951,1732850,11731296,17.33
9837447,9999839,3423,1198050,11197889,11.98
9837448,9989310,4764,1667400,11656710,16.69
9837449,9981052,4281,1498350,11479402,15.01
9837450,9990201,3366,1178100,11168301,11.79
9837451,9975662,4954,1733900,11709562,17.38
9837452,5930837,3444,1205400,7136237,20.32
9837453,9992505,2517,880950,10873455,8.82
9837454,9977452,6401,2240350,12217802,22.45
9837455,9966335,6268,2193800,12160135,22.01
9837456,9970459,3565,1247750,11218209,12.51
9837457,9980482,4648,1626800,11607282,16.30
9837458,9981070,5352,1873200,11854270,18.77
9837459,9994742,2244,785400,10780142,7.86
9837460,9980577,3454,1208900,11189477,12.11
9837461,9986419,3757,1314950,11301369,13.17
9837462,9382906,5098,1784300,11167206,19.02
9837463,9997110,5416,1895600,11892710,18.96
9837464,9998979,4511,1578850,11577829,15.79
9837465,9991615,3705,1296750,11288365,12.98
9837466,9987160,3434,1201900,11189060,12.03
9837467,9986282,5715,2000250,11986532,20.03
9837468,9982418,4350,1522500,11504918,15.25
9837469,9984429,4187,1465450,11449879,14.68
9837470,9970488,5227,1829450,11799938,18.35
9837471,9982907,3820,1337000,11319907,13.39
9837472,9383690,4676,1636600,11020290,17.44
9837473,9965099,3376,1181600,11146699,11.86
9837474,9966852,2966,1038100,11004952,10.42
9837475,9962379,3661,1281350,11243729,12.86
9837476,9973063,5202,1820700,11793763,18.26
9837477,9974166,2363,827050,10801216,8.29
9837478,9979426,5082,1778700,11758126,17.82
9837479,9993159,2130,745500,10738659,7.46
9837480,9977018,5637,1972950,11949968,19.77
9837481,9965525,2410,843500,10809025,8.46
9837482,9982671,4315,1510250,11492921,15.13
9837483,2078883,392,137200,2216083,6.60
9837484,9976130,4101,1435350,11411480,14.39
9837485,9973695,4266,1493100,11466795,14.97
9837486,9675024,3603,1261050,10936074,13.03
9837487,9962313,3333,1166550,11128863,11.71
9837488,9983937,2405,841750,10825687,8.43
9837489,9978470,4943,1730050,11708520,17.34
9837490,9827254,4823,1688050,11515304,17.18
9837491,9978949,3158,1105300,11084249,11.08
9837492,9978893,1894,662900,10641793,6.64
9837493,9925116,3388,1185800,11110916,11.95
9837494,3674758,1372,480200,4154958,13.07
9837495,9987674,3341,1169350,11157024,11.71
9837496,9966550,4140,1449000,11415550,14.54
9837497,9855490,3028,1059800,10915290,10.75
9837498,9983490,5139,1798650,11782140,18.02
9837499,9988310,4643,1625050,11613360,16.27
9837500,9976738,4149,1452150,11428888,14.56
9837501,9982590,2884,1009400,10991990,10.11
9837502,9972613,3495,1223250,11195863,12.27
9837503,9988961,3077,1076950,11065911,10.78
9837504,9994646,3571,1249850,11244496,12.51
9837505,9983661,3690,1291500,11275161,12.94
9837506,9987530,3443,1205050,11192580,12.07
9837507,9968562,3153,1103550,11072112,11.07
9837508,9981413,3779,1322650,11304063,13.25
9837509,9981579,3811,1333850,11315429,13.36
9837510,9975016,4330,1515500,11490516,15.19
9837511,9982742,2465,862750,10845492,8.64
9837512,9979729,4569,1599150,11578879,16.02
9837513,9973014,4744,1660400,11633414,16.65
9837514,9975384,4343,1520050,11495434,15.24
9837515,9975111,4016,1405600,11380711,14.09
9837516,9989351,4496,1573600,11562951,15.75
9837517,9982617,4031,1410850,11393467,14.13
9837518,9932469,7825,2738750,12671219,27.57
9837519,9989666,3557,1244950,11234616,12.46
9837520,9867742,3781,1323350,11191092,13.41
9837521,5591698,4350,1522500,7114198,27.23
9837522,9986985,3416,1195600,11182585,11.97
9837523,9998314,3641,1274350,11272664,12.75
9837524,2190382,786,275100,2465482,12.56
9837525,6563628,4895,1713250,8276878,26.10
9837526,9968118,4571,1599850,11567968,16.05
9837527,9972635,4232,1481200,11453835,14.85
9837528,9977545,3266,1143100,11120645,11.46
9837529,9971066,3492,1222200,11193266,12.26
9837530,9975765,5189,1816150,11791915,18.21
9837531,9998872,6074,2125900,12124772,21.26
9837532,9983486,4366,1528100,11511586,15.31
9837533,9978460,3636,1272600,11251060,12.75
9837534,9965735,3767,1318450,11284185,13.23
9837535,9970491,2962,1036700,11007191,10.40
9837536,8327897,4094,1432900,9760797,17.21
9837537,9987992,3535,1237250,11225242,12.39
9837538,9993667,5470,1914500,11908167,19.16
9837539,9980098,3275,1146250,11126348,11.49
9837540,9985419,3629,1270150,11255569,12.72
9837541,9979993,1488,520800,10500793,5.22
9837542,4864688,1424,498400,5363088,10.25
9837543,2511029,824,288400,2799429,11.49
9837544,9980530,3291,1151850,11132380,11.54
9837545,9987324,4310,1508500,11495824,15.10
9837546,9992441,3584,1254400,11246841,12.55
9837547,7782008,2163,757050,8539058,9.73
9837548,2194712,1063,372050,2566762,16.95
9837549,9952359,3491,1221850,11174209,12.28
9837550,9965494,3272,1145200,11110694,11.49
9837551,9977608,4846,1696100,11673708,17.00
9837552,9981932,5366,1878100,11860032,18.81
9837553,9992334,4523,1583050,11575384,15.84
9837554,9989902,5376,1881600,11871502,18.84
9837555,9980529,4882,1708700,11689229,17.12
9837556,9660259,5603,1961050,11621309,20.30
9837557,9219407,4879,1707650,10927057,18.52
9837558,9971787,2164,757400,10729187,7.60
9837559,957063,1107,387450,1344513,40.48
9837560,9941887,4252,1488200,11430087,14.97
9837561,9959490,4314,1509900,11469390,15.16
9837562,9957462,4474,1565900,11523362,15.73
9837563,9985787,4202,1470700,11456487,14.73
9837564,9981214,2493,872550,10853764,8.74
9837565,9959843,4939,1728650,11688493,17.36
9837566,9973004,3396,1188600,11161604,11.92
9837567,9988625,6648,2326800,12315425,23.29
9837568,9983488,4827,1689450,11672938,16.92
9837569,9989813,3920,1372000,11361813,13.73
9837570,9984540,5423,1898050,11882590,19.01
9837571,9488875,4080,1428000,10916875,15.05
9837572,9927960,4417,1545950,11473910,15.57
9837573,9470608,3529,1235150,10705758,13.04
9837574,4775998,643,225050,5001048,4.71
9837575,9968222,4319,1511650,11479872,15.16
9837576,9510483,3895,1363250,10873733,14.33
9837577,9986883,4088,1430800,11417683,14.33
9837578,9991481,2628,919800,10911281,9.21
9837579,9993044,3435,1202250,11195294,12.03
9837580,9991088,4800,1680000,11671088,16.81
9837581,1408886,735,257250,1666136,18.26
9837582,9992237,4913,1719550,11711787,17.21
9837583,9985393,1369,479150,10464543,4.80
9837585,4921022,3234,1131900,6052922,23.00
9837586,9980504,5799,2029650,12010154,20.34
9837587,9970532,3822,1337700,11308232,13.42
9837588,9973570,3051,1067850,11041420,10.71
9837589,9963031,417,145950,10108981,1.46
9837590,9943181,5558,1945300,11888481,19.56
9837591,9963701,2564,897400,10861101,9.01
9837592,9939352,1373,480550,10419902,4.83
9837593,9931782,5023,1758050,11689832,17.70
9837594,9945609,3159,1105650,11051259,11.12
9837595,2195307,745,260750,2456057,11.88
9837596,9940415,1906,667100,10607515,6.71
9837597,9949285,5029,1760150,11709435,17.69
9837598,9961385,4145,1450750,11412135,14.56
9837599,9655679,4166,1458100,11113779,15.10
9837600,9970415,2592,907200,10877615,9.10
9837601,9971366,4362,1526700,11498066,15.31
9837602,3179909,1725,603750,3783659,18.99
9837603,9317717,5043,1765050,11082767,18.94
9837604,9992592,4409,1543150,11535742,15.44
9837605,9992649,5745,2010750,12003399,20.12
9837607,6767680,2697,943950,7711630,13.95
9837608,9987229,4324,1513400,11500629,15.15
9837609,9977739,4002,1400700,11378439,14.04
9837610,9986757,3855,1349250,11336007,13.51
9837611,463212,113,39550,502762,8.54
9837612,9971863,3958,1385300,11357163,13.89
9837613,9972968,4373,1530550,11503518,15.35
9837614,9977774,1870,654500,10632274,6.56
9837615,9963370,6718,2351300,12314670,23.60
9837616,9984619,1694,592900,10577519,5.94
9837617,9986159,1561,546350,10532509,5.47
9837618,9991441,2272,795200,10786641,7.96
9837620,9094629,2228,779800,9874429,8.57
9837622,9977764,2105,736750,10714514,7.38
9837623,9961576,2915,1020250,10981826,10.24
9837624,9967397,3277,1146950,11114347,11.51
9837625,9974079,4007,1402450,11376529,14.06
9837626,9976553,3599,1259650,11236203,12.63
9837627,9972395,3057,1069950,11042345,10.73
9837628,9975734,4113,1439550,11415284,14.43
9837629,4034053,1326,464100,4498153,11.50
9837630,9966366,4092,1432200,11398566,14.37
9837631,9986658,4297,1503950,11490608,15.06
9837632,9962282,4792,1677200,11639482,16.84
9837633,9945646,2980,1043000,10988646,10.49
9837634,9979446,3886,1360100,11339546,13.63
9837635,9960932,4975,1741250,11702182,17.48
9837636,9981227,3764,1317400,11298627,13.20
9837637,9981096,4443,1555050,11536146,15.58
9837638,9979244,4017,1405950,11385194,14.09
9837639,9978862,3458,1210300,11189162,12.13
9837640,4874685,1851,647850,5522535,13.29
9837641,9981757,4299,1504650,11486407,15.07
9837642,9989825,4350,1522500,11512325,15.24
9837643,9993754,3779,1322650,11316404,13.23
9837644,9991203,4552,1593200,11584403,15.95
9837645,9826743,2248,786800,10613543,8.01
9837646,9993688,3004,1051400,11045088,10.52
9837647,9983521,4770,1669500,11653021,16.72
9837648,9990186,2999,1049650,11039836,10.51
9837649,1117203,825,288750,1405953,25.85
9837650,9965021,2462,861700,10826721,8.65
9837651,9943935,2802,980700,10924635,9.86
9837652,9933381,3816,1335600,11268981,13.45
9837653,2608568,957,334950,2943518,12.84
9837654,9929506,2014,704900,10634406,7.10
9837655,9930735,1485,519750,10450485,5.23
9837656,9938530,1973,690550,10629080,6.95
9837658,9937664,4982,1743700,11681364,17.55
9837659,9955335,3840,1344000,11299335,13.50
9837660,9935686,1491,521850,10457536,5.25
9837661,9949668,4470,1564500,11514168,15.72
9837662,3822047,258,90300,3912347,2.36
9837663,9940568,5960,2086000,12026568,20.98
9837664,9939998,4586,1605100,11545098,16.15
9837665,9933745,3166,1108100,11041845,11.15
9837666,8950107,2509,878150,9828257,9.81
9837667,8489887,2737,957950,9447837,11.28
9837668,9938820,3963,1387050,11325870,13.96
9837669,9928186,2307,807450,10735636,8.13
9837670,3018570,1565,547750,3566320,18.15
9837671,9943283,3336,1167600,11110883,11.74
9837672,1406445,472,165200,1571645,11.75
9837673,9930397,2975,1041250,10971647,10.49
9837674,9936236,3081,1078350,11014586,10.85
9837675,9954991,2833,991550,10946541,9.96
9837676,9966429,4232,1481200,11447629,14.86
9837677,3306827,2387,835450,4142277,25.26
9837678,9972402,3460,1211000,11183402,12.14
9837679,9974489,1825,638750,10613239,6.40
9837680,9982157,2960,1036000,11018157,10.38
9837681,9968599,3047,1066450,11035049,10.70
9837682,696896,199,69650,766546,9.99
9837683,9934572,4603,1611050,11545622,16.22
9837684,9953293,4105,1436750,11390043,14.43
9837685,735994,372,130200,866194,17.69
9837686,9944195,3571,1249850,11194045,12.57
9837687,9945225,1410,493500,10438725,4.96
9837688,9958511,4975,1741250,11699761,17.49
9837689,9970408,3475,1216250,11186658,12.20
9837690,9984555,4027,1409450,11394005,14.12
9837691,9978482,3457,1209950,11188432,12.13
9837692,9983913,4471,1564850,11548763,15.67
9837693,1339340,736,257600,1596940,19.23
9837694,9957274,1109,388150,10345424,3.90
9837695,3265017,1131,395850,3660867,12.12
9837696,9969711,3595,1258250,11227961,12.62
9837697,9973312,5439,1903650,11876962,19.09
9837698,9971465,3187,1115450,11086915,11.19
9837699,9987496,3645,1275750,11263246,12.77
9837700,9549784,5602,1960700,11510484,20.53
9837701,9979381,4715,1650250,11629631,16.54
9837702,9991025,4692,1642200,11633225,16.44
9837703,9969073,3501,1225350,11194423,12.29
9837704,9996818,4537,1587950,11584768,15.88
9837705,9985147,4402,1540700,11525847,15.43
9837707,9964889,3756,1314600,11279489,13.19
9837708,9969143,3527,1234450,11203593,12.38
9837709,9992035,2611,913850,10905885,9.15
9837710,3207239,1817,635950,3843189,19.83
9837711,9979258,3053,1068550,11047808,10.71
9837712,9982888,3730,1305500,11288388,13.08
9837713,9999977,2120,742000,10741977,7.42
9837714,2895076,1567,548450,3443526,18.94
9837715,9972451,3668,1283800,11256251,12.87
9837716,9972628,2793,977550,10950178,9.80
9837717,9997534,5057,1769950,11767484,17.70
9837718,543843,759,265650,809493,48.85
9837719,9975922,4171,1459850,11435772,14.63
9837720,9968681,4291,1501850,11470531,15.07
9837721,9948682,2428,849800,10798482,8.54
9837722,9949441,6517,2280950,12230391,22.93
9837723,9935869,4435,1552250,11488119,15.62
9837725,9934269,2518,881300,10815569,8.87
9837726,9933991,4205,1471750,11405741,14.82
9837727,822421,344,120400,942821,14.64
9837728,9913650,3085,1079750,10993400,10.89
9837729,9918884,4405,1541750,11460634,15.54
9837730,9916751,2518,881300,10798051,8.89
9837731,9880192,4538,1588300,11468492,16.08
9837732,9937853,4071,1424850,11362703,14.34
9837733,9953363,4233,1481550,11434913,14.88
9837734,9899482,3396,1188600,11088082,12.01
9837735,9946745,6463,2262050,12208795,22.74
9837736,1836810,1157,404950,2241760,22.05
9837737,9932786,3278,1147300,11080086,11.55
9837738,7880893,4146,1451100,9331993,18.41
9837739,297341,182,63700,361041,21.42
9837740,9920254,3951,1382850,11303104,13.94
9837741,9919425,1527,534450,10453875,5.39
9837742,9908001,3415,1195250,11103251,12.06
9837743,9917446,2995,1048250,10965696,10.57
9837744,9909998,1784,624400,10534398,6.30
9837745,9892031,3486,1220100,11112131,12.33
9837746,9913768,2593,907550,10821318,9.15
9837747,9908786,4185,1464750,11373536,14.78
9837748,9925591,3606,1262100,11187691,12.72
9837749,9932420,4467,1563450,11495870,15.74
9837750,9922417,2584,904400,10826817,9.11
9837751,9939460,3679,1287650,11227110,12.95
9837752,9935510,3471,1214850,11150360,12.23
9837753,9924702,3053,1068550,10993252,10.77
9837754,9933898,4361,1526350,11460248,15.37
9837755,9937582,3885,1359750,11297332,13.68
9837756,9983902,3245,1135750,11119652,11.38
9837757,9997865,4875,1706250,11704115,17.07
9837758,9985311,4867,1703450,11688761,17.06
9837759,5131209,2570,899500,6030709,17.53
9837760,9980126,3698,1294300,11274426,12.97
9837761,9978517,2826,989100,10967617,9.91
9837762,9958350,4489,1571150,11529500,15.78
9837763,9959461,1140,399000,10358461,4.01
9837764,9938124,1655,579250,10517374,5.83
9837765,9957307,3112,1089200,11046507,10.94
9837766,9945246,2313,809550,10754796,8.14
9837767,3971711,1860,651000,4622711,16.39
9837768,9938387,3650,1277500,11215887,12.85
9837769,773240,435,152250,925490,19.69
9837770,9914924,3937,1377950,11292874,13.90
9837771,5044829,1844,645400,5690229,12.79
9837772,9925398,3834,1341900,11267298,13.52
9837773,9931539,4636,1622600,11554139,16.34
9837774,9885603,3984,1394400,11280003,14.11
9837775,9942008,4069,1424150,11366158,14.32
9837776,9960685,4182,1463700,11424385,14.69
9837777,9932983,4717,1650950,11583933,16.62
9837778,9939154,1963,687050,10626204,6.91
9837779,9952622,4451,1557850,11510472,15.65
9837780,9936374,2888,1010800,10947174,10.17
9837781,9971179,834,291900,10263079,2.93
9837782,9978689,2628,919800,10898489,9.22
9837784,9977526,4130,1445500,11423026,14.49
9837785,9977514,4421,1547350,11524864,15.51
9837786,9961146,3332,1166200,11127346,11.71
9837787,9955809,4977,1741950,11697759,17.50
9837788,9983225,3538,1238300,11221525,12.40
9837789,9985268,5520,1932000,11917268,19.35
9837790,9988013,5545,1940750,11928763,19.43
9837791,9971388,2774,970900,10942288,9.74
9837792,1691806,754,263900,1955706,15.60
9837793,9958439,333,116550,10074989,1.17
9837794,9974138,3976,1391600,11365738,13.95
9837795,9959409,3782,1323700,11283109,13.29
9837796,7226352,2066,723100,7949452,10.01
9837797,1931239,363,127050,2058289,6.58
9837798,9954173,4780,1673000,11627173,16.81
9837799,8120264,3133,1096550,9216814,13.50
9837800,9882264,4573,1600550,11482814,16.20
9837801,9963288,5260,1841000,11804288,18.48
9837802,9963819,2716,950600,10914419,9.54
9837803,9963363,4135,1447250,11410613,14.53
9837804,9966740,2689,941150,10907890,9.44
9837805,9974064,2715,950250,10924314,9.53
9837806,9956167,2870,1004500,10960667,10.09
9837807,9966176,4066,1423100,11389276,14.28
9837808,9968386,4210,1473500,11441886,14.78
9837809,9987839,3397,1188950,11176789,11.90
9837810,9996201,3912,1369200,11365401,13.70
9837811,672860,248,86800,759660,12.90
9837812,9988976,3082,1078700,11067676,10.80
9837813,9977455,3792,1327200,11304655,13.30
9837814,6235791,2709,948150,7183941,15.20
9837815,9974377,2446,856100,10830477,8.58
9837816,4878348,3144,1100400,5978748,22.56
9837817,9985097,4800,1680000,11665097,16.83
9837818,3063812,2058,720300,3784112,23.51
9837819,9968086,3621,1267350,11235436,12.71
9837821,9972265,4009,1403150,11375415,14.07
9837822,9960927,5133,1796550,11757477,18.04
9837823,9964313,2114,739900,10704213,7.43
9837824,9989218,3658,1280300,11269518,12.82
9837825,9995924,5987,2095450,12091374,20.96
9837826,9980734,2213,774550,10755284,7.76
9837827,3269077,1850,647500,3916577,19.81
9837828,9977186,5160,1806000,11783186,18.10
9837829,9989589,2757,964950,10954539,9.66
9837830,9999387,2915,1020250,11019637,10.20
9837831,9989097,3510,1228500,11217597,12.30
9837832,1904825,817,285950,2190775,15.01
9837833,7289381,3064,1072400,8361781,14.71
9837834,9981790,4246,1486100,11467890,14.89
9837835,9982370,2347,821450,10803820,8.23
9837836,9998128,4228,1479800,11477928,14.80
9837837,9988581,4801,1680350,11668931,16.82
9837838,9981127,3556,1244600,11225727,12.47
9837839,9986547,3725,1303750,11290297,13.06
9837840,1509850,923,323050,1832900,21.40
9837841,2950756,2073,725550,3676306,24.59
9837842,9501475,2784,974400,10475875,10.26
9837843,9978721,3419,1196650,11175371,11.99
9837844,7966988,4700,1645000,9611988,20.65
9837845,9933612,3800,1330000,11263612,13.39
9837846,9972915,2958,1035300,11008215,10.38
9837847,9962568,1906,667100,10629668,6.70
9837848,9964012,3371,1179850,11143862,11.84
9837849,9970987,4435,1552250,11523237,15.57
9837850,9978315,4859,1700650,11678965,17.04
9837851,9974947,5765,2017750,11992697,20.23
9837852,9981219,4548,1591800,11573019,15.95
9837853,2226547,1098,384300,2610847,17.26
9837854,9993325,4091,1431850,11425175,14.33
9837855,9981656,5145,1800750,11782406,18.04
9837856,9997969,5595,1958250,11956219,19.59
9837857,9971376,5135,1797250,11768626,18.02
9837858,9977020,3320,1162000,11139020,11.65
9837859,6635000,2919,1021650,7656650,15.40
9837860,9980275,3974,1390900,11371175,13.94
9837861,9970334,5361,1876350,11846684,18.82
9837862,9959389,4054,1418900,11378289,14.25
9837863,9964322,4496,1573600,11537922,15.79
9837864,9966908,6227,2179450,12146358,21.87
9837865,9970410,1659,580650,10551060,5.82
9837867,9967023,5155,1804250,11771273,18.10
9837868,9960348,4327,1514450,11474798,15.20
9837869,9964368,2935,1027250,10991618,10.31
9837870,9292155,4746,1661100,10953255,17.88
9837871,9430509,3193,1117550,10548059,11.85
9837872,9842376,5720,2002000,11844376,20.34
9837873,9947428,4231,1480850,11428278,14.89
9837874,1830880,242,84700,1915580,4.63
9837875,9974319,4911,1718850,11693169,17.23
9837876,9968383,4390,1536500,11504883,15.41
9837877,9974317,4602,1610700,11585017,16.15
9837878,9987567,4995,1748250,11735817,17.50
9837879,9995856,4758,1665300,11661156,16.66
9837880,9973980,4744,1660400,11634380,16.65
9837881,9983332,4886,1710100,11693432,17.13
9837882,9980618,4782,1673700,11654318,16.77
9837883,9997260,5789,2026150,12023410,20.27
9837884,8787477,3349,1172150,9959627,13.34
9837885,9980128,4079,1427650,11407778,14.30
9837887,3406468,4028,1409800,4816268,41.39
9837888,9960534,5775,2021250,11981784,20.29
9837889,9965380,5011,1753850,11719230,17.60
9837890,9976571,6563,2297050,12273621,23.02
9837891,9997075,3054,1068900,11065975,10.69
9837892,9981364,3627,1269450,11250814,12.72
9837893,9959558,5488,1920800,11880358,19.29
9837894,9998939,4004,1401400,11400339,14.02
9837895,9989239,3477,1216950,11206189,12.18
9837896,9978239,2134,746900,10725139,7.49
9837897,9994236,5171,1809850,11804086,18.11
9837898,9985620,4504,1576400,11562020,15.79
9837899,9957876,4951,1732850,11690726,17.40
9837900,9989665,2970,1039500,11029165,10.41
9837901,9996212,6408,2242800,12239012,22.44
9837902,9987030,4243,1485050,11472080,14.87
9837903,9977112,4962,1736700,11713812,17.41
9837904,9954277,6182,2163700,12117977,21.74
9837905,9912231,5713,1999550,11911781,20.17
9837906,3809386,3008,1052800,4862186,27.64
9837907,9961059,5394,1887900,11848959,18.95
9837908,9941668,6201,2170350,12112018,21.83
9837909,9936078,3307,1157450,11093528,11.65
9837910,9931655,2029,710150,10641805,7.15
9837911,9933870,6743,2360050,12293920,23.76
9837912,9946610,6338,2218300,12164910,22.30
9837913,9945731,7101,2485350,12431081,24.99
9837914,4318192,3399,1189650,5507842,27.55
9837915,9972706,4763,1667050,11639756,16.72
9837916,9974597,5201,1820350,11794947,18.25
9837917,6400904,4904,1716400,8117304,26.81
9837919,9989501,4107,1437450,11426951,14.39
9837920,9991799,4107,1437450,11429249,14.39
9837921,4062402,2792,977200,5039602,24.05
9837922,9964738,2725,953750,10918488,9.57
9837923,9987462,5754,2013900,12001362,20.16
9837924,9327199,5617,1965950,11293149,21.08
9837925,9984234,4599,1609650,11593884,16.12
9837926,9974014,5860,2051000,12025014,20.56
9837927,9988779,3500,1225000,11213779,12.26
9837928,9469778,5055,1769250,11239028,18.68
9837929,9980528,5183,1814050,11794578,18.18
9837930,9978965,4180,1463000,11441965,14.66
9837931,9978475,6554,2293900,12272375,22.99
9837932,9094998,5686,1990100,11085098,21.88
9837933,9987801,4286,1500100,11487901,15.02
9837934,9991311,5644,1975400,11966711,19.77
9837935,7883280,2631,920850,8804130,11.68
9837936,8123786,3723,1303050,9426836,16.04
9837937,9988257,5386,1885100,11873357,18.87
9837938,9975124,4234,1481900,11457024,14.86
9837939,9968040,2940,1029000,10997040,10.32
9837940,9971126,5379,1882650,11853776,18.88
9837941,9976098,4233,1481550,11457648,14.85
9837942,9993247,3601,1260350,11253597,12.61
9837943,9982573,4996,1748600,11731173,17.52
9837944,9340453,4897,1713950,11054403,18.35
9837945,9979734,1884,659400,10639134,6.61
9837946,9980710,5035,1762250,11742960,17.66
9837947,9988523,4680,1638000,11626523,16.40
9837948,9996180,6412,2244200,12240380,22.45
9837949,9980738,3041,1064350,11045088,10.66
9837950,9925711,2915,1020250,10945961,10.28
9837951,9998984,3316,1160600,11159584,11.61
9837952,9970484,4644,1625400,11595884,16.30
9837953,2704496,1079,377650,3082146,13.96
9837954,9978678,3456,1209600,11188278,12.12
9837955,6636516,3023,1058050,7694566,15.94
9837956,9953528,6797,2378950,12332478,23.90
9837957,9957748,3143,1100050,11057798,11.05
9837958,9966977,3961,1386350,11353327,13.91
9837959,9963471,1630,570500,10533971,5.73
9837960,9626138,4072,1425200,11051338,14.81
9837961,9721568,3542,1239700,10961268,12.75
9837962,2132385,962,336700,2469085,15.79
9837964,9920691,4667,1633450,11554141,16.47
9837965,295431,141,49350,344781,16.70
9837966,9911836,4244,1485400,11397236,14.99
9837967,9889530,4799,1679650,11569180,16.98
9837968,683677,411,143850,827527,21.04
9837969,9908184,3833,1341550,11249734,13.54
9837970,9916588,5299,1854650,11771238,18.70
9837971,9937461,5221,1827350,11764811,18.39
9837972,8949367,3772,1320200,10269567,14.75
9837973,9939100,4222,1477700,11416800,14.87
9837974,9960076,3385,1184750,11144826,11.89
9837975,9946367,5219,1826650,11773017,18.36
9837976,9957931,5070,1774500,11732431,17.82
9837977,9967109,6466,2263100,12230209,22.71
9837978,9944868,4587,1605450,11550318,16.14
9837980,9937201,6152,2153200,12090401,21.67
9837981,9945357,3982,1393700,11339057,14.01
9837982,9942493,5451,1907850,11850343,19.19
9837983,9945187,3304,1156400,11101587,11.63
9837984,9955073,5628,1969800,11924873,19.79
9837985,9953997,3733,1306550,11260547,13.13
9837986,9956395,2943,1030050,10986445,10.35
9837987,9953507,3048,1066800,11020307,10.72
9837988,9951901,4847,1696450,11648351,17.05
9837989,9976801,3541,1239350,11216151,12.42
9837990,9964650,3506,1227100,11191750,12.31
9837991,9970318,3294,1152900,11123218,11.56
9837992,3678703,1703,596050,4274753,16.20
9837993,9970167,3239,1133650,11103817,11.37
9837994,9989340,5165,1807750,11797090,18.10
9837995,9985657,3938,1378300,11363957,13.80
9837996,6761820,4427,1549450,8311270,22.91
9837997,9984354,4119,1441650,11426004,14.44
9837998,9971759,3076,1076600,11048359,10.80
9837999,9984663,2299,804650,10789313,8.06
9838000,9970146,3714,1299900,11270046,13.04
9838001,9975428,4258,1490300,11465728,14.94
9838002,1431407,901,315350,1746757,22.03
9838003,9958458,3379,1182650,11141108,11.88
9838004,9970871,5790,2026500,11997371,20.32
9838005,9983506,4265,1492750,11476256,14.95
9838006,9994643,3052,1068200,11062843,10.69
9838007,9993749,4254,1488900,11482649,14.90
9838008,9978447,4155,1454250,11432697,14.57
9838010,9953925,2541,889350,10843275,8.93
9838011,9978701,2721,952350,10931051,9.54
9838012,9955735,4524,1583400,11539135,15.90
9838013,3423427,4010,1403500,4826927,41.00
9838015,9952045,1626,569100,10521145,5.72
9838016,9965276,3357,1174950,11140226,11.79
9838017,9973662,3661,1281350,11255012,12.85
9838018,9960860,3661,1281350,11242210,12.86
9838019,9965646,4558,1595300,11560946,16.01
9838020,9935618,2366,828100,10763718,8.33
9838021,9946498,3906,1367100,11313598,13.74
9838022,9385239,2803,981050,10366289,10.45
9838023,9926707,2295,803250,10729957,8.09
9838024,9945965,3036,1062600,11008565,10.68
9838025,9947433,3472,1215200,11162633,12.22
9838026,9899478,4297,1503950,11403428,15.19
9838027,9873569,1982,693700,10567269,7.03
9838028,9965644,2430,850500,10816144,8.53
9838029,9965617,4170,1459500,11425117,14.65
9838030,9978509,4819,1686650,11665159,16.90
9838031,9966337,1603,561050,10527387,5.63
9838032,9955971,1967,688450,10644421,6.91
9838033,9946516,3346,1171100,11117616,11.77
9838034,9953049,2345,820750,10773799,8.25
9838035,9974452,4540,1589000,11563452,15.93
9838036,1483041,704,246400,1729441,16.61
9838037,9973309,3368,1178800,11152109,11.82
9838038,9979940,2949,1032150,11012090,10.34
9838039,9991414,2812,984200,10975614,9.85
9838040,9980372,1027,359450,10339822,3.60
9838041,9983255,4548,1591800,11575055,15.94
9838042,2870214,537,187950,3058164,6.55
9838043,9985392,2107,737450,10722842,7.39
9838044,9982597,5005,1751750,11734347,17.55
9838045,7498140,2833,991550,8489690,13.22
9838046,9966145,3191,1116850,11082995,11.21
9838047,9976751,5421,1897350,11874101,19.02
9838048,9980307,3402,1190700,11171007,11.93
9838049,4760807,3457,1209950,5970757,25.41
9838050,9991660,6705,2346750,12338410,23.49
9838051,9987212,3890,1361500,11348712,13.63
9838052,9085869,3888,1360800,10446669,14.98
9838053,9994019,4499,1574650,11568669,15.76
9838054,9999259,2122,742700,10741959,7.43
9838055,1344315,1070,374500,1718815,27.86
9838056,9959914,3160,1106000,11065914,11.10
9838057,9964435,5716,2000600,11965035,20.08
9838058,9990159,2676,936600,10926759,9.38
9838059,9960061,1678,587300,10547361,5.90
9838060,9980521,3018,1056300,11036821,10.58
9838061,3342489,1191,416850,3759339,12.47
9838062,9990418,2209,773150,10763568,7.74
9838063,9966351,3294,1152900,11119251,11.57
9838064,9992076,1396,488600,10480676,4.89
9838065,8988948,2901,1015350,10004298,11.30
9838066,9970293,2185,764750,10735043,7.67
9838067,9995480,4703,1646050,11641530,16.47
9838069,9969919,4637,1622950,11592869,16.28
9838070,9963532,2527,884450,10847982,8.88
9838071,9944011,6313,2209550,12153561,22.22
9838072,9950005,5379,1882650,11832655,18.92
9838073,9938531,3972,1390200,11328731,13.99
9838074,9948225,4980,1743000,11691225,17.52
9838075,9947584,2769,969150,10916734,9.74
9838076,9951602,4140,1449000,11400602,14.56
9838077,9457416,2156,754600,10212016,7.98
9838078,9954361,5649,1977150,11931511,19.86
9838079,9953379,2939,1028650,10982029,10.33
9838080,9949861,2649,927150,10877011,9.32
9838081,9964740,5586,1955100,11919840,19.62
9838082,2726011,2143,750050,3476061,27.51
9838083,9944510,5859,2050650,11995160,20.62
9838084,9934506,4159,1455650,11390156,14.65
9838085,3664911,1253,438550,4103461,11.97
9838086,9943725,2714,949900,10893625,9.55
9838087,9943993,5112,1789200,11733193,17.99
9838088,9943427,1303,456050,10399477,4.59
9838089,9949878,4439,1553650,11503528,15.61
9838090,9933765,3508,1227800,11161565,12.36
9838091,9920606,3495,1223250,11143856,12.33
9838092,9910887,1893,662550,10573437,6.69
9838093,9911135,2529,885150,10796285,8.93
9838094,9904155,3663,1282050,11186205,12.94
9838095,9919015,1743,610050,10529065,6.15
9838096,9918113,3099,1084650,11002763,10.94
9838097,9911446,1742,609700,10521146,6.15
9838098,9902627,4404,1541400,11444027,15.57
9838099,9902439,3223,1128050,11030489,11.39
9838100,9902160,2396,838600,10740760,8.47
9838101,9901573,4505,1576750,11478323,15.92
9838102,9911884,4447,1556450,11468334,15.70
9838103,3007686,1749,612150,3619836,20.35
9838104,9910621,4527,1584450,11495071,15.99
9838105,9916838,3677,1286950,11203788,12.98
9838106,9918349,3629,1270150,11188499,12.81
9838107,9919342,3352,1173200,11092542,11.83
9838108,9925544,3959,1385650,11311194,13.96
9838109,9939129,3132,1096200,11035329,11.03
9838110,9921839,3487,1220450,11142289,12.30
9838111,9936541,2977,1041950,10978491,10.49
9838112,9932275,3981,1393350,11325625,14.03
9838113,9867997,3284,1149400,11017397,11.65
9838114,9947527,3671,1284850,11232377,12.92
9838115,9869162,2827,989450,10858612,10.03
9838116,9946917,3356,1174600,11121517,11.81
9838117,9961506,2773,970550,10932056,9.74
9838119,9941625,5063,1772050,11713675,17.82
9838120,9923541,3279,1147650,11071191,11.56
9838121,9942852,3631,1270850,11213702,12.78
9838122,9927283,4997,1748950,11676233,17.62
9838123,9940218,3795,1328250,11268468,13.36
9838124,9915622,3396,1188600,11104222,11.99
9838125,9929978,4555,1594250,11524228,16.05
9838126,9933486,4856,1699600,11633086,17.11
9838127,9773413,5313,1859550,11632963,19.03
9838128,9929090,6305,2206750,12135840,22.23
9838129,9926232,3712,1299200,11225432,13.09
9838130,9932404,4382,1533700,11466104,15.44
9838131,9951997,4646,1626100,11578097,16.34
9838132,9960685,4663,1632050,11592735,16.38
9838133,9938426,4498,1574300,11512726,15.84
9838134,9942903,3638,1273300,11216203,12.81
9838135,9922627,5750,2012500,11935127,20.28
9838136,9930102,3488,1220800,11150902,12.29
9838137,9916493,3334,1166900,11083393,11.77
9838138,8934524,4645,1625750,10560274,18.20
9838139,9940802,5198,1819300,11760102,18.30
9838140,9952080,3691,1291850,11243930,12.98
9838141,9945185,4247,1486450,11431635,14.95
9838142,2554158,1431,500850,3055008,19.61
9838143,9941159,3323,1163050,11104209,11.70
9838144,9948633,3657,1279950,11228583,12.87
9838145,9953802,3731,1305850,11259652,13.12
9838146,9953028,2761,966350,10919378,9.71
9838147,9965683,2928,1024800,10990483,10.28
9838148,9964435,1936,677600,10642035,6.80
9838149,9980662,4222,1477700,11458362,14.81
9838150,9978395,3030,1060500,11038895,10.63
9838151,9981794,3425,1198750,11180544,12.01
9838152,9993079,2975,1041250,11034329,10.42
9838153,9967128,5797,2028950,11996078,20.36
9838154,9987899,2312,809200,10797099,8.10
9838155,9999326,2533,886550,10885876,8.87
9838157,9966868,2499,874650,10841518,8.78
9838158,9974387,4287,1500450,11474837,15.04
9838159,9977159,5770,2019500,11996659,20.24
9838160,9979158,4974,1740900,11720058,17.45
9838161,9977630,5045,1765750,11743380,17.70
9838162,9976966,4601,1610350,11587316,16.14
9838163,9977723,3953,1383550,11361273,13.87
9838164,9988915,3805,1331750,11320665,13.33
9838165,9979627,3952,1383200,11362827,13.86
9838166,9972255,5372,1880200,11852455,18.85
9838167,9997200,2857,999950,10997150,10.00
9838168,9971439,5101,1785350,11756789,17.90
9838169,9992950,5005,1751750,11744700,17.53
9838170,9978653,4208,1472800,11451453,14.76
9838171,9967496,1689,591150,10558646,5.93
9838172,9963497,2879,1007650,10971147,10.11
9838173,9969777,2504,876400,10846177,8.79
9838174,9974786,3100,1085000,11059786,10.88
9838176,9959078,3184,1114400,11073478,11.19
9838177,9958511,2125,743750,10702261,7.47
9838178,9952893,3272,1145200,11098093,11.51
9838179,9941970,4798,1679300,11621270,16.89
9838180,9946136,2345,820750,10766886,8.25
9838181,9934966,3879,1357650,11292616,13.67
9838182,9934344,4301,1505350,11439694,15.15
9838183,9960356,5626,1969100,11929456,19.77
9838184,9955409,3227,1129450,11084859,11.35
9838185,9964697,4052,1418200,11382897,14.23
9838186,9984286,5403,1891050,11875336,18.94
9838187,9723477,3086,1080100,10803577,11.11
9838188,9993201,4125,1443750,11436951,14.45
9838189,9970068,1899,664650,10634718,6.67
9838190,9971152,4044,1415400,11386552,14.19
9838191,9960393,3315,1160250,11120643,11.65
9838192,9906957,2951,1032850,10939807,10.43
9838193,9971745,3794,1327900,11299645,13.32
9838194,9976896,3353,1173550,11150446,11.76
9838195,3170213,986,345100,3515313,10.89
9838196,9944806,3406,1192100,11136906,11.99
9838197,9960695,2960,1036000,10996695,10.40
9838198,9964661,4017,1405950,11370611,14.11
9838199,9957494,7149,2502150,12459644,25.13
9838200,9967275,5317,1860950,11828225,18.67
9838201,9979970,2667,933450,10913420,9.35
9838202,9482014,2545,890750,10372764,9.39
9838203,8796324,2315,810250,9606574,9.21
9838204,9991834,3707,1297450,11289284,12.99
9838205,9994348,3479,1217650,11211998,12.18
9838206,9999403,3573,1250550,11249953,12.51
9838207,9974394,3737,1307950,11282344,13.11
9838208,9977215,3176,1111600,11088815,11.14
9838209,4926835,1600,560000,5486835,11.37
9838210,9981534,2478,867300,10848834,8.69
9838211,9976713,2898,1014300,10991013,10.17
9838212,9072149,5531,1935850,11007999,21.34
9838213,9997487,4500,1575000,11572487,15.75
9838214,9982303,3602,1260700,11243003,12.63
9838215,9962761,4106,1437100,11399861,14.42
9838216,9971018,5812,2034200,12005218,20.40
9838217,9978149,5282,1848700,11826849,18.53
9838218,9997571,3069,1074150,11071721,10.74
9838219,9976648,6922,2422700,12399348,24.28
9838220,9983494,269,94150,10077644,0.94
9838221,9979344,4240,1484000,11463344,14.87
9838222,9982334,5375,1881250,11863584,18.85
9838223,9997420,1738,608300,10605720,6.08
9838224,2363842,929,325150,2688992,13.76
9838225,9959643,6093,2132550,12092193,21.41
9838226,9951535,3796,1328600,11280135,13.35
9838227,9992767,5212,1824200,11816967,18.26
9838228,6019714,3641,1274350,7294064,21.17
9838229,1469514,682,238700,1708214,16.24
9838230,1252814,659,230650,1483464,18.41
9838231,9958113,3224,1128400,11086513,11.33
9838232,9961493,2767,968450,10929943,9.72
9838233,9937396,3659,1280650,11218046,12.89
9838234,9967304,4394,1537900,11505204,15.43
9838235,1859084,699,244650,2103734,13.16
9838236,9933668,3530,1235500,11169168,12.44
9838237,9932331,4822,1687700,11620031,16.99
9838238,7975909,4904,1716400,9692309,21.52
9838239,7692696,4630,1620500,9313196,21.07
9838240,9925662,4431,1550850,11476512,15.62
9838241,9943458,2669,934150,10877608,9.39
9838242,9934146,4247,1486450,11420596,14.96
9838243,8865039,2312,809200,9674239,9.13
9838245,9896145,3519,1231650,11127795,12.45
9838246,9905382,2348,821800,10727182,8.30
9838247,9900788,5543,1940050,11840838,19.59
9838248,9812458,4576,1601600,11414058,16.32
9838249,9870941,3398,1189300,11060241,12.05
9838250,9875436,1712,599200,10474636,6.07
9838251,9879231,3160,1106000,10985231,11.20
9838253,9854707,3556,1244600,11099307,12.63
9838254,9878077,4631,1620850,11498927,16.41
9838255,9882046,5356,1874600,11756646,18.97
9838256,453334,234,81900,535234,18.07
9838257,9863279,5210,1823500,11686779,18.49
9838258,9883249,1574,550900,10434149,5.57
9838259,9863141,2957,1034950,10898091,10.49
9838260,9870726,3997,1398950,11269676,14.17
9838261,9884608,3596,1258600,11143208,12.73
9838262,9877859,4768,1668800,11546659,16.89
9838263,9868159,3671,1284850,11153009,13.02
9838264,9875839,3527,1234450,11110289,12.50
9838265,9858552,3614,1264900,11123452,12.83
9838266,9862369,1941,679350,10541719,6.89
9838267,9884494,2301,805350,10689844,8.15
9838269,9859880,2068,723800,10583680,7.34
9838270,9887754,2423,848050,10735804,8.58
9838271,9876212,3173,1110550,10986762,11.24
9838272,9878703,1174,410900,10289603,4.16
9838273,9861954,3010,1053500,10915454,10.68
9838274,9845696,3606,1262100,11107796,12.82
9838275,9860982,5239,1833650,11694632,18.60
9838276,9876742,3577,1251950,11128692,12.68
9838277,9875709,1398,489300,10365009,4.95
9838278,9882146,2421,847350,10729496,8.57
9838279,9867369,5169,1809150,11676519,18.33
9838280,9885578,3319,1161650,11047228,11.75
9838281,9834275,3828,1339800,11174075,13.62
9838282,9875965,2551,892850,10768815,9.04
9838284,9895246,5149,1802150,11697396,18.21
9838285,9880686,5242,1834700,11715386,18.57
9838286,9546169,6190,2166500,11712669,22.69
9838287,9902681,5678,1987300,11889981,20.07
9838288,9907431,3826,1339100,11246531,13.52
9838289,9901797,2971,1039850,10941647,10.50
9838290,9909705,4591,1606850,11516555,16.21
9838291,9924702,5416,1895600,11820302,19.10
9838292,9935851,5194,1817900,11753751,18.30
9838293,9922575,2267,793450,10716025,8.00
9838294,9930730,3240,1134000,11064730,11.42
9838295,9927296,5845,2045750,11973046,20.61
9838296,9922048,3518,1231300,11153348,12.41
9838297,9919404,2645,925750,10845154,9.33
9838298,9934648,3660,1281000,11215648,12.89
9838299,9832229,4500,1575000,11407229,16.02
9838300,8660197,4850,1697500,10357697,19.60
9838301,8913318,4409,1543150,10456468,17.31
9838302,9942306,4214,1474900,11417206,14.83
9838303,9943024,4736,1657600,11600624,16.67
9838304,9956261,5069,1774150,11730411,17.82
9838305,7298786,3653,1278550,8577336,17.52
9838306,9964260,4991,1746850,11711110,17.53
9838307,9973144,3958,1385300,11358444,13.89
9838308,9962315,4225,1478750,11441065,14.84
9838309,9985426,3131,1095850,11081276,10.97
9838310,9980268,3872,1355200,11335468,13.58
9838311,9984536,5143,1800050,11784586,18.03
9838312,9948014,4403,1541050,11489064,15.49
9838313,9968118,5672,1985200,11953318,19.92
9838314,9984320,5257,1839950,11824270,18.43
9838315,9907777,6315,2210250,12118027,22.31
9838316,9984653,4367,1528450,11513103,15.31
9838317,9984256,2449,857150,10841406,8.59
9838318,9998763,5602,1960700,11959463,19.61
9838319,7506101,2836,992600,8498701,13.22
9838320,9967681,4104,1436400,11404081,14.41
9838321,9988158,3099,1084650,11072808,10.86
9838322,9976183,4801,1680350,11656533,16.84
9838323,9963233,4853,1698550,11661783,17.05
9838324,9945101,2772,970200,10915301,9.76
9838325,9965490,4100,1435000,11400490,14.40
9838326,9964545,4857,1699950,11664495,17.06
9838327,9971956,4897,1713950,11685906,17.19
9838328,9967897,5499,1924650,11892547,19.31
9838329,9983669,4685,1639750,11623419,16.42
9838330,9960734,2957,1034950,10995684,10.39
9838331,9988345,3581,1253350,11241695,12.55
9838333,9978090,3670,1284500,11262590,12.87
9838334,9989975,6933,2426550,12416525,24.29
9838335,9984774,3255,1139250,11124024,11.41
9838336,9978733,4822,1687700,11666433,16.91
9838337,9964012,3312,1159200,11123212,11.63
9838338,9983316,4184,1464400,11447716,14.67
9838339,9998721,1393,487550,10486271,4.88
9838340,9997038,4625,1618750,11615788,16.19
9838342,9997189,4549,1592150,11589339,15.93
9838343,9986536,5709,1998150,11984686,20.01
9838344,9997739,3616,1265600,11263339,12.66
9838345,9991167,4304,1506400,11497567,15.08
9838346,9821263,3228,1129800,10951063,11.50
9838347,9763086,6943,2430050,12193136,24.89
9838349,5486167,2946,1031100,6517267,18.79
9838350,9961221,3950,1382500,11343721,13.88
9838351,9969648,5496,1923600,11893248,19.29
9838352,9988197,4233,1481550,11469747,14.83
9838353,9991001,4423,1548050,11539051,15.49
9838355,9990570,3323,1163050,11153620,11.64
9838356,9997478,3554,1243900,11241378,12.44
9838357,9989885,5370,1879500,11869385,18.81
9838358,9973686,4711,1648850,11622536,16.53
9838359,9984816,4295,1503250,11488066,15.06
9838360,9979436,5410,1893500,11872936,18.97
9838362,9976972,4868,1703800,11680772,17.08
9838363,9978032,5043,1765050,11743082,17.69
9838365,9957282,6609,2313150,12270432,23.23
9838366,9961328,4721,1652350,11613678,16.59
9838368,9956204,3720,1302000,11258204,13.08
9838369,9957650,3630,1270500,11228150,12.76
9838370,9947062,3695,1293250,11240312,13.00
9838371,9887152,6701,2345350,12232502,23.72
9838372,9948503,4117,1440950,11389453,14.48
9838373,9943704,3036,1062600,11006304,10.69
9838374,1136123,669,234150,1370273,20.61
9838375,9925936,4561,1596350,11522286,16.08
9838376,9938316,4172,1460200,11398516,14.69
9838377,9948167,4323,1513050,11461217,15.21
9838379,9927874,5002,1750700,11678574,17.63
9838381,9922165,5290,1851500,11773665,18.66
9838382,8043695,3033,1061550,9105245,13.20
9838383,9927662,4069,1424150,11351812,14.35
9838384,9951773,4562,1596700,11548473,16.04
9838385,9926018,1898,664300,10590318,6.69
9838386,9932018,3041,1064350,10996368,10.72
9838387,9925397,3396,1188600,11113997,11.98
9838388,9935052,3720,1302000,11237052,13.11
9838389,9933797,4288,1500800,11434597,15.11
9838390,9928710,4744,1660400,11589110,16.72
9838391,9907387,6828,2389800,12297187,24.12
9838392,9926466,4001,1400350,11326816,14.11
9838393,9925404,4399,1539650,11465054,15.51
9838394,9933930,5026,1759100,11693030,17.71
9838395,9948739,5281,1848350,11797089,18.58
9838396,9943647,4868,1703800,11647447,17.13
9838398,8278056,5802,2030700,10308756,24.53
9838399,9934518,3898,1364300,11298818,13.73
9838400,9941892,6597,2308950,12250842,23.22
9838401,2543936,646,226100,2770036,8.89
9838402,4110889,2861,1001350,5112239,24.36
9838403,9920013,3659,1280650,11200663,12.91
9838404,9958996,5360,1876000,11834996,18.84
9838405,9959278,5913,2069550,12028828,20.78
9838406,9949639,4454,1558900,11508539,15.67
9838407,9958171,4230,1480500,11438671,14.87
9838408,9843360,3816,1335600,11178960,13.57
9838409,6356777,1597,558950,6915727,8.79
9838410,9684675,3639,1273650,10958325,13.15
9838411,9965605,4835,1692250,11657855,16.98
9838412,9957332,4503,1576050,11533382,15.83
9838413,9936888,5204,1821400,11758288,18.33
9838414,9852978,3642,1274700,11127678,12.94
9838415,4005357,1256,439600,4444957,10.98
9838416,9954407,5619,1966650,11921057,19.76
9838417,9970159,7260,2541000,12511159,25.49
9838418,9978853,3807,1332450,11311303,13.35
9838419,5286946,4325,1513750,6800696,28.63
9838420,9983160,2685,939750,10922910,9.41
9838421,9989359,4390,1536500,11525859,15.38
9838422,9984947,2758,965300,10950247,9.67
9838423,9980018,4849,1697150,11677168,17.01
9838424,9979737,3462,1211700,11191437,12.14
9838425,9984325,2948,1031800,11016125,10.33
9838426,9985287,3603,1261050,11246337,12.63
9838427,9981634,3058,1070300,11051934,10.72
9838428,9999866,3840,1344000,11343866,13.44
9838429,9996596,7472,2615200,12611796,26.16
9838430,9990938,5442,1904700,11895638,19.06
9838431,9984341,3178,1112300,11096641,11.14
9838432,9974905,4227,1479450,11454355,14.83
9838433,9978194,4452,1558200,11536394,15.62
9838435,9996775,3696,1293600,11290375,12.94
9838436,699716,95,33250,732966,4.75
9838437,9979147,4062,1421700,11400847,14.25
9838438,9983833,3522,1232700,11216533,12.35
9838439,9974156,4909,1718150,11692306,17.23
9838440,9980539,4272,1495200,11475739,14.98
9838441,3611123,1005,351750,3962873,9.74
9838442,9995798,4930,1725500,11721298,17.26
9838443,9971361,2966,1038100,11009461,10.41
9838444,9988515,3621,1267350,11255865,12.69
9838445,9995342,5312,1859200,11854542,18.60
9838446,9978745,4126,1444100,11422845,14.47
9838447,9810312,4705,1646750,11457062,16.79
9838448,9998422,3523,1233050,11231472,12.33
9838450,9726117,4436,1552600,11278717,15.96
9838451,9987461,4485,1569750,11557211,15.72
9838452,9992941,3365,1177750,11170691,11.79
9838453,8975381,3664,1282400,10257781,14.29
9838454,9979208,4183,1464050,11443258,14.67
9838455,9972494,4390,1536500,11508994,15.41
9838456,9978993,5758,2015300,11994293,20.20
9838457,9994410,3901,1365350,11359760,13.66
9838458,9986163,6045,2115750,12101913,21.19
9838459,9993849,2880,1008000,11001849,10.09
9838460,9986920,4580,1603000,11589920,16.05
9838461,9995424,5134,1796900,11792324,17.98
9838462,1403460,502,175700,1579160,12.52
9838463,9971563,5606,1962100,11933663,19.68
9838464,4556812,1974,690900,5247712,15.16
9838465,9960422,3782,1323700,11284122,13.29
9838466,9984439,4956,1734600,11719039,17.37
9838467,9988423,4712,1649200,11637623,16.51
9838468,9974500,6085,2129750,12104250,21.35
9838469,9947682,4395,1538250,11485932,15.46
9838470,9960917,3941,1379350,11340267,13.85
9838471,9976425,4122,1442700,11419125,14.46
9838472,9967879,3261,1141350,11109229,11.45
9838473,4869646,2327,814450,5684096,16.73
9838474,9969789,4784,1674400,11644189,16.79
9838475,9994627,5353,1873550,11868177,18.75
9838476,9998237,5217,1825950,11824187,18.26
9838477,9496849,5441,1904350,11401199,20.05
9838478,9977314,4635,1622250,11599564,16.26
9838480,9978450,3588,1255800,11234250,12.59
9838481,9974973,4206,1472100,11447073,14.76
9838482,9981990,4813,1684550,11666540,16.88
9838483,9958545,2983,1044050,11002595,10.48
9838484,7200684,1969,689150,7889834,9.57
9838485,9979889,2963,1037050,11016939,10.39
9838486,9981876,6052,2118200,12100076,21.22
9838487,9751466,4595,1608250,11359716,16.49
9838488,9969906,3014,1054900,11024806,10.58
9838489,9987505,4023,1408050,11395555,14.10
9838490,9977101,6189,2166150,12143251,21.71
9838491,9998694,3605,1261750,11260444,12.62
9838492,4385993,1330,465500,4851493,10.61
9838493,9993535,4698,1644300,11637835,16.45
9838494,1682500,805,281750,1964250,16.75
9838495,9940482,4772,1670200,11610682,16.80
9838496,9972385,4839,1693650,11666035,16.98
9838497,9985143,3646,1276100,11261243,12.78
9838498,9988288,2754,963900,10952188,9.65
9838499,9981866,2746,961100,10942966,9.63
9838500,9201840,3095,1083250,10285090,11.77
9838501,9959807,4385,1534750,11494557,15.41
9838503,9970883,6717,2350950,12321833,23.58
9838504,9950037,4165,1457750,11407787,14.65
9838505,9973753,3309,1158150,11131903,11.61
9838506,9983338,2311,808850,10792188,8.10
9838507,679816,358,125300,805116,18.43
9838508,9950953,2986,1045100,10996053,10.50
9838509,9956537,3174,1110900,11067437,11.16
9838510,9963388,5158,1805300,11768688,18.12
9838511,9971478,4375,1531250,11502728,15.36
9838513,9981323,3707,1297450,11278773,13.00
9838514,4682497,3159,1105650,5788147,23.61
9838516,2222815,1044,365400,2588215,16.44
9838517,9968518,3800,1330000,11298518,13.34
9838518,9958281,5810,2033500,11991781,20.42
9838519,9948643,2898,1014300,10962943,10.20
9838520,9957943,3832,1341200,11299143,13.47
9838521,9967781,4157,1454950,11422731,14.60
9838522,8972917,2641,924350,9897267,10.30
9838523,9894973,5668,1983800,11878773,20.05
9838524,9577203,4720,1652000,11229203,17.25
9838525,9965550,3690,1291500,11257050,12.96
9838526,9959020,4249,1487150,11446170,14.93
9838527,9944305,2022,707700,10652005,7.12
9838528,9970224,5998,2099300,12069524,21.06
9838529,9945639,4846,1696100,11641739,17.05
9838530,9954345,6951,2432850,12387195,24.44
9838531,9977881,3842,1344700,11322581,13.48
9838532,9972920,3667,1283450,11256370,12.87
9838534,9959504,1126,394100,10353604,3.96
9838535,7524718,2908,1017800,8542518,13.53
9838536,9953972,4560,1596000,11549972,16.03
9838537,9978525,4460,1561000,11539525,15.64
9838538,9980744,5184,1814400,11795144,18.18
9838539,9936214,5161,1806350,11742564,18.18
9838540,1454289,476,166600,1620889,11.46
9838541,9947341,2742,959700,10907041,9.65
9838542,9944107,1923,673050,10617157,6.77
9838544,9915255,3800,1330000,11245255,13.41
9838545,9922089,5818,2036300,11958389,20.52
9838546,9924172,4391,1536850,11461022,15.49
9838547,9891298,1024,358400,10249698,3.62
9838548,9892661,4172,1460200,11352861,14.76
9838549,625078,180,63000,688078,10.08
9838550,9896883,5488,1920800,11817683,19.41
9838551,9902247,6436,2252600,12154847,22.75
9838552,9902837,4902,1715700,11618537,17.33
9838553,9893443,4238,1483300,11376743,14.99
9838554,9911658,4274,1495900,11407558,15.09
9838555,9658148,3477,1216950,10875098,12.60
9838556,9940906,3906,1367100,11308006,13.75
9838557,9938695,4767,1668450,11607145,16.79
9838558,9931614,3135,1097250,11028864,11.05
9838559,9934317,3352,1173200,11107517,11.81
9838560,9947104,3863,1352050,11299154,13.59
9838561,9937361,5467,1913450,11850811,19.26
9838562,9869993,4189,1466150,11336143,14.85
9838563,9947100,4423,1548050,11495150,15.56
9838564,2293348,1562,546700,2840048,23.84
9838565,9880985,4724,1653400,11534385,16.73
9838566,9952454,3693,1292550,11245004,12.99
9838567,9959337,2832,991200,10950537,9.95
9838568,9950159,3596,1258600,11208759,12.65
9838569,9710403,6592,2307200,12017603,23.76
9838570,9962990,3974,1390900,11353890,13.96
9838571,7795970,3652,1278200,9074170,16.40
9838572,1420732,723,253050,1673782,17.81
9838573,9461357,5089,1781150,11242507,18.83
9838574,9947421,2722,952700,10900121,9.58
9838575,9973468,3973,1390550,11364018,13.94
9838577,9955006,3000,1050000,11005006,10.55
9838578,9969064,3434,1201900,11170964,12.06
9838579,9960886,3046,1066100,11026986,10.70
9838580,9960307,3399,1189650,11149957,11.94
9838581,9975156,2162,756700,10731856,7.59
9838582,9835130,4272,1495200,11330330,15.20
9838583,9962013,3297,1153950,11115963,11.58
9838584,9986607,4728,1654800,11641407,16.57
9838585,9991882,2534,886900,10878782,8.88
9838586,9982969,4258,1490300,11473269,14.93
9838587,9988124,4011,1403850,11391974,14.06
9838588,9994757,3563,1247050,11241807,12.48
9838589,9979592,3522,1232700,11212292,12.35
9838591,9987059,5193,1817550,11804609,18.20
9838592,9655332,3538,1238300,10893632,12.83
9838593,9987993,3401,1190350,11178343,11.92
9838594,9975713,3598,1259300,11235013,12.62
9838595,9989774,3930,1375500,11365274,13.77
9838596,9982489,4619,1616650,11599139,16.19
9838597,9924472,4930,1725500,11649972,17.39
9838598,5660446,3797,1328950,6989396,23.48
9838599,9980657,4920,1722000,11702657,17.25
9838600,9983429,6282,2198700,12182129,22.02
9838601,4317737,2705,946750,5264487,21.93
9838602,9978948,5141,1799350,11778298,18.03
9838603,9991165,2453,858550,10849715,8.59
9838604,9992766,3526,1234100,11226866,12.35
9838605,9980718,3799,1329650,11310368,13.32
9838606,9980123,5811,2033850,12013973,20.38
9838607,9992895,3109,1088150,11081045,10.89
9838608,9998760,3660,1281000,11279760,12.81
9838609,9988370,4338,1518300,11506670,15.20
9838610,9983217,2484,869400,10852617,8.71
9838611,9998281,2716,950600,10948881,9.51
9838612,9979201,3519,1231650,11210851,12.34
9838613,9977210,1739,608650,10585860,6.10
9838614,9970611,3650,1277500,11248111,12.81
9838615,9993407,3461,1211350,11204757,12.12
9838616,9973236,6792,2377200,12350436,23.84
9838617,9955055,4621,1617350,11572405,16.25
9838618,9974690,2509,878150,10852840,8.80
9838619,9962727,3119,1091650,11054377,10.96
9838620,9968526,1505,526750,10495276,5.28
9838621,9974126,4612,1614200,11588326,16.18
9838622,9971939,5507,1927450,11899389,19.33
9838623,9750863,3480,1218000,10968863,12.49
9838624,9976025,3064,1072400,11048425,10.75
9838625,9992634,4581,1603350,11595984,16.05
9838626,9990675,4685,1639750,11630425,16.41
9838627,9987955,3166,1108100,11096055,11.09
9838628,9997206,3711,1298850,11296056,12.99
9838629,9996686,5709,1998150,11994836,19.99
9838630,9981710,1774,620900,10602610,6.22
9838631,4294049,1521,532350,4826399,12.40
9838632,9972560,5892,2062200,12034760,20.68
9838633,9992506,5666,1983100,11975606,19.85
9838634,2058812,619,216650,2275462,10.52
9838635,9969667,5829,2040150,12009817,20.46
9838636,9973748,3698,1294300,11268048,12.98
9838637,9972776,4053,1418550,11391326,14.22
9838638,9996809,2860,1001000,10997809,10.01
9838639,9979688,3482,1218700,11198388,12.21
9838640,9979105,4015,1405250,11384355,14.08
9838641,6746731,2569,899150,7645881,13.33
9838642,6936763,2315,810250,7747013,11.68
9838643,9972851,6003,2101050,12073901,21.07
9838644,9991860,3551,1242850,11234710,12.44
9838645,9998931,3687,1290450,11289381,12.91
9838646,9974120,5233,1831550,11805670,18.36
9838647,9996117,3976,1391600,11387717,13.92
9838648,9978065,4609,1613150,11591215,16.17
9838649,9984206,4504,1576400,11560606,15.79
9838650,9989674,4267,1493450,11483124,14.95
9838651,9973803,4217,1475950,11449753,14.80
9838652,9350795,4388,1535800,10886595,16.42
9838654,9970683,5488,1920800,11891483,19.26
9838655,2319339,446,156100,2475439,6.73
9838656,8012862,4175,1461250,9474112,18.24
9838657,9993131,2504,876400,10869531,8.77
9838658,1474034,261,91350,1565384,6.20
9838659,9993518,2378,832300,10825818,8.33
9838660,9984877,2688,940800,10925677,9.42
9838661,9954509,5745,2010750,11965259,20.20
9838662,9998107,2273,795550,10793657,7.96
9838663,9989148,4034,1411900,11401048,14.13
9838664,9367318,2884,1009400,10376718,10.78
9838665,9821973,4298,1504300,11326273,15.32
9838666,9657429,2576,901600,10559029,9.34
9838667,9996903,4017,1405950,11402853,14.06
9838668,9978407,4428,1549800,11528207,15.53
9838669,9989153,3437,1202950,11192103,12.04
9838670,9996128,3552,1243200,11239328,12.44
9838671,9999362,4541,1589350,11588712,15.89
9838672,9969883,4145,1450750,11420633,14.55
9838673,9972496,4104,1436400,11408896,14.40
9838674,9986239,3360,1176000,11162239,11.78
9838675,9986785,4677,1636950,11623735,16.39
9838676,9982907,5551,1942850,11925757,19.46
9838677,9974369,6266,2193100,12167469,21.99
9838678,9982668,4801,1680350,11663018,16.83
9838679,9982580,2790,976500,10959080,9.78
9838680,9876954,3857,1349950,11226904,13.67
9838681,2053386,970,339500,2392886,16.53
9838682,5779506,2531,885850,6665356,15.33
9838683,9989968,3865,1352750,11342718,13.54
9838684,9993971,3262,1141700,11135671,11.42
9838685,9980565,4109,1438150,11418715,14.41
9838686,6288877,2591,906850,7195727,14.42
9838687,9931632,5125,1793750,11725382,18.06
9838688,9984994,4870,1704500,11689494,17.07
9838689,9976511,4403,1541050,11517561,15.45
9838690,9978432,2743,960050,10938482,9.62
9838691,9979637,3282,1148700,11128337,11.51
9838692,9997793,5079,1777650,11775443,17.78
9838693,9986282,3685,1289750,11276032,12.92
9838694,9966026,5128,1794800,11760826,18.01
9838695,9984117,2748,961800,10945917,9.63
9838696,9996365,4419,1546650,11543015,15.47
9838697,9984103,6618,2316300,12300403,23.20
9838698,9970502,3688,1290800,11261302,12.95
9838699,9974162,3752,1313200,11287362,13.17
9838700,9967717,3638,1273300,11241017,12.77
9838701,9986112,3086,1080100,11066212,10.82
9838702,9992659,2240,784000,10776659,7.85
9838703,2042692,1318,461300,2503992,22.58
9838704,9977992,3718,1301300,11279292,13.04
9838705,9983266,5219,1826650,11809916,18.30
9838706,9991825,3682,1288700,11280525,12.90
9838707,9970248,1810,633500,10603748,6.35
9838708,9971675,3670,1284500,11256175,12.88
9838709,9968364,4217,1475950,11444314,14.81
9838710,9831553,3957,1384950,11216503,14.09
9838711,9980171,3634,1271900,11252071,12.74
9838712,9983338,3386,1185100,11168438,11.87
9838713,9987385,3872,1355200,11342585,13.57
9838715,9982690,3444,1205400,11188090,12.07
9838716,9973353,3921,1372350,11345703,13.76
9838717,9969450,3522,1232700,11202150,12.36
9838718,9974857,4480,1568000,11542857,15.72
9838719,9981858,6191,2166850,12148708,21.71
9838720,7640915,2715,950250,8591165,12.44
9838721,9995170,4865,1702750,11697920,17.04
9838723,9978505,5527,1934450,11912955,19.39
9838724,9988683,2911,1018850,11007533,10.20
9838725,9994291,1750,612500,10606791,6.13
9838726,9960727,3282,1148700,11109427,11.53
9838727,9989326,5061,1771350,11760676,17.73
9838728,9991113,1979,692650,10683763,6.93
9838729,9977017,2091,731850,10708867,7.34
9838730,9967382,1362,476700,10444082,4.78
9838731,9984064,2642,924700,10908764,9.26
9838732,9990760,2953,1033550,11024310,10.35
9838733,9980124,4550,1592500,11572624,15.96
9838734,9998750,3684,1289400,11288150,12.90
9838736,9971469,4650,1627500,11598969,16.32
9838737,9993924,4110,1438500,11432424,14.39
9838738,9995501,4204,1471400,11466901,14.72
9838739,7479229,3378,1182300,8661529,15.81
9838740,9988578,3573,1250550,11239128,12.52
9838741,9979418,4555,1594250,11573668,15.98
9838742,9970055,4440,1554000,11524055,15.59
9838743,9982181,3427,1199450,11181631,12.02
9838744,9996080,2585,904750,10900830,9.05
9838745,9976552,3863,1352050,11328602,13.55
9838746,9989494,3743,1310050,11299544,13.11
9838747,9982389,4373,1530550,11512939,15.33
9838748,9982787,4896,1713600,11696387,17.17
9838749,9979785,3036,1062600,11042385,10.65
9838750,9988399,7218,2526300,12514699,25.29
9838751,9977530,2380,833000,10810530,8.35
9838752,9967143,4215,1475250,11442393,14.80
9838754,9994071,3426,1199100,11193171,12.00
9838755,9986867,3817,1335950,11322817,13.38
9838756,9993838,3800,1330000,11323838,13.31
9838757,9975157,2518,881300,10856457,8.83
9838758,9974611,3520,1232000,11206611,12.35
9838759,9988570,4299,1504650,11493220,15.06
9838760,9969376,5373,1880550,11849926,18.86
9838761,9994933,3379,1182650,11177583,11.83
9838762,9958450,5108,1787800,11746250,17.95
9838763,9991655,5132,1796200,11787855,17.98
9838764,9980687,2941,1029350,11010037,10.31
9838765,9988180,4856,1699600,11687780,17.02
9838766,9968867,4388,1535800,11504667,15.41
9838767,9734893,4790,1676500,11411393,17.22
9838768,9961443,3409,1193150,11154593,11.98
9838769,9959703,5224,1828400,11788103,18.36
9838770,9674721,3532,1236200,10910921,12.78
9838771,9972848,1638,573300,10546148,5.75
9838772,9994054,3260,1141000,11135054,11.42
9838773,9985778,3508,1227800,11213578,12.30
9838774,9985493,3148,1101800,11087293,11.03
9838775,9981081,3869,1354150,11335231,13.57
9838776,9972943,4951,1732850,11705793,17.38
9838777,9975321,2283,799050,10774371,8.01
9838778,9987331,5197,1818950,11806281,18.21
9838779,9077401,4992,1747200,10824601,19.25
9838780,9571370,5233,1831550,11402920,19.14
9838781,9988954,3157,1104950,11093904,11.06
9838782,9980465,2387,835450,10815915,8.37
9838783,9996457,5830,2040500,12036957,20.41
9838784,9987048,3281,1148350,11135398,11.50
9838785,9988563,4910,1718500,11707063,17.20
9838786,9993216,3404,1191400,11184616,11.92
9838787,9988728,3399,1189650,11178378,11.91
9838788,9975991,3481,1218350,11194341,12.21
9838789,9979005,4228,1479800,11458805,14.83
9838790,419339,142,49700,469039,11.85
9838791,9987183,4641,1624350,11611533,16.26
9838792,9980243,7327,2564450,12544693,25.70
9838793,9971999,3411,1193850,11165849,11.97
9838794,9982016,5109,1788150,11770166,17.91
9838795,9996836,6347,2221450,12218286,22.22
9838796,9996411,3626,1269100,11265511,12.70
9838797,9977164,5507,1927450,11904614,19.32
9838798,9529167,2420,847000,10376167,8.89
9838799,9982291,3394,1187900,11170191,11.90
9838800,9989074,3712,1299200,11288274,13.01
9838801,9982417,5268,1843800,11826217,18.47
9838802,9983468,4920,1722000,11705468,17.25
9838804,9982996,5932,2076200,12059196,20.80
9838805,9967604,2661,931350,10898954,9.34
9838806,9955098,4566,1598100,11553198,16.05
9838807,9971963,2377,831950,10803913,8.34
9838809,9937245,4748,1661800,11599045,16.72
9838810,9970976,3296,1153600,11124576,11.57
9838811,9964510,2794,977900,10942410,9.81
9838812,9961431,5914,2069900,12031331,20.78
9838814,9953889,3791,1326850,11280739,13.33
9838815,9955199,2036,712600,10667799,7.16
9838816,9949884,5430,1900500,11850384,19.10
9838817,9963513,5427,1899450,11862963,19.06
9838818,9953786,2377,831950,10785736,8.36
9838819,9941069,4062,1421700,11362769,14.30
9838820,9944620,5201,1820350,11764970,18.30
9838821,9939438,4289,1501150,11440588,15.10
9838822,3823455,2180,763000,4586455,19.96
9838823,9915182,3585,1254750,11169932,12.65
9838824,9943887,4527,1584450,11528337,15.93
9838825,9950501,5093,1782550,11733051,17.91
9838827,9970481,3692,1292200,11262681,12.96
9838828,9973301,4338,1518300,11491601,15.22
9838829,9446888,3912,1369200,10816088,14.49
9838830,9979292,4497,1573950,11553242,15.77
9838831,8889614,2728,954800,9844414,10.74
9838832,9578547,4159,1455650,11034197,15.20
9838833,2020511,1167,408450,2428961,20.22
9838834,9981011,5037,1762950,11743961,17.66
9838835,9978756,4353,1523550,11502306,15.27
9838836,9989042,4703,1646050,11635092,16.48
9838837,9990028,3259,1140650,11130678,11.42
9838838,9955122,4235,1482250,11437372,14.89
9838839,9989845,2494,872900,10862745,8.74
9838840,9944497,3430,1200500,11144997,12.07
9838841,9977380,4723,1653050,11630430,16.57
9838842,9964315,2811,983850,10948165,9.87
9838843,9978422,3773,1320550,11298972,13.23
9838844,9987397,4201,1470350,11457747,14.72
9838845,9996957,3075,1076250,11073207,10.77
9838846,9982558,2878,1007300,10989858,10.09
9838847,9993556,4856,1699600,11693156,17.01
9838848,9980534,6705,2346750,12327284,23.51
9838849,9976831,4391,1536850,11513681,15.40
9838850,9986147,3223,1128050,11114197,11.30
9838851,9982238,3704,1296400,11278638,12.99
9838852,9979885,3458,1210300,11190185,12.13
9838853,9983844,4305,1506750,11490594,15.09
9838854,9918728,3678,1287300,11206028,12.98
9838855,9965883,3768,1318800,11284683,13.23
9838856,9981427,5865,2052750,12034177,20.57
9838857,9989210,5433,1901550,11890760,19.04
9838858,9990115,2957,1034950,11025065,10.36
9838859,9998140,4556,1594600,11592740,15.95
9838860,9984310,3630,1270500,11254810,12.72
9838861,9983947,3757,1314950,11298897,13.17
9838862,7959939,5186,1815100,9775039,22.80
9838863,9419327,3629,1270150,10689477,13.48
9838864,9979293,3020,1057000,11036293,10.59
9838865,9961625,4047,1416450,11378075,14.22
9838866,9956053,5009,1753150,11709203,17.61
9838867,9958307,817,285950,10244257,2.87
9838868,9982165,4080,1428000,11410165,14.31
9838869,9971589,3790,1326500,11298089,13.30
9838870,9905761,6735,2357250,12263011,23.80
9838871,8185089,2965,1037750,9222839,12.68
9838872,9985768,3906,1367100,11352868,13.69
9838873,9992540,3182,1113700,11106240,11.15
9838874,9788486,4108,1437800,11226286,14.69
9838875,9983067,3255,1139250,11122317,11.41
9838876,9992449,4714,1649900,11642349,16.51
9838878,9969070,5343,1870050,11839120,18.76
9838879,9961422,4521,1582350,11543772,15.88
9838880,9976545,2036,712600,10689145,7.14
9838881,9984996,2663,932050,10917046,9.33
9838882,9995067,5521,1932350,11927417,19.33
9838883,9988556,2800,980000,10968556,9.81
9838884,9985015,4664,1632400,11617415,16.35
9838885,9967568,4363,1527050,11494618,15.32
9838886,1612775,589,206150,1818925,12.78
9838887,9975033,4812,1684200,11659233,16.88
9838888,1613767,735,257250,1871017,15.94
9838889,9969226,4289,1501150,11470376,15.06
9838890,9977083,4926,1724100,11701183,17.28
9838891,9980292,3890,1361500,11341792,13.64
9838892,9997971,920,322000,10319971,3.22
9838893,9972957,2607,912450,10885407,9.15
9838894,9968215,4451,1557850,11526065,15.63
9838895,9980355,2578,902300,10882655,9.04
9838896,9990449,1572,550200,10540649,5.51
9838897,9995213,2808,982800,10978013,9.83
9838898,9970671,4550,1592500,11563171,15.97
9838899,9974254,6490,2271500,12245754,22.77
9838900,4507008,1278,447300,4954308,9.92
9838901,9971496,2932,1026200,10997696,10.29
9838902,9975519,3101,1085350,11060869,10.88
9838903,9971473,4534,1586900,11558373,15.91
9838904,9987023,3580,1253000,11240023,12.55
9838905,9986696,3564,1247400,11234096,12.49
9838906,9986814,5580,1953000,11939814,19.56
9838907,7043168,3616,1265600,8308768,17.97
9838908,5445159,1871,654850,6100009,12.03
9838909,9990174,4024,1408400,11398574,14.10
9838910,9991149,5003,1751050,11742199,17.53
9838911,9989214,3808,1332800,11322014,13.34
9838912,9985308,5615,1965250,11950558,19.68
9838913,9983801,4839,1693650,11677451,16.96
9838914,9595343,4582,1603700,11199043,16.71
9838915,9997648,4255,1489250,11486898,14.90
9838916,9344150,4276,1496600,10840750,16.02
9838917,9474360,4741,1659350,11133710,17.51
9838918,9987026,5000,1750000,11737026,17.52
9838919,9981814,1651,577850,10559664,5.79
9838921,9958990,5287,1850450,11809440,18.58
9838922,9971224,5263,1842050,11813274,18.47
9838923,9995415,4256,1489600,11485015,14.90
9838924,9988875,4665,1632750,11621625,16.35
9838925,156985,68,23800,180785,15.16
9838926,9969627,4434,1551900,11521527,15.57
9838927,9979113,2993,1047550,11026663,10.50
9838928,9597395,4010,1403500,11000895,14.62
9838929,9959731,332,116200,10075931,1.17
9838930,9955603,5926,2074100,12029703,20.83
9838931,9957470,4988,1745800,11703270,17.53
9838932,9957918,3967,1388450,11346368,13.94
9838933,9960110,3169,1109150,11069260,11.14
9838934,9940631,5355,1874250,11814881,18.85
9838935,9939415,3905,1366750,11306165,13.75
9838936,9947830,4529,1585150,11532980,15.93
9838937,9958965,4233,1481550,11440515,14.88
9838938,9947364,4169,1459150,11406514,14.67
9838939,4625456,2174,760900,5386356,16.45
9838940,3615260,2595,908250,4523510,25.12
9838941,779938,967,338450,1118388,43.39
9838942,9953094,3633,1271550,11224644,12.78
9838943,1852886,1538,538300,2391186,29.05
9838944,9969000,3941,1379350,11348350,13.84
9838945,9966862,4021,1407350,11374212,14.12
9838946,9989091,5506,1927100,11916191,19.29
9838947,9989946,4350,1522500,11512446,15.24
9838948,9981167,2802,980700,10961867,9.83
9838949,2399234,1264,442400,2841634,18.44
9838950,9959026,3074,1075900,11034926,10.80
9838951,9978392,5015,1755250,11733642,17.59
9838952,9988148,5173,1810550,11798698,18.13
9838953,9914374,3022,1057700,10972074,10.67
9838954,9973515,4355,1524250,11497765,15.28
9838955,9956201,4643,1625050,11581251,16.32
9838956,9963439,3919,1371650,11335089,13.77
9838957,9978924,4631,1620850,11599774,16.24
9838958,9973277,4590,1606500,11579777,16.11
9838959,9987859,2962,1036700,11024559,10.38
9838960,9970442,2156,754600,10725042,7.57
9838961,9905744,5355,1874250,11779994,18.92
9838962,9987946,2631,920850,10908796,9.22
9838963,9994171,3639,1273650,11267821,12.74
9838964,9994352,3617,1265950,11260302,12.67
9838965,9976112,3628,1269800,11245912,12.73
9838966,9985809,3872,1355200,11341009,13.57
9838967,9977897,3369,1179150,11157047,11.82
9838968,9970675,6793,2377550,12348225,23.85
9838969,9972599,3524,1233400,11205999,12.37
9838970,9963507,3091,1081850,11045357,10.86
9838971,9960497,3497,1223950,11184447,12.29
9838973,9948354,2072,725200,10673554,7.29
9838974,9952401,5509,1928150,11880551,19.37
9838975,9709198,3122,1092700,10801898,11.25
9838976,9826842,3082,1078700,10905542,10.98
9838977,9957593,3531,1235850,11193443,12.41
9838978,9976119,5621,1967350,11943469,19.72
9838979,9981953,3389,1186150,11168103,11.88
9838980,8982732,3276,1146600,10129332,12.76
9838981,9991129,4815,1685250,11676379,16.87
9838982,9975606,2672,935200,10910806,9.37
9838983,910244,1217,425950,1336194,46.80
9838984,9989154,3868,1353800,11342954,13.55
9838985,6306402,2277,796950,7103352,12.64
9838986,9641765,3656,1279600,10921365,13.27
9838987,9967916,3136,1097600,11065516,11.01
9838988,8975523,2499,874650,9850173,9.74
9838989,9973692,3168,1108800,11082492,11.12
9838990,730834,443,155050,885884,21.22
9838991,9981959,4374,1530900,11512859,15.34
9838992,9972477,2139,748650,10721127,7.51
9838993,9989692,3800,1330000,11319692,13.31
9838994,9995344,2832,991200,10986544,9.92
9838995,9993893,4232,1481200,11475093,14.82
9838996,9998318,4237,1482950,11481268,14.83
9838997,9969834,2196,768600,10738434,7.71
9838998,5225501,2900,1015000,6240501,19.42
9838999,9993026,2826,989100,10982126,9.90
9839000,9976725,4354,1523900,11500625,15.27
9839001,9976676,3817,1335950,11312626,13.39
9839002,4189986,3100,1085000,5274986,25.90
9839003,9980796,3141,1099350,11080146,11.01
9839004,9901254,4069,1424150,11325404,14.38
9839005,9993527,3475,1216250,11209777,12.17
9839006,9994272,5228,1829800,11824072,18.31
9839007,9988025,3405,1191750,11179775,11.93
9839008,1093115,663,232050,1325165,21.23
9839010,9983659,2678,937300,10920959,9.39
9839011,9985506,3298,1154300,11139806,11.56
9839012,1148544,486,170100,1318644,14.81
9839013,3513368,1743,610050,4123418,17.36
9839014,9970639,5301,1855350,11825989,18.61
9839015,9752224,3367,1178450,10930674,12.08
9839016,9988167,4645,1625750,11613917,16.28
9839017,9983344,5389,1886150,11869494,18.89
9839018,9983314,4435,1552250,11535564,15.55
9839019,401241,68,23800,425041,5.93
9839020,9954204,4255,1489250,11443454,14.96
9839021,9949748,3088,1080800,11030548,10.86
9839022,9954277,2882,1008700,10962977,10.13
9839023,9960302,2338,818300,10778602,8.22
9839024,9971625,4027,1409450,11381075,14.13
9839025,9967005,3695,1293250,11260255,12.98
9839026,3779221,2023,708050,4487271,18.74
9839027,9957415,3868,1353800,11311215,13.60
9839028,9916642,2055,719250,10635892,7.25
9839030,9950327,4469,1564150,11514477,15.72
9839031,9958364,2372,830200,10788564,8.34
9839032,9953564,3964,1387400,11340964,13.94
9839033,9969752,2835,992250,10962002,9.95
9839034,9967235,2488,870800,10838035,8.74
9839035,9982211,3210,1123500,11105711,11.26
9839036,9703361,711,248850,9952211,2.56
9839038,283790,151,52850,336640,18.62
9839039,9948258,2301,805350,10753608,8.10
9839040,9951669,4058,1420300,11371969,14.27
9839041,9966207,3527,1234450,11200657,12.39
9839042,9965800,4576,1601600,11567400,16.07
9839043,9975209,3257,1139950,11115159,11.43
9839044,9977493,3231,1130850,11108343,11.33
9839045,9978372,3004,1051400,11029772,10.54
9839046,9985087,3977,1391950,11377037,13.94
9839047,9982395,2610,913500,10895895,9.15
9839048,9988648,3906,1367100,11355748,13.69
9839049,7954163,2916,1020600,8974763,12.83
9839050,9977574,2318,811300,10788874,8.13
9839051,9960255,3606,1262100,11222355,12.67
9839052,9979609,4541,1589350,11568959,15.93
9839053,9981630,3468,1213800,11195430,12.16
9839054,9975522,3352,1173200,11148722,11.76
9839055,5261899,1057,369950,5631849,7.03
9839056,2706680,893,312550,3019230,11.55
9839057,9969697,3743,1310050,11279747,13.14
9839058,9974310,5075,1776250,11750560,17.81
9839059,9990060,3549,1242150,11232210,12.43
9839060,9987587,4360,1526000,11513587,15.28
9839061,9996331,4848,1696800,11693131,16.97
9839062,9982091,2194,767900,10749991,7.69
9839063,9866685,3760,1316000,11182685,13.34
9839064,9987410,4584,1604400,11591810,16.06
9839065,4815308,1761,616350,5431658,12.80
9839066,9972936,3009,1053150,11026086,10.56
9839067,1032375,588,205800,1238175,19.93
9839068,9980531,2227,779450,10759981,7.81
9839069,9995255,3968,1388800,11384055,13.89
9839071,9997720,2791,976850,10974570,9.77
9839072,67506,48,16800,84306,24.89
9839073,1496848,1430,500500,1997348,33.44
9839074,9955359,5246,1836100,11791459,18.44
9839075,9967320,1955,684250,10651570,6.86
9839076,9963498,2642,924700,10888198,9.28
9839077,9964716,3096,1083600,11048316,10.87
9839078,9977133,2093,732550,10709683,7.34
9839079,8972308,1545,540750,9513058,6.03
9839080,9979701,3981,1393350,11373051,13.96
9839081,9987742,1566,548100,10535842,5.49
9839082,9991395,3083,1079050,11070445,10.80
9839083,2419844,1577,551950,2971794,22.81
9839084,5937599,1190,416500,6354099,7.01
9839085,1283313,531,185850,1469163,14.48
9839086,447604,254,88900,536504,19.86
9839087,9969655,3321,1162350,11132005,11.66
9839088,5027221,1699,594650,5621871,11.83
9839089,9973874,6614,2314900,12288774,23.21
9839090,9979257,3181,1113350,11092607,11.16
9839091,9986868,1404,491400,10478268,4.92
9839092,159603,42,14700,174303,9.21
9839094,9929220,6194,2167900,12097120,21.83
9839095,1220078,546,191100,1411178,15.66
9839096,9887086,4849,1697150,11584236,17.17
9839097,9970943,2051,717850,10688793,7.20
9839098,426220,279,97650,523870,22.91
9839099,493601,251,87850,581451,17.80
9839100,1859870,997,348950,2208820,18.76
9839101,9838149,3718,1301300,11139449,13.23
9839103,9941271,4018,1406300,11347571,14.15
9839104,4005674,2774,970900,4976574,24.24
9839105,9945705,3033,1061550,11007255,10.67
9839106,1587736,720,252000,1839736,15.87
9839107,7839268,1725,603750,8443018,7.70
9839108,9940802,4676,1636600,11577402,16.46
9839109,9943212,4793,1677550,11620762,16.87
9839110,9948660,2439,853650,10802310,8.58
9839111,9956833,5150,1802500,11759333,18.10
9839112,9973853,3224,1128400,11102253,11.31
9839113,9980101,4394,1537900,11518001,15.41
9839114,9989074,3974,1390900,11379974,13.92
9839115,7984561,1834,641900,8626461,8.04
9839116,9994156,4355,1524250,11518406,15.25
9839117,9970078,3750,1312500,11282578,13.16
9839118,8720336,882,308700,9029036,3.54
9839119,9989077,1077,376950,10366027,3.77
9839120,9956970,2509,878150,10835120,8.82
9839121,9974081,2515,880250,10854331,8.83
9839122,9974318,983,344050,10318368,3.45
9839123,9982375,1754,613900,10596275,6.15
9839124,9974370,3497,1223950,11198320,12.27
9839125,9979396,4949,1732150,11711546,17.36
9839126,9976037,3388,1185800,11161837,11.89
9839128,9972671,4094,1432900,11405571,14.37
9839129,1419902,502,175700,1595602,12.37
9839130,9966879,3583,1254050,11220929,12.58
9839131,9970264,3934,1376900,11347164,13.81
9839132,8684771,3090,1081500,9766271,12.45
9839133,4830535,3766,1318100,6148635,27.29
9839134,9976979,3996,1398600,11375579,14.02
9839135,9970303,4055,1419250,11389553,14.23
9839136,9985623,3115,1090250,11075873,10.92
9839137,9996264,4242,1484700,11480964,14.85
9839138,9223899,3526,1234100,10457999,13.38
9839139,9278033,5083,1779050,11057083,19.17
9839140,9082611,2378,832300,9914911,9.16
9839141,9977946,2799,979650,10957596,9.82
9839142,9974473,5063,1772050,11746523,17.77
9839143,9985483,4706,1647100,11632583,16.49
9839144,9962787,6802,2380700,12343487,23.90
9839145,9973464,4453,1558550,11532014,15.63
9839146,9740334,2808,982800,10723134,10.09
9839147,9980068,4800,1680000,11660068,16.83
9839148,9989334,4298,1504300,11493634,15.06
9839149,9987035,2311,808850,10795885,8.10
9839150,9974446,6805,2381750,12356196,23.88
9839151,9989311,1601,560350,10549661,5.61
9839152,9974480,1089,381150,10355630,3.82
9839153,9975601,3421,1197350,11172951,12.00
9839154,9931578,3491,1221850,11153428,12.30
9839155,9971744,6166,2158100,12129844,21.64
9839156,9960245,6361,2226350,12186595,22.35
9839157,9953791,1645,575750,10529541,5.78
9839158,9978302,2568,898800,10877102,9.01
9839159,9972903,4210,1473500,11446403,14.78
9839160,9981654,3164,1107400,11089054,11.09
9839161,9982066,6721,2352350,12334416,23.57
9839162,9976905,2901,1015350,10992255,10.18
9839163,1260723,610,213500,1474223,16.93
9839164,9627184,6334,2216900,11844084,23.03
9839165,9966053,4896,1713600,11679653,17.19
9839166,9978070,3956,1384600,11362670,13.88
9839167,9862764,5197,1818950,11681714,18.44
9839168,7480971,127,44450,7525421,0.59
9839169,7636038,2305,806750,8442788,10.57
9839170,9932370,5569,1949150,11881520,19.62
9839171,9941172,4181,1463350,11404522,14.72
9839172,9940732,5045,1765750,11706482,17.76
9839173,9926337,3893,1362550,11288887,13.73
9839175,9913406,6235,2182250,12095656,22.01
9839176,9936845,5909,2068150,12004995,20.81
9839177,9937750,3757,1314950,11252700,13.23
9839178,9940083,4971,1739850,11679933,17.50
9839179,4996191,1563,547050,5543241,10.95
9839180,9969221,2725,953750,10922971,9.57
9839181,9960623,3442,1204700,11165323,12.09
9839182,9980553,2541,889350,10869903,8.91
9839183,9983925,3061,1071350,11055275,10.73
9839184,9988120,3002,1050700,11038820,10.52
9839185,9984837,3944,1380400,11365237,13.82
9839186,9976356,1773,620550,10596906,6.22
9839187,9993932,2065,722750,10716682,7.23
9839188,1984972,713,249550,2234522,12.57
9839189,9965123,4707,1647450,11612573,16.53
9839190,9970104,4918,1721300,11691404,17.26
9839192,9932421,2390,836500,10768921,8.42
9839193,9981275,4589,1606150,11587425,16.09
9839194,9994765,1566,548100,10542865,5.48
9839195,9981261,7507,2627450,12608711,26.32
9839196,9980940,2191,766850,10747790,7.68
9839197,9971118,5592,1957200,11928318,19.63
9839198,9977973,5526,1934100,11912073,19.38
9839199,8102523,3652,1278200,9380723,15.78
9839200,9975377,2014,704900,10680277,7.07
9839203,6421197,2695,943250,7364447,14.69
9839204,9984798,3414,1194900,11179698,11.97
9839205,9987655,1353,473550,10461205,4.74
9839206,1249893,431,150850,1400743,12.07
9839207,9963531,3567,1248450,11211981,12.53
9839208,9992335,4646,1626100,11618435,16.27
9839209,1689232,558,195300,1884532,11.56
9839210,9980160,3538,1238300,11218460,12.41
9839211,9970169,3757,1314950,11285119,13.19
9839212,9962455,5920,2072000,12034455,20.80
9839213,9990039,4977,1741950,11731989,17.44
9839214,9990153,2787,975450,10965603,9.76
9839215,9983315,2890,1011500,10994815,10.13
9839216,9988210,1518,531300,10519510,5.32
9839217,9967235,572,200200,10167435,2.01
9839218,9970917,3234,1131900,11102817,11.35
9839219,9988335,1845,645750,10634085,6.47
9839220,1885807,399,139650,2025457,7.41
9839221,2807470,2333,816550,3624020,29.08
9839222,245587,97,33950,279537,13.82
9839224,9721672,4179,1462650,11184322,15.05
9839225,9969141,5133,1796550,11765691,18.02
9839226,9978461,2006,702100,10680561,7.04
9839227,9988269,1858,650300,10638569,6.51
9839228,9992803,3793,1327550,11320353,13.29
9839229,9999152,2690,941500,10940652,9.42
9839230,9990319,2807,982450,10972769,9.83
9839231,1209617,286,100100,1309717,8.28
9839232,9983421,1034,361900,10345321,3.63
9839233,9976368,815,285250,10261618,2.86
9839234,9983633,1557,544950,10528583,5.46
9839235,9981532,2438,853300,10834832,8.55
9839236,9994963,2765,967750,10962713,9.68
9839237,9972447,760,266000,10238447,2.67
9839238,9999295,3353,1173550,11172845,11.74
9839240,9974545,5729,2005150,11979695,20.10
9839241,9980116,4050,1417500,11397616,14.20
9839242,9992854,4409,1543150,11536004,15.44
9839243,9993538,4532,1586200,11579738,15.87
9839244,9983393,4619,1616650,11600043,16.19
9839245,9973764,4433,1551550,11525314,15.56
9839246,9986435,6249,2187150,12173585,21.90
9839247,9988918,3114,1089900,11078818,10.91
9839248,9979163,5049,1767150,11746313,17.71
9839249,9975905,4685,1639750,11615655,16.44
9839250,9968215,4342,1519700,11487915,15.25
9839251,9978043,3631,1270850,11248893,12.74
9839252,9975032,3515,1230250,11205282,12.33
9839253,9964363,4115,1440250,11404613,14.45
9839254,9970682,4024,1408400,11379082,14.13
9839255,9959839,2426,849100,10808939,8.53
9839256,9967113,4181,1463350,11430463,14.68
9839257,9980489,4011,1403850,11384339,14.07
9839258,9980886,5045,1765750,11746636,17.69
9839259,9994278,5370,1879500,11873778,18.81
9839260,6999434,498,174300,7173734,2.49
9839261,9985301,5024,1758400,11743701,17.61
9839262,9992716,5582,1953700,11946416,19.55
9839263,9967624,2770,969500,10937124,9.73
9839264,9963730,1969,689150,10652880,6.92
9839265,9210888,3354,1173900,10384788,12.74
9839266,9967617,3763,1317050,11284667,13.21
9839268,8787884,2116,740600,9528484,8.43
9839269,9983477,2607,912450,10895927,9.14
9839270,9994620,3096,1083600,11078220,10.84
9839271,2732501,568,198800,2931301,7.28
9839272,9978708,3912,1369200,11347908,13.72
9839273,9973787,5144,1800400,11774187,18.05
9839274,9980259,1251,437850,10418109,4.39
9839275,2122483,998,349300,2471783,16.46
9839276,9973093,3699,1294650,11267743,12.98
9839277,9989260,5739,2008650,11997910,20.11
9839278,9837375,1520,532000,10369375,5.41
9839279,8856914,3937,1377950,10234864,15.56
9839280,9979626,5069,1774150,11753776,17.78
9839281,4385502,956,334600,4720102,7.63
9839283,1223254,622,217700,1440954,17.80
9839284,9972603,3009,1053150,11025753,10.56
9839285,9982505,4972,1740200,11722705,17.43
9839287,9996131,3188,1115800,11111931,11.16
9839288,9998778,4650,1627500,11626278,16.28
9839289,1129222,740,259000,1388222,22.94
9839290,9979519,5184,1814400,11793919,18.18
9839291,9941972,4229,1480150,11422122,14.89
9839293,7256983,3355,1174250,8431233,16.18
9839294,5735770,1599,559650,6295420,9.76
9839295,9964379,4740,1659000,11623379,16.65
9839296,9967346,4408,1542800,11510146,15.48
9839297,9969685,4037,1412950,11382635,14.17
9839298,7872713,5358,1875300,9748013,23.82
9839299,9994559,4570,1599500,11594059,16.00
9839300,9986837,2312,809200,10796037,8.10
9839301,9979426,2898,1014300,10993726,10.16
9839302,9993152,4561,1596350,11589502,15.97
9839303,9977697,2097,733950,10711647,7.36
9839304,9961598,3714,1299900,11261498,13.05
9839305,9978092,5885,2059750,12037842,20.64
9839306,377349,93,32550,409899,8.63
9839307,9067358,4047,1416450,10483808,15.62
9839308,9966169,3118,1091300,11057469,10.95
9839309,9963476,4791,1676850,11640326,16.83
9839310,9944711,1949,682150,10626861,6.86
9839312,9939061,3683,1289050,11228111,12.97
9839313,9922782,3783,1324050,11246832,13.34
9839314,7731223,2237,782950,8514173,10.13
9839315,8921665,3640,1274000,10195665,14.28
9839316,9938991,3612,1264200,11203191,12.72
9839317,9935462,4190,1466500,11401962,14.76
9839318,9944306,5654,1978900,11923206,19.90
9839319,9938767,4130,1445500,11384267,14.54
9839320,9938214,3738,1308300,11246514,13.16
9839321,9954065,3908,1367800,11321865,13.74
9839322,9963418,3793,1327550,11290968,13.32
9839323,9962343,3955,1384250,11346593,13.89
9839324,6856919,559,195650,7052569,2.85
9839325,3306616,861,301350,3607966,9.11
9839326,9940773,2042,714700,10655473,7.19
9839327,9952914,4160,1456000,11408914,14.63
9839328,9351470,4405,1541750,10893220,16.49
9839329,9977841,1812,634200,10612041,6.36
9839330,9982079,1548,541800,10523879,5.43
9839331,9948916,5257,1839950,11788866,18.49
9839332,9985487,1582,553700,10539187,5.55
9839333,9983892,5023,1758050,11741942,17.61
9839334,7334087,1826,639100,7973187,8.71
9839335,9964725,3679,1287650,11252375,12.92
9839336,9964610,4861,1701350,11665960,17.07
9839337,9981618,1439,503650,10485268,5.05
9839338,9992807,4642,1624700,11617507,16.26
9839340,4157632,2126,744100,4901732,17.90
9839342,9970696,5887,2060450,12031146,20.67
9839343,701051,668,233800,934851,33.35
9839344,9983053,2862,1001700,10984753,10.03
9839345,9957363,3686,1290100,11247463,12.96
9839346,2372869,759,265650,2638519,11.20
9839347,9953663,2884,1009400,10963063,10.14
9839348,9955684,5345,1870750,11826434,18.79
9839349,9955639,2879,1007650,10963289,10.12
9839350,9938836,3121,1092350,11031186,10.99
9839351,9937564,3593,1257550,11195114,12.65
9839352,9949152,545,190750,10139902,1.92
9839353,2978803,1123,393050,3371853,13.19
9839354,2409629,768,268800,2678429,11.16
9839355,9962001,3588,1255800,11217801,12.61
9839356,9955649,4227,1479450,11435099,14.86
9839357,9973295,2854,998900,10972195,10.02
9839358,2224677,1059,370650,2595327,16.66
9839359,9970281,6584,2304400,12274681,23.11
9839360,9927057,3867,1353450,11280507,13.63
9839361,9966691,4938,1728300,11694991,17.34
9839362,9965780,3847,1346450,11312230,13.51
9839363,9973110,6723,2353050,12326160,23.59
9839364,9972695,2796,978600,10951295,9.81
9839365,8348297,500,175000,8523297,2.10
9839366,9973489,4102,1435700,11409189,14.40
9839367,9990721,4960,1736000,11726721,17.38
9839368,1438813,350,122500,1561313,8.51
9839369,9969126,3573,1250550,11219676,12.54
9839370,9976568,4032,1411200,11387768,14.15
9839371,9970447,4458,1560300,11530747,15.65
9839372,9970250,4975,1741250,11711500,17.46
9839374,9946242,4941,1729350,11675592,17.39
9839375,9956194,2538,888300,10844494,8.92
9839376,9948339,3147,1101450,11049789,11.07
9839377,9939907,3701,1295350,11235257,13.03
9839378,9945223,2580,903000,10848223,9.08
9839379,9958639,1990,696500,10655139,6.99
9839380,9961251,1928,674800,10636051,6.77
9839381,9965912,1166,408100,10374012,4.09
9839382,9949398,3979,1392650,11342048,14.00
9839383,9972712,5072,1775200,11747912,17.80
9839384,9801435,2682,938700,10740135,9.58
9839385,4563258,1970,689500,5252758,15.11
9839386,1475072,1021,357350,1832422,24.23
9839387,9958543,4203,1471050,11429593,14.77
9839388,9964568,2399,839650,10804218,8.43
9839389,9957161,4466,1563100,11520261,15.70
9839390,9958591,3207,1122450,11081041,11.27
9839391,9964167,4517,1580950,11545117,15.87
9839392,9977677,5388,1885800,11863477,18.90
9839393,9911479,5068,1773800,11685279,17.90
9839394,9980430,3556,1244600,11225030,12.47
9839395,5279893,760,266000,5545893,5.04
9839396,9977132,3722,1302700,11279832,13.06
9839397,9966984,2401,840350,10807334,8.43
9839398,8884267,2139,748650,9632917,8.43
9839399,9978122,2878,1007300,10985422,10.10
9839400,9981895,3823,1338050,11319945,13.40
9839401,7255508,553,193550,7449058,2.67
9839402,9977830,2626,919100,10896930,9.21
9839403,9980971,4531,1585850,11566821,15.89
9839404,9988770,2891,1011850,11000620,10.13
9839405,2928144,401,140350,3068494,4.79
9839406,9971548,2713,949550,10921098,9.52
9839407,9979697,3551,1242850,11222547,12.45
9839408,4336765,2975,1041250,5378015,24.01
9839409,9978395,4749,1662150,11640545,16.66
9839410,2405120,574,200900,2606020,8.35
9839411,9976834,4751,1662850,11639684,16.67
9839412,9974156,3851,1347850,11322006,13.51
9839413,9976970,4155,1454250,11431220,14.58
9839414,3221819,394,137900,3359719,4.28
9839415,9973561,2886,1010100,10983661,10.13
9839416,9981954,4065,1422750,11404704,14.25
9839417,9976419,4935,1727250,11703669,17.31
9839418,9988200,2315,810250,10798450,8.11
9839419,9978934,4057,1419950,11398884,14.23
9839420,9987573,2862,1001700,10989273,10.03
9839421,9979712,3730,1305500,11285212,13.08
9839422,9971312,3196,1118600,11089912,11.22
9839423,1466965,537,187950,1654915,12.81
9839424,3780782,1396,488600,4269382,12.92
9839425,9972417,4016,1405600,11378017,14.09
9839426,9981046,2755,964250,10945296,9.66
9839427,9958305,3372,1180200,11138505,11.85
9839428,9975196,2828,989800,10964996,9.92
9839429,9960809,2315,810250,10771059,8.13
9839430,9976291,2319,811650,10787941,8.14
9839431,9984934,2989,1046150,11031084,10.48
9839432,9977296,3618,1266300,11243596,12.69
9839433,9532869,3046,1066100,10598969,11.18
9839435,3908400,1769,619150,4527550,15.84
9839436,9952690,4299,1504650,11457340,15.12
9839437,9963317,4499,1574650,11537967,15.80
9839438,9968203,4289,1501150,11469353,15.06
9839439,9976966,7408,2592800,12569766,25.99
9839440,9959525,2186,765100,10724625,7.68
9839441,9958011,4716,1650600,11608611,16.58
9839442,9956577,6011,2103850,12060427,21.13
9839443,9944780,4205,1471750,11416530,14.80
9839444,9947557,5015,1755250,11702807,17.65
9839445,109314,100,35000,144314,32.02
9839446,9968192,5831,2040850,12009042,20.47
9839447,9981665,3292,1152200,11133865,11.54
9839448,9974551,4304,1506400,11480951,15.10
9839449,9978540,2358,825300,10803840,8.27
9839450,9975149,1809,633150,10608299,6.35
9839451,9986540,4906,1717100,11703640,17.19
9839452,9984073,3225,1128750,11112823,11.31
9839453,9986336,1285,449750,10436086,4.50
9839454,2899501,309,108150,3007651,3.73
9839455,9981815,2376,831600,10813415,8.33
9839456,9978121,5142,1799700,11777821,18.04
9839457,9991568,843,295050,10286618,2.95
9839458,9983882,4244,1485400,11469282,14.88
9839459,7920198,1861,651350,8571548,8.22
9839460,661351,228,79800,741151,12.07
9839461,9983189,4054,1418900,11402089,14.21
9839462,9999654,2437,852950,10852604,8.53
9839463,9990446,3335,1167250,11157696,11.68
9839464,9989054,3475,1216250,11205304,12.18
9839465,9981866,4202,1470700,11452566,14.73
9839466,9987495,4165,1457750,11445245,14.60
9839467,9971309,3898,1364300,11335609,13.68
9839468,9976507,4764,1667400,11643907,16.71
9839470,9964744,2784,974400,10939144,9.78
9839471,9986673,4527,1584450,11571123,15.87
9839472,9976097,5827,2039450,12015547,20.44
9839473,6578570,985,344750,6923320,5.24
9839474,6213910,1204,421400,6635310,6.78
9839475,9982356,5044,1765400,11747756,17.69
9839476,9944632,4095,1433250,11377882,14.41
9839477,9974668,5990,2096500,12071168,21.02
9839478,9973394,5290,1851500,11824894,18.56
9839479,9988061,3290,1151500,11139561,11.53
9839480,9996755,3782,1323700,11320455,13.24
9839481,9976401,4780,1673000,11649401,16.77
9839482,9979172,2580,903000,10882172,9.05
9839483,9979957,4807,1682450,11662407,16.86
9839484,9973375,5628,1969800,11943175,19.75
9839485,2273400,841,294350,2567750,12.95
9839487,9974322,3079,1077650,11051972,10.80
9839488,9992489,4996,1748600,11741089,17.50
9839489,9993506,2785,974750,10968256,9.75
9839490,9982251,6470,2264500,12246751,22.69
9839491,863193,347,121450,984643,14.07
9839492,9987198,3026,1059100,11046298,10.60
9839493,9988248,8014,2804900,12793148,28.08
9839494,9990917,3336,1167600,11158517,11.69
9839495,9988188,4017,1405950,11394138,14.08
9839496,9993980,2608,912800,10906780,9.13
9839497,9994754,3591,1256850,11251604,12.58
9839498,9973447,8169,2859150,12832597,28.67
9839499,9991790,3811,1333850,11325640,13.35
9839500,9987110,5147,1801450,11788560,18.04
9839501,9983861,3588,1255800,11239661,12.58
9839502,9974770,2472,865200,10839970,8.67
9839503,9976818,4467,1563450,11540268,15.67
9839504,9994733,6226,2179100,12173833,21.80
9839505,9985822,6055,2119250,12105072,21.22
9839506,9988547,1062,371700,10360247,3.72
9839507,9994063,4855,1699250,11693313,17.00
9839508,9996861,5462,1911700,11908561,19.12
9839509,9998080,1890,661500,10659580,6.62
9839510,9989024,2348,821800,10810824,8.23
9839511,9987493,2029,710150,10697643,7.11
9839512,9982761,2103,736050,10718811,7.37
9839513,9974428,2833,991550,10965978,9.94
9839515,9981812,2851,997850,10979662,10.00
9839516,9971310,2843,995050,10966360,9.98
9839517,9988375,5609,1963150,11951525,19.65
9839518,7459178,3082,1078700,8537878,14.46
9839519,9768527,6047,2116450,11884977,21.67
9839520,9994414,4580,1603000,11597414,16.04
9839521,9984573,4512,1579200,11563773,15.82
9839522,9951974,3683,1289050,11241024,12.95
9839523,9964379,5148,1801800,11766179,18.08
9839524,9996387,3260,1141000,11137387,11.41
9839525,9992178,2965,1037750,11029928,10.39
9839526,9990205,5470,1914500,11904705,19.16
9839527,9984343,4807,1682450,11666793,16.85
9839528,9992982,4049,1417150,11410132,14.18
9839529,9974098,2453,858550,10832648,8.61
9839530,9994080,1178,412300,10406380,4.13
9839531,601537,474,165900,767437,27.58
9839532,339942,211,73850,413792,21.72
9839533,9958585,3364,1177400,11135985,11.82
9839534,9979419,4594,1607900,11587319,16.11
9839535,2763829,1581,553350,3317179,20.02
9839536,9992447,3507,1227450,11219897,12.28
9839538,7109992,3268,1143800,8253792,16.09
9839539,9979764,4131,1445850,11425614,14.49
9839540,1840867,702,245700,2086567,13.35
9839541,1160790,609,213150,1373940,18.36
9839542,4271339,3644,1275400,5546739,29.86
9839543,9972791,4935,1727250,11700041,17.32
9839544,9985700,2532,886200,10871900,8.87
9839545,9960965,3316,1160600,11121565,11.65
9839546,9975457,4433,1551550,11527007,15.55
9839548,9945338,1310,458500,10403838,4.61
9839549,9977049,6220,2177000,12154049,21.82
9839550,9985371,4579,1602650,11588021,16.05
9839551,9984360,3778,1322300,11306660,13.24
9839552,9987954,4026,1409100,11397054,14.11
9839553,9981387,5379,1882650,11864037,18.86
9839554,8865311,1151,402850,9268161,4.54
9839555,9975584,2879,1007650,10983234,10.10
9839556,9974246,3051,1067850,11042096,10.71
9839557,9992961,5586,1955100,11948061,19.56
9839558,8903910,4433,1551550,10455460,17.43
9839559,9985391,4612,1614200,11599591,16.17
9839560,9994514,4718,1651300,11645814,16.52
9839561,9985181,5081,1778350,11763531,17.81
9839562,9975245,1439,503650,10478895,5.05
9839563,9988711,3386,1185100,11173811,11.86
9839564,9995522,2504,876400,10871922,8.77
9839565,9998744,3890,1361500,11360244,13.62
9839566,9986206,3646,1276100,11262306,12.78
9839567,1261424,500,175000,1436424,13.87
9839568,9975991,4266,1493100,11469091,14.97
9839569,9961899,3283,1149050,11110949,11.53
9839570,9970269,2074,725900,10696169,7.28
9839571,9980292,3452,1208200,11188492,12.11
9839572,9975688,5132,1796200,11771888,18.01
9839573,9974221,6392,2237200,12211421,22.43
9839574,9971754,2127,744450,10716204,7.47
9839575,9992258,4939,1728650,11720908,17.30
9839576,9997211,4946,1731100,11728311,17.32
9839578,5965594,2805,981750,6947344,16.46
9839579,9974918,5139,1798650,11773568,18.03
9839580,9980790,6149,2152150,12132940,21.56
9839581,9976084,3589,1256150,11232234,12.59
9839582,675761,316,110600,786361,16.37
9839583,9949866,4110,1438500,11388366,14.46
9839584,9970458,4372,1530200,11500658,15.35
9839585,9962746,5822,2037700,12000446,20.45
9839586,9977530,4180,1463000,11440530,14.66
9839587,1866687,920,322000,2188687,17.25
9839588,8412004,4115,1440250,9852254,17.12
9839589,9979202,5857,2049950,12029152,20.54
9839590,525648,272,95200,620848,18.11
9839591,9967633,2675,936250,10903883,9.39
9839592,9963015,3911,1368850,11331865,13.74
9839593,9965075,3706,1297100,11262175,13.02
9839594,9988235,5077,1776950,11765185,17.79
9839595,9984536,6051,2117850,12102386,21.21
9839596,9984167,2101,735350,10719517,7.37
9839597,9977955,1836,642600,10620555,6.44
9839598,9989434,4357,1524950,11514384,15.27
9839599,9971692,3460,1211000,11182692,12.14
9839600,9997883,3522,1232700,11230583,12.33
9839601,9988035,3561,1246350,11234385,12.48
9839602,9983963,3901,1365350,11349313,13.68
9839603,754382,72,25200,779582,3.34
9839604,9966846,2776,971600,10938446,9.75
9839605,257669,196,68600,326269,26.62
9839606,9202809,3875,1356250,10559059,14.74
9839607,9889363,4224,1478400,11367763,14.95
9839608,9489989,4658,1630300,11120289,17.18
9839609,3389084,1016,355600,3744684,10.49
9839610,9983518,5808,2032800,12016318,20.36
9839611,9987761,4201,1470350,11458111,14.72
9839612,9990223,5635,1972250,11962473,19.74
9839613,9845797,5285,1849750,11695547,18.79
9839614,9963739,4386,1535100,11498839,15.41
9839616,9975361,2817,985950,10961311,9.88
9839618,9980290,5645,1975750,11956040,19.80
9839619,655829,305,106750,762579,16.28
9839620,9979264,2695,943250,10922514,9.45
9839621,1818039,1393,487550,2305589,26.82
9839622,9975434,3545,1240750,11216184,12.44
9839623,1590393,2024,708400,2298793,44.54
9839624,9935584,3832,1341200,11276784,13.50
9839625,9980457,4297,1503950,11484407,15.07
9839626,9980971,4342,1519700,11500671,15.23
9839627,9996619,4020,1407000,11403619,14.07
9839628,9979043,893,312550,10291593,3.13
9839629,209965,292,102200,312165,48.67
9839630,9967127,6255,2189250,12156377,21.96
9839631,9972722,5047,1766450,11739172,17.71
9839632,1407183,879,307650,1714833,21.86
9839633,1595354,645,225750,1821104,14.15
9839634,4804215,1984,694400,5498615,14.45
9839635,9983787,5119,1791650,11775437,17.95
9839636,9992410,5902,2065700,12058110,20.67
9839638,1141005,608,212800,1353805,18.65
9839639,9970177,3274,1145900,11116077,11.49
9839640,4640788,3830,1340500,5981288,28.89
9839641,9988192,2177,761950,10750142,7.63
9839642,9998564,4927,1724450,11723014,17.25
9839643,9989703,3928,1374800,11364503,13.76
9839644,9983899,4348,1521800,11505699,15.24
9839645,9991976,4086,1430100,11422076,14.31
9839646,9991534,4246,1486100,11477634,14.87
9839647,425747,326,114100,539847,26.80
9839648,9972169,6143,2150050,12122219,21.56
9839650,527832,151,52850,580682,10.01
9839651,9981506,5296,1853600,11835106,18.57
9839652,9985352,4466,1563100,11548452,15.65
9839653,3963020,1647,576450,4539470,14.55
9839654,7346118,3241,1134350,8480468,15.44
9839655,5669331,3632,1271200,6940531,22.42
9839656,1020084,774,270900,1290984,26.56
9839657,9976330,5370,1879500,11855830,18.84
9839658,9986611,1715,600250,10586861,6.01
9839659,9983899,3840,1344000,11327899,13.46
9839660,679953,565,197750,877703,29.08
9839661,823377,388,135800,959177,16.49
9839662,1640855,1446,506100,2146955,30.84
9839663,9997398,2254,788900,10786298,7.89
9839664,9998716,3843,1345050,11343766,13.45
9839665,9993610,4247,1486450,11480060,14.87
9839667,9668381,4666,1633100,11301481,16.89
9839668,9988043,5371,1879850,11867893,18.82
9839669,9990879,5234,1831900,11822779,18.34
9839670,9970985,3193,1117550,11088535,11.21
9839671,9992732,2051,717850,10710582,7.18
9839672,9989660,2964,1037400,11027060,10.38
9839673,9983451,2094,732900,10716351,7.34
9839674,9988583,1394,487900,10476483,4.88
9839675,9986279,1897,663950,10650229,6.65
9839676,141356,72,25200,166556,17.83
9839678,1746526,1049,367150,2113676,21.02
9839679,9973298,2371,829850,10803148,8.32
9839680,9990168,728,254800,10244968,2.55
9839681,9976846,1025,358750,10335596,3.60
9839682,9978918,6277,2196950,12175868,22.02
9839683,9971159,3579,1252650,11223809,12.56
9839684,9995124,3290,1151500,11146624,11.52
9839685,9987976,920,322000,10309976,3.22
9839686,9983305,4866,1703100,11686405,17.06
9839687,9991780,1428,499800,10491580,5.00
9839688,9979833,4718,1651300,11631133,16.55
9839689,2130107,1803,631050,2761157,29.63
9839691,9960209,5941,2079350,12039559,20.88
9839692,9904104,2699,944650,10848754,9.54
9839693,9978407,1605,561750,10540157,5.63
9839694,1940216,750,262500,2202716,13.53
9839695,9941224,1724,603400,10544624,6.07
9839696,8952672,5282,1848700,10801372,20.65
9839697,9965037,5000,1750000,11715037,17.56
9839698,9969071,4996,1748600,11717671,17.54
9839699,9967520,4990,1746500,11714020,17.52
9839700,776332,241,84350,860682,10.87
9839701,9946229,4861,1701350,11647579,17.11
9839702,9965650,5346,1871100,11836750,18.78
9839703,4969848,3376,1181600,6151448,23.78
9839704,9980641,4633,1621550,11602191,16.25
9839705,9977723,6247,2186450,12164173,21.91
9839706,9987715,4384,1534400,11522115,15.36
9839707,9971112,3954,1383900,11355012,13.88
9839708,9982137,5653,1978550,11960687,19.82
9839709,9994313,5146,1801100,11795413,18.02
9839710,9987937,2499,874650,10862587,8.76
9839711,9991684,5494,1922900,11914584,19.25
9839712,1321264,647,226450,1547714,17.14
9839713,8965824,3987,1395450,10361274,15.56
9839714,4017186,2212,774200,4791386,19.27
9839715,9959938,3597,1258950,11218888,12.64
9839717,9984168,5756,2014600,11998768,20.18
9839719,6568103,3542,1239700,7807803,18.87
9839720,9966544,5067,1773450,11739994,17.79
9839721,9945069,4394,1537900,11482969,15.46
9839722,207923,71,24850,232773,11.95
9839723,9935313,4481,1568350,11503663,15.79
9839724,9891582,1185,414750,10306332,4.19
9839725,86209,42,14700,100909,17.05
9839726,1854794,867,303450,2158244,16.36
9839727,9932261,4789,1676150,11608411,16.88
9839728,9941504,2080,728000,10669504,7.32
9839730,986838,705,246750,1233588,25.00
9839731,433732,116,40600,474332,9.36
9839732,9925776,1549,542150,10467926,5.46
9839733,9918321,3996,1398600,11316921,14.10
9839734,9915869,3835,1342250,11258119,13.54
9839735,443152,421,147350,590502,33.25
9839736,9908790,2789,976150,10884940,9.85
9839737,9920143,4913,1719550,11639693,17.33
9839738,9924707,2395,838250,10762957,8.45
9839739,9923733,564,197400,10121133,1.99
9839740,9945756,985,344750,10290506,3.47
9839741,9932609,747,261450,10194059,2.63
9839742,9941270,3327,1164450,11105720,11.71
9839743,2131808,816,285600,2417408,13.40
9839744,9945249,3452,1208200,11153449,12.15
9839745,131221,42,14700,145921,11.20
9839746,458896,261,91350,550246,19.91
9839748,9934460,5355,1874250,11808710,18.87
9839749,1493872,624,218400,1712272,14.62
9839750,9952876,2768,968800,10921676,9.73
9839751,9954121,5780,2023000,11977121,20.32
9839752,9926219,6876,2406600,12332819,24.24
9839753,9965081,6037,2112950,12078031,21.20
9839754,9977109,3463,1212050,11189159,12.15
9839756,9997673,3393,1187550,11185223,11.88
9839757,9990942,6105,2136750,12127692,21.39
9839758,9984768,6026,2109100,12093868,21.12
9839759,9985868,5582,1953700,11939568,19.56
9839760,1606197,795,278250,1884447,17.32
9839761,56209,42,14700,70909,26.15
9839762,9920082,6864,2402400,12322482,24.22
9839763,9474882,5504,1926400,11401282,20.33
9839764,9972785,4488,1570800,11543585,15.75
9839765,9964509,1261,441350,10405859,4.43
9839766,9969882,6212,2174200,12144082,21.81
9839767,9965965,1092,382200,10348165,3.84
9839768,9979619,3418,1196300,11175919,11.99
9839769,9979915,4501,1575350,11555265,15.79
9839770,9974206,6268,2193800,12168006,21.99
9839772,1745075,981,343350,2088425,19.68
9839773,9963648,4617,1615950,11579598,16.22
9839774,9978234,6834,2391900,12370134,23.97
9839775,9973024,6135,2147250,12120274,21.53
9839776,9983678,5802,2030700,12014378,20.34
9839777,9975020,5853,2048550,12023570,20.54
9839778,9959945,6804,2381400,12341345,23.91
9839779,433213,336,117600,550813,27.15
9839780,9947178,7176,2511600,12458778,25.25
9839781,9954574,5635,1972250,11926824,19.81
9839782,1424417,1149,402150,1826567,28.23
9839783,9959093,3167,1108450,11067543,11.13
9839785,359256,585,204750,564006,56.99
9839786,9971815,5884,2059400,12031215,20.65
9839787,1121377,615,215250,1336627,19.20
9839788,9955639,6009,2103150,12058789,21.13
9839789,1304762,884,309400,1614162,23.71
9839790,3647103,2893,1012550,4659653,27.76
9839791,9965331,6332,2216200,12181531,22.24
9839792,9960926,5709,1998150,11959076,20.06
9839793,161958,62,21700,183658,13.40
9839794,9955162,5258,1840300,11795462,18.49
9839795,9945199,1715,600250,10545449,6.04
9839796,3948374,2498,874300,4822674,22.14
9839797,9927784,6045,2115750,12043534,21.31
9839798,9945279,5406,1892100,11837379,19.03
9839799,9938633,3965,1387750,11326383,13.96
9839800,9940914,8234,2881900,12822814,28.99
9839801,1090464,1000,350000,1440464,32.10
9839803,9961986,7079,2477650,12439636,24.87
9839804,3644401,1402,490700,4135101,13.46
9839805,9948641,3905,1366750,11315391,13.74
9839806,9472211,3092,1082200,10554411,11.42
9839807,9958209,2814,984900,10943109,9.89
9839808,9851048,3569,1249150,11100198,12.68
9839809,9934468,3809,1333150,11267618,13.42
9839810,9808677,4276,1496600,11305277,15.26
9839811,9951865,3690,1291500,11243365,12.98
9839812,9945290,5437,1902950,11848240,19.13
9839813,9936602,3426,1199100,11135702,12.07
9839814,9943547,5146,1801100,11744647,18.11
9839815,9962479,4804,1681400,11643879,16.88
9839816,1122614,1712,599200,1721814,53.38
9839817,1502189,536,187600,1689789,12.49
9839818,9964541,3484,1219400,11183941,12.24
9839819,9970420,3917,1370950,11341370,13.75
9839820,9974744,4688,1640800,11615544,16.45
9839822,9991646,2570,899500,10891146,9.00
9839823,9988848,1806,632100,10620948,6.33
9839824,9999122,3106,1087100,11086222,10.87
9839825,821805,535,187250,1009055,22.79
9839826,9972823,5702,1995700,11968523,20.01
9839827,9994395,2113,739550,10733945,7.40
9839828,8983095,2469,864150,9847245,9.62
9839830,9980859,4531,1585850,11566709,15.89
9839831,9996963,3568,1248800,11245763,12.49
9839832,1138587,124,43400,1181987,3.81
9839833,9972042,4901,1715350,11687392,17.20
9839834,9989143,4759,1665650,11654793,16.67
9839835,2059381,1365,477750,2537131,23.20
9839836,714538,294,102900,817438,14.40
9839837,9998222,3531,1235850,11234072,12.36
9839838,9989099,3740,1309000,11298099,13.10
9839839,9975408,2983,1044050,11019458,10.47
9839840,9981160,8012,2804200,12785360,28.09
9839841,9985377,3632,1271200,11256577,12.73
9839842,9998125,3673,1285550,11283675,12.86
9839843,9990915,3134,1096900,11087815,10.98
9839844,9983062,6132,2146200,12129262,21.50
9839845,9973673,3001,1050350,11024023,10.53
9839846,9985289,4807,1682450,11667739,16.85
9839847,9976543,2893,1012550,10989093,10.15
9839848,9976450,797,278950,10255400,2.80
9839849,9986619,4413,1544550,11531169,15.47
9839851,9983480,4926,1724100,11707580,17.27
9839852,2831243,1496,523600,3354843,18.49
9839853,9991912,4266,1493100,11485012,14.94
9839854,9978809,5698,1994300,11973109,19.99
9839855,9977035,4712,1649200,11626235,16.53
9839856,9976713,3093,1082550,11059263,10.85
9839857,2938975,1020,357000,3295975,12.15
9839858,9989476,8534,2986900,12976376,29.90
9839859,9984106,6577,2301950,12286056,23.06
9839860,9906469,5640,1974000,11880469,19.93
9839861,9957505,4595,1608250,11565755,16.15
9839862,9984496,3449,1207150,11191646,12.09
9839864,9977786,7580,2653000,12630786,26.59
9839865,9957159,7248,2536800,12493959,25.48
9839866,2377452,1400,490000,2867452,20.61
9839867,9103373,4630,1620500,10723873,17.80
9839868,9969349,7534,2636900,12606249,26.45
9839869,9975928,7846,2746100,12722028,27.53
9839870,9981325,3278,1147300,11128625,11.49
9839871,9993443,4727,1654450,11647893,16.56
9839872,8877974,2330,815500,9693474,9.19
9839873,9981568,6254,2188900,12170468,21.93
9839874,2629553,1666,583100,3212653,22.17
9839875,9981876,5517,1930950,11912826,19.34
9839876,310927,161,56350,367277,18.12
9839877,9976873,5763,2017050,11993923,20.22
9839878,9966294,2873,1005550,10971844,10.09
9839879,9989811,8976,3141600,13131411,31.45
9839880,1482787,499,174650,1657437,11.78
9839881,9964796,4882,1708700,11673496,17.15
9839882,9974938,5007,1752450,11727388,17.57
9839883,9959312,3652,1278200,11237512,12.83
9839885,1223063,746,261100,1484163,21.35
9839886,9970024,5654,1978900,11948924,19.85
9839887,9979841,7361,2576350,12556191,25.82
9839888,9889568,5187,1815450,11705018,18.36
9839889,9983363,2429,850150,10833513,8.52
9839890,9964240,4587,1605450,11569690,16.11
9839891,22206,38,13300,35506,59.89
9839892,1266224,1403,491050,1757274,38.78
9839894,9931890,6514,2279900,12211790,22.96
9839895,9956554,3901,1365350,11321904,13.71
9839896,9958372,3912,1369200,11327572,13.75
9839897,9968846,2690,941500,10910346,9.44
9839898,9960369,1920,672000,10632369,6.75
9839899,9940220,5090,1781500,11721720,17.92
9839900,7555426,2027,709450,8264876,9.39
9839901,9947681,4256,1489600,11437281,14.97
9839902,9933444,3627,1269450,11202894,12.78
9839903,9878585,4003,1401050,11279635,14.18
9839904,9940199,5017,1755950,11696149,17.67
9839905,9935103,4498,1574300,11509403,15.85
9839906,9945212,5465,1912750,11857962,19.23
9839907,9938941,5512,1929200,11868141,19.41
9839908,5551996,2516,880600,6432596,15.86
9839910,9921520,4167,1458450,11379970,14.70
9839911,9918677,4554,1593900,11512577,16.07
9839912,9915467,500,175000,10090467,1.76
9839913,9924202,5221,1827350,11751552,18.41
9839914,9921768,3109,1088150,11009918,10.97
9839915,9910101,5408,1892800,11802901,19.10
9839916,135284,47,16450,151734,12.16
9839917,9907394,4023,1408050,11315444,14.21
9839918,9892838,318,111300,10004138,1.13
9839919,1810962,520,182000,1992962,10.05
9839920,2874155,1269,444150,3318305,15.45
9839921,9941884,5027,1759450,11701334,17.70
9839922,9927250,4614,1614900,11542150,16.27
9839923,9932730,2620,917000,10849730,9.23
9839924,9942908,853,298550,10241458,3.00
9839925,342730,158,55300,398030,16.14
9839926,9973526,5417,1895950,11869476,19.01
9839927,9971613,5124,1793400,11765013,17.99
9839928,9976335,618,216300,10192635,2.17
9839929,9981064,4232,1481200,11462264,14.84
9839930,9995470,4149,1452150,11447620,14.53
9839931,9984842,2972,1040200,11025042,10.42
9839932,4714187,1920,672000,5386187,14.25
9839933,9976119,4685,1639750,11615869,16.44
9839934,6651115,3368,1178800,7829915,17.72
9839935,9952966,5765,2017750,11970716,20.27
9839936,9982473,6425,2248750,12231223,22.53
9839937,9996950,4542,1589700,11586650,15.90
9839938,9980083,6895,2413250,12393333,24.18
9839939,891893,685,239750,1131643,26.88
9839940,9989679,4633,1621550,11611229,16.23
9839941,9988573,3488,1220800,11209373,12.22
9839942,490507,294,102900,593407,20.98
9839943,9966844,3104,1086400,11053244,10.90
9839944,2087112,1513,529550,2616662,25.37
9839945,9977782,2279,797650,10775432,7.99
9839946,9970039,5690,1991500,11961539,19.97
9839947,6507198,3504,1226400,7733598,18.85
9839948,9960403,4698,1644300,11604703,16.51
9839949,9962083,5820,2037000,11999083,20.45
9839950,9950985,2661,931350,10882335,9.36
9839951,9951880,5481,1918350,11870230,19.28
9839952,9961112,1247,436450,10397562,4.38
9839953,9968612,4720,1652000,11620612,16.57
9839954,9985036,923,323050,10308086,3.24
9839955,8982348,3881,1358350,10340698,15.12
9839956,9977909,522,182700,10160609,1.83
9839957,9993331,1049,367150,10360481,3.67
9839958,121125,75,26250,147375,21.67
9839960,9995456,6937,2427950,12423406,24.29
9839961,9984922,2334,816900,10801822,8.18
9839962,6332769,1540,539000,6871769,8.51
9839963,1662354,991,346850,2009204,20.86
9839964,9985869,5246,1836100,11821969,18.39
9839965,1835503,999,349650,2185153,19.05
9839966,9984715,6233,2181550,12166265,21.85
9839967,9980418,4925,1723750,11704168,17.27
9839968,9987425,636,222600,10210025,2.23
9839969,9974580,3582,1253700,11228280,12.57
9839970,9979628,4845,1695750,11675378,16.99
9839971,9989289,4895,1713250,11702539,17.15
9839972,607244,477,166950,774194,27.49
9839973,9990194,4989,1746150,11736344,17.48
9839974,9975153,3903,1366050,11341203,13.69
9839975,526983,182,63700,590683,12.09
9839976,9163500,2111,738850,9902350,8.06
9839977,9983282,3821,1337350,11320632,13.40
9839978,9976060,5938,2078300,12054360,20.83
9839979,9969541,3675,1286250,11255791,12.90
9839980,9990294,3983,1394050,11384344,13.95
9839981,9983377,3059,1070650,11054027,10.72
9839982,9986637,612,214200,10200837,2.14
9839983,9971331,3030,1060500,11031831,10.64
9839984,9911110,2068,723800,10634910,7.30
9839985,9990710,3679,1287650,11278360,12.89
9839986,9970680,1428,499800,10470480,5.01
9839987,9754753,4878,1707300,11462053,17.50
9839988,9986221,5448,1906800,11893021,19.09
9839989,9983227,1439,503650,10486877,5.04
9839990,9979945,5139,1798650,11778595,18.02
9839991,9895113,3254,1138900,11034013,11.51
9839992,1367461,871,304850,1672311,22.29
9839993,9981697,3143,1100050,11081747,11.02
9839994,9980172,3494,1222900,11203072,12.25
9839995,9989140,2572,900200,10889340,9.01
9839996,1217950,532,186200,1404150,15.29
9839997,9992598,3901,1365350,11357948,13.66
9839998,3166693,1874,655900,3822593,20.71
9839999,9959728,1514,529900,10489628,5.32
9840000,9966049,4638,1623300,11589349,16.29
9840001,2344072,1566,548100,2892172,23.38
9840002,9883871,4756,1664600,11548471,16.84
9840003,625463,474,165900,791363,26.52
9840005,1172096,612,214200,1386296,18.27
9840006,9946793,6011,2103850,12050643,21.15
9840007,9956958,3684,1289400,11246358,12.95
9840008,9959073,2807,982450,10941523,9.86
9840009,9968994,1601,560350,10529344,5.62
9840010,9965981,2494,872900,10838881,8.76
9840011,9991864,2240,784000,10775864,7.85
9840012,9981582,1398,489300,10470882,4.90
9840013,9993022,2865,1002750,10995772,10.03
9840014,8958230,3318,1161300,10119530,12.96
9840015,9977655,2868,1003800,10981455,10.06
9840016,9981722,763,267050,10248772,2.68
9840017,9996514,3836,1342600,11339114,13.43
9840018,9970499,2179,762650,10733149,7.65
9840019,858153,213,74550,932703,8.69
9840020,2091879,1699,594650,2686529,28.43
9840021,8963284,4324,1513400,10476684,16.88
9840022,9971488,5781,2023350,11994838,20.29
9840023,9988549,3099,1084650,11073199,10.86
9840024,9973805,3514,1229900,11203705,12.33
9840025,9980324,5927,2074450,12054774,20.79
9840027,9966071,6406,2242100,12208171,22.50
9840028,9969671,767,268450,10238121,2.69
9840029,9983693,2943,1030050,11013743,10.32
9840030,9991472,3275,1146250,11137722,11.47
9840031,9989406,4242,1484700,11474106,14.86
9840032,226885,99,34650,261535,15.27
9840033,9971755,2531,885850,10857605,8.88
9840034,9966970,4683,1639050,11606020,16.44
9840035,9976680,3823,1338050,11314730,13.41
9840036,9986869,1249,437150,10424019,4.38
9840037,9984824,3900,1365000,11349824,13.67
9840038,9992521,2121,742350,10734871,7.43
9840039,9972949,878,307300,10280249,3.08
9840040,9996737,3623,1268050,11264787,12.68
9840041,9982245,3755,1314250,11296495,13.17
9840042,9988211,3231,1130850,11119061,11.32
9840043,9989549,2758,965300,10954849,9.66
9840044,9985178,4888,1710800,11695978,17.13
9840045,9974072,5904,2066400,12040472,20.72
9840046,9996644,929,325150,10321794,3.25
9840047,9992395,5422,1897700,11890095,18.99
9840049,9979532,1107,387450,10366982,3.88
9840050,9974418,2797,978950,10953368,9.81
9840051,9994740,2340,819000,10813740,8.19
9840052,9984707,3236,1132600,11117307,11.34
9840053,9992930,585,204750,10197680,2.05
9840054,9980151,1188,415800,10395951,4.17
9840055,9995183,1660,581000,10576183,5.81
9840056,9905905,4230,1480500,11386405,14.95
9840057,162998,63,22050,185048,13.53
9840058,9977660,2022,707700,10685360,7.09
9840059,9966946,3140,1099000,11065946,11.03
9840060,9981603,3157,1104950,11086553,11.07
9840061,9980111,3602,1260700,11240811,12.63
9840062,5489916,1791,626850,6116766,11.42
9840063,1470657,613,214550,1685207,14.59
9840064,9977056,5683,1989050,11966106,19.94
9840065,571659,505,176750,748409,30.92
9840066,9955187,4361,1526350,11481537,15.33
9840067,9943514,2858,1000300,10943814,10.06
9840068,9970146,3223,1128050,11098196,11.31
9840069,9977648,3203,1121050,11098698,11.24
9840070,6829078,3399,1189650,8018728,17.42
9840071,9975035,3959,1385650,11360685,13.89
9840072,9719926,5401,1890350,11610276,19.45
9840073,201004,113,39550,240554,19.68
9840074,9966375,5391,1886850,11853225,18.93
9840076,9958889,4569,1599150,11558039,16.06
9840077,9943263,1010,353500,10296763,3.56
9840078,9961806,4999,1749650,11711456,17.56
9840079,9949843,729,255150,10204993,2.56
9840080,9946825,3595,1258250,11205075,12.65
9840081,4504826,2533,886550,5391376,19.68
9840082,9919459,5173,1810550,11730009,18.25
9840083,9968324,1819,636650,10604974,6.39
9840084,9989984,5547,1941450,11931434,19.43
9840085,9992479,376,131600,10124079,1.32
9840086,1657024,910,318500,1975524,19.22
9840087,9990766,6519,2281650,12272416,22.84
9840088,9982553,4727,1654450,11637003,16.57
9840089,9995186,757,264950,10260136,2.65
9840090,9991658,5157,1804950,11796608,18.06
9840091,9986880,5524,1933400,11920280,19.36
9840092,9960236,479,167650,10127886,1.68
9840094,1815171,1221,427350,2242521,23.54
9840095,9964037,3449,1207150,11171187,12.12
9840096,9952115,2616,915600,10867715,9.20
9840097,9988328,2813,984550,10972878,9.86
9840098,9963131,389,136150,10099281,1.37
9840099,9982811,1855,649250,10632061,6.50
9840100,2505747,1016,355600,2861347,14.19
9840101,9981326,2863,1002050,10983376,10.04
9840102,9992812,1705,596750,10589562,5.97
9840103,9994168,790,276500,10270668,2.77
9840104,9966184,882,308700,10274884,3.10
9840105,9969885,2336,817600,10787485,8.20
9840106,9984558,465,162750,10147308,1.63
9840107,9979271,2728,954800,10934071,9.57
9840108,9959930,4966,1738100,11698030,17.45
9840109,9985131,3866,1353100,11338231,13.55
9840110,9989093,1969,689150,10678243,6.90
9840111,9983247,5075,1776250,11759497,17.79
9840112,9977188,3575,1251250,11228438,12.54
9840113,8061640,2900,1015000,9076640,12.59
9840114,9983486,2391,836850,10820336,8.38
9840115,9992673,2189,766150,10758823,7.67
9840116,9988254,4333,1516550,11504804,15.18
9840117,9982650,2160,756000,10738650,7.57
9840118,1431063,517,180950,1612013,12.64
9840119,5617582,1705,596750,6214332,10.62
9840120,9965658,4664,1632400,11598058,16.38
9840121,9983186,4267,1493450,11476636,14.96
9840122,9984887,5609,1963150,11948037,19.66
9840123,579325,500,175000,754325,30.21
9840124,9984396,2080,728000,10712396,7.29
9840125,9978591,727,254450,10233041,2.55
9840126,9979782,1001,350350,10330132,3.51
9840127,9832329,1781,623350,10455679,6.34
9840128,26209,42,14700,40909,56.09
9840129,9981673,1158,405300,10386973,4.06
9840130,9988175,3805,1331750,11319925,13.33
9840131,9981570,3782,1323700,11305270,13.26
9840132,9993167,584,204400,10197567,2.05
9840133,9991263,2317,810950,10802213,8.12
9840134,9975591,860,301000,10276591,3.02
9840135,372745,304,106400,479145,28.54
9840136,9959363,5096,1783600,11742963,17.91
9840137,9972331,1967,688450,10660781,6.90
9840138,9958980,907,317450,10276430,3.19
9840139,9985629,782,273700,10259329,2.74
9840140,9978709,4164,1457400,11436109,14.61
9840141,2898375,2245,785750,3684125,27.11
9840142,9989968,2029,710150,10700118,7.11
9840143,1271326,435,152250,1423576,11.98
9840144,577395,259,90650,668045,15.70
9840145,1100869,817,285950,1386819,25.97
9840146,9965588,4223,1478050,11443638,14.83
9840147,9963430,3629,1270150,11233580,12.75
9840148,9965377,4342,1519700,11485077,15.25
9840149,9977133,5814,2034900,12012033,20.40
9840150,9965652,3156,1104600,11070252,11.08
9840151,9984144,4502,1575700,11559844,15.78
9840152,9979604,1145,400750,10380354,4.02
9840153,9976059,4070,1424500,11400559,14.28
9840154,9999309,512,179200,10178509,1.79
9840155,9992079,1764,617400,10609479,6.18
9840156,9974501,3747,1311450,11285951,13.15
9840157,9981488,4435,1552250,11533738,15.55
9840158,9984355,7544,2640400,12624755,26.45
9840159,1371945,272,95200,1467145,6.94
9840160,9973609,4734,1656900,11630509,16.61
9840161,9943043,5084,1779400,11722443,17.90
9840162,9991091,3132,1096200,11087291,10.97
9840163,51115,24,8400,59515,16.43
9840164,7348993,3435,1202250,8551243,16.36
9840165,9999564,645,225750,10225314,2.26
9840166,9977899,669,234150,10212049,2.35
9840167,223209,119,41650,264859,18.66
9840168,9956456,1030,360500,10316956,3.62
9840169,2772957,1254,438900,3211857,15.83
9840170,9955109,3853,1348550,11303659,13.55
9840171,9968095,5402,1890700,11858795,18.97
9840172,9979944,441,154350,10134294,1.55
9840173,9981726,749,262150,10243876,2.63
9840174,9997426,991,346850,10344276,3.47
9840175,9981393,1440,504000,10485393,5.05
9840176,9977178,1498,524300,10501478,5.25
9840178,9965835,5267,1843450,11809285,18.50
9840179,9952605,1504,526400,10479005,5.29
9840180,9955663,1335,467250,10422913,4.69
9840181,9956217,973,340550,10296767,3.42
9840182,9974944,620,217000,10191944,2.18
9840183,9962511,4840,1694000,11656511,17.00
9840185,9993934,3191,1116850,11110784,11.18
9840186,1569279,626,219100,1788379,13.96
9840187,9842528,3546,1241100,11083628,12.61
9840188,9976246,5104,1786400,11762646,17.91
9840189,9993869,5277,1846950,11840819,18.48
9840190,9980172,4043,1415050,11395222,14.18
9840191,9981288,5806,2032100,12013388,20.36
9840192,9999648,2041,714350,10713998,7.14
9840193,1429173,557,194950,1624123,13.64
9840194,9971924,2412,844200,10816124,8.47
9840195,8514134,4945,1730750,10244884,20.33
9840196,163338,68,23800,187138,14.57
9840197,9948516,885,309750,10258266,3.11
9840198,9947390,3740,1309000,11256390,13.16
9840200,9938532,4102,1435700,11374232,14.45
9840201,9963185,1009,353150,10316335,3.54
9840203,9862087,5196,1818600,11680687,18.44
9840204,9949218,5350,1872500,11821718,18.82
9840205,212021,123,43050,255071,20.30
9840206,9922644,4817,1685950,11608594,16.99
9840207,626505,739,258650,885155,41.28
9840208,9724114,3776,1321600,11045714,13.59
9840209,9904488,5850,2047500,11951988,20.67
9840210,9917306,3457,1209950,11127256,12.20
9840211,3279477,1826,639100,3918577,19.49
9840212,7836988,2487,870450,8707438,11.11
9840213,9934250,4201,1470350,11404600,14.80
9840214,9944783,3990,1396500,11341283,14.04
9840215,9944955,3153,1103550,11048505,11.10
9840216,9971350,1046,366100,10337450,3.67
9840217,204514,129,45150,249664,22.08
9840218,9977243,1635,572250,10549493,5.74
9840219,9987074,1477,516950,10504024,5.18
9840220,9984572,587,205450,10190022,2.06
9840221,9988069,4633,1621550,11609619,16.23
9840222,9982354,3002,1050700,11033054,10.53
9840223,94679,28,9800,104479,10.35
9840224,9989745,2218,776300,10766045,7.77
9840225,9960639,547,191450,10152089,1.92
9840226,9972208,2549,892150,10864358,8.95
9840227,9874398,1393,487550,10361948,4.94
9840230,9984548,2996,1048600,11033148,10.50
9840233,9961341,6431,2250850,12212191,22.60
9840234,9986183,2789,976150,10962333,9.78
9840235,9977557,146,51100,10028657,0.51
9840236,9965709,3006,1052100,11017809,10.56
9840237,9988356,3021,1057350,11045706,10.59
9840238,9999229,2952,1033200,11032429,10.33
9840239,9983779,99,34650,10018429,0.35
9840240,9995086,2865,1002750,10997836,10.03
9840242,9971048,4387,1535450,11506498,15.40
9840243,9990763,4122,1442700,11433463,14.44
9840244,9996112,4749,1662150,11658262,16.63
9840245,9972388,1769,619150,10591538,6.21
9840246,9975516,3135,1097250,11072766,11.00
9840248,9967297,6956,2434600,12401897,24.43
9840249,824284,510,178500,1002784,21.66
9840250,8089025,4629,1620150,9709175,20.03
9840251,9950410,4832,1691200,11641610,17.00
9840252,9953476,5187,1815450,11768926,18.24
9840253,3436166,3563,1247050,4683216,36.29
9840254,9929938,1692,592200,10522138,5.96
9840255,9922714,1359,475650,10398364,4.79
9840256,9934816,3633,1271550,11206366,12.80
9840257,1550545,914,319900,1870445,20.63
9840258,9925589,2247,786450,10712039,7.92
9840259,9921412,1976,691600,10613012,6.97
9840260,215008,152,53200,268208,24.74
9840261,1801637,1201,420350,2221987,23.33
9840262,9936434,1306,457100,10393534,4.60
9840263,9943594,172,60200,10003794,0.61
9840264,9937786,5549,1942150,11879936,19.54
9840265,9943159,2022,707700,10650859,7.12
9840266,9945245,5057,1769950,11715195,17.80
9840267,9915728,2939,1028650,10944378,10.37
9840268,300948,100,35000,335948,11.63
9840269,9907971,3272,1145200,11053171,11.56
9840270,9899397,1397,488950,10388347,4.94
9840271,2043554,375,131250,2174804,6.42
9840272,9898937,2157,754950,10653887,7.63
9840273,9909184,5147,1801450,11710634,18.18
9840274,9918060,2346,821100,10739160,8.28
9840275,9916523,3062,1071700,10988223,10.81
9840276,9933873,1205,421750,10355623,4.25
9840277,9913456,1138,398300,10311756,4.02
9840278,9943598,2284,799400,10742998,8.04
9840279,3751683,1659,580650,4332333,15.48
9840280,9969716,5222,1827700,11797416,18.33
9840281,333942,226,79100,413042,23.69
9840282,9950389,4913,1719550,11669939,17.28
9840283,9946480,3709,1298150,11244630,13.05
9840284,9950478,725,253750,10204228,2.55
9840285,9973846,3893,1362550,11336396,13.66
9840286,9971976,1035,362250,10334226,3.63
9840287,9978108,1220,427000,10405108,4.28
9840288,2518285,1698,594300,3112585,23.60
9840289,9956463,3860,1351000,11307463,13.57
9840290,9473304,5206,1822100,11295404,19.23
9840291,9970921,3815,1335250,11306171,13.39
9840292,9983861,5199,1819650,11803511,18.23
9840293,1839315,1454,508900,2348215,27.67
9840294,9985174,5291,1851850,11837024,18.55
9840295,9977650,7086,2480100,12457750,24.86
9840297,9955264,3874,1355900,11311164,13.62
9840298,8182861,2488,870800,9053661,10.64
9840299,2376076,1134,396900,2772976,16.70
9840300,9952105,5369,1879150,11831255,18.88
9840301,9952885,4231,1480850,11433735,14.88
9840302,2941078,1324,463400,3404478,15.76
9840303,9922778,7296,2553600,12476378,25.73
9840304,9941134,1350,472500,10413634,4.75
9840305,9947707,3711,1298850,11246557,13.06
9840306,9939708,1610,563500,10503208,5.67
9840307,9961259,1232,431200,10392459,4.33
9840308,9943411,566,198100,10141511,1.99
9840309,9960552,3681,1288350,11248902,12.93
9840310,3967203,1526,534100,4501303,13.46
9840311,9933253,2587,905450,10838703,9.12
9840313,5717779,2183,764050,6481829,13.36
9840314,9928923,2597,908950,10837873,9.15
9840315,9953495,5380,1883000,11836495,18.92
9840316,9967145,2742,959700,10926845,9.63
9840317,9966690,3245,1135750,11102440,11.40
9840318,9974546,6393,2237550,12212096,22.43
9840320,9942281,5936,2077600,12019881,20.90
9840321,9957744,4136,1447600,11405344,14.54
9840322,9952595,5384,1884400,11836995,18.93
9840323,9970684,5126,1794100,11764784,17.99
9840324,9948189,2033,711550,10659739,7.15
9840325,9962993,430,150500,10113493,1.51
9840326,9959828,2263,792050,10751878,7.95
9840327,9960865,2700,945000,10905865,9.49
9840328,9980407,2102,735700,10716107,7.37
9840329,9989311,5177,1811950,11801261,18.14
9840330,42589,21,7350,49939,17.26
9840331,9990228,3514,1229900,11220128,12.31
9840332,9979357,2251,787850,10767207,7.89
9840333,9981988,4147,1451450,11433438,14.54
9840334,9975286,6501,2275350,12250636,22.81
9840335,9354718,4331,1515850,10870568,16.20
9840336,9967205,3306,1157100,11124305,11.61
9840337,9973136,2308,807800,10780936,8.10
9840338,9969957,834,291900,10261857,2.93
9840339,9979927,3541,1239350,11219277,12.42
9840340,9989906,2701,945350,10935256,9.46
9840341,9970047,4059,1420650,11390697,14.25
9840342,9972642,2629,920150,10892792,9.23
9840343,904726,456,159600,1064326,17.64
9840344,9952192,3975,1391250,11343442,13.98
9840345,1228675,659,230650,1459325,18.77
9840347,9971828,3050,1067500,11039328,10.71
9840348,9967678,109,38150,10005828,0.38
9840349,9956113,382,133700,10089813,1.34
9840351,1532871,281,98350,1631221,6.42
9840353,9949789,6019,2106650,12056439,21.17
9840354,9937347,2245,785750,10723097,7.91
9840355,9938279,2538,888300,10826579,8.94
9840356,9945531,2019,706650,10652181,7.11
9840357,249936,136,47600,297536,19.04
9840358,9945417,4176,1461600,11407017,14.70
9840359,9954117,1639,573650,10527767,5.76
9840360,9968305,1346,471100,10439405,4.73
9840361,9965797,4574,1600900,11566697,16.06
9840362,9944656,4327,1514450,11459106,15.23
9840364,9956471,694,242900,10199371,2.44
9840365,9958896,1469,514150,10473046,5.16
9840366,9952378,704,246400,10198778,2.48
9840368,1214942,1412,494200,1709142,40.68
9840369,9949250,1240,434000,10383250,4.36
9840370,9967382,3173,1110550,11077932,11.14
9840371,9955998,1277,446950,10402948,4.49
9840372,752120,342,119700,871820,15.92
9840373,9950902,1446,506100,10457002,5.09
9840374,9963828,1018,356300,10320128,3.58
9840375,959010,1083,379050,1338060,39.53
9840377,9976556,2029,710150,10686706,7.12
9840378,9972722,663,232050,10204772,2.33
9840379,922679,445,155750,1078429,16.88
9840380,1965204,991,346850,2312054,17.65
9840381,4337593,2512,879200,5216793,20.27
9840382,9973552,3189,1116150,11089702,11.19
9840383,9954379,4823,1688050,11642429,16.96
9840384,9965421,1787,625450,10590871,6.28
9840385,9989493,1914,669900,10659393,6.71
9840386,9997680,764,267400,10265080,2.67
9840387,9989168,3209,1123150,11112318,11.24
9840388,9979415,2136,747600,10727015,7.49
9840389,919129,219,76650,995779,8.34
9840390,1777495,2291,801850,2579345,45.11
9840391,9362511,2578,902300,10264811,9.64
9840392,73256,13,4550,77806,6.21
9840393,9970968,2169,759150,10730118,7.61
9840394,9986241,5718,2001300,11987541,20.04
9840395,9963689,3696,1293600,11257289,12.98
9840396,9979408,5803,2031050,12010458,20.35
9840397,9061573,4025,1408750,10470323,15.55
9840398,9974114,5251,1837850,11811964,18.43
9840399,9979401,4403,1541050,11520451,15.44
9840400,810986,301,105350,916336,12.99
9840401,2389477,3006,1052100,3441577,44.03
9840402,9984441,5769,2019150,12003591,20.22
9840403,9983950,957,334950,10318900,3.35
9840404,9973786,2801,980350,10954136,9.83
9840405,9975083,839,293650,10268733,2.94
9840406,9968560,4112,1439200,11407760,14.44
9840408,9995304,3088,1080800,11076104,10.81
9840409,9997344,822,287700,10285044,2.88
9840410,9970432,905,316750,10287182,3.18
9840411,9990381,1840,644000,10634381,6.45
9840412,116078,50,17500,133578,15.08
9840413,210652,263,92050,302702,43.70
9840414,9990581,3841,1344350,11334931,13.46
9840415,9980879,1619,566650,10547529,5.68
9840416,9975396,1832,641200,10616596,6.43
9840417,9979322,2030,710500,10689822,7.12
9840418,9987997,1923,673050,10661047,6.74
9840419,1448465,1428,499800,1948265,34.51
9840420,9967184,3570,1249500,11216684,12.54
9840421,9981404,5073,1775550,11756954,17.79
9840422,667091,327,114450,781541,17.16
9840423,9998708,1888,660800,10659508,6.61
9840424,9963148,822,287700,10250848,2.89
9840425,9956508,1716,600600,10557108,6.03
9840426,9983226,4230,1480500,11463726,14.83
9840427,9988887,3917,1370950,11359837,13.72
9840428,3240163,1115,390250,3630413,12.04
9840429,4854904,977,341950,5196854,7.04
9840430,1208010,766,268100,1476110,22.19
9840431,6058798,3438,1203300,7262098,19.86
9840432,9995109,4056,1419600,11414709,14.20
9840433,9982872,5337,1867950,11850822,18.71
9840434,159856,33,11550,171406,7.23
9840435,9969960,4094,1432900,11402860,14.37
9840436,423565,243,85050,508615,20.08
9840437,9892373,3699,1294650,11187023,13.09
9840439,154232,95,33250,187482,21.56
9840440,9864848,4336,1517600,11382448,15.38
9840443,9978899,4296,1503600,11482499,15.07
9840444,9955234,1752,613200,10568434,6.16
9840445,9960545,3301,1155350,11115895,11.60
9840446,639732,943,330050,969782,51.59
9840447,9953587,5123,1793050,11746637,18.01
9840448,9966901,3719,1301650,11268551,13.06
9840449,9960565,2554,893900,10854465,8.97
9840450,782656,389,136150,918806,17.40
9840451,9965092,4726,1654100,11619192,16.60
9840453,9949487,5809,2033150,11982637,20.43
9840454,9658108,787,275450,9933558,2.85
9840455,573217,767,268450,841667,46.83
9840456,9955495,5277,1846950,11802445,18.55
9840457,2679645,1149,402150,3081795,15.01
9840458,9949743,5584,1954400,11904143,19.64
9840459,9955279,5550,1942500,11897779,19.51
9840460,9231312,2799,979650,10210962,10.61
9840461,9949625,3892,1362200,11311825,13.69
9840462,9943440,4725,1653750,11597190,16.63
9840463,9955330,3051,1067850,11023180,10.73
9840464,9959748,4237,1482950,11442698,14.89
9840466,9955991,5766,2018100,11974091,20.27
9840467,9953089,5641,1974350,11927439,19.84
9840468,9963075,3630,1270500,11233575,12.75
9840469,9961080,725,253750,10214830,2.55
9840470,9970777,1311,458850,10429627,4.60
9840471,9976153,3525,1233750,11209903,12.37
9840472,9966468,341,119350,10085818,1.20
9840473,3330358,1771,619850,3950208,18.61
9840474,9962830,3648,1276800,11239630,12.82
9840475,9950466,2619,916650,10867116,9.21
9840476,9950632,3938,1378300,11328932,13.85
9840477,3193261,1737,607950,3801211,19.04
9840479,9933077,4898,1714300,11647377,17.26
9840480,9912828,3937,1377950,11290778,13.90
9840481,9831861,3374,1180900,11012761,12.01
9840482,9932223,2860,1001000,10933223,10.08
9840483,9912914,3513,1229550,11142464,12.40
9840484,6910933,3090,1081500,7992433,15.65
9840485,9914063,3899,1364650,11278713,13.76
9840486,9915570,4877,1706950,11622520,17.21
9840487,9931830,4443,1555050,11486880,15.66
9840488,1947456,1680,588000,2535456,30.19
9840489,9897843,4611,1613850,11511693,16.31
9840490,9907124,5060,1771000,11678124,17.88
9840491,9919665,6631,2320850,12240515,23.40
9840493,9662454,4835,1692250,11354704,17.51
9840494,9929701,4165,1457750,11387451,14.68
9840495,9917822,2179,762650,10680472,7.69
9840496,9937597,4197,1468950,11406547,14.78
9840497,3673803,2094,732900,4406703,19.95
9840498,9920222,4604,1611400,11531622,16.24
9840499,9916052,5286,1850100,11766152,18.66
9840500,2871803,1575,551250,3423053,19.20
9840501,1275028,1183,414050,1689078,32.47
9840502,2623970,1453,508550,3132520,19.38
9840503,3740699,2620,917000,4657699,24.51
9840504,9949130,2293,802550,10751680,8.07
9840505,9972650,6049,2117150,12089800,21.23
9840506,9955348,5993,2097550,12052898,21.07
9840507,9192955,2627,919450,10112405,10.00
9840508,9921083,4128,1444800,11365883,14.56
9840509,9952865,2349,822150,10775015,8.26
9840510,9953270,5461,1911350,11864620,19.20
9840511,9988805,2935,1027250,11016055,10.28
9840512,9978031,3063,1072050,11050081,10.74
9840513,9986191,4182,1463700,11449891,14.66
9840514,9982433,751,262850,10245283,2.63
9840515,9940758,1938,678300,10619058,6.82
9840516,9979380,2847,996450,10975830,9.99
9840517,9967097,623,218050,10185147,2.19
9840518,9988546,1108,387800,10376346,3.88
9840519,821343,232,81200,902543,9.89
9840520,9995814,6290,2201500,12197314,22.02
9840521,9973283,2998,1049300,11022583,10.52
9840522,9992870,4827,1689450,11682320,16.91
9840523,9983250,2397,838950,10822200,8.40
9840524,9972585,847,296450,10269035,2.97
9840525,9982814,2125,743750,10726564,7.45
9840526,9977790,2007,702450,10680240,7.04
9840527,9967940,917,320950,10288890,3.22
9840528,9965424,5775,2021250,11986674,20.28
9840529,514157,208,72800,586957,14.16
9840530,9971523,3134,1096900,11068423,11.00
9840531,9820296,1283,449050,10269346,4.57
9840532,9979290,3557,1244950,11224240,12.48
9840533,9984520,1014,354900,10339420,3.55
9840534,9984017,2799,979650,10963667,9.81
9840535,9984083,910,318500,10302583,3.19
9840536,9975911,1597,558950,10534861,5.60
9840537,9990318,1418,496300,10486618,4.97
9840538,9990185,2093,732550,10722735,7.33
9840539,9991548,1617,565950,10557498,5.66
9840540,9977921,4825,1688750,11666671,16.92
9840541,1370356,557,194950,1565306,14.23
9840542,650756,540,189000,839756,29.04
9840543,7023922,2740,959000,7982922,13.65
9840544,9976162,1724,603400,10579562,6.05
9840545,9990320,1744,610400,10600720,6.11
9840546,9969544,3169,1109150,11078694,11.13
9840547,177083,74,25900,202983,14.63
9840548,9947787,2861,1001350,10949137,10.07
9840549,9949291,1074,375900,10325191,3.78
9840550,9940076,2149,752150,10692226,7.57
9840551,9950728,1785,624750,10575478,6.28
9840552,9949706,3773,1320550,11270256,13.27
9840553,9964940,2044,715400,10680340,7.18
9840554,9962072,2296,803600,10765672,8.07
9840555,9955401,2236,782600,10738001,7.86
9840556,9951812,3240,1134000,11085812,11.39
9840557,9942212,944,330400,10272612,3.32
9840558,9880523,2589,906150,10786673,9.17
9840560,1583174,753,263550,1846724,16.65
9840561,9924391,2666,933100,10857491,9.40
9840562,9930434,2300,805000,10735434,8.11
9840563,9937033,3050,1067500,11004533,10.74
9840564,9927374,3699,1294650,11222024,13.04
9840565,9907451,3180,1113000,11020451,11.23
9840566,9903652,2713,949550,10853202,9.59
9840567,9914845,4915,1720250,11635095,17.35
9840568,9928328,6198,2169300,12097628,21.85
9840569,9919540,1327,464450,10383990,4.68
9840570,79267,69,24150,103417,30.47
9840571,9903852,4352,1523200,11427052,15.38
9840572,9899651,1570,549500,10449151,5.55
9840573,9901714,1359,475650,10377364,4.80
9840574,9918872,374,130900,10049772,1.32
9840575,9920015,579,202650,10122665,2.04
9840576,993377,479,167650,1161027,16.88
9840577,9892666,1568,548800,10441466,5.55
9840578,9898637,3655,1279250,11177887,12.92
9840579,1265910,1093,382550,1648460,30.22
9840580,9461348,4020,1407000,10868348,14.87
9840581,9912675,782,273700,10186375,2.76
9840582,9909013,1305,456750,10365763,4.61
9840583,9675582,4482,1568700,11244282,16.21
9840584,9918595,1919,671650,10590245,6.77
9840585,9934948,1533,536550,10471498,5.40
9840586,4623591,3640,1274000,5897591,27.55
9840587,9913644,3200,1120000,11033644,11.30
9840589,9910284,2810,983500,10893784,9.92
9840590,9923223,4505,1576750,11499973,15.89
9840591,968878,254,88900,1057778,9.18
9840592,9923372,5875,2056250,11979622,20.72
9840593,9916869,1399,489650,10406519,4.94
9840594,9936641,3570,1249500,11186141,12.57
9840595,9913724,1416,495600,10409324,5.00
9840596,9921433,6875,2406250,12327683,24.25
9840597,9943900,2227,779450,10723350,7.84
9840598,9943825,5879,2057650,12001475,20.69
9840599,9957418,5409,1893150,11850568,19.01
9840600,9949162,2154,753900,10703062,7.58
9840601,9958884,3595,1258250,11217134,12.63
9840602,9954396,3639,1273650,11228046,12.79
9840603,9969675,2760,966000,10935675,9.69
9840604,9970204,1243,435050,10405254,4.36
9840606,3232527,1109,388150,3620677,12.01
9840607,9951357,1125,393750,10345107,3.96
9840608,5460546,604,211400,5671946,3.87
9840609,9976202,3970,1389500,11365702,13.93
9840610,51606,23,8050,59656,15.60
9840611,9960991,3179,1112650,11073641,11.17
9840612,9970355,2996,1048600,11018955,10.52
9840613,9979569,2640,924000,10903569,9.26
9840614,347946,131,45850,393796,13.18
9840615,1177297,807,282450,1459747,23.99
9840616,9958584,4158,1455300,11413884,14.61
9840617,9970304,5825,2038750,12009054,20.45
9840618,3867695,806,282100,4149795,7.29
9840619,1489615,314,109900,1599515,7.38
9840620,9952599,4438,1553300,11505899,15.61
9840621,9966183,3982,1393700,11359883,13.98
9840622,9971115,4497,1573950,11545065,15.79
9840623,9984172,5674,1985900,11970072,19.89
9840624,9982694,611,213850,10196544,2.14
9840625,9990111,1616,565600,10555711,5.66
9840626,9965094,3520,1232000,11197094,12.36
9840627,9979401,1639,573650,10553051,5.75
9840628,9989412,2892,1012200,11001612,10.13
9840629,9987403,2044,715400,10702803,7.16
9840630,9676466,2559,895650,10572116,9.26
9840631,9981488,4006,1402100,11383588,14.05
9840632,9975614,678,237300,10212914,2.38
9840633,9981551,1179,412650,10394201,4.13
9840635,3949348,2968,1038800,4988148,26.30
9840636,1253072,866,303100,1556172,24.19
9840637,9965128,3709,1298150,11263278,13.03
9840638,9968246,1767,618450,10586696,6.20
9840639,9669971,4746,1661100,11331071,17.18
9840640,9965993,1394,487900,10453893,4.90
9840641,9968487,6282,2198700,12167187,22.06
9840642,9974516,971,339850,10314366,3.41
9840643,433051,253,88550,521601,20.45
9840644,4824616,1638,573300,5397916,11.88
9840645,9940287,5916,2070600,12010887,20.83
9840646,9953199,4249,1487150,11440349,14.94
9840648,400965,373,130550,531515,32.56
9840649,9942816,2735,957250,10900066,9.63
9840650,9925931,5038,1763300,11689231,17.76
9840651,573992,165,57750,631742,10.06
9840652,9949732,5916,2070600,12020332,20.81
9840653,9954993,5186,1815100,11770093,18.23
9840654,9960332,6175,2161250,12121582,21.70
9840655,9937619,4118,1441300,11378919,14.50
9840656,9940837,1305,456750,10397587,4.59
9840657,9502087,5835,2042250,11544337,21.49
9840658,277832,60,21000,298832,7.56
9840659,1743204,2221,777350,2520554,44.59
9840660,9960829,3383,1184050,11144879,11.89
9840661,2824932,1781,623350,3448282,22.07
9840662,9714136,3430,1200500,10914636,12.36
9840663,1875990,1031,360850,2236840,19.24
9840664,1379736,1225,428750,1808486,31.07
9840665,9962225,5622,1967700,11929925,19.75
9840667,5706718,4795,1678250,7384968,29.41
9840668,9892353,2160,756000,10648353,7.64
9840669,9689418,6379,2232650,11922068,23.04
9840670,9941536,3056,1069600,11011136,10.76
9840671,1270649,425,148750,1419399,11.71
9840672,9935801,3647,1276450,11212251,12.85
9840673,9904222,3491,1221850,11126072,12.34
9840674,9953349,4575,1601250,11554599,16.09
9840675,196731,199,69650,266381,35.40
9840676,9935531,3249,1137150,11072681,11.45
9840677,9942052,1366,478100,10420152,4.81
9840678,9946760,4078,1427300,11374060,14.35
9840679,9951287,1214,424900,10376187,4.27
9840680,9966566,1324,463400,10429966,4.65
9840681,811260,110,38500,849760,4.75
9840682,9946126,1670,584500,10530626,5.88
9840683,9963560,2723,953050,10916610,9.57
9840684,9958201,320,112000,10070201,1.12
9840685,9949687,272,95200,10044887,0.96
9840686,9950917,951,332850,10283767,3.34
9840687,645204,254,88900,734104,13.78
9840688,9963857,2927,1024450,10988307,10.28
9840689,9894917,2004,701400,10596317,7.09
9840691,9961461,4880,1708000,11669461,17.15
9840692,9964214,709,248150,10212364,2.49
9840693,9961555,2483,869050,10830605,8.72
9840694,9960009,1249,437150,10397159,4.39
9840695,439575,150,52500,492075,11.94
9840696,9967875,1346,471100,10438975,4.73
9840697,9961820,2590,906500,10868320,9.10
9840698,704804,641,224350,929154,31.83
9840699,9998028,5227,1829450,11827478,18.30
9840700,9997270,2186,765100,10762370,7.65
9840701,9995832,2069,724150,10719982,7.24
9840702,9975905,1351,472850,10448755,4.74
9840703,9980138,2619,916650,10896788,9.18
9840704,9997670,3701,1295350,11293020,12.96
9840705,9978761,2179,762650,10741411,7.64
9840706,918667,419,146650,1065317,15.96
9840707,3605841,1962,686700,4292541,19.04
9840708,9215889,4176,1461600,10677489,15.86
9840710,9927309,817,285950,10213259,2.88
9840711,9976676,2050,717500,10694176,7.19
9840712,9995012,198,69300,10064312,0.69
9840713,191190,171,59850,251040,31.30
9840714,9983752,5206,1822100,11805852,18.25
9840715,9992652,2134,746900,10739552,7.47
9840716,9984874,1263,442050,10426924,4.43
9840717,9986230,1044,365400,10351630,3.66
9840718,1617116,861,301350,1918466,18.64
9840719,9963533,2341,819350,10782883,8.22
9840720,31256,13,4550,35806,14.56
9840721,9972450,4389,1536150,11508600,15.40
9840722,9987225,3799,1329650,11316875,13.31
9840723,9980687,5451,1907850,11888537,19.12
9840724,9982371,4637,1622950,11605321,16.26
9840725,9983372,707,247450,10230822,2.48
9840726,9973564,3852,1348200,11321764,13.52
9840727,9983299,2795,978250,10961549,9.80
9840728,9987463,1150,402500,10389963,4.03
9840729,9989467,1460,511000,10500467,5.12
9840730,9958565,3499,1224650,11183215,12.30
9840731,9980695,706,247100,10227795,2.48
9840732,721184,355,124250,845434,17.23
9840733,9979048,2086,730100,10709148,7.32
9840734,9986254,724,253400,10239654,2.54
9840735,9984021,1915,670250,10654271,6.71
9840736,9977186,3947,1381450,11358636,13.85
9840737,9992889,3144,1100400,11093289,11.01
9840738,68243,39,13650,81893,20.00
9840739,9974719,5050,1767500,11742219,17.72
9840741,9961748,4099,1434650,11396398,14.40
9840742,9967209,1894,662900,10630109,6.65
9840743,9985189,234,81900,10067089,0.82
9840744,9975884,2711,948850,10924734,9.51
9840745,9965712,2484,869400,10835112,8.72
9840746,9963983,299,104650,10068633,1.05
9840747,9984327,1563,547050,10531377,5.48
9840748,9966571,1216,425600,10392171,4.27
9840750,9973422,4253,1488550,11461972,14.93
9840751,9993026,1271,444850,10437876,4.45
9840752,9875039,4746,1661100,11536139,16.82
9840753,635185,219,76650,711835,12.07
9840754,9991217,5423,1898050,11889267,19.00
9840755,9864614,6235,2182250,12046864,22.12
9840756,9989746,1200,420000,10409746,4.20
9840757,2507032,1560,546000,3053032,21.78
9840758,9992292,3836,1342600,11334892,13.44
9840760,9987427,5068,1773800,11761227,17.76
9840761,9992376,5643,1975050,11967426,19.77
9840762,9993924,1402,490700,10484624,4.91
9840763,9972593,1489,521150,10493743,5.23
9840764,677368,650,227500,904868,33.59
9840765,9983817,965,337750,10321567,3.38
9840766,5432663,2994,1047900,6480563,19.29
9840767,2264652,619,216650,2481302,9.57
9840768,124439,133,46550,170989,37.41
9840769,9955736,5944,2080400,12036136,20.90
9840770,8985302,4330,1515500,10500802,16.87
9840771,9962315,2831,990850,10953165,9.95
9840772,9955896,4312,1509200,11465096,15.16
9840773,9962820,4940,1729000,11691820,17.35
9840774,9965973,569,199150,10165123,2.00
9840775,9911792,2458,860300,10772092,8.68
9840776,9975320,1959,685650,10660970,6.87
9840777,9953395,2970,1039500,10992895,10.44
9840779,9960997,1760,616000,10576997,6.18
9840780,9979400,2448,856800,10836200,8.59
9840781,64001,57,19950,83951,31.17
9840782,9950590,4486,1570100,11520690,15.78
9840783,9955777,4664,1632400,11588177,16.40
9840784,9961007,641,224350,10185357,2.25
9840785,9953851,3254,1138900,11092751,11.44
9840786,1646517,738,258300,1904817,15.69
9840787,9991447,6160,2156000,12147447,21.58
9840788,151280,127,44450,195730,29.38
9840789,9983970,4403,1541050,11525020,15.44
9840790,9950015,2989,1046150,10996165,10.51
9840791,9987687,5548,1941800,11929487,19.44
9840792,9988656,4907,1717450,11706106,17.19
9840793,619643,207,72450,692093,11.69
9840794,9975404,5448,1906800,11882204,19.12
9840795,3219465,2395,838250,4057715,26.04
9840796,5246059,4870,1704500,6950559,32.49
9840797,9980914,2728,954800,10935714,9.57
9840798,9983535,5060,1771000,11754535,17.74
9840799,9995134,1775,621250,10616384,6.22
9840800,108656,62,21700,130356,19.97
9840801,252135,338,118300,370435,46.92
9840802,9976658,3942,1379700,11356358,13.83
9840803,9996329,1293,452550,10448879,4.53
9840804,9983950,744,260400,10244350,2.61
9840805,9983582,360,126000,10109582,1.26
9840806,9967933,759,265650,10233583,2.67
9840807,705954,523,183050,889004,25.93
9840808,9966103,2050,717500,10683603,7.20
9840809,136702,96,33600,170302,24.58
9840811,564082,326,114100,678182,20.23
9840812,9955712,3382,1183700,11139412,11.89
9840813,9960841,2655,929250,10890091,9.33
9840814,9979449,4039,1413650,11393099,14.17
9840815,9968900,2561,896350,10865250,8.99
9840816,9983117,2904,1016400,10999517,10.18
9840817,9989881,4144,1450400,11440281,14.52
9840818,1070986,415,145250,1216236,13.56
9840819,9974895,3247,1136450,11111345,11.39
9840820,9981466,3321,1162350,11143816,11.65
9840821,1907106,950,332500,2239606,17.43
9840822,9958900,880,308000,10266900,3.09
9840823,9975414,4821,1687350,11662764,16.92
9840824,37071,13,4550,41621,12.27
9840825,9940691,3739,1308650,11249341,13.16
9840826,9965772,1626,569100,10534872,5.71
9840827,9969240,3645,1275750,11244990,12.80
9840829,9947813,860,301000,10248813,3.03
9840830,9916552,1465,512750,10429302,5.17
9840831,2335689,1081,378350,2714039,16.20
9840832,9936320,3731,1305850,11242170,13.14
9840834,6670953,5104,1786400,8457353,26.78
9840835,9930585,6953,2433550,12364135,24.51
9840836,9924007,1715,600250,10524257,6.05
9840837,3549065,2752,963200,4512265,27.14
9840838,9933090,4554,1593900,11526990,16.05
9840839,9899940,5634,1971900,11871840,19.92
9840840,9945992,4166,1458100,11404092,14.66
9840841,9952194,2923,1023050,10975244,10.28
9840842,9944505,754,263900,10208405,2.65
9840843,9955087,5771,2019850,11974937,20.29
9840844,9962039,1556,544600,10506639,5.47
9840845,9957297,3578,1252300,11209597,12.58
9840846,9962464,6310,2208500,12170964,22.17
9840847,2015124,302,105700,2120824,5.25
9840848,1450834,1180,413000,1863834,28.47
9840850,9945400,3824,1338400,11283800,13.46
9840851,131407,53,18550,149957,14.12
9840852,9901962,2969,1039150,10941112,10.49
9840853,9915130,4714,1649900,11565030,16.64
9840854,9920606,2501,875350,10795956,8.82
9840855,9938151,2237,782950,10721101,7.88
9840856,9952273,3758,1315300,11267573,13.22
9840857,9926200,3958,1385300,11311500,13.96
9840858,9954763,4220,1477000,11431763,14.84
9840859,2749932,1709,598150,3348082,21.75
9840860,9955232,2643,925050,10880282,9.29
9840861,9952574,1852,648200,10600774,6.51
9840862,5557354,3402,1190700,6748054,21.43
9840863,9958412,4101,1435350,11393762,14.41
9840864,9963176,3459,1210650,11173826,12.15
9840865,9982655,389,136150,10118805,1.36
9840866,9909753,1598,559300,10469053,5.64
9840867,9990193,709,248150,10238343,2.48
9840868,9994692,4244,1485400,11480092,14.86
9840869,9967807,1011,353850,10321657,3.55
9840870,327040,444,155400,482440,47.52
9840871,9977983,4498,1574300,11552283,15.78
9840872,9972012,3217,1125950,11097962,11.29
9840873,9988857,1515,530250,10519107,5.31
9840874,9985650,1811,633850,10619500,6.35
9840875,9985797,4458,1560300,11546097,15.63
9840876,9982874,564,197400,10180274,1.98
9840879,9954859,3324,1163400,11118259,11.69
9840880,626173,190,66500,692673,10.62
9840881,9797868,1706,597100,10394968,6.09
9840882,9959684,2915,1020250,10979934,10.24
9840883,9960402,3560,1246000,11206402,12.51
9840884,9983651,2142,749700,10733351,7.51
9840885,9956709,4873,1705550,11662259,17.13
9840886,9972892,2512,879200,10852092,8.82
9840887,9978365,886,310100,10288465,3.11
9840888,9979216,1739,608650,10587866,6.10
9840889,9994538,4314,1509900,11504438,15.11
9840890,447873,177,61950,509823,13.83
9840891,9988003,4803,1681050,11669053,16.83
9840892,9992286,2065,722750,10715036,7.23
9840893,9985699,1966,688100,10673799,6.89
9840894,753318,271,94850,848168,12.59
9840895,9978912,1397,488950,10467862,4.90
9840896,9967862,1998,699300,10667162,7.02
9840899,9976844,6442,2254700,12231544,22.60
9840900,9992459,3516,1230600,11223059,12.32
9840901,9999639,1226,429100,10428739,4.29
9840902,204761,47,16450,221211,8.03
9840903,9965150,1096,383600,10348750,3.85
9840904,390768,227,79450,470218,20.33
9840905,9977493,2231,780850,10758343,7.83
9840906,2823524,1657,579950,3403474,20.54
9840907,9913661,2847,996450,10910111,10.05
9840908,9966962,2936,1027600,10994562,10.31
9840909,9974075,1098,384300,10358375,3.85
9840910,9983609,4417,1545950,11529559,15.48
9840911,9989051,1229,430150,10419201,4.31
9840912,1969869,1238,433300,2403169,22.00
9840913,2833996,721,252350,3086346,8.90
9840914,9986361,1901,665350,10651711,6.66
9840915,9983214,4441,1554350,11537564,15.57
9840916,9992289,2337,817950,10810239,8.19
9840917,9981883,2261,791350,10773233,7.93
9840918,9949543,2313,809550,10759093,8.14
9840919,9974444,5014,1754900,11729344,17.59
9840920,1769595,1200,420000,2189595,23.73
9840921,9991988,5819,2036650,12028638,20.38
9840922,9980603,1936,677600,10658203,6.79
9840923,9977958,2918,1021300,10999258,10.24
9840924,9987203,3372,1180200,11167403,11.82
9840925,9981159,5502,1925700,11906859,19.29
9840926,9980489,3385,1184750,11165239,11.87
9840927,9984530,3091,1081850,11066380,10.84
9840928,9986146,4552,1593200,11579346,15.95
9840929,9977125,2726,954100,10931225,9.56
9840930,9976074,5369,1879150,11855224,18.84
9840932,9962984,2192,767200,10730184,7.70
9840933,9973661,2771,969850,10943511,9.72
9840934,9987289,1610,563500,10550789,5.64
9840935,167215,103,36050,203265,21.56
9840936,9960380,1779,622650,10583030,6.25
9840937,9973771,3772,1320200,11293971,13.24
9840938,9972602,2819,986650,10959252,9.89
9840939,1567281,1647,576450,2143731,36.78
9840940,9983378,3519,1231650,11215028,12.34
9840941,402794,189,66150,468944,16.42
9840942,9956291,4111,1438850,11395141,14.45
9840943,9984641,2457,859950,10844591,8.61
9840944,9995079,1923,673050,10668129,6.73
9840945,2226101,1198,419300,2645401,18.84
9840946,9963961,3984,1394400,11358361,13.99
9840947,9977733,1961,686350,10664083,6.88
9840948,9980158,4797,1678950,11659108,16.82
9840949,9983427,1470,514500,10497927,5.15
9840950,5999320,2810,983500,6982820,16.39
9840951,9979244,3143,1100050,11079294,11.02
9840952,9976675,1439,503650,10480325,5.05
9840953,524179,567,198450,722629,37.86
9840955,1292982,752,263200,1556182,20.36
9840956,9951900,1281,448350,10400250,4.51
9840957,9955991,3323,1163050,11119041,11.68
9840958,9969904,4858,1700300,11670204,17.05
9840959,336295,103,36050,372345,10.72
9840960,9942999,6041,2114350,12057349,21.26
9840961,1670634,1460,511000,2181634,30.59
9840962,747346,239,83650,830996,11.19
9840963,2251718,1885,659750,2911468,29.30
9840964,9949927,3023,1058050,11007977,10.63
9840965,9961198,2865,1002750,10963948,10.07
9840966,9946083,3069,1074150,11020233,10.80
9840967,9951308,5168,1808800,11760108,18.18
9840968,9954817,2048,716800,10671617,7.20
9840970,9953201,3159,1105650,11058851,11.11
9840971,9948754,380,133000,10081754,1.34
9840972,9959786,1988,695800,10655586,6.99
9840973,1906452,1892,662200,2568652,34.73
9840974,1220061,913,319550,1539611,26.19
9840975,9427347,3338,1168300,10595647,12.39
9840976,4561721,3732,1306200,5867921,28.63
9840977,2006273,1504,526400,2532673,26.24
9840978,9999880,4505,1576750,11576630,15.77
9840979,9975932,4237,1482950,11458882,14.87
9840980,279569,294,102900,382469,36.81
9840981,9979583,4410,1543500,11523083,15.47
9840982,9971868,1368,478800,10450668,4.80
9840983,9979781,3920,1372000,11351781,13.75
9840984,9987091,3040,1064000,11051091,10.65
9840985,9992608,914,319900,10312508,3.20
9840986,9997368,790,276500,10273868,2.77
9840987,9991938,3288,1150800,11142738,11.52
9840988,9981612,1866,653100,10634712,6.54
9840989,9986681,1780,623000,10609681,6.24
9840990,9991029,3075,1076250,11067279,10.77
9840991,9994825,5593,1957550,11952375,19.59
9840992,9999979,3248,1136800,11136779,11.37
9840993,9982218,3078,1077300,11059518,10.79
9840994,9983396,2723,953050,10936446,9.55
9840995,9987909,4003,1401050,11388959,14.03
9840996,9796754,4388,1535800,11332554,15.68
9840997,9990320,3900,1365000,11355320,13.66
9840998,9756138,3126,1094100,10850238,11.21
9840999,9962424,3725,1303750,11266174,13.09
9841000,9965806,4377,1531950,11497756,15.37
9841001,9906362,2430,850500,10756862,8.59
9841002,9999330,3991,1396850,11396180,13.97
9841003,3619071,918,321300,3940371,8.88
9841004,9947577,1165,407750,10355327,4.10
9841005,9986580,3784,1324400,11310980,13.26
9841006,9964062,1753,613550,10577612,6.16
9841007,414393,248,86800,501193,20.95
9841008,9969251,4912,1719200,11688451,17.25
9841009,9972884,4915,1720250,11693134,17.25
9841010,9987083,4964,1737400,11724483,17.40
9841011,9991563,1654,578900,10570463,5.79
9841012,9970085,2559,895650,10865735,8.98
9841013,9980740,1576,551600,10532340,5.53
9841014,808382,657,229950,1038332,28.45
9841015,9974347,4762,1666700,11641047,16.71
9841016,1124558,415,145250,1269808,12.92
9841017,9971781,4124,1443400,11415181,14.47
9841018,436910,244,85400,522310,19.55
9841019,9974696,2770,969500,10944196,9.72
9841020,110197,42,14700,124897,13.34
9841021,1613377,922,322700,1936077,20.00
9841022,9972465,3032,1061200,11033665,10.64
9841023,9994391,3418,1196300,11190691,11.97
9841024,9804792,6044,2115400,11920192,21.58
9841025,839368,354,123900,963268,14.76
9841026,9925859,4135,1447250,11373109,14.58
9841027,9991864,4851,1697850,11689714,16.99
9841028,9983990,1760,616000,10599990,6.17
9841029,484993,518,181300,666293,37.38
9841030,9940372,1149,402150,10342522,4.05
9841031,9972048,1858,650300,10622348,6.52
9841032,9973084,3705,1296750,11269834,13.00
9841033,9902181,844,295400,10197581,2.98
9841034,361802,287,100450,462252,27.76
9841035,9967992,2610,913500,10881492,9.16
9841036,9957949,4742,1659700,11617649,16.67
9841037,2107845,1300,455000,2562845,21.59
9841038,9930120,3364,1177400,11107520,11.86
9841039,3676282,1678,587300,4263582,15.98
9841040,9950055,3133,1096550,11046605,11.02
9841041,1221168,917,320950,1542118,26.28
9841042,8110387,3555,1244250,9354637,15.34
9841043,9935517,4695,1643250,11578767,16.54
9841044,654800,559,195650,850450,29.88
9841045,9902803,2862,1001700,10904503,10.12
9841046,9891751,3456,1209600,11101351,12.23
9841049,9906739,3068,1073800,10980539,10.84
9841050,5757512,2503,876050,6633562,15.22
9841051,9913263,3614,1264900,11178163,12.76
9841052,119209,42,14700,133909,12.33
9841053,9887777,2564,897400,10785177,9.08
9841054,9887944,4634,1621900,11509844,16.40
9841055,9911143,3285,1149750,11060893,11.60
9841056,9906160,3975,1391250,11297410,14.04
9841057,9910287,5641,1974350,11884637,19.92
9841058,9918476,2066,723100,10641576,7.29
9841059,9935332,944,330400,10265732,3.33
9841060,1524433,860,301000,1825433,19.75
9841061,9941883,3691,1291850,11233733,12.99
9841062,9944047,4446,1556100,11500147,15.65
9841063,9947225,4736,1657600,11604825,16.66
9841064,9939233,3434,1201900,11141133,12.09
9841065,9927786,979,342650,10270436,3.45
9841066,665920,330,115500,781420,17.34
9841067,9924162,3830,1340500,11264662,13.51
9841068,9927995,910,318500,10246495,3.21
9841069,9928531,753,263550,10192081,2.65
9841070,9930319,550,192500,10122819,1.94
9841071,9936639,5063,1772050,11708689,17.83
9841072,9924100,1989,696150,10620250,7.01
9841073,9942199,3842,1344700,11286899,13.53
9841074,2144246,1035,362250,2506496,16.89
9841075,9942465,5407,1892450,11834915,19.03
9841076,9956202,3499,1224650,11180852,12.30
9841077,9955476,3098,1084300,11039776,10.89
9841078,9819951,4285,1499750,11319701,15.27
9841079,9976068,2506,877100,10853168,8.79
9841080,9957077,1888,660800,10617877,6.64
9841081,9967004,3705,1296750,11263754,13.01
9841082,9976801,5805,2031750,12008551,20.36
9841083,1466693,697,243950,1710643,16.63
9841084,9971330,4867,1703450,11674780,17.08
9841085,9988417,3040,1064000,11052417,10.65
9841086,1804306,777,271950,2076256,15.07
9841087,9983166,5362,1876700,11859866,18.80
9841088,9977549,1215,425250,10402799,4.26
9841089,9972916,4773,1670550,11643466,16.75
9841090,9984963,2987,1045450,11030413,10.47
9841091,9979661,5865,2052750,12032411,20.57
9841092,9898830,5608,1962800,11861630,19.83
9841093,9969487,4108,1437800,11407287,14.42
9841094,9986894,1906,667100,10653994,6.68
9841095,9970971,4317,1510950,11481921,15.15
9841096,9982758,1593,557550,10540308,5.59
9841097,9990034,4345,1520750,11510784,15.22
9841098,9974541,1196,418600,10393141,4.20
9841099,9967380,1037,362950,10330330,3.64
9841100,9979855,4601,1610350,11590205,16.14
9841101,9982157,2484,869400,10851557,8.71
9841102,9975693,3860,1351000,11326693,13.54
9841103,9978982,1007,352450,10331432,3.53
9841104,1648950,952,333200,1982150,20.21
9841105,1677499,914,319900,1997399,19.07
9841106,9982494,2468,863800,10846294,8.65
9841107,9994455,1753,613550,10608005,6.14
9841108,9991817,5217,1825950,11817767,18.27
9841109,9974483,3426,1199100,11173583,12.02
9841110,1900543,1016,355600,2256143,18.71
9841111,9973862,3656,1279600,11253462,12.83
9841112,9996440,1554,543900,10540340,5.44
9841113,9989677,2123,743050,10732727,7.44
9841114,9982368,1947,681450,10663818,6.83
9841115,1105517,441,154350,1259867,13.96
9841116,9951844,3872,1355200,11307044,13.62
9841118,9946820,4646,1626100,11572920,16.35
9841119,9955884,3269,1144150,11100034,11.49
9841120,9920935,2382,833700,10754635,8.40
9841121,9948303,585,204750,10153053,2.06
9841122,1752709,1493,522550,2275259,29.81
9841123,9928283,880,308000,10236283,3.10
9841124,4283152,2596,908600,5191752,21.21
9841125,9918823,1129,395150,10313973,3.98
9841126,9836317,2252,788200,10624517,8.01
9841127,9941521,192,67200,10008721,0.68
9841128,9948877,3702,1295700,11244577,13.02
9841129,9943181,4884,1709400,11652581,17.19
9841130,9931962,1681,588350,10520312,5.92
9841131,9863314,3156,1104600,10967914,11.20
9841132,9944752,3197,1118950,11063702,11.25
9841133,9966761,1957,684950,10651711,6.87
9841134,9958363,3264,1142400,11100763,11.47
9841135,9967137,2655,929250,10896387,9.32
9841136,9982387,2859,1000650,10983037,10.02
9841137,9991968,5689,1991150,11983118,19.93
9841138,9977962,4091,1431850,11409812,14.35
9841139,9979895,6375,2231250,12211145,22.36
9841140,9980773,4725,1653750,11634523,16.57
9841141,9896791,5324,1863400,11760191,18.83
9841142,9977985,2629,920150,10898135,9.22
9841143,9985151,5154,1803900,11789051,18.07
9841144,9983351,6373,2230550,12213901,22.34
9841145,9995860,6145,2150750,12146610,21.52
9841146,9982641,2654,928900,10911541,9.31
9841147,9987315,5502,1925700,11913015,19.28
9841148,9982297,3532,1236200,11218497,12.38
9841149,9988284,4453,1558550,11546834,15.60
9841150,9988446,2405,841750,10830196,8.43
9841151,9981873,1134,396900,10378773,3.98
9841152,9991888,3623,1268050,11259938,12.69
9841153,1170917,387,135450,1306367,11.57
9841154,2911313,1429,500150,3411463,17.18
9841155,9982482,3890,1361500,11343982,13.64
9841156,9980034,4567,1598450,11578484,16.02
9841157,9997703,3482,1218700,11216403,12.19
9841158,9979512,3512,1229200,11208712,12.32
9841159,9980493,4423,1548050,11528543,15.51
9841160,9992362,5705,1996750,11989112,19.98
9841161,7785807,3946,1381100,9166907,17.74
9841162,9999442,2172,760200,10759642,7.60
9841163,9985245,356,124600,10109845,1.25
9841164,9983281,1451,507850,10491131,5.09
9841165,9989778,3983,1394050,11383828,13.95
9841166,9990508,3890,1361500,11352008,13.63
9841167,180217,66,23100,203317,12.82
9841168,9948583,419,146650,10095233,1.47
9841169,9969157,3132,1096200,11065357,11.00
9841170,921839,511,178850,1100689,19.40
9841171,9978930,551,192850,10171780,1.93
9841172,9979209,1342,469700,10448909,4.71
9841173,9980000,3996,1398600,11378600,14.01
9841174,9986544,1757,614950,10601494,6.16
9841175,9985964,1265,442750,10428714,4.43
9841176,9985720,1085,379750,10365470,3.80
9841177,9991194,3147,1101450,11092644,11.02
9841178,9895141,3967,1388450,11283591,14.03
9841179,9987777,3608,1262800,11250577,12.64
9841180,351408,197,68950,420358,19.62
9841181,9979484,4668,1633800,11613284,16.37
9841182,9963135,1018,356300,10319435,3.58
9841183,9945855,5358,1875300,11821155,18.86
9841184,9939779,5232,1831200,11770979,18.42
9841185,9950849,2527,884450,10835299,8.89
9841186,663409,892,312200,975609,47.06
9841187,9959150,3092,1082200,11041350,10.87
9841188,9768459,1643,575050,10343509,5.89
9841189,9969476,5926,2074100,12043576,20.80
9841190,9965960,581,203350,10169310,2.04
9841191,9982946,3830,1340500,11323446,13.43
9841192,124888,88,30800,155688,24.66
9841193,9984454,1528,534800,10519254,5.36
9841194,9983033,859,300650,10283683,3.01
9841195,9998319,762,266700,10265019,2.67
9841196,9986358,669,234150,10220508,2.34
9841197,9720157,1708,597800,10317957,6.15
9841198,9983103,5386,1885100,11868203,18.88
9841199,9997505,2310,808500,10806005,8.09
9841200,9981579,5043,1765050,11746629,17.68
9841201,9982707,5349,1872150,11854857,18.75
9841202,9994649,2919,1021650,11016299,10.22
9841203,9979574,4484,1569400,11548974,15.73
9841204,9978496,2901,1015350,10993846,10.18
9841205,9977950,740,259000,10236950,2.60
9841206,9985458,1011,353850,10339308,3.54
9841207,9983285,2260,791000,10774285,7.92
9841208,9979665,4501,1575350,11555015,15.79
9841209,9979594,884,309400,10288994,3.10
9841210,9975393,3385,1184750,11160143,11.88
9841211,9972759,554,193900,10166659,1.94
9841212,9988574,5416,1895600,11884174,18.98
9841214,9983515,1932,676200,10659715,6.77
9841215,1387279,823,288050,1675329,20.76
9841216,9979112,948,331800,10310912,3.32
9841217,4130929,1651,577850,4708779,13.99
9841218,9981725,4728,1654800,11636525,16.58
9841219,9981329,956,334600,10315929,3.35
9841220,3702258,2802,980700,4682958,26.49
9841221,9994018,3588,1255800,11249818,12.57
9841222,3928266,2225,778750,4707016,19.82
9841223,9989996,5147,1801450,11791446,18.03
9841224,9978975,6294,2202900,12181875,22.08
9841225,9980723,2304,806400,10787123,8.08
9841226,9979794,3461,1211350,11191144,12.14
9841227,9990095,3861,1351350,11341445,13.53
9841228,9963345,5910,2068500,12031845,20.76
9841229,9972489,2042,714700,10687189,7.17
9841230,9985387,1991,696850,10682237,6.98
9841231,2102128,2401,840350,2942478,39.98
9841232,9975406,5100,1785000,11760406,17.89
9841233,9987849,3640,1274000,11261849,12.76
9841234,2974855,1145,400750,3375605,13.47
9841235,9976076,5027,1759450,11735526,17.64
9841236,9994420,2977,1041950,11036370,10.43
9841237,9983501,5807,2032450,12015951,20.36
9841238,9981504,4189,1466150,11447654,14.69
9841239,9976720,3197,1118950,11095670,11.22
9841240,9995734,4494,1572900,11568634,15.74
9841241,9992475,4267,1493450,11485925,14.95
9841242,2830474,500,175000,3005474,6.18
9841243,9982196,2383,834050,10816246,8.36
9841244,9966877,1963,687050,10653927,6.89
9841245,9960331,3727,1304450,11264781,13.10
9841246,9976053,4728,1654800,11630853,16.59
9841247,9301463,2718,951300,10252763,10.23
9841248,2083368,1599,559650,2643018,26.86
9841249,9955726,2558,895300,10851026,8.99
9841250,987287,827,289450,1276737,29.32
9841251,9930896,4279,1497650,11428546,15.08
9841252,145541,32,11200,156741,7.70
9841253,6072553,3455,1209250,7281803,19.91
9841254,482264,360,126000,608264,26.13
9841255,24241,26,9100,33341,37.54
9841256,9916029,3939,1378650,11294679,13.90
9841257,9923518,2966,1038100,10961618,10.46
9841258,9929218,2212,774200,10703418,7.80
9841259,9927214,4782,1673700,11600914,16.86
9841263,9900572,3479,1217650,11118222,12.30
9841264,9907518,2095,733250,10640768,7.40
9841265,9925739,3333,1166550,11092289,11.75
9841267,8543541,35,12250,8555791,0.14
9841268,3713255,1389,486150,4199405,13.09
9841269,9916663,6174,2160900,12077563,21.79
9841270,1970148,1011,353850,2323998,17.96
9841271,9924021,4265,1492750,11416771,15.04
9841272,9148423,6981,2443350,11591773,26.71
9841273,9920927,3834,1341900,11262827,13.53
9841274,9921093,5003,1751050,11672143,17.65
9841275,9915787,5386,1885100,11800887,19.01
9841276,9920867,3373,1180550,11101417,11.90
9841278,9917780,5070,1774500,11692280,17.89
9841279,1746685,653,228550,1975235,13.08
9841281,2307784,798,279300,2587084,12.10
9841282,9899690,6949,2432150,12331840,24.57
9841283,9900400,7556,2644600,12545000,26.71
9841284,9903942,2861,1001350,10905292,10.11
9841285,9899593,4988,1745800,11645393,17.64
9841286,9914703,4531,1585850,11500553,15.99
9841287,9928328,3342,1169700,11098028,11.78
9841288,1577075,709,248150,1825225,15.73
9841289,9929721,4289,1501150,11430871,15.12
9841290,1900011,741,259350,2159361,13.65
9841291,9921919,3227,1129450,11051369,11.38
9841292,9921116,3101,1085350,11006466,10.94
9841293,9933749,1628,569800,10503549,5.74
9841294,9937014,1920,672000,10609014,6.76
9841295,9938534,1091,381850,10320384,3.84
9841296,9959507,2563,897050,10856557,9.01
9841297,5000721,934,326900,5327621,6.54
9841298,1032051,470,164500,1196551,15.94
9841299,9953725,3589,1256150,11209875,12.62
9841300,9947461,1354,473900,10421361,4.76
9841301,9972722,4569,1599150,11571872,16.04
9841302,4189396,1018,356300,4545696,8.50
9841303,3105305,1568,548800,3654105,17.67
9841304,9952176,4029,1410150,11362326,14.17
9841305,9864456,4350,1522500,11386956,15.43
9841306,9949947,1066,373100,10323047,3.75
9841307,8507127,834,291900,8799027,3.43
9841308,9969752,4079,1427650,11397402,14.32
9841309,9958320,4408,1542800,11501120,15.49
9841310,9980461,2941,1029350,11009811,10.31
9841311,9970829,890,311500,10282329,3.12
9841312,7521260,3639,1273650,8794910,16.93
9841314,9984767,2962,1036700,11021467,10.38
9841315,9898425,6153,2153550,12051975,21.76
9841316,9977070,3460,1211000,11188070,12.14
9841317,913637,223,78050,991687,8.54
9841318,9982104,4270,1494500,11476604,14.97
9841319,9979746,3914,1369900,11349646,13.73
9841320,9990707,3196,1118600,11109307,11.20
9841321,6747450,1473,515550,7263000,7.64
9841322,673307,640,224000,897307,33.27
9841323,9964890,2707,947450,10912340,9.51
9841324,8566345,3385,1184750,9751095,13.83
9841326,9978327,3730,1305500,11283827,13.08
9841327,9984166,1663,582050,10566216,5.83
9841328,9988292,6623,2318050,12306342,23.21
9841329,9999465,2086,730100,10729565,7.30
9841330,9971729,1005,351750,10323479,3.53
9841331,9992732,1195,418250,10410982,4.19
9841332,9973754,1581,553350,10527104,5.55
9841333,9999822,3896,1363600,11363422,13.64
9841334,9999152,3850,1347500,11346652,13.48
9841335,3477183,1572,550200,4027383,15.82
9841336,3477116,1272,445200,3922316,12.80
9841337,9971511,5218,1826300,11797811,18.32
9841338,9966523,3350,1172500,11139023,11.76
9841339,1081143,681,238350,1319493,22.05
9841340,9957229,844,295400,10252629,2.97
9841341,9956742,1849,647150,10603892,6.50
9841342,1275393,777,271950,1547343,21.32
9841343,9942134,3493,1222550,11164684,12.30
9841344,9941714,3140,1099000,11040714,11.05
9841345,9953284,4147,1451450,11404734,14.58
9841346,1657670,379,132650,1790320,8.00
9841347,7857744,2421,847350,8705094,10.78
9841348,9918545,2129,745150,10663695,7.51
9841349,792481,575,201250,993731,25.39
9841350,9918286,3679,1287650,11205936,12.98
9841351,7773420,4302,1505700,9279120,19.37
9841352,4831452,2305,806750,5638202,16.70
9841353,100607,94,32900,133507,32.70
9841354,9952983,5279,1847650,11800633,18.56
9841355,2320450,892,312200,2632650,13.45
9841356,9953496,4972,1740200,11693696,17.48
9841357,9946149,3876,1356600,11302749,13.64
9841358,9948727,4947,1731450,11680177,17.40
9841361,202903,194,67900,270803,33.46
9841362,9963720,4583,1604050,11567770,16.10
9841363,9948098,5512,1929200,11877298,19.39
9841364,9943112,3417,1195950,11139062,12.03
9841365,9944206,1679,587650,10531856,5.91
9841366,8945046,3895,1363250,10308296,15.24
9841367,9971808,4569,1599150,11570958,16.04
9841368,9950928,3885,1359750,11310678,13.66
9841369,9940154,1110,388500,10328654,3.91
9841370,9958608,2087,730450,10689058,7.33
9841371,9952099,868,303800,10255899,3.05
9841372,4566312,1608,562800,5129112,12.33
9841373,8957732,3755,1314250,10271982,14.67
9841374,9937097,3613,1264550,11201647,12.73
9841375,7497042,1842,644700,8141742,8.60
9841376,9937263,4119,1441650,11378913,14.51
9841377,764927,289,101150,866077,13.22
9841378,9907644,2754,963900,10871544,9.73
9841379,4972443,3149,1102150,6074593,22.17
9841380,9914032,4421,1547350,11461382,15.61
9841381,9924837,3445,1205750,11130587,12.15
9841382,9933814,4463,1562050,11495864,15.72
9841383,9938677,4722,1652700,11591377,16.63
9841384,417182,210,73500,490682,17.62
9841385,9932873,4700,1645000,11577873,16.56
9841386,9557032,3825,1338750,10895782,14.01
9841387,9942096,4796,1678600,11620696,16.88
9841388,9937897,2306,807100,10744997,8.12
9841389,9934196,3508,1227800,11161996,12.36
9841390,9944836,811,283850,10228686,2.85
9841391,9953218,261,91350,10044568,0.92
9841392,9962206,4433,1551550,11513756,15.57
9841393,9949454,3421,1197350,11146804,12.03
9841394,9979025,1750,612500,10591525,6.14
9841395,876187,445,155750,1031937,17.78
9841396,7628929,3938,1378300,9007229,18.07
9841397,1784801,829,290150,2074951,16.26
9841398,9965498,5453,1908550,11874048,19.15
9841399,174366,93,32550,206916,18.67
9841400,1147963,582,203700,1351663,17.74
9841401,9968440,5768,2018800,11987240,20.25
9841402,9164875,3404,1191400,10356275,13.00
9841403,9982257,6400,2240000,12222257,22.44
9841404,113196,70,24500,137696,21.64
9841405,671238,468,163800,835038,24.40
9841406,9971485,6741,2359350,12330835,23.66
9841407,9983085,7860,2751000,12734085,27.56
9841408,1433275,347,121450,1554725,8.47
9841410,9968425,6549,2292150,12260575,22.99
9841411,3376197,2562,896700,4272897,26.56
9841412,9992490,5438,1903300,11895790,19.05
9841413,8992373,3726,1304100,10296473,14.50
9841414,9976433,6689,2341150,12317583,23.47
9841415,8663792,3900,1365000,10028792,15.76
9841416,9976172,2230,780500,10756672,7.82
9841417,9989622,5255,1839250,11828872,18.41
9841418,9995522,5286,1850100,11845622,18.51
9841419,9741467,4216,1475600,11217067,15.15
9841420,9981762,7005,2451750,12433512,24.56
9841421,9989091,1907,667450,10656541,6.68
9841422,9969770,3293,1152550,11122320,11.56
9841423,9982528,4021,1407350,11389878,14.10
9841424,144224,97,33950,178174,23.54
9841425,9988720,3144,1100400,11089120,11.02
9841426,9998357,3054,1068900,11067257,10.69
9841427,642022,425,148750,790772,23.17
9841428,9969235,936,327600,10296835,3.29
9841429,9974890,5127,1794450,11769340,17.99
9841432,9976190,6299,2204650,12180840,22.10
9841433,9969220,2400,840000,10809220,8.43
9841434,9958830,5437,1902950,11861780,19.11
9841435,4526831,2048,716800,5243631,15.83
9841437,9947767,4874,1705900,11653667,17.15
9841438,9958809,2768,968800,10927609,9.73
9841439,9944640,3053,1068550,11013190,10.74
9841441,9931815,2870,1004500,10936315,10.11
9841443,9946063,288,100800,10046863,1.01
9841444,9946206,5365,1877750,11823956,18.88
9841445,9941008,4176,1461600,11402608,14.70
9841446,9945190,3385,1184750,11129940,11.91
9841447,9961102,1224,428400,10389502,4.30
9841448,9964154,4413,1544550,11508704,15.50
9841449,9969931,5310,1858500,11828431,18.64
9841450,9949185,3124,1093400,11042585,10.99
9841451,9972832,2690,941500,10914332,9.44
9841452,9971366,930,325500,10296866,3.26
9841453,9962606,3901,1365350,11327956,13.70
9841454,9978980,3011,1053850,11032830,10.56
9841455,2781636,1730,605500,3387136,21.77
9841456,9976103,4205,1471750,11447853,14.75
9841457,9988763,3556,1244600,11233363,12.46
9841458,9991816,3881,1358350,11350166,13.59
9841459,9981549,4239,1483650,11465199,14.86
9841460,9970443,5407,1892450,11862893,18.98
9841461,9984737,5714,1999900,11984637,20.03
9841462,9965154,2419,846650,10811804,8.50
9841463,5094607,1895,663250,5757857,13.02
9841464,9941918,4185,1464750,11406668,14.73
9841465,9980933,4324,1513400,11494333,15.16
9841466,9984144,3550,1242500,11226644,12.44
9841467,9970376,2837,992950,10963326,9.96
9841469,9945924,3857,1349950,11295874,13.57
9841470,9950216,5266,1843100,11793316,18.52
9841471,9943734,3312,1159200,11102934,11.66
9841472,1353920,777,271950,1625870,20.09
9841473,9949717,5673,1985550,11935267,19.96
9841474,9941847,4051,1417850,11359697,14.26
9841475,3125032,1368,478800,3603832,15.32
9841476,9938204,4676,1636600,11574804,16.47
9841477,9952494,5118,1791300,11743794,18.00
9841478,9956812,3831,1340850,11297662,13.47
9841479,9984393,5452,1908200,11892593,19.11
9841480,9985299,3366,1178100,11163399,11.80
9841481,9983906,5257,1839950,11823856,18.43
9841482,9976043,4169,1459150,11435193,14.63
9841483,9999146,3252,1138200,11137346,11.38
9841484,9996522,3563,1247050,11243572,12.47
9841485,9994735,3972,1390200,11384935,13.91
9841486,9987444,968,338800,10326244,3.39
9841487,9975881,4282,1498700,11474581,15.02
9841488,9996147,4625,1618750,11614897,16.19
9841489,1035792,614,214900,1250692,20.75
9841490,9973638,4972,1740200,11713838,17.45
9841491,9988980,1937,677950,10666930,6.79
9841492,9993464,1613,564550,10558014,5.65
9841493,1977133,980,343000,2320133,17.35
9841494,9951819,6780,2373000,12324819,23.84
9841496,9969568,4879,1707650,11677218,17.13
9841497,9963426,3001,1050350,11013776,10.54
9841498,9929612,3468,1213800,11143412,12.22
9841499,1929188,728,254800,2183988,13.21
9841500,9946478,4810,1683500,11629978,16.93
9841501,272587,93,32550,305137,11.94
9841502,9933882,771,269850,10203732,2.72
9841503,9938854,1970,689500,10628354,6.94
9841504,9920669,4565,1597750,11518419,16.11
9841505,9929772,4633,1621550,11551322,16.33
9841506,9938728,3505,1226750,11165478,12.34
9841507,9943879,3339,1168650,11112529,11.75
9841508,379135,104,36400,415535,9.60
9841509,9964409,2541,889350,10853759,8.93
9841510,9968686,4628,1619800,11588486,16.25
9841511,9973182,988,345800,10318982,3.47
9841512,9960988,2652,928200,10889188,9.32
9841513,9965997,1164,407400,10373397,4.09
9841514,9982154,1018,356300,10338454,3.57
9841515,9986962,424,148400,10135362,1.49
9841516,236816,111,38850,275666,16.41
9841517,1929014,447,156450,2085464,8.11
9841518,2466453,1136,397600,2864053,16.12
9841519,9869292,1575,551250,10420542,5.59
9841520,9983350,4094,1432900,11416250,14.35
9841521,9972506,2486,870100,10842606,8.72
9841522,9989592,4275,1496250,11485842,14.98
9841523,1435105,796,278600,1713705,19.41
9841524,9980389,5291,1851850,11832239,18.55
9841525,9990591,6584,2304400,12294991,23.07
9841526,9980110,1606,562100,10542210,5.63
9841527,1711770,276,96600,1808370,5.64
9841528,9988579,2342,819700,10808279,8.21
9841529,25097,16,5600,30697,22.31
9841530,9988924,3628,1269800,11258724,12.71
9841531,9994594,1861,651350,10645944,6.52
9841532,633273,99,34650,667923,5.47
9841533,9990121,3803,1331050,11321171,13.32
9841534,9996066,3156,1104600,11100666,11.05
9841535,9989653,1416,495600,10485253,4.96
9841536,9602788,2524,883400,10486188,9.20
9841537,9982832,4954,1733900,11716732,17.37
9841538,56209,42,14700,70909,26.15
9841539,9995753,4016,1405600,11401353,14.06
9841540,2484224,1168,408800,2893024,16.46
9841541,4267977,1972,690200,4958177,16.17
9841542,3813146,1640,574000,4387146,15.05
9841543,9973453,4443,1555050,11528503,15.59
9841544,9976310,3377,1181950,11158260,11.85
9841545,9994971,5106,1787100,11782071,17.88
9841546,420296,76,26600,446896,6.33
9841547,473220,148,51800,525020,10.95
9841548,9963076,5064,1772400,11735476,17.79
9841549,9967897,2659,930650,10898547,9.34
9841550,9969816,4869,1704150,11673966,17.09
9841551,1697407,628,219800,1917207,12.95
9841552,9975793,4461,1561350,11537143,15.65
9841553,9959063,4864,1702400,11661463,17.09
9841554,9979708,2373,830550,10810258,8.32
9841555,9961140,3176,1111600,11072740,11.16
9841556,1393567,429,150150,1543717,10.77
9841557,9994107,450,157500,10151607,1.58
9841558,9987744,2623,918050,10905794,9.19
9841559,208811,152,53200,262011,25.48
9841560,9987553,3587,1255450,11243003,12.57
9841561,2657972,1033,361550,3019522,13.60
9841562,9973345,3453,1208550,11181895,12.12
9841563,9990440,4487,1570450,11560890,15.72
9841564,9989050,4421,1547350,11536400,15.49
9841565,9987779,3385,1184750,11172529,11.86
9841566,9993630,3032,1061200,11054830,10.62
9841567,9991833,2024,708400,10700233,7.09
9841568,5406593,1767,618450,6025043,11.44
9841569,1844100,1982,693700,2537800,37.62
9841570,9972170,2669,934150,10906320,9.37
9841571,9980785,3648,1276800,11257585,12.79
9841572,9996621,5215,1825250,11821871,18.26
9841573,5609194,2090,731500,6340694,13.04
9841574,7191008,1601,560350,7751358,7.79
9841575,9980361,2855,999250,10979611,10.01
9841576,9982881,4463,1562050,11544931,15.65
9841577,9985254,4320,1512000,11497254,15.14
9841578,1394708,776,271600,1666308,19.47
9841579,9999963,3085,1079750,11079713,10.80
9841580,9975946,4653,1628550,11604496,16.32
9841581,9986299,3564,1247400,11233699,12.49
9841582,1075439,975,341250,1416689,31.73
9841583,2975560,563,197050,3172610,6.62
9841584,1287255,657,229950,1517205,17.86
9841585,2059860,531,185850,2245710,9.02
9841586,9922267,2942,1029700,10951967,10.38
9841587,9980159,4193,1467550,11447709,14.70
9841588,9984100,3596,1258600,11242700,12.61
9841589,9959564,3268,1143800,11103364,11.48
9841590,9966902,3454,1208900,11175802,12.13
9841591,9971670,4326,1514100,11485770,15.18
9841592,9980611,4456,1559600,11540211,15.63
9841593,9998818,5761,2016350,12015168,20.17
9841594,9972792,3981,1393350,11366142,13.97
9841596,9959088,4420,1547000,11506088,15.53
9841597,9980517,3949,1382150,11362667,13.85
9841598,7487383,3436,1202600,8689983,16.06
9841599,937788,569,199150,1136938,21.24
9841600,9948542,4433,1551550,11500092,15.60
9841601,9966911,4501,1575350,11542261,15.81
9841602,9971672,4066,1423100,11394772,14.27
9841603,4809597,1104,386400,5195997,8.03
9841604,9973213,2380,833000,10806213,8.35
9841606,9954291,4880,1708000,11662291,17.16
9841607,9967123,1717,600950,10568073,6.03
9841608,7081101,758,265300,7346401,3.75
9841609,9965679,5374,1880900,11846579,18.87
9841610,9972798,2472,865200,10837998,8.68
9841611,4824074,2141,749350,5573424,15.53
9841613,9981972,2245,785750,10767722,7.87
9841614,9990229,3548,1241800,11232029,12.43
9841615,9992161,5005,1751750,11743911,17.53
9841616,9992860,2765,967750,10960610,9.68
9841617,3078741,2174,760900,3839641,24.71
9841618,9961682,5824,2038400,12000082,20.46
9841619,9884478,4591,1606850,11491328,16.26
9841621,9985199,6787,2375450,12360649,23.79
9841622,9973873,3617,1265950,11239823,12.69
9841623,9959449,2313,809550,10768999,8.13
9841624,9958599,2407,842450,10801049,8.46
9841625,9943576,4711,1648850,11592426,16.58
9841626,9942857,3433,1201550,11144407,12.08
9841627,9944079,3520,1232000,11176079,12.39
9841628,9945879,2320,812000,10757879,8.16
9841629,9966436,4555,1594250,11560686,16.00
9841630,9956324,3713,1299550,11255874,13.05
9841631,9962376,5765,2017750,11980126,20.25
9841632,9478805,3402,1190700,10669505,12.56
9841633,4768641,2202,770700,5539341,16.16
9841634,9983419,5099,1784650,11768069,17.88
9841635,9978345,5211,1823850,11802195,18.28
9841636,9981646,5262,1841700,11823346,18.45
9841637,9999441,5461,1911350,11910791,19.11
9841638,9982799,2982,1043700,11026499,10.45
9841639,9969298,3030,1060500,11029798,10.64
9841640,9960086,5790,2026500,11986586,20.35
9841641,9976288,3904,1366400,11342688,13.70
9841642,3565894,2393,837550,4403444,23.49
9841643,9979998,3250,1137500,11117498,11.40
9841644,761379,191,66850,828229,8.78
9841645,9960724,5176,1811600,11772324,18.19
9841646,9972950,4275,1496250,11469200,15.00
9841647,161795,68,23800,185595,14.71
9841648,9944045,8545,2990750,12934795,30.08
9841649,9953872,3370,1179500,11133372,11.85
9841650,9964422,5473,1915550,11879972,19.22
9841651,9958350,3297,1153950,11112300,11.59
9841652,5438966,2083,729050,6168016,13.40
9841653,9960167,4988,1745800,11705967,17.53
9841654,9984433,6587,2305450,12289883,23.09
9841655,9968972,3087,1080450,11049422,10.84
9841656,9981329,4363,1527050,11508379,15.30
9841657,9988222,3069,1074150,11062372,10.75
9841658,9979648,4379,1532650,11512298,15.36
9841659,1988006,933,326550,2314556,16.43
9841660,9983518,4890,1711500,11695018,17.14
9841661,9997202,5776,2021600,12018802,20.22
9841662,3834140,1411,493850,4327990,12.88
9841663,9967336,4104,1436400,11403736,14.41
9841664,9985449,5499,1924650,11910099,19.27
9841665,4845022,2463,862050,5707072,17.79
9841666,9973253,3816,1335600,11308853,13.39
9841668,9966337,3006,1052100,11018437,10.56
9841669,9975082,4359,1525650,11500732,15.29
9841670,9887507,4389,1536150,11423657,15.54
9841671,9986883,2390,836500,10823383,8.38
9841672,9992983,1842,644700,10637683,6.45
9841673,8144518,2791,976850,9121368,11.99
9841674,9992348,1929,675150,10667498,6.76
9841675,9996196,3874,1355900,11352096,13.56
9841676,9981322,4931,1725850,11707172,17.29
9841677,9976494,3783,1324050,11300544,13.27
9841678,687872,411,143850,831722,20.91
9841679,9967262,4771,1669850,11637112,16.75
9841680,9959336,4701,1645350,11604686,16.52
9841681,9862187,4208,1472800,11334987,14.93
9841682,2701949,1144,400400,3102349,14.82
9841683,9577216,4155,1454250,11031466,15.18
9841684,9970991,3877,1356950,11327941,13.61
9841685,9970837,4789,1676150,11646987,16.81
9841686,9996780,4233,1481550,11478330,14.82
9841688,4210927,1250,437500,4648427,10.39
9841689,9970614,3693,1292550,11263164,12.96
9841690,9990256,5171,1809850,11800106,18.12
9841691,9993418,5949,2082150,12075568,20.84
9841692,9982473,5613,1964550,11947023,19.68
9841693,9980785,4223,1478050,11458835,14.81
9841694,3610372,1549,542150,4152522,15.02
9841695,9990972,3345,1170750,11161722,11.72
9841696,2159348,798,279300,2438648,12.93
9841697,9962973,3394,1187900,11150873,11.92
9841698,9870283,2830,990500,10860783,10.04
9841699,1631009,477,166950,1797959,10.24
9841700,9954397,4525,1583750,11538147,15.91
9841701,9962022,4555,1594250,11556272,16.00
9841702,9980245,4323,1513050,11493295,15.16
9841703,9977676,5918,2071300,12048976,20.76
9841704,9972807,2837,992950,10965757,9.96
9841705,9995438,3971,1389850,11385288,13.90
9841707,2951549,1571,549850,3501399,18.63
9841708,9990824,2961,1036350,11027174,10.37
9841709,5439239,4087,1430450,6869689,26.30
9841710,9972492,4089,1431150,11403642,14.35
9841711,9966723,3448,1206800,11173523,12.11
9841714,9969715,3690,1291500,11261215,12.95
9841716,9993232,3815,1335250,11328482,13.36
9841717,9982662,5493,1922550,11905212,19.26
9841718,9985777,3752,1313200,11298977,13.15
9841719,9994490,3035,1062250,11056740,10.63
9841720,9777491,3505,1226750,11004241,12.55
9841721,9984548,3098,1084300,11068848,10.86
9841723,9962962,3305,1156750,11119712,11.61
9841724,3058730,179,62650,3121380,2.05
9841725,9988276,4060,1421000,11409276,14.23
9841726,9976247,6262,2191700,12167947,21.97
9841727,9965919,4973,1740550,11706469,17.47
9841728,9966021,4382,1533700,11499721,15.39
9841729,9969079,4103,1436050,11405129,14.41
9841730,9984205,2921,1022350,11006555,10.24
9841731,9986998,3636,1272600,11259598,12.74
9841732,9973276,3860,1351000,11324276,13.55
9841733,9981778,4716,1650600,11632378,16.54
9841734,9979619,3774,1320900,11300519,13.24
9841735,1108562,312,109200,1217762,9.85
9841736,7714494,3433,1201550,8916044,15.58
9841737,6088034,2306,807100,6895134,13.26
9841738,9970942,4978,1742300,11713242,17.47
9841739,9972679,4717,1650950,11623629,16.55
9841740,9976634,4245,1485750,11462384,14.89
9841741,4972745,2732,956200,5928945,19.23
9841742,9989958,2969,1039150,11029108,10.40
9841743,6650486,3887,1360450,8010936,20.46
9841744,9984297,4603,1611050,11595347,16.14
9841745,9975781,3864,1352400,11328181,13.56
9841746,9979700,3926,1374100,11353800,13.77
9841748,1420237,1507,527450,1947687,37.14
9841749,9987576,2908,1017800,11005376,10.19
9841750,9974266,4754,1663900,11638166,16.68
9841751,9987300,4063,1422050,11409350,14.24
9841753,9974437,3789,1326150,11300587,13.30
9841754,9993329,3163,1107050,11100379,11.08
9841756,9895135,5126,1794100,11689235,18.13
9841757,2199383,957,334950,2534333,15.23
9841758,9967859,4109,1438150,11406009,14.43
9841759,617566,617,215950,833516,34.97
9841760,9978472,3548,1241800,11220272,12.44
9841761,9978505,4968,1738800,11717305,17.43
9841762,9983194,3474,1215900,11199094,12.18
9841763,9985167,5678,1987300,11972467,19.90
9841764,9972528,1835,642250,10614778,6.44
9841765,9991676,909,318150,10309826,3.18
9841766,2747156,1740,609000,3356156,22.17
9841767,9961537,2640,924000,10885537,9.28
9841768,9948833,5122,1792700,11741533,18.02
9841769,9969010,1145,400750,10369760,4.02
9841770,9944826,4421,1547350,11492176,15.56
9841771,9964833,3438,1203300,11168133,12.08
9841772,9939007,6838,2393300,12332307,24.08
9841774,9951175,3368,1178800,11129975,11.85
9841775,9697602,5799,2029650,11727252,20.93
9841776,6076678,2424,848400,6925078,13.96
9841777,9924512,5893,2062550,11987062,20.78
9841778,9926219,2553,893550,10819769,9.00
9841779,985478,441,154350,1139828,15.66
9841780,9913295,6550,2292500,12205795,23.13
9841781,9911310,3243,1135050,11046360,11.45
9841782,9934755,3445,1205750,11140505,12.14
9841783,9925237,3135,1097250,11022487,11.06
9841784,9950592,2092,732200,10682792,7.36
9841785,9948083,2848,996800,10944883,10.02
9841786,9468511,1687,590450,10058961,6.24
9841787,9967901,3958,1385300,11353201,13.90
9841788,1128458,642,224700,1353158,19.91
9841789,9959552,1614,564900,10524452,5.67
9841790,9944252,3020,1057000,11001252,10.63
9841791,9936564,4835,1692250,11628814,17.03
9841792,9937331,5180,1813000,11750331,18.24
9841793,9943385,3571,1249850,11193235,12.57
9841794,565783,120,42000,607783,7.42
9841795,4558057,1257,439950,4998007,9.65
9841796,9920685,3587,1255450,11176135,12.65
9841797,2335663,786,275100,2610763,11.78
9841798,9917360,4865,1702750,11620110,17.17
9841799,9937226,2788,975800,10913026,9.82
9841800,9913136,3996,1398600,11311736,14.11
9841801,9924455,3592,1257200,11181655,12.67
9841802,9926417,2954,1033900,10960317,10.42
9841803,1662742,493,172550,1835292,10.38
9841804,9924121,4096,1433600,11357721,14.45
9841805,9940868,1794,627900,10568768,6.32
9841806,9934842,1130,395500,10330342,3.98
9841807,9942699,3737,1307950,11250649,13.15
9841808,6646972,2208,772800,7419772,11.63
9841809,9949875,4218,1476300,11426175,14.84
9841810,9980609,3662,1281700,11262309,12.84
9841811,9967303,4056,1419600,11386903,14.24
9841812,3101458,1140,399000,3500458,12.86
9841813,9964195,2447,856450,10820645,8.60
9841814,9962759,3807,1332450,11295209,13.37
9841815,9955976,3450,1207500,11163476,12.13
9841816,9947120,3203,1121050,11068170,11.27
9841817,9965099,3825,1338750,11303849,13.43
9841818,2131367,1055,369250,2500617,17.32
9841819,9968666,4009,1403150,11371816,14.08
9841820,9972043,3893,1362550,11334593,13.66
9841821,9975377,3385,1184750,11160127,11.88
9841822,838617,177,61950,900567,7.39
9841823,9995307,3686,1290100,11285407,12.91
9841824,9994854,3056,1069600,11064454,10.70
9841825,246225,152,53200,299425,21.61
9841826,9961151,2862,1001700,10962851,10.06
9841827,9978937,3558,1245300,11224237,12.48
9841828,9959782,5346,1871100,11830882,18.79
9841829,9986627,1913,669550,10656177,6.70
9841831,9978011,4384,1534400,11512411,15.38
9841832,7778015,2476,866600,8644615,11.14
9841833,9983261,4234,1481900,11465161,14.84
9841834,9980883,2015,705250,10686133,7.07
9841835,9989988,4570,1599500,11589488,16.01
9841838,9979817,2221,777350,10757167,7.79
9841839,8352855,3944,1380400,9733255,16.53
9841840,9987119,2639,923650,10910769,9.25
9841841,9965335,3435,1202250,11167585,12.06
9841842,9984827,2954,1033900,11018727,10.35
9841843,9977044,2012,704200,10681244,7.06
9841844,9984319,5908,2067800,12052119,20.71
9841845,9987140,7450,2607500,12594640,26.11
9841847,9969766,1876,656600,10626366,6.59
9841848,1841774,541,189350,2031124,10.28
9841849,9950420,2025,708750,10659170,7.12
9841850,9950672,1527,534450,10485122,5.37
9841851,9933383,4614,1614900,11548283,16.26
9841852,9953106,1588,555800,10508906,5.58
9841853,9970940,3597,1258950,11229890,12.63
9841854,2520496,1784,624400,3144896,24.77
9841855,9962004,2429,850150,10812154,8.53
9841856,9968626,3175,1111250,11079876,11.15
9841857,9967714,4104,1436400,11404114,14.41
9841858,9983343,3951,1382850,11366193,13.85
9841859,9998527,4583,1604050,11602577,16.04
9841860,9990216,2208,772800,10763016,7.74
9841861,9922195,694,242900,10165095,2.45
9841862,9981949,5530,1935500,11917449,19.39
9841863,9993268,3711,1298850,11292118,13.00
9841864,9995495,7368,2578800,12574295,25.80
9841865,9956479,4047,1416450,11372929,14.23
9841866,9988389,3622,1267700,11256089,12.69
9841867,9992741,3752,1313200,11305941,13.14
9841868,3535193,1319,461650,3996843,13.06
9841870,2072091,1934,676900,2748991,32.67
9841871,9979419,435,152250,10131669,1.53
9841872,9980475,4765,1667750,11648225,16.71
9841873,9984991,4989,1746150,11731141,17.49
9841874,2713574,1045,365750,3079324,13.48
9841875,9988375,3217,1125950,11114325,11.27
9841876,7302894,2852,998200,8301094,13.67
9841877,9985498,3638,1273300,11258798,12.75
9841878,6528281,1596,558600,7086881,8.56
9841879,3599063,1145,400750,3999813,11.13
9841880,9987854,2424,848400,10836254,8.49
9841881,1240506,425,148750,1389256,11.99
9841882,5386309,2476,866600,6252909,16.09
9841883,9989336,2991,1046850,11036186,10.48
9841884,9984467,6557,2294950,12279417,22.99
9841885,9980134,6424,2248400,12228534,22.53
9841886,9969789,3448,1206800,11176589,12.10
9841888,9960342,3763,1317050,11277392,13.22
9841889,9946156,6777,2371950,12318106,23.85
9841890,9952069,7215,2525250,12477319,25.37
9841891,9923463,2087,730450,10653913,7.36
9841892,9954365,4532,1586200,11540565,15.93
9841893,9954793,3146,1101100,11055893,11.06
9841894,9962301,4191,1466850,11429151,14.72
9841896,9956575,4900,1715000,11671575,17.22
9841897,9963123,3963,1387050,11350173,13.92
9841898,9977994,8096,2833600,12811594,28.40
9841899,9970020,5684,1989400,11959420,19.95
9841900,9964292,6992,2447200,12411492,24.56
9841901,9977104,4525,1583750,11560854,15.87
9841902,6476992,4693,1642550,8119542,25.36
9841903,9980121,4380,1533000,11513121,15.36
9841904,4533956,2458,860300,5394256,18.97
9841905,9986477,5210,1823500,11809977,18.26
9841906,9982210,3304,1156400,11138610,11.58
9841907,5976790,1722,602700,6579490,10.08
9841908,9974429,4157,1454950,11429379,14.59
9841909,9986744,4011,1403850,11390594,14.06
9841911,9707655,2984,1044400,10752055,10.76
9841912,9992310,4392,1537200,11529510,15.38
9841913,9996622,4520,1582000,11578622,15.83
9841914,9969344,3546,1241100,11210444,12.45
9841915,9967487,5933,2076550,12044037,20.83
9841916,9979776,2921,1022350,11002126,10.24
9841917,9985392,4194,1467900,11453292,14.70
9841918,9987191,4693,1642550,11629741,16.45
9841919,9982839,4865,1702750,11685589,17.06
9841920,9971827,6001,2100350,12072177,21.06
9841921,9981539,3761,1316350,11297889,13.19
9841922,3176111,1433,501550,3677661,15.79
9841923,9990563,3810,1333500,11324063,13.35
9841924,9971492,4471,1564850,11536342,15.69
9841925,9987547,4089,1431150,11418697,14.33
9841926,9889646,3715,1300250,11189896,13.15
9841927,9979321,4829,1690150,11669471,16.94
9841928,9979685,4939,1728650,11708335,17.32
9841929,9992577,5362,1876700,11869277,18.78
9841930,9983413,4481,1568350,11551763,15.71
9841931,8463004,5245,1835750,10298754,21.69
9841932,9977072,6694,2342900,12319972,23.48
9841933,9996075,4209,1473150,11469225,14.74
9841934,9974963,6042,2114700,12089663,21.20
9841935,9983403,4468,1563800,11547203,15.66
9841936,9995529,4895,1713250,11708779,17.14
9841937,9989039,4268,1493800,11482839,14.95
9841938,840653,177,61950,902603,7.37
9841939,9975796,1810,633500,10609296,6.35
9841940,9988347,1992,697200,10685547,6.98
9841941,9993985,6310,2208500,12202485,22.10
9841943,9975915,4171,1459850,11435765,14.63
9841944,9699837,7654,2678900,12378737,27.62
9841945,9972271,5759,2015650,11987921,20.21
9841946,9973067,2520,882000,10855067,8.84
9841947,9088331,4514,1579900,10668231,17.38
9841948,4085580,2612,914200,4999780,22.38
9841949,5336374,1548,541800,5878174,10.15
9841950,9996038,2736,957600,10953638,9.58
9841951,9995069,3268,1143800,11138869,11.44
9841952,9999437,3152,1103200,11102637,11.03
9841953,9978793,4827,1689450,11668243,16.93
9841954,9984111,3523,1233050,11217161,12.35
9841955,9990837,3886,1360100,11350937,13.61
9841956,1700524,1105,386750,2087274,22.74
9841957,9972675,7120,2492000,12464675,24.99
9841958,3298798,1635,572250,3871048,17.35
9841959,9955455,2561,896350,10851805,9.00
9841960,9533130,3373,1180550,10713680,12.38
9841961,9954573,5572,1950200,11904773,19.59
9841962,464362,187,65450,529812,14.09
9841963,9946641,5219,1826650,11773291,18.36
9841964,9946163,4389,1536150,11482313,15.44
9841965,9951332,5598,1959300,11910632,19.69
9841966,2008575,620,217000,2225575,10.80
9841967,9931989,4832,1691200,11623189,17.03
9841968,9945367,4755,1664250,11609617,16.73
9841969,9860057,40,14000,9874057,0.14
9841970,9965411,2756,964600,10930011,9.68
9841972,9962025,5308,1857800,11819825,18.65
9841973,8967000,3320,1162000,10129000,12.96
9841974,9979766,5672,1985200,11964966,19.89
9841976,9984703,79,27650,10012353,0.28
9841977,9988508,44,15400,10003908,0.15
9841978,9965642,2747,961450,10927092,9.65
9841979,9978905,4806,1682100,11661005,16.86
9841980,9981410,4026,1409100,11390510,14.12
9841981,4037372,1991,696850,4734222,17.26
9841982,9982226,2631,920850,10903076,9.22
9841983,9982956,3170,1109500,11092456,11.11
9841984,9974170,5130,1795500,11769670,18.00
9841985,9983890,4578,1602300,11586190,16.05
9841986,5549272,2557,894950,6444222,16.13
9841987,3707327,2551,892850,4600177,24.08
9841988,8652300,2784,974400,9626700,11.26
9841989,9978251,3865,1352750,11331001,13.56
9841990,9983692,4687,1640450,11624142,16.43
9841991,9968366,3820,1337000,11305366,13.41
9841993,9956251,71,24850,9981101,0.25
9841994,9970181,5019,1756650,11726831,17.62
9841995,9336497,4179,1462650,10799147,15.67
9841996,1348188,575,201250,1549438,14.93
9841997,9992681,4320,1512000,11504681,15.13
9841998,9983940,4217,1475950,11459890,14.78
9841999,9980422,5374,1880900,11861322,18.85
9842000,9989410,4644,1625400,11614810,16.27
9842001,9989250,3782,1323700,11312950,13.25
9842002,2105661,780,273000,2378661,12.97
9842003,9988712,2784,974400,10963112,9.76
9842004,9980624,4620,1617000,11597624,16.20
9842005,9987142,4161,1456350,11443492,14.58
9842006,9975346,2641,924350,10899696,9.27
9842007,9983934,3590,1256500,11240434,12.59
9842008,9983874,2587,905450,10889324,9.07
9842009,9990408,4219,1476650,11467058,14.78
9842010,9978583,1837,642950,10621533,6.44
9842011,3945209,1788,625800,4571009,15.86
9842012,5268720,2130,745500,6014220,14.15
9842013,9979497,4851,1697850,11677347,17.01
9842014,5130984,1552,543200,5674184,10.59
9842015,9986309,3438,1203300,11189609,12.05
9842016,9997327,3390,1186500,11183827,11.87
9842017,9985729,5385,1884750,11870479,18.87
9842018,9996630,2641,924350,10920980,9.25
9842019,9975528,2939,1028650,11004178,10.31
9842020,2950949,156,54600,3005549,1.85
9842021,808866,239,83650,892516,10.34
9842022,9977113,4863,1702050,11679163,17.06
9842023,9991436,3783,1324050,11315486,13.25
9842024,9986788,2690,941500,10928288,9.43
9842027,9978031,4827,1689450,11667481,16.93
9842028,9990431,4095,1433250,11423681,14.35
9842029,1522106,94,32900,1555006,2.16
9842030,9849568,2264,792400,10641968,8.05
9842031,9980343,1845,645750,10626093,6.47
9842032,6708106,2512,879200,7587306,13.11
9842033,7893571,1627,569450,8463021,7.21
9842034,8585377,3132,1096200,9681577,12.77
9842035,3565152,1633,571550,4136702,16.03
9842036,9960121,4537,1587950,11548071,15.94
9842037,9979625,5200,1820000,11799625,18.24
9842038,9983751,3370,1179500,11163251,11.81
9842039,9986797,4970,1739500,11726297,17.42
9842040,9986339,3833,1341550,11327889,13.43
9842041,9974255,3383,1184050,11158305,11.87
9842042,8992871,4496,1573600,10566471,17.50
9842043,9987346,2364,827400,10814746,8.28
9842044,9988505,5068,1773800,11762305,17.76
9842045,9979399,3386,1185100,11164499,11.88
9842046,9984115,3819,1336650,11320765,13.39
9842047,9981240,3629,1270150,11251390,12.73
9842048,9981499,1485,519750,10501249,5.21
9842049,9976299,3493,1222550,11198849,12.25
9842050,2145169,745,260750,2405919,12.16
9842051,9983865,4411,1543850,11527715,15.46
9842052,9962478,3420,1197000,11159478,12.02
9842053,9955870,3096,1083600,11039470,10.88
9842054,9956663,4414,1544900,11501563,15.52
9842055,9964306,4316,1510600,11474906,15.16
9842056,9963397,5390,1886500,11849897,18.93
9842057,714477,318,111300,825777,15.58
9842058,9938144,3957,1384950,11323094,13.94
9842059,9949265,3780,1323000,11272265,13.30
9842060,9967419,3360,1176000,11143419,11.80
9842061,4736234,1042,364700,5100934,7.70
9842062,9969462,3654,1278900,11248362,12.83
9842063,998832,554,193900,1192732,19.41
9842064,9943543,5111,1788850,11732393,17.99
9842065,9947790,2030,710500,10658290,7.14
9842066,9945789,2908,1017800,10963589,10.23
9842067,9951195,4312,1509200,11460395,15.17
9842068,9954763,3979,1392650,11347413,13.99
9842069,9968893,4083,1429050,11397943,14.34
9842070,9974785,3748,1311800,11286585,13.15
9842071,9972651,4545,1590750,11563401,15.95
9842072,9978199,3219,1126650,11104849,11.29
9842074,9969763,3008,1052800,11022563,10.56
9842075,9989258,4538,1588300,11577558,15.90
9842076,7547221,824,288400,7835621,3.82
9842077,9984066,3453,1208550,11192616,12.10
9842078,9918640,2408,842800,10761440,8.50
9842079,847932,218,76300,924232,9.00
9842080,3228194,1522,532700,3760894,16.50
9842081,9989476,4193,1467550,11457026,14.69
9842082,3711285,1751,612850,4324135,16.51
9842083,9986442,4510,1578500,11564942,15.81
9842084,3554855,1162,406700,3961555,11.44
9842085,255745,151,52850,308595,20.67
9842086,9952705,5773,2020550,11973255,20.30
9842087,9875866,4037,1412950,11288816,14.31
9842088,6367464,3099,1084650,7452114,17.03
9842089,9957773,4892,1712200,11669973,17.19
9842090,9973091,4307,1507450,11480541,15.12
9842091,9980441,2896,1013600,10994041,10.16
9842092,9971095,6046,2116100,12087195,21.22
9842093,9985617,3885,1359750,11345367,13.62
9842094,232514,112,39200,271714,16.86
9842095,9978373,4840,1694000,11672373,16.98
9842098,9957981,2996,1048600,11006581,10.53
9842100,9943054,4901,1715350,11658404,17.25
9842101,8773185,2541,889350,9662535,10.14
9842102,9937002,4234,1481900,11418902,14.91
9842103,5232053,3786,1325100,6557153,25.33
9842104,9920121,4539,1588650,11508771,16.01
9842105,9919410,4984,1744400,11663810,17.59
9842106,9915195,5647,1976450,11891645,19.93
9842107,9934324,3682,1288700,11223024,12.97
9842108,9930828,4475,1566250,11497078,15.77
9842109,9932131,4487,1570450,11502581,15.81
9842110,9961560,2941,1029350,10990910,10.33
9842111,9958733,3945,1380750,11339483,13.86
9842112,9945266,3339,1168650,11113916,11.75
9842113,9947899,5385,1884750,11832649,18.95
9842114,9945251,2919,1021650,10966901,10.27
9842116,9968760,2184,764400,10733160,7.67
9842117,9969017,3782,1323700,11292717,13.28
9842118,9982803,5419,1896650,11879453,19.00
9842119,9996928,4629,1620150,11617078,16.21
9842120,9571187,3401,1190350,10761537,12.44
9842121,9431015,4388,1535800,10966815,16.28
9842122,9971875,4384,1534400,11506275,15.39
9842123,9969070,2734,956900,10925970,9.60
9842124,9984422,4614,1614900,11599322,16.17
9842125,9992508,3414,1194900,11187408,11.96
9842126,9986877,3291,1151850,11138727,11.53
9842127,9994338,3886,1360100,11354438,13.61
9842129,9987167,5308,1857800,11844967,18.60
9842130,9981525,4023,1408050,11389575,14.11
9842131,9995856,4085,1429750,11425606,14.30
9842132,9971541,4125,1443750,11415291,14.48
9842133,9983220,4226,1479100,11462320,14.82
9842134,9984206,3870,1354500,11338706,13.57
9842135,9997276,5145,1800750,11798026,18.01
9842136,9981093,3717,1300950,11282043,13.03
9842137,628486,347,121450,749936,19.32
9842139,9968650,3781,1323350,11292000,13.28
9842140,9963471,4563,1597050,11560521,16.03
9842141,9964237,3843,1345050,11309287,13.50
9842142,9963985,4468,1563800,11527785,15.69
9842143,9976339,3984,1394400,11370739,13.98
9842144,9980850,2171,759850,10740700,7.61
9842145,1063270,360,126000,1189270,11.85
9842146,9958487,5854,2048900,12007387,20.57
9842147,9953171,4939,1728650,11681821,17.37
9842148,9970994,2798,979300,10950294,9.82
9842149,9976000,3896,1363600,11339600,13.67
9842150,9981560,4710,1648500,11630060,16.52
9842151,9896268,4539,1588650,11484918,16.05
9842152,7497194,3931,1375850,8873044,18.35
9842153,4212025,2713,949550,5161575,22.54
9842154,9968512,3805,1331750,11300262,13.36
9842155,9976504,3472,1215200,11191704,12.18
9842156,9975697,4083,1429050,11404747,14.33
9842157,9983888,4771,1669850,11653738,16.73
9842158,9999907,3143,1100050,11099957,11.00
9842159,9971130,5987,2095450,12066580,21.02
9842160,1699046,1475,516250,2215296,30.38
9842161,1085040,671,234850,1319890,21.64
9842162,9964020,6729,2355150,12319170,23.64
9842163,8844538,3340,1169000,10013538,13.22
9842164,9837980,4874,1705900,11543880,17.34
9842165,9867351,4870,1704500,11571851,17.27
9842166,9981800,3573,1250550,11232350,12.53
9842167,9981990,4459,1560650,11542640,15.63
9842168,9997306,5345,1870750,11868056,18.71
9842169,9981396,5976,2091600,12072996,20.95
9842170,9981913,6755,2364250,12346163,23.69
9842171,9959022,5949,2082150,12041172,20.91
9842172,9605859,4881,1708350,11314209,17.78
9842173,9982499,4625,1618750,11601249,16.22
9842174,9981815,4671,1634850,11616665,16.38
9842175,9989259,4640,1624000,11613259,16.26
9842176,9824124,6008,2102800,11926924,21.40
9842177,9982582,4281,1498350,11480932,15.01
9842178,9993106,5203,1821050,11814156,18.22
9842179,9992074,5163,1807050,11799124,18.08
9842180,9996756,4562,1596700,11593456,15.97
9842181,9962934,3871,1354850,11317784,13.60
9842182,4207672,3756,1314600,5522272,31.24
9842183,9978754,4797,1678950,11657704,16.83
9842184,9982759,3827,1339450,11322209,13.42
9842185,9986875,5397,1888950,11875825,18.91
9842186,391231,292,102200,493431,26.12
9842187,9320026,4511,1578850,10898876,16.94
9842189,9951414,4173,1460550,11411964,14.68
9842190,4537697,1777,621950,5159647,13.71
9842191,9934519,4265,1492750,11427269,15.03
9842192,9946103,3944,1380400,11326503,13.88
9842193,9935675,5496,1923600,11859275,19.36
9842194,2786752,897,313950,3100702,11.27
9842195,9941475,4005,1401750,11343225,14.10
9842196,9965980,3158,1105300,11071280,11.09
9842197,9968085,5125,1793750,11761835,17.99
9842198,9952106,5474,1915900,11868006,19.25
9842199,9956370,4870,1704500,11660870,17.12
9842200,9970075,5114,1789900,11759975,17.95
9842201,9964971,5491,1921850,11886821,19.29
9842202,9989495,5999,2099650,12089145,21.02
9842203,5610304,1601,560350,6170654,9.99
9842204,9992109,3974,1390900,11383009,13.92
9842205,4761554,2386,835100,5596654,17.54
9842206,9984361,3513,1229550,11213911,12.31
9842207,9970679,6035,2112250,12082929,21.18
9842208,9985004,4601,1610350,11595354,16.13
9842209,9995161,4929,1725150,11720311,17.26
9842210,9987696,7154,2503900,12491596,25.07
9842211,9971483,8094,2832900,12804383,28.41
9842212,9951643,2643,925050,10876693,9.30
9842213,2307431,1475,516250,2823681,22.37
9842214,9973821,6717,2350950,12324771,23.57
9842215,9965268,3462,1211700,11176968,12.16
9842216,5027837,2943,1030050,6057887,20.49
9842217,9945010,4710,1648500,11593510,16.58
9842218,9933534,5460,1911000,11844534,19.24
9842219,9941149,4839,1693650,11634799,17.04
9842220,9940921,5924,2073400,12014321,20.86
9842221,9933730,4243,1485050,11418780,14.95
9842222,9956740,4648,1626800,11583540,16.34
9842223,9952178,4973,1740550,11692728,17.49
9842224,9966571,5455,1909250,11875821,19.16
9842225,9973301,6481,2268350,12241651,22.74
9842226,9968109,4964,1737400,11705509,17.43
9842227,994913,231,80850,1075763,8.13
9842228,9899857,4939,1728650,11628507,17.46
9842229,9977525,4802,1680700,11658225,16.84
9842230,9978164,2286,800100,10778264,8.02
9842231,9979970,4728,1654800,11634770,16.58
9842232,4100809,1614,564900,4665709,13.78
9842233,9948534,4318,1511300,11459834,15.19
9842234,2355071,1226,429100,2784171,18.22
9842235,2484309,1484,519400,3003709,20.91
9842236,9972936,6230,2180500,12153436,21.86
9842237,9984864,6414,2244900,12229764,22.48
9842238,9984004,6882,2408700,12392704,24.13
9842239,9831357,7253,2538550,12369907,25.82
9842240,3032007,2428,849800,3881807,28.03
9842241,9992828,8695,3043250,13036078,30.45
9842242,9993295,5673,1985550,11978845,19.87
9842244,9973063,5675,1986250,11959313,19.92
9842245,9978473,5593,1957550,11936023,19.62
9842246,9979240,4389,1536150,11515390,15.39
9842247,9987099,6782,2373700,12360799,23.77
9842248,9982152,4356,1524600,11506752,15.27
9842249,9980125,4678,1637300,11617425,16.41
9842250,9988416,4452,1558200,11546616,15.60
9842251,9987787,4308,1507800,11495587,15.10
9842252,9992310,4873,1705550,11697860,17.07
9842253,9990142,3552,1243200,11233342,12.44
9842254,9980209,4811,1683850,11664059,16.87
9842255,9988486,4283,1499050,11487536,15.01
9842257,9875369,5281,1848350,11723719,18.72
9842258,9975129,4154,1453900,11429029,14.58
9842259,9969751,4532,1586200,11555951,15.91
9842260,9976968,5425,1898750,11875718,19.03
9842261,9620278,4041,1414350,11034628,14.70
9842262,9954828,6323,2213050,12167878,22.23
9842264,9973898,4205,1471750,11445648,14.76
9842265,9815287,4629,1620150,11435437,16.51
9842266,9977958,5467,1913450,11891408,19.18
9842267,9952876,4406,1542100,11494976,15.49
9842268,9974586,6619,2316650,12291236,23.23
9842269,9970516,4735,1657250,11627766,16.62
9842270,9969862,3038,1063300,11033162,10.67
9842271,9993469,3913,1369550,11363019,13.70
9842272,9995597,3779,1322650,11318247,13.23
9842273,9975757,3821,1337350,11313107,13.41
9842274,9979183,4091,1431850,11411033,14.35
9842275,9966607,3430,1200500,11167107,12.05
9842276,9965752,5738,2008300,11974052,20.15
9842277,910092,630,220500,1130592,24.23
9842278,9943986,4510,1578500,11522486,15.87
9842279,9952485,5853,2048550,12001035,20.58
9842280,9967572,4670,1634500,11602072,16.40
9842282,9940022,5072,1775200,11715222,17.86
9842283,9958449,5953,2083550,12041999,20.92
9842284,9949159,4499,1574650,11523809,15.83
9842285,9951264,5532,1936200,11887464,19.46
9842286,9962647,3938,1378300,11340947,13.83
9842287,9947993,4768,1668800,11616793,16.78
9842288,9955578,4774,1670900,11626478,16.78
9842289,9976377,5416,1895600,11871977,19.00
9842290,8884893,4162,1456700,10341593,16.40
9842291,9974810,5269,1844150,11818960,18.49
9842292,9972701,5297,1853950,11826651,18.59
9842293,9971175,4474,1565900,11537075,15.70
9842294,9958761,3646,1276100,11234861,12.81
9842295,9968827,4557,1594950,11563777,16.00
9842296,9953973,5812,2034200,11988173,20.44
9842297,9960544,4479,1567650,11528194,15.74
9842298,9941301,5583,1954050,11895351,19.66
9842299,9960570,5495,1923250,11883820,19.31
9842300,9966636,3660,1281000,11247636,12.85
9842301,9962709,6188,2165800,12128509,21.74
9842302,9975104,4631,1620850,11595954,16.25
9842303,8333028,3496,1223600,9556628,14.68
9842305,9962646,5288,1850800,11813446,18.58
9842306,9992269,5445,1905750,11898019,19.07
9842307,9979926,5709,1998150,11978076,20.02
9842308,9999127,5967,2088450,12087577,20.89
9842309,9988698,5686,1990100,11978798,19.92
9842310,9995386,7544,2640400,12635786,26.42
9842311,9990056,3520,1232000,11222056,12.33
9842312,9944104,6018,2106300,12050404,21.18
9842313,9929467,7978,2792300,12721767,28.12
9842314,9958564,4752,1663200,11621764,16.70
9842316,9916269,3130,1095500,11011769,11.05
9842317,9955411,3516,1230600,11186011,12.36
9842318,9945003,5842,2044700,11989703,20.56
9842319,9958308,5431,1900850,11859158,19.09
9842320,9933781,3341,1169350,11103131,11.77
9842321,9943677,5918,2071300,12014977,20.83
9842322,9930726,6295,2203250,12133976,22.19
9842323,9940276,7099,2484650,12424926,25.00
9842324,9917384,5223,1828050,11745434,18.43
9842325,9945604,5185,1814750,11760354,18.25
9842326,9928963,3389,1186150,11115113,11.95
9842327,9935732,4487,1570450,11506182,15.81
9842328,6959922,3241,1134350,8094272,16.30
9842329,9960680,3248,1136800,11097480,11.41
9842330,9948290,7586,2655100,12603390,26.69
9842331,5760863,904,316400,6077263,5.49
9842332,9917244,3850,1347500,11264744,13.59
9842333,9919894,4925,1723750,11643644,17.38
9842334,9911675,4213,1474550,11386225,14.88
9842335,9929407,6305,2206750,12136157,22.22
9842336,9933448,3652,1278200,11211648,12.87
9842337,9938021,5067,1773450,11711471,17.85
9842338,9937592,6001,2100350,12037942,21.14
9842339,9947944,5265,1842750,11790694,18.52
9842340,9924123,3931,1375850,11299973,13.86
9842341,9914910,5385,1884750,11799660,19.01
9842342,9914298,5694,1992900,11907198,20.10
9842343,9900914,4190,1466500,11367414,14.81
9842344,9895927,6470,2264500,12160427,22.88
9842345,4882546,1599,559650,5442196,11.46
9842346,9872044,6165,2157750,12029794,21.86
9842347,4255978,445,155750,4411728,3.66
9842348,9889382,3240,1134000,11023382,11.47
9842349,9868146,6994,2447900,12316046,24.81
9842350,8697943,2928,1024800,9722743,11.78
9842351,9841050,6326,2214100,12055150,22.50
9842352,9849050,4573,1600550,11449600,16.25
9842353,9846148,3890,1361500,11207648,13.83
9842354,9851531,3254,1138900,10990431,11.56
9842355,9868059,3892,1362200,11230259,13.80
9842356,9867420,5031,1760850,11628270,17.85
9842357,9875163,3880,1358000,11233163,13.75
9842358,9893982,2759,965650,10859632,9.76
9842359,9881297,3260,1141000,11022297,11.55
9842360,9869855,3773,1320550,11190405,13.38
9842361,9880379,5320,1862000,11742379,18.85
9842362,9892972,3231,1130850,11023822,11.43
9842363,9886525,3925,1373750,11260275,13.90
9842364,9873476,4301,1505350,11378826,15.25
9842365,9837597,4825,1688750,11526347,17.17
9842366,9889260,4748,1661800,11551060,16.80
9842367,9906387,4502,1575700,11482087,15.91
9842368,9900913,2362,826700,10727613,8.35
9842369,9901364,4355,1524250,11425614,15.39
9842370,3101109,1182,413700,3514809,13.34
9842371,9284652,4877,1706950,10991602,18.38
9842372,9886749,5584,1954400,11841149,19.77
9842373,4803666,992,347200,5150866,7.23
9842374,9875169,5380,1883000,11758169,19.07
9842375,8292284,3557,1244950,9537234,15.01
9842376,9882419,5832,2041200,11923619,20.65
9842377,9804511,4361,1526350,11330861,15.57
9842378,9883050,2720,952000,10835050,9.63
9842379,9890651,4566,1598100,11488751,16.16
9842380,9863833,5281,1848350,11712183,18.74
9842381,9899763,4325,1513750,11413513,15.29
9842382,9914699,5214,1824900,11739599,18.41
9842383,4339147,3492,1222200,5561347,28.17
9842384,9911957,5141,1799350,11711307,18.15
9842385,9931755,4802,1680700,11612455,16.92
9842386,9929658,5019,1756650,11686308,17.69
9842387,9935768,5713,1999550,11935318,20.12
9842388,9924463,5460,1911000,11835463,19.26
9842389,9920531,4826,1689100,11609631,17.03
9842390,9931239,3608,1262800,11194039,12.72
9842391,9914408,5783,2024050,11938458,20.42
9842392,9912289,4876,1706600,11618889,17.22
9842393,9910958,5642,1974700,11885658,19.92
9842394,9918700,4091,1431850,11350550,14.44
9842395,2924970,816,285600,3210570,9.76
9842396,8933532,3502,1225700,10159232,13.72
9842397,608898,189,66150,675048,10.86
9842398,9938069,4520,1582000,11520069,15.92
9842399,9937044,4503,1576050,11513094,15.86
9842400,9956106,5656,1979600,11935706,19.88
9842401,1259030,1247,436450,1695480,34.67
9842402,9930794,4793,1677550,11608344,16.89
9842403,9940029,5542,1939700,11879729,19.51
9842404,9946911,5793,2027550,11974461,20.38
9842405,9945411,4781,1673350,11618761,16.83
9842406,1890864,628,219800,2110664,11.62
9842407,9928681,4754,1663900,11592581,16.76
9842408,9946605,5393,1887550,11834155,18.98
9842409,9935578,3453,1208550,11144128,12.16
9842410,9943182,6093,2132550,12075732,21.45
9842411,9494653,4707,1647450,11142103,17.35
9842412,9928941,4253,1488550,11417491,14.99
9842413,9949582,4211,1473850,11423432,14.81
9842414,9939064,6245,2185750,12124814,21.99
9842415,9933416,3959,1385650,11319066,13.95
9842416,9947477,3387,1185450,11132927,11.92
9842417,4309437,1590,556500,4865937,12.91
9842418,9507036,5973,2090550,11597586,21.99
9842419,6491319,2685,939750,7431069,14.48
9842420,9977525,6141,2149350,12126875,21.54
9842421,9986865,5847,2046450,12033315,20.49
9842422,9968774,3140,1099000,11067774,11.02
9842423,7511634,2613,914550,8426184,12.18
9842424,9977413,5489,1921150,11898563,19.25
9842425,909749,387,135450,1045199,14.89
9842426,2690644,1010,353500,3044144,13.14
9842427,9962319,2677,936950,10899269,9.40
9842428,9952881,2012,704200,10657081,7.08
9842429,4556731,2301,805350,5362081,17.67
9842430,9959541,2720,952000,10911541,9.56
9842431,9966607,6319,2211650,12178257,22.19
9842432,9984103,4685,1639750,11623853,16.42
9842433,9989422,5137,1797950,11787372,18.00
9842434,9983267,6428,2249800,12233067,22.54
9842435,9989586,6316,2210600,12200186,22.13
9842436,9979191,3984,1394400,11373591,13.97
9842437,9979114,2424,848400,10827514,8.50
9842439,9986301,4542,1589700,11576001,15.92
9842440,9975324,5395,1888250,11863574,18.93
9842442,9980221,3563,1247050,11227271,12.50
9842443,9981041,3729,1305150,11286191,13.08
9842444,9481808,5624,1968400,11450208,20.76
9842445,9989713,5437,1902950,11892663,19.05
9842446,9996786,4032,1411200,11407986,14.12
9842447,8873736,4691,1641850,10515586,18.50
9842448,9983974,5375,1881250,11865224,18.84
9842449,9975919,5219,1826650,11802569,18.31
9842450,9944364,5953,2083550,12027914,20.95
9842452,9912880,7633,2671550,12584430,26.95
9842453,9987329,5187,1815450,11802779,18.18
9842454,9981741,5145,1800750,11782491,18.04
9842455,9999526,7194,2517900,12517426,25.18
9842456,4854112,1020,357000,5211112,7.35
9842457,9993699,6165,2157750,12151449,21.59
9842458,9989491,6585,2304750,12294241,23.07
9842459,9971279,4479,1567650,11538929,15.72
9842460,9990090,4834,1691900,11681990,16.94
9842461,9979544,6205,2171750,12151294,21.76
9842462,9978360,3652,1278200,11256560,12.81
9842463,7972359,5914,2069900,10042259,25.96
9842464,8106974,6108,2137800,10244774,26.37
9842465,9979362,6299,2204650,12184012,22.09
9842466,9974838,6844,2395400,12370238,24.01
9842467,9983085,7113,2489550,12472635,24.94
9842468,9983720,4629,1620150,11603870,16.23
9842469,9983932,3432,1201200,11185132,12.03
9842470,9994160,5900,2065000,12059160,20.66
9842471,9980734,6301,2205350,12186084,22.10
9842472,9977317,6021,2107350,12084667,21.12
9842473,9978453,2860,1001000,10979453,10.03
9842474,9976474,3620,1267000,11243474,12.70
9842475,1291538,651,227850,1519388,17.64
9842476,9974647,2798,979300,10953947,9.82
9842477,9990978,3868,1353800,11344778,13.55
9842478,9971698,4649,1627150,11598848,16.32
9842479,9959841,4066,1423100,11382941,14.29
9842480,6745672,4437,1552950,8298622,23.02
9842481,3336963,2191,766850,4103813,22.98
9842482,9957521,4322,1512700,11470221,15.19
9842483,9966594,3119,1091650,11058244,10.95
9842484,481982,360,126000,607982,26.14
9842485,9965447,3171,1109850,11075297,11.14
9842486,9952303,4127,1444450,11396753,14.51
9842487,9952448,4736,1657600,11610048,16.66
9842488,6195605,4271,1494850,7690455,24.13
9842489,2278883,1630,570500,2849383,25.03
9842490,9954484,3814,1334900,11289384,13.41
9842491,1357111,1150,402500,1759611,29.66
9842492,8266013,3711,1298850,9564863,15.71
9842493,9959265,5598,1959300,11918565,19.67
9842494,9945236,4077,1426950,11372186,14.35
9842495,9928390,2497,873950,10802340,8.80
9842496,9914869,4129,1445150,11360019,14.58
9842497,9913280,4040,1414000,11327280,14.26
9842498,9923820,2221,777350,10701170,7.83
9842499,9842651,2773,970550,10813201,9.86
9842501,9930724,3980,1393000,11323724,14.03
9842502,9864981,3200,1120000,10984981,11.35
9842503,9954435,5578,1952300,11906735,19.61
9842504,2811436,1516,530600,3342036,18.87
9842505,9949552,4321,1512350,11461902,15.20
9842506,9954314,853,298550,10252864,3.00
9842507,2174300,1147,401450,2575750,18.46
9842508,9979925,5131,1795850,11775775,17.99
9842509,9976550,4162,1456700,11433250,14.60
9842510,9983365,4744,1660400,11643765,16.63
9842511,9988266,2476,866600,10854866,8.68
9842512,9993148,4692,1642200,11635348,16.43
9842513,9980800,4768,1668800,11649600,16.72
9842514,9979573,2628,919800,10899373,9.22
9842515,9564479,3128,1094800,10659279,11.45
9842516,9992311,4224,1478400,11470711,14.80
9842517,9993760,2202,770700,10764460,7.71
9842518,1753894,752,263200,2017094,15.01
9842519,9959622,3820,1337000,11296622,13.42
9842520,9966072,4129,1445150,11411222,14.50
9842521,9987691,3218,1126300,11113991,11.28
9842522,9987935,3555,1244250,11232185,12.46
9842523,675038,244,85400,760438,12.65
9842524,9973315,2786,975100,10948415,9.78
9842525,9971248,3529,1235150,11206398,12.39
9842526,9198715,3990,1396500,10595215,15.18
9842527,9957279,4738,1658300,11615579,16.65
9842528,375480,102,35700,411180,9.51
9842529,9971618,1616,565600,10537218,5.67
9842530,9958437,4038,1413300,11371737,14.19
9842531,9963768,6564,2297400,12261168,23.06
9842532,9967167,2840,994000,10961167,9.97
9842533,9986611,3003,1051050,11037661,10.52
9842534,9999642,4661,1631350,11630992,16.31
9842535,9984279,3813,1334550,11318829,13.37
9842536,9989743,5171,1809850,11799593,18.12
9842537,9994430,4060,1421000,11415430,14.22
9842538,9998690,5549,1942150,11940840,19.42
9842539,1469798,1531,535850,2005648,36.46
9842540,9966088,4239,1483650,11449738,14.89
9842541,9972795,2704,946400,10919195,9.49
9842542,9946325,6627,2319450,12265775,23.32
9842543,9899244,4133,1446550,11345794,14.61
9842544,9948222,4879,1707650,11655872,17.17
9842545,4597951,4294,1502900,6100851,32.69
9842546,9943212,5141,1799350,11742562,18.10
9842547,9960653,7510,2628500,12589153,26.39
9842548,9956264,6007,2102450,12058714,21.12
9842549,9959550,4803,1681050,11640600,16.88
9842550,9953430,5848,2046800,12000230,20.56
9842551,9965878,6034,2111900,12077778,21.19
9842552,9961546,3446,1206100,11167646,12.11
9842553,9959685,3548,1241800,11201485,12.47
9842554,9973465,6051,2117850,12091315,21.23
9842555,9969911,5788,2025800,11995711,20.32
9842556,9985176,6139,2148650,12133826,21.52
9842557,9984101,4482,1568700,11552801,15.71
9842558,9986705,4310,1508500,11495205,15.11
9842559,9992051,4591,1606850,11598901,16.08
9842560,9993173,5545,1940750,11933923,19.42
9842561,9993627,3706,1297100,11290727,12.98
9842562,9989805,6115,2140250,12130055,21.42
9842563,9981503,4744,1660400,11641903,16.63
9842564,9988435,3417,1195950,11184385,11.97
9842565,9993418,3869,1354150,11347568,13.55
9842566,9988156,3386,1185100,11173256,11.87
9842567,9982925,5368,1878800,11861725,18.82
9842568,9988464,4132,1446200,11434664,14.48
9842569,9985708,4154,1453900,11439608,14.56
9842570,9984895,3221,1127350,11112245,11.29
9842571,9989516,5148,1801800,11791316,18.04
9842572,9982675,5002,1750700,11733375,17.54
9842573,9981480,4878,1707300,11688780,17.10
9842574,9992526,7484,2619400,12611926,26.21
9842575,9979255,6790,2376500,12355755,23.81
9842576,9985474,5615,1965250,11950724,19.68
9842577,9964739,8130,2845500,12810239,28.56
9842578,9975719,4992,1747200,11722919,17.51
9842579,9982746,4544,1590400,11573146,15.93
9842580,9988987,4717,1650950,11639937,16.53
9842581,7257555,2294,802900,8060455,11.06
9842582,863482,449,157150,1020632,18.20
9842583,1412477,850,297500,1709977,21.06
9842584,9977121,3145,1100750,11077871,11.03
9842585,9990221,3919,1371650,11361871,13.73
9842586,9959651,4030,1410500,11370151,14.16
9842587,9938736,5126,1794100,11732836,18.05
9842588,9999606,6509,2278150,12277756,22.78
9842589,9985364,4272,1495200,11480564,14.97
9842590,9992238,5119,1791650,11783888,17.93
9842591,9990401,6398,2239300,12229701,22.41
9842592,6672236,2139,748650,7420886,11.22
9842593,1906173,1505,526750,2432923,27.63
9842594,9964653,7395,2588250,12552903,25.97
9842595,9932170,5869,2054150,11986320,20.68
9842596,9962660,4438,1553300,11515960,15.59
9842597,9978138,4237,1482950,11461088,14.86
9842598,7842281,3576,1251600,9093881,15.96
9842599,9948303,5832,2041200,11989503,20.52
9842600,6594451,4743,1660050,8254501,25.17
9842601,9982559,4852,1698200,11680759,17.01
9842602,9978964,3715,1300250,11279214,13.03
9842603,8983075,4658,1630300,10613375,18.15
9842604,9993111,6467,2263450,12256561,22.65
9842605,9996837,5592,1957200,11954037,19.58
9842606,9981734,3761,1316350,11298084,13.19
9842607,9959688,5517,1930950,11890638,19.39
9842608,5772785,1653,578550,6351335,10.02
9842609,9971375,4174,1460900,11432275,14.65
9842610,9987258,5130,1795500,11782758,17.98
9842611,1545356,1261,441350,1986706,28.56
9842612,9983542,3827,1339450,11322992,13.42
9842613,9974316,3982,1393700,11368016,13.97
9842614,9987907,3559,1245650,11233557,12.47
9842615,9976613,4130,1445500,11422113,14.49
9842616,9988076,4344,1520400,11508476,15.22
9842617,9982810,3275,1146250,11129060,11.48
9842618,9979961,3537,1237950,11217911,12.40
9842619,9992741,6977,2441950,12434691,24.44
9842620,9995368,4046,1416100,11411468,14.17
9842621,7930530,5230,1830500,9761030,23.08
9842622,9980441,3873,1355550,11335991,13.58
9842623,4256212,1725,603750,4859962,14.19
9842624,9980521,5279,1847650,11828171,18.51
9842625,9990314,4365,1527750,11518064,15.29
9842626,9982261,3556,1244600,11226861,12.47
9842627,9965821,2687,940450,10906271,9.44
9842628,9965364,5099,1784650,11750014,17.91
9842629,9977277,3946,1381100,11358377,13.84
9842630,9984277,3815,1335250,11319527,13.37
9842631,9999912,4535,1587250,11587162,15.87
9842632,9987372,5362,1876700,11864072,18.79
9842633,9975701,4068,1423800,11399501,14.27
9842634,9988802,4995,1748250,11737052,17.50
9842635,9964287,2186,765100,10729387,7.68
9842636,5728262,2002,700700,6428962,12.23
9842637,9968097,3458,1210300,11178397,12.14
9842638,9970390,5028,1759800,11730190,17.65
9842639,9959943,3522,1232700,11192643,12.38
9842640,9976115,4829,1690150,11666265,16.94
9842641,9949489,3210,1123500,11072989,11.29
9842642,6624868,4426,1549100,8173968,23.38
9842643,9958353,2904,1016400,10974753,10.21
9842644,9980555,1908,667800,10648355,6.69
9842645,9989157,3624,1268400,11257557,12.70
9842646,9985419,3973,1390550,11375969,13.93
9842647,9987997,5146,1801100,11789097,18.03
9842648,9969620,5252,1838200,11807820,18.44
9842649,9973370,3632,1271200,11244570,12.75
9842650,8505602,4016,1405600,9911202,16.53
9842651,9982857,5451,1907850,11890707,19.11
9842652,2449330,1539,538650,2987980,21.99
9842653,9980928,4494,1572900,11553828,15.76
9842654,8178193,2816,985600,9163793,12.05
9842655,9974833,4391,1536850,11511683,15.41
9842656,9977948,4645,1625750,11603698,16.29
9842657,9990751,2725,953750,10944501,9.55
9842658,9982358,3904,1366400,11348758,13.69
9842659,6834573,5133,1796550,8631123,26.29
9842661,9999460,5330,1865500,11864960,18.66
9842662,7497700,4190,1466500,8964200,19.56
9842663,9967027,4290,1501500,11468527,15.06
9842664,9991960,5034,1761900,11753860,17.63
9842665,9989100,4333,1516550,11505650,15.18
9842666,9989532,3011,1053850,11043382,10.55
9842667,9996053,4244,1485400,11481453,14.86
9842668,9979254,5916,2070600,12049854,20.75
9842669,9990215,5628,1969800,11960015,19.72
9842670,9970588,4373,1530550,11501138,15.35
9842671,9697786,5341,1869350,11567136,19.28
9842672,9984318,2288,800800,10785118,8.02
9842673,9998684,4624,1618400,11617084,16.19
9842674,9999377,3805,1331750,11331127,13.32
9842675,9999682,4220,1477000,11476682,14.77
9842676,9990230,4117,1440950,11431180,14.42
9842677,9998215,7464,2612400,12610615,26.13
9842678,9999551,3821,1337350,11336901,13.37
9842679,9998616,6022,2107700,12106316,21.08
9842680,9984177,4963,1737050,11721227,17.40
9842681,9992699,5659,1980650,11973349,19.82
9842682,9980774,6164,2157400,12138174,21.62
9842683,9954632,4706,1647100,11601732,16.55
9842684,8970778,5314,1859900,10830678,20.73
9842685,9951974,5271,1844850,11796824,18.54
9842686,9977923,4022,1407700,11385623,14.11
9842687,9961114,3850,1347500,11308614,13.53
9842688,9993256,4061,1421350,11414606,14.22
9842689,9981704,5391,1886850,11868554,18.90
9842690,9975844,7215,2525250,12501094,25.31
9842691,9981745,3703,1296050,11277795,12.98
9842692,9986285,4452,1558200,11544485,15.60
9842693,9978515,4548,1591800,11570315,15.95
9842694,9974110,4562,1596700,11570810,16.01
9842695,9985908,4138,1448300,11434208,14.50
9842696,9974504,4339,1518650,11493154,15.23
9842697,9977416,5884,2059400,12036816,20.64
9842698,9975904,5322,1862700,11838604,18.67
9842699,9987639,3165,1107750,11095389,11.09
9842700,9994187,3688,1290800,11284987,12.92
9842701,9975142,5173,1810550,11785692,18.15
9842702,9988469,2882,1008700,10997169,10.10
9842703,9994817,5445,1905750,11900567,19.07
9842704,9979798,4206,1472100,11451898,14.75
9842705,9970090,3272,1145200,11115290,11.49
9842706,9984615,2623,918050,10902665,9.19
9842708,9974661,3875,1356250,11330911,13.60
9842709,9973077,6409,2243150,12216227,22.49
9842710,9959725,3793,1327550,11287275,13.33
9842711,9960989,4070,1424500,11385489,14.30
9842712,9987600,3313,1159550,11147150,11.61
9842713,3542468,465,162750,3705218,4.59
9842714,9987013,3579,1252650,11239663,12.54
9842715,9992635,4764,1667400,11660035,16.69
9842716,9995909,3643,1275050,11270959,12.76
9842717,9895192,3214,1124900,11020092,11.37
9842718,9958566,6735,2357250,12315816,23.67
9842719,9978972,5610,1963500,11942472,19.68
9842720,9971146,6284,2199400,12170546,22.06
9842721,9972728,5637,1972950,11945678,19.78
9842722,9966309,3831,1340850,11307159,13.45
9842723,9972389,5240,1834000,11806389,18.39
9842724,9973496,3115,1090250,11063746,10.93
9842725,9974586,5004,1751400,11725986,17.56
9842726,9988171,3784,1324400,11312571,13.26
9842727,9995242,3679,1287650,11282892,12.88
9842728,9979019,3216,1125600,11104619,11.28
9842729,9971828,4757,1664950,11636778,16.70
9842730,9992558,2672,935200,10927758,9.36
9842731,9988231,5537,1937950,11926181,19.40
9842732,9986145,5054,1768900,11755045,17.71
9842734,9987520,6807,2382450,12369970,23.85
9842735,9971082,4688,1640800,11611882,16.46
9842736,9988503,5328,1864800,11853303,18.67
9842737,9975166,6185,2164750,12139916,21.70
9842738,9969787,2356,824600,10794387,8.27
9842739,9953538,2324,813400,10766938,8.17
9842740,9952030,3703,1296050,11248080,13.02
9842741,9963957,6697,2343950,12307907,23.52
9842742,9967487,4407,1542450,11509937,15.47
9842743,9988251,5227,1829450,11817701,18.32
9842744,9988681,3584,1254400,11243081,12.56
9842745,9487869,4482,1568700,11056569,16.53
9842746,9969505,3944,1380400,11349905,13.85
9842747,9968506,6474,2265900,12234406,22.73
9842748,9975424,6428,2249800,12225224,22.55
9842749,9985747,5459,1910650,11896397,19.13
9842750,9992088,5050,1767500,11759588,17.69
9842751,9985502,3823,1338050,11323552,13.40
9842752,1111360,1107,387450,1498810,34.86
9842753,1914899,1136,397600,2312499,20.76
9842754,9953844,5386,1885100,11838944,18.94
9842755,9937059,2837,992950,10930009,9.99
9842756,9931895,4129,1445150,11377045,14.55
9842757,9947632,5463,1912050,11859682,19.22
9842758,9934229,3615,1265250,11199479,12.74
9842759,2385453,466,163100,2548553,6.84
9842761,9953957,4578,1602300,11556257,16.10
9842762,9958727,3678,1287300,11246027,12.93
9842763,3885586,1697,593950,4479536,15.29
9842764,3511434,814,284900,3796334,8.11
9842765,9964315,6959,2435650,12399965,24.44
9842766,9980709,4025,1408750,11389459,14.11
9842767,9992339,4999,1749650,11741989,17.51
9842768,9993888,4783,1674050,11667938,16.75
9842769,9972032,5018,1756300,11728332,17.61
9842770,9989375,4437,1552950,11542325,15.55
9842771,9983041,3621,1267350,11250391,12.70
9842772,9989677,4234,1481900,11471577,14.83
9842773,9989225,2781,973350,10962575,9.74
9842774,9753574,3311,1158850,10912424,11.88
9842775,9864098,5640,1974000,11838098,20.01
9842776,9998491,3388,1185800,11184291,11.86
9842777,9986170,3823,1338050,11324220,13.40
9842778,9973667,3333,1166550,11140217,11.70
9842779,9985151,2881,1008350,10993501,10.10
9842780,9987530,2355,824250,10811780,8.25
9842781,9980110,5910,2068500,12048610,20.73
9842782,9984188,3386,1185100,11169288,11.87
9842783,9995432,2898,1014300,11009732,10.15
9842784,9989380,3419,1196650,11186030,11.98
9842785,9991401,4325,1513750,11505151,15.15
9842786,9989205,4819,1686650,11675855,16.88
9842787,2984653,3945,1380750,4365403,46.26
9842788,9976922,5460,1911000,11887922,19.15
9842789,9981317,3974,1390900,11372217,13.94
9842790,9982371,3738,1308300,11290671,13.11
9842791,9995549,4058,1420300,11415849,14.21
9842792,9970914,8154,2853900,12824814,28.62
9842793,9792640,4232,1481200,11273840,15.13
9842794,9982380,2893,1012550,10994930,10.14
9842795,9970946,3047,1066450,11037396,10.70
9842796,9949851,3430,1200500,11150351,12.07
9842797,9951136,4063,1422050,11373186,14.29
9842798,9971519,5097,1783950,11755469,17.89
9842799,9970593,3730,1305500,11276093,13.09
9842800,9977971,4226,1479100,11457071,14.82
9842801,9376021,2658,930300,10306321,9.92
9842802,9940697,5317,1860950,11801647,18.72
9842803,9957525,4870,1704500,11662025,17.12
9842804,9966791,4532,1586200,11552991,15.91
9842805,9970328,5094,1782900,11753228,17.88
9842806,9967509,5780,2023000,11990509,20.30
9842807,9968975,4713,1649550,11618525,16.55
9842808,9988478,5228,1829800,11818278,18.32
9842809,9993263,5169,1809150,11802413,18.10
9842810,9984821,3284,1149400,11134221,11.51
9842811,9978771,2638,923300,10902071,9.25
9842812,9998305,4371,1529850,11528155,15.30
9842813,9989014,3233,1131550,11120564,11.33
9842814,9973244,5480,1918000,11891244,19.23
9842815,9976098,3132,1096200,11072298,10.99
9842816,9976023,3034,1061900,11037923,10.64
9842817,9977829,4694,1642900,11620729,16.47
9842818,9974483,2921,1022350,10996833,10.25
9842819,9991948,5204,1821400,11813348,18.23
9842820,9993219,5855,2049250,12042469,20.51
9842821,9969280,5451,1907850,11877130,19.14
9842822,9966498,2462,861700,10828198,8.65
9842823,9969180,5172,1810200,11779380,18.16
9842824,9984521,2544,890400,10874921,8.92
9842825,9984573,5163,1807050,11791623,18.10
9842826,9986213,4481,1568350,11554563,15.71
9842827,9989040,5719,2001650,11990690,20.04
9842828,9986034,9065,3172750,13158784,31.77
9842829,9979151,3264,1142400,11121551,11.45
9842830,9949980,2585,904750,10854730,9.09
9842831,9979704,3429,1200150,11179854,12.03
9842832,9978225,6550,2292500,12270725,22.98
9842833,5995299,4508,1577800,7573099,26.32
9842834,9983814,5183,1814050,11797864,18.17
9842835,9949877,2938,1028300,10978177,10.33
9842836,9958279,5037,1762950,11721229,17.70
9842837,9973953,6589,2306150,12280103,23.12
9842838,9980328,4626,1619100,11599428,16.22
9842839,9964892,3552,1243200,11208092,12.48
9842840,9954673,4422,1547700,11502373,15.55
9842841,9938703,4823,1688050,11626753,16.98
9842842,9952855,4262,1491700,11444555,14.99
9842844,9950759,2872,1005200,10955959,10.10
9842845,9947826,5131,1795850,11743676,18.05
9842846,9965070,4967,1738450,11703520,17.45
9842847,9974610,3167,1108450,11083060,11.11
9842848,9965400,2547,891450,10856850,8.95
9842850,9961561,3943,1380050,11341611,13.85
9842851,738185,143,50050,788235,6.78
9842852,9965338,3656,1279600,11244938,12.84
9842853,2178859,1222,427700,2606559,19.63
9842854,9952980,2431,850850,10803830,8.55
9842855,6509337,2826,989100,7498437,15.20
9842856,9950119,4402,1540700,11490819,15.48
9842857,9944343,4430,1550500,11494843,15.59
9842858,9948609,6588,2305800,12254409,23.18
9842859,9056724,3511,1228850,10285574,13.57
9842860,9978123,5629,1970150,11948273,19.74
9842862,9974113,4848,1696800,11670913,17.01
9842863,9712198,5435,1902250,11614448,19.59
9842864,9983903,6233,2181550,12165453,21.85
9842865,6872558,2855,999250,7871808,14.54
9842866,8096518,5007,1752450,9848968,21.64
9842867,9984024,5229,1830150,11814174,18.33
9842868,9996855,4819,1686650,11683505,16.87
9842869,9987894,6222,2177700,12165594,21.80
9842870,9978353,5107,1787450,11765803,17.91
9842871,9955796,5419,1896650,11852446,19.05
9842872,9912165,4206,1472100,11384265,14.85
9842873,9973330,4103,1436050,11409380,14.40
9842874,9986982,3801,1330350,11317332,13.32
9842875,9735282,4593,1607550,11342832,16.51
9842876,9984815,3787,1325450,11310265,13.27
9842877,9985483,6419,2246650,12232133,22.50
9842878,9994659,5532,1936200,11930859,19.37
9842879,9998105,5003,1751050,11749155,17.51
9842880,9974083,4869,1704150,11678233,17.09
9842881,725691,261,91350,817041,12.59
9842882,9971724,3003,1051050,11022774,10.54
9842883,9952921,4161,1456350,11409271,14.63
9842884,9972950,4823,1688050,11661000,16.93
9842885,9971633,5421,1897350,11868983,19.03
9842886,9981345,5163,1807050,11788395,18.10
9842888,9978647,4760,1666000,11644647,16.70
9842889,9969606,4892,1712200,11681806,17.17
9842890,9983739,4120,1442000,11425739,14.44
9842891,9976872,6771,2369850,12346722,23.75
9842892,9976853,4252,1488200,11465053,14.92
9842893,9950377,4866,1703100,11653477,17.12
9842894,9959717,3897,1363950,11323667,13.69
9842895,9949447,3779,1322650,11272097,13.29
9842896,9938625,3380,1183000,11121625,11.90
9842897,9953907,6243,2185050,12138957,21.95
9842898,9947719,4945,1730750,11678469,17.40
9842899,9947828,4507,1577450,11525278,15.86
9842900,3083688,1675,586250,3669938,19.01
9842901,2774798,1187,415450,3190248,14.97
9842902,9947723,2981,1043350,10991073,10.49
9842903,9884354,4040,1414000,11298354,14.31
9842905,3132295,1023,358050,3490345,11.43
9842906,9935548,3963,1387050,11322598,13.96
9842907,9951494,5512,1929200,11880694,19.39
9842908,9946454,4292,1502200,11448654,15.10
9842909,1293678,366,128100,1421778,9.90
9842910,9940716,5098,1784300,11725016,17.95
9842911,9934251,3227,1129450,11063701,11.37
9842912,9941324,3753,1313550,11254874,13.21
9842913,9957409,3558,1245300,11202709,12.51
9842914,9976674,3688,1290800,11267474,12.94
9842915,9985125,4853,1698550,11683675,17.01
9842916,9980476,4084,1429400,11409876,14.32
9842917,9958811,4808,1682800,11641611,16.90
9842918,9982798,3600,1260000,11242798,12.62
9842919,6695537,3439,1203650,7899187,17.98
9842920,9986212,2440,854000,10840212,8.55
9842921,9995376,4095,1433250,11428626,14.34
9842922,9987876,4672,1635200,11623076,16.37
9842923,9971123,5181,1813350,11784473,18.19
9842924,9999185,4066,1423100,11422285,14.23
9842925,9979999,4047,1416450,11396449,14.19
9842926,9980801,3386,1185100,11165901,11.87
9842927,9963818,5070,1774500,11738318,17.81
9842928,9979762,2293,802550,10782312,8.04
9842929,9986721,6694,2342900,12329621,23.46
9842930,9982510,4195,1468250,11450760,14.71
9842931,9963036,3597,1258950,11221986,12.64
9842932,9972661,6676,2336600,12309261,23.43
9842933,9965566,2416,845600,10811166,8.49
9842934,9974938,5450,1907500,11882438,19.12
9842935,9961259,2926,1024100,10985359,10.28
9842936,9974680,3674,1285900,11260580,12.89
9842937,6121830,5922,2072700,8194530,33.86
9842938,9969177,4530,1585500,11554677,15.90
9842939,9972399,5548,1941800,11914199,19.47
9842940,9976552,4469,1564150,11540702,15.68
9842941,9982532,3197,1118950,11101482,11.21
9842942,9995367,2910,1018500,11013867,10.19
9842943,9980928,2962,1036700,11017628,10.39
9842944,9993827,5992,2097200,12091027,20.98
9842945,9983604,4542,1589700,11573304,15.92
9842946,9987560,4354,1523900,11511460,15.26
9842947,9980447,2836,992600,10973047,9.95
9842948,9362590,3185,1114750,10477340,11.91
9842949,9959583,3367,1178450,11138033,11.83
9842950,9967972,2959,1035650,11003622,10.39
9842951,2412453,1100,385000,2797453,15.96
9842952,9960035,4066,1423100,11383135,14.29
9842953,5582962,2812,984200,6567162,17.63
9842954,1569674,561,196350,1766024,12.51
9842955,9996083,3878,1357300,11353383,13.58
9842956,5049287,562,196700,5245987,3.90
9842957,9982410,1935,677250,10659660,6.78
9842958,516275,129,45150,561425,8.75
9842959,677100,347,121450,798550,17.94
9842960,1912616,1115,390250,2302866,20.40
9842961,9977402,2633,921550,10898952,9.24
9842962,9980164,3575,1251250,11231414,12.54
9842963,9984711,2617,915950,10900661,9.17
9842964,9969680,3240,1134000,11103680,11.37
9842966,9957913,1576,551600,10509513,5.54
9842967,9955408,5675,1986250,11941658,19.95
9842969,9958265,4333,1516550,11474815,15.23
9842970,9972529,2681,938350,10910879,9.41
9842971,9982049,3527,1234450,11216499,12.37
9842972,9959926,1221,427350,10387276,4.29
9842973,9968922,3960,1386000,11354922,13.90
9842974,9976279,1915,670250,10646529,6.72
9842975,9988722,2391,836850,10825572,8.38
9842976,9930176,2330,815500,10745676,8.21
9842977,9971898,3232,1131200,11103098,11.34
9842978,9994221,4685,1639750,11633971,16.41
9842979,9980502,3221,1127350,11107852,11.30
9842980,9979101,4822,1687700,11666801,16.91
9842981,9987672,1661,581350,10569022,5.82
9842982,9990714,3774,1320900,11311614,13.22
9842983,9986865,4360,1526000,11512865,15.28
9842984,9966916,3543,1240050,11206966,12.44
9842985,9955388,2924,1023400,10978788,10.28
9842986,9963172,4327,1514450,11477622,15.20
9842987,9978897,1786,625100,10603997,6.26
9842988,5655410,1221,427350,6082760,7.56
9842989,1470170,716,250600,1720770,17.05
9842990,9972247,2215,775250,10747497,7.77
9842992,9937494,4573,1600550,11538044,16.11
9842993,9097925,3330,1165500,10263425,12.81
9842994,9935789,2495,873250,10809039,8.79
9842995,9951817,3692,1292200,11244017,12.98
9842996,9958715,3622,1267700,11226415,12.73
9842997,9956706,3370,1179500,11136206,11.85
9842998,9973003,3351,1172850,11145853,11.76
9842999,9960603,4132,1446200,11406803,14.52
9843000,9982372,3251,1137850,11120222,11.40
9843001,3454367,540,189000,3643367,5.47
9843002,9989807,4297,1503950,11493757,15.05
9843003,9986600,3845,1345750,11332350,13.48
9843004,9996244,5387,1885450,11881694,18.86
9843005,9969338,2088,730800,10700138,7.33
9843006,9975879,3920,1372000,11347879,13.75
9843007,9994002,2976,1041600,11035602,10.42
9843008,9980045,2584,904400,10884445,9.06
9843009,9983082,2936,1027600,11010682,10.29
9843010,8979937,4053,1418550,10398487,15.80
9843011,9976113,2000,700000,10676113,7.02
9843012,9981670,3991,1396850,11378520,13.99
9843013,9988936,2631,920850,10909786,9.22
9843014,9958410,4036,1412600,11371010,14.18
9843015,9981583,2986,1045100,11026683,10.47
9843016,3626833,1514,529900,4156733,14.61
9843017,9976202,3215,1125250,11101452,11.28
9843018,9955993,3813,1334550,11290543,13.40
9843019,9864710,4459,1560650,11425360,15.82
9843020,9315947,2643,925050,10240997,9.93
9843021,9997688,2551,892850,10890538,8.93
9843022,9988988,4235,1482250,11471238,14.84
9843023,9831468,2439,853650,10685118,8.68
9843024,9982968,4281,1498350,11481318,15.01
9843025,9992713,2937,1027950,11020663,10.29
9843026,9982263,3562,1246700,11228963,12.49
9843027,5577822,2358,825300,6403122,14.80
9843028,9963571,3228,1129800,11093371,11.34
9843029,9968024,5085,1779750,11747774,17.85
9843030,9965044,3771,1319850,11284894,13.24
9843031,9960695,5256,1839600,11800295,18.47
9843032,4259628,808,282800,4542428,6.64
9843033,9974666,5452,1908200,11882866,19.13
9843034,9980273,1922,672700,10652973,6.74
9843035,9979204,1611,563850,10543054,5.65
9843036,9965606,3604,1261400,11227006,12.66
9843037,9974664,3593,1257550,11232214,12.61
9843038,9986331,5049,1767150,11753481,17.70
9843039,9967846,3921,1372350,11340196,13.77
9843040,9967450,3955,1384250,11351700,13.89
9843041,9974788,4963,1737050,11711838,17.41
9843042,9982511,3163,1107050,11089561,11.09
9843043,9981973,3461,1211350,11193323,12.14
9843044,9985683,1366,478100,10463783,4.79
9843045,9965134,236,82600,10047734,0.83
9843046,9952062,1915,670250,10622312,6.73
9843047,9969726,3310,1158500,11128226,11.62
9843048,9983846,4257,1489950,11473796,14.92
9843049,9980531,3615,1265250,11245781,12.68
9843050,9998478,2427,849450,10847928,8.50
9843051,9985304,445,155750,10141054,1.56
9843052,9994605,5295,1853250,11847855,18.54
9843053,9982740,2387,835450,10818190,8.37
9843054,9984464,4575,1601250,11585714,16.04
9843055,9985553,3890,1361500,11347053,13.63
9843056,9987722,6036,2112600,12100322,21.15
9843057,9975244,4645,1625750,11600994,16.30
9843058,7621022,4089,1431150,9052172,18.78
9843059,459187,71,24850,484037,5.41
9843060,9988015,4152,1453200,11441215,14.55
9843061,9997266,4192,1467200,11464466,14.68
9843062,9981025,5647,1976450,11957475,19.80
9843063,9965635,4874,1705900,11671535,17.12
9843064,9967518,4562,1596700,11564218,16.02
9843065,9984288,4634,1621900,11606188,16.24
9843066,9980587,4755,1664250,11644837,16.67
9843067,9992889,3387,1185450,11178339,11.86
9843068,9987052,6971,2439850,12426902,24.43
9843069,9984815,6426,2249100,12233915,22.53
9843070,9970627,5001,1750350,11720977,17.56
9843071,9982262,6139,2148650,12130912,21.52
9843072,9994083,6601,2310350,12304433,23.12
9843073,9992482,3562,1246700,11239182,12.48
9843074,9969408,2714,949900,10919308,9.53
9843075,9980446,6037,2112950,12093396,21.17
9843076,9995778,5481,1918350,11914128,19.19
9843077,9990789,4727,1654450,11645239,16.56
9843079,9990947,4587,1605450,11596397,16.07
9843080,7846398,2110,738500,8584898,9.41
9843081,9985823,3157,1104950,11090773,11.07
9843082,9972744,5301,1855350,11828094,18.60
9843083,9975959,3227,1129450,11105409,11.32
9843084,9974324,4718,1651300,11625624,16.56
9843085,9980695,3843,1345050,11325745,13.48
9843087,9975896,2867,1003450,10979346,10.06
9843088,9983212,3772,1320200,11303412,13.22
9843089,9971953,4180,1463000,11434953,14.67
9843090,9982733,4649,1627150,11609883,16.30
9843091,9982091,3711,1298850,11280941,13.01
9843092,9976126,1615,565250,10541376,5.67
9843093,9992411,4753,1663550,11655961,16.65
9843094,9989242,5241,1834350,11823592,18.36
9843095,9991421,4186,1465100,11456521,14.66
9843096,9970162,5772,2020200,11990362,20.26
9843097,9962474,4457,1559950,11522424,15.66
9843098,9975892,5059,1770650,11746542,17.75
9843099,9993776,4737,1657950,11651726,16.59
9843100,9992594,2997,1048950,11041544,10.50
9843102,9967250,4112,1439200,11406450,14.44
9843103,9976693,3903,1366050,11342743,13.69
9843104,2420140,641,224350,2644490,9.27
9843105,9948480,2008,702800,10651280,7.06
9843106,8165900,1925,673750,8839650,8.25
9843107,9969125,7181,2513350,12482475,25.21
9843108,9966533,4893,1712550,11679083,17.18
9843109,9967771,6345,2220750,12188521,22.28
9843110,9956322,3844,1345400,11301722,13.51
9843111,9950976,4392,1537200,11488176,15.45
9843112,9975097,3640,1274000,11249097,12.77
9843113,9804467,3132,1096200,10900667,11.18
9843115,9995877,4211,1473850,11469727,14.74
9843116,2702934,1692,592200,3295134,21.91
9843117,9975091,3632,1271200,11246291,12.74
9843118,9988738,4885,1709750,11698488,17.12
9843119,9995416,4003,1401050,11396466,14.02
9843120,9970656,3430,1200500,11171156,12.04
9843121,6215663,2130,745500,6961163,11.99
9843122,9968000,5616,1965600,11933600,19.72
9843123,9990203,3264,1142400,11132603,11.44
9843124,9979004,6790,2376500,12355504,23.82
9843125,9988843,6390,2236500,12225343,22.39
9843126,9984576,4827,1689450,11674026,16.92
9843127,9999201,2353,823550,10822751,8.24
9843128,9995599,4499,1574650,11570249,15.75
9843129,9970365,4515,1580250,11550615,15.85
9843131,9975106,3152,1103200,11078306,11.06
9843132,9988384,6496,2273600,12261984,22.76
9843133,9975274,4602,1610700,11585974,16.15
9843134,9991722,2542,889700,10881422,8.90
9843135,9988517,5220,1827000,11815517,18.29
9843136,9989102,3823,1338050,11327152,13.40
9843137,9978005,5899,2064650,12042655,20.69
9843138,9647477,5125,1793750,11441227,18.59
9843139,9966332,3351,1172850,11139182,11.77
9843140,9977017,4493,1572550,11549567,15.76
9843141,613915,221,77350,691265,12.60
9843142,9946023,3127,1094450,11040473,11.00
9843143,9626453,4223,1478050,11104503,15.35
9843144,9960983,5158,1805300,11766283,18.12
9843145,9931720,4717,1650950,11582670,16.62
9843146,9972531,4085,1429750,11402281,14.34
9843147,9981518,3621,1267350,11248868,12.70
9843148,9978338,2937,1027950,11006288,10.30
9843149,9977784,3464,1212400,11190184,12.15
9843150,9976610,4373,1530550,11507160,15.34
9843151,9993252,5492,1922200,11915452,19.23
9843152,9991342,4487,1570450,11561792,15.72
9843153,9989021,3007,1052450,11041471,10.54
9843154,9985949,3454,1208900,11194849,12.11
9843155,5936083,4077,1426950,7363033,24.04
9843156,9969624,4910,1718500,11688124,17.24
9843157,9963529,4023,1408050,11371579,14.13
9843158,9971634,5084,1779400,11751034,17.84
9843159,9969443,4969,1739150,11708593,17.44
9843160,9962536,5218,1826300,11788836,18.33
9843161,9893584,4765,1667750,11561334,16.86
9843162,9983074,6439,2253650,12236724,22.57
9843163,9984145,4100,1435000,11419145,14.37
9843164,9995299,4358,1525300,11520599,15.26
9843165,9811953,4596,1608600,11420553,16.39
9843167,9978143,5389,1886150,11864293,18.90
9843168,9978428,3851,1347850,11326278,13.51
9843169,9965887,5034,1761900,11727787,17.68
9843170,9972163,3410,1193500,11165663,11.97
9843171,9975846,2495,873250,10849096,8.75
9843172,9991178,3573,1250550,11241728,12.52
9843173,9996978,1691,591850,10588828,5.92
9843175,9981467,4546,1591100,11572567,15.94
9843176,9987897,3963,1387050,11374947,13.89
9843178,9992235,4892,1712200,11704435,17.14
9843179,9997031,4557,1594950,11591981,15.95
9843180,9988221,6461,2261350,12249571,22.64
9843181,9985392,3834,1341900,11327292,13.44
9843182,9986573,9148,3201800,13188373,32.06
9843183,9991787,7096,2483600,12475387,24.86
9843184,9994681,5961,2086350,12081031,20.87
9843185,9916692,4715,1650250,11566942,16.64
9843186,9984551,4112,1439200,11423751,14.41
9843187,5370378,2232,781200,6151578,14.55
9843188,9980665,8632,3021200,13001865,30.27
9843189,1149536,992,347200,1496736,30.20
9843191,9971782,2912,1019200,10990982,10.22
9843192,9966827,6608,2312800,12279627,23.20
9843193,9981090,4752,1663200,11644290,16.66
9843194,9969772,3945,1380750,11350522,13.85
9843195,9966496,4995,1748250,11714746,17.54
9843196,9972213,4139,1448650,11420863,14.53
9843197,9986874,5826,2039100,12025974,20.42
9843198,9963571,5363,1877050,11840621,18.84
9843199,9983613,3075,1076250,11059863,10.78
9843200,9977679,5606,1962100,11939779,19.66
9843201,9972839,3770,1319500,11292339,13.23
9843202,9994423,5756,2014600,12009023,20.16
9843203,9998924,5858,2050300,12049224,20.51
9843204,9996389,4231,1480850,11477239,14.81
9843205,9976762,4604,1611400,11588162,16.15
9843206,9977722,4943,1730050,11707772,17.34
9843207,9979280,2252,788200,10767480,7.90
9843209,9980464,4061,1421350,11401814,14.24
9843210,9969839,2656,929600,10899439,9.32
9843211,9898214,4874,1705900,11604114,17.23
9843212,9904189,4203,1471050,11375239,14.85
9843213,9992011,3840,1344000,11336011,13.45
9843214,9971314,6992,2447200,12418514,24.54
9843215,9978799,2516,880600,10859399,8.82
9843216,9999210,4075,1426250,11425460,14.26
9843217,9985234,5165,1807750,11792984,18.10
9843218,9789463,6427,2249450,12038913,22.98
9843219,9979684,6419,2246650,12226334,22.51
9843220,9983242,4967,1738450,11721692,17.41
9843222,9987297,5993,2097550,12084847,21.00
9843223,9985840,4376,1531600,11517440,15.34
9843224,9996002,1697,593950,10589952,5.94
9843225,9988075,3082,1078700,11066775,10.80
9843226,6574168,2676,936600,7510768,14.25
9843228,9971084,3972,1390200,11361284,13.94
9843229,4338079,1354,473900,4811979,10.92
9843230,9968202,4521,1582350,11550552,15.87
9843231,9985233,4646,1626100,11611333,16.29
9843232,9904813,5235,1832250,11737063,18.50
9843233,9916015,6071,2124850,12040865,21.43
9843234,9993872,3044,1065400,11059272,10.66
9843235,9987549,2525,883750,10871299,8.85
9843236,9989952,4086,1430100,11420052,14.32
9843237,9983711,5705,1996750,11980461,20.00
9843238,9967717,4978,1742300,11710017,17.48
9843239,9974105,4148,1451800,11425905,14.56
9843240,9965340,1820,637000,10602340,6.39
9843241,9970869,1662,581700,10552569,5.83
9843242,9975794,4018,1406300,11382094,14.10
9843243,9975491,4641,1624350,11599841,16.28
9843244,9989355,2918,1021300,11010655,10.22
9843245,9982315,6788,2375800,12358115,23.80
9843246,9996210,4429,1550150,11546360,15.51
9843247,9980037,4796,1678600,11658637,16.82
9843248,9976768,3488,1220800,11197568,12.24
9843249,9971523,5886,2060100,12031623,20.66
9843250,9987830,3946,1381100,11368930,13.83
9843251,3777852,2339,818650,4596502,21.67
9843252,9979616,6390,2236500,12216116,22.41
9843253,9982891,3470,1214500,11197391,12.17
9843254,9971654,3528,1234800,11206454,12.38
9843255,9972002,3362,1176700,11148702,11.80
9843256,9965072,4946,1731100,11696172,17.37
9843257,5929341,4179,1462650,7391991,24.67
9843258,9969886,3060,1071000,11040886,10.74
9843259,9961155,3591,1256850,11218005,12.62
9843260,9952357,3322,1162700,11115057,11.68
9843261,9957977,7919,2771650,12729627,27.83
9843262,2069388,660,231000,2300388,11.16
9843263,9974317,4917,1720950,11695267,17.25
9843264,9978706,2052,718200,10696906,7.20
9843265,9978969,5867,2053450,12032419,20.58
9843266,9969719,4656,1629600,11599319,16.35
9843267,9987887,5930,2075500,12063387,20.78
9843268,9969766,3220,1127000,11096766,11.30
9843269,9989693,4041,1414350,11404043,14.16
9843270,9983884,2527,884450,10868334,8.86
9843271,9982429,6582,2303700,12286129,23.08
9843272,9990718,3060,1071000,11061718,10.72
9843273,9975323,4647,1626450,11601773,16.30
9843274,9979852,3164,1107400,11087252,11.10
9843275,9977438,6248,2186800,12164238,21.92
9843276,9977733,4121,1442350,11420083,14.46
9843277,9981714,3682,1288700,11270414,12.91
9843278,9983444,5969,2089150,12072594,20.93
9843279,9976428,4562,1596700,11573128,16.00
9843280,9989154,5329,1865150,11854304,18.67
9843281,9979906,2749,962150,10942056,9.64
9843282,9975383,3174,1110900,11086283,11.14
9843283,9629390,3423,1198050,10827440,12.44
9843284,9986639,3178,1112300,11098939,11.14
9843285,9996753,2562,896700,10893453,8.97
9843286,9975915,2837,992950,10968865,9.95
9843287,9980295,4989,1746150,11726445,17.50
9843288,9986682,3999,1399650,11386332,14.02
9843289,9984701,2195,768250,10752951,7.69
9843290,9997950,4132,1446200,11444150,14.46
9843291,9981740,3759,1315650,11297390,13.18
9843292,9993114,2904,1016400,11009514,10.17
9843293,9993873,4868,1703800,11697673,17.05
9843294,9952438,5474,1915900,11868338,19.25
9843295,9985120,5143,1800050,11785170,18.03
9843296,7724757,2745,960750,8685507,12.44
9843297,9979478,2180,763000,10742478,7.65
9843298,9979719,3240,1134000,11113719,11.36
9843299,9951342,3478,1217300,11168642,12.23
9843300,9969121,3235,1132250,11101371,11.36
9843301,9091176,2536,887600,9978776,9.76
9843302,845501,428,149800,995301,17.72
9843303,9953303,3324,1163400,11116703,11.69
9843304,9956510,4983,1744050,11700560,17.52
9843305,9961572,3972,1390200,11351772,13.96
9843306,9950456,3883,1359050,11309506,13.66
9843307,9949117,4800,1680000,11629117,16.89
9843308,9844948,3352,1173200,11018148,11.92
9843309,9949469,4142,1449700,11399169,14.57
9843310,9958097,4191,1466850,11424947,14.73
9843311,9962336,3668,1283800,11246136,12.89
9843312,578694,356,124600,703294,21.53
9843313,9970259,5009,1753150,11723409,17.58
9843314,9960097,4131,1445850,11405947,14.52
9843315,9976506,4887,1710450,11686956,17.14
9843316,9989760,3399,1189650,11179410,11.91
9843317,9492623,3236,1132600,10625223,11.93
9843318,9957132,3454,1208900,11166032,12.14
9843319,9980657,3761,1316350,11297007,13.19
9843320,9788709,2087,730450,10519159,7.46
9843321,9977136,3137,1097950,11075086,11.00
9843322,9964160,3906,1367100,11331260,13.72
9843323,9970569,3335,1167250,11137819,11.71
9843324,9990543,5243,1835050,11825593,18.37
9843325,9975245,5526,1934100,11909345,19.39
9843326,9976162,2871,1004850,10981012,10.07
9843327,9962734,2093,732550,10695284,7.35
9843328,9979174,2321,812350,10791524,8.14
9843329,9999211,3377,1181950,11181161,11.82
9843330,9997000,3068,1073800,11070800,10.74
9843331,8493582,2864,1002400,9495982,11.80
9843332,9981589,5417,1895950,11877539,18.99
9843333,9999844,4984,1744400,11744244,17.44
9843334,1413565,1311,458850,1872415,32.46
9843335,9979955,4345,1520750,11500705,15.24
9843336,9991908,2775,971250,10963158,9.72
9843337,9970873,3849,1347150,11318023,13.51
9843338,2162777,1642,574700,2737477,26.57
9843339,9956160,4530,1585500,11541660,15.92
9843340,9964648,3342,1169700,11134348,11.74
9843341,3584499,2813,984550,4569049,27.47
9843342,4038292,1990,696500,4734792,17.25
9843343,9943390,4777,1671950,11615340,16.81
9843344,9959028,4833,1691550,11650578,16.99
9843345,9967365,4070,1424500,11391865,14.29
9843346,9980673,4188,1465800,11446473,14.69
9843348,9958647,5688,1990800,11949447,19.99
9843349,9961690,4846,1696100,11657790,17.03
9843350,9975005,1959,685650,10660655,6.87
9843351,9979798,7671,2684850,12664648,26.90
9843352,9937315,2672,935200,10872515,9.41
9843353,9969068,4683,1639050,11608118,16.44
9843354,1382363,866,303100,1685463,21.93
9843355,9951402,3236,1132600,11084002,11.38
9843356,9946876,3475,1216250,11163126,12.23
9843357,9963407,6968,2438800,12402207,24.48
9843358,9974203,2449,857150,10831353,8.59
9843359,9955929,5632,1971200,11927129,19.80
9843360,9970529,3770,1319500,11290029,13.23
9843361,9975791,4078,1427300,11403091,14.31
9843362,9982263,5889,2061150,12043413,20.65
9843363,9973608,6575,2301250,12274858,23.07
9843364,9974813,3641,1274350,11249163,12.78
9843365,5600590,2771,969850,6570440,17.32
9843366,9986178,4444,1555400,11541578,15.58
9843368,9979313,1280,448000,10427313,4.49
9843369,9986579,3800,1330000,11316579,13.32
9843370,9980746,6964,2437400,12418146,24.42
9843371,4457939,848,296800,4754739,6.66
9843372,2966852,728,254800,3221652,8.59
9843373,9986118,4412,1544200,11530318,15.46
9843374,9818105,5532,1936200,11754305,19.72
9843375,9983298,2880,1008000,10991298,10.10
9843376,9997563,4221,1477350,11474913,14.78
9843377,9994179,4108,1437800,11431979,14.39
9843378,9971002,2995,1048250,11019252,10.51
9843379,9977804,1946,681100,10658904,6.83
9843380,9975955,3081,1078350,11054305,10.81
9843381,9988860,4643,1625050,11613910,16.27
9843382,9991365,4944,1730400,11721765,17.32
9843383,9427741,1651,577850,10005591,6.13
9843384,9718627,3931,1375850,11094477,14.16
9843385,9950580,3942,1379700,11330280,13.87
9843386,9963643,4210,1473500,11437143,14.79
9843387,701776,253,88550,790326,12.62
9843388,9961393,5808,2032800,11994193,20.41
9843389,9974658,2016,705600,10680258,7.07
9843390,9970767,3273,1145550,11116317,11.49
9843391,9980038,4337,1517950,11497988,15.21
9843392,9980486,3820,1337000,11317486,13.40
9843393,9983342,2966,1038100,11021442,10.40
9843394,9990242,2703,946050,10936292,9.47
9843395,9981005,3808,1332800,11313805,13.35
9843396,9978438,4876,1706600,11685038,17.10
9843397,9989727,4213,1474550,11464277,14.76
9843398,6732905,1953,683550,7416455,10.15
9843399,6275470,4303,1506050,7781520,24.00
9843400,9959713,5739,2008650,11968363,20.17
9843401,9956901,2523,883050,10839951,8.87
9843402,9968176,4433,1551550,11519726,15.57
9843403,9986723,6016,2105600,12092323,21.08
9843404,9962860,5383,1884050,11846910,18.91
9843405,9977368,5418,1896300,11873668,19.01
9843406,9959390,3679,1287650,11247040,12.93
9843407,9971862,1336,467600,10439462,4.69
9843408,9973529,7532,2636200,12609729,26.43
9843409,9996886,5046,1766100,11762986,17.67
9843410,9995660,6271,2194850,12190510,21.96
9843411,9971915,3504,1226400,11198315,12.30
9843412,9966447,5874,2055900,12022347,20.63
9843414,9974367,4878,1707300,11681667,17.12
9843415,9975863,2820,987000,10962863,9.89
9843416,9971999,5128,1794800,11766799,18.00
9843417,9994776,4298,1504300,11499076,15.05
9843418,9987821,4397,1538950,11526771,15.41
9843419,9971991,4525,1583750,11555741,15.88
9843421,9983842,4104,1436400,11420242,14.39
9843423,9976601,5726,2004100,11980701,20.09
9843424,9986846,4605,1611750,11598596,16.14
9843425,9983317,4815,1685250,11668567,16.88
9843426,9986926,3660,1281000,11267926,12.83
9843427,9982175,5845,2045750,12027925,20.49
9843428,9976048,3496,1223600,11199648,12.27
9843429,9968284,6372,2230200,12198484,22.37
9843430,9957946,5299,1854650,11812596,18.62
9843431,9967480,3413,1194550,11162030,11.98
9843433,9949042,4692,1642200,11591242,16.51
9843434,9951515,1577,551950,10503465,5.55
9843435,9960543,2208,772800,10733343,7.76
9843436,9956653,3221,1127350,11084003,11.32
9843437,9974913,4234,1481900,11456813,14.86
9843438,9972866,2126,744100,10716966,7.46
9843439,9974454,3902,1365700,11340154,13.69
9843440,9982366,2302,805700,10788066,8.07
9843441,9867582,2733,956550,10824132,9.69
9843442,9981224,3206,1122100,11103324,11.24
9843443,9992842,4141,1449350,11442192,14.50
9843444,9983506,4114,1439900,11423406,14.42
9843445,9995203,1749,612150,10607353,6.12
9843446,9654577,4078,1427300,11081877,14.78
9843447,9994128,3489,1221150,11215278,12.22
9843448,9989574,4181,1463350,11452924,14.65
9843449,9972892,921,322350,10295242,3.23
9843450,9980931,5460,1911000,11891931,19.15
9843451,9988834,4308,1507800,11496634,15.09
9843453,9986877,2846,996100,10982977,9.97
9843454,9950853,2164,757400,10708253,7.61
9843455,9989787,4177,1461950,11451737,14.63
9843456,9983329,4922,1722700,11706029,17.26
9843457,9982105,3436,1202600,11184705,12.05
9843458,9991462,3205,1121750,11113212,11.23
9843459,9965800,1282,448700,10414500,4.50
9843460,9980301,4370,1529500,11509801,15.33
9843461,9970381,5225,1828750,11799131,18.34
9843462,9983685,2181,763350,10747035,7.65
9843463,9973757,1534,536900,10510657,5.38
9843464,9973337,5987,2095450,12068787,21.01
9843465,9896291,1963,687050,10583341,6.94
9843466,9989087,2646,926100,10915187,9.27
9843467,9994548,5311,1858850,11853398,18.60
9843468,9996255,5643,1975050,11971305,19.76
9843469,9987037,3497,1223950,11210987,12.26
9843470,9988707,3250,1137500,11126207,11.39
9843472,9953261,2690,941500,10894761,9.46
9843473,9959454,3797,1328950,11288404,13.34
9843474,9965958,2158,755300,10721258,7.58
9843475,1827368,252,88200,1915568,4.83
9843476,9966834,3074,1075900,11042734,10.79
9843477,9970917,3257,1139950,11110867,11.43
9843478,9971319,2750,962500,10933819,9.65
9843479,9986561,5801,2030350,12016911,20.33
9843480,9988972,2877,1006950,10995922,10.08
9843481,9973933,3507,1227450,11201383,12.31
9843482,2338682,556,194600,2533282,8.32
9843483,9983477,4314,1509900,11493377,15.12
9843484,9993234,3446,1206100,11199334,12.07
9843485,9995253,5031,1760850,11756103,17.62
9843486,9970293,2285,799750,10770043,8.02
9843487,9988736,1682,588700,10577436,5.89
9843488,9986658,5304,1856400,11843058,18.59
9843489,9972930,5145,1800750,11773680,18.06
9843490,9960424,3282,1148700,11109124,11.53
9843491,9967714,3491,1221850,11189564,12.26
9843493,9945475,2799,979650,10925125,9.85
9843494,9914495,3508,1227800,11142295,12.38
9843495,9951394,2006,702100,10653494,7.06
9843496,9951608,3144,1100400,11052008,11.06
9843497,9943586,4833,1691550,11635136,17.01
9843498,9954384,2965,1037750,10992134,10.43
9843499,9946342,1582,553700,10500042,5.57
9843500,9949436,6375,2231250,12180686,22.43
9843501,9958423,3381,1183350,11141773,11.88
9843503,9931444,2172,760200,10691644,7.65
9843505,9923770,4370,1529500,11453270,15.41
9843506,9936616,3893,1362550,11299166,13.71
9843507,9936436,2019,706650,10643086,7.11
9843508,9957670,7238,2533300,12490970,25.44
9843509,9967407,2161,756350,10723757,7.59
9843510,7723864,3840,1344000,9067864,17.40
9843511,711226,415,145250,856476,20.42
9843512,9964490,4807,1682450,11646940,16.88
9843513,9950915,4064,1422400,11373315,14.29
9843514,9963229,4570,1599500,11562729,16.05
9843515,9965851,6736,2357600,12323451,23.66
9843516,9975844,3492,1222200,11198044,12.25
9843517,8515214,3981,1393350,9908564,16.36
9843518,9976697,2538,888300,10864997,8.90
9843519,9987303,3788,1325800,11313103,13.27
9843520,9972634,2568,898800,10871434,9.01
9843521,9645276,2016,705600,10350876,7.32
9843522,9984241,5679,1987650,11971891,19.91
9843523,9980302,4274,1495900,11476202,14.99
9843524,9972266,6367,2228450,12200716,22.35
9843525,9967705,3309,1158150,11125855,11.62
9843526,9990157,3698,1294300,11284457,12.96
9843527,9994310,5240,1834000,11828310,18.35
9843528,2877699,970,339500,3217199,11.80
9843529,9980236,6137,2147950,12128186,21.52
9843530,9282775,2569,899150,10181925,9.69
9843531,9974561,3400,1190000,11164561,11.93
9843532,9990410,4148,1451800,11442210,14.53
9843533,9982619,3218,1126300,11108919,11.28
9843534,9984232,4484,1569400,11553632,15.72
9843535,9982034,2975,1041250,11023284,10.43
9843536,9988525,2428,849800,10838325,8.51
9843537,9991475,4722,1652700,11644175,16.54
9843538,9982236,5957,2084950,12067186,20.89
9843539,9970609,4020,1407000,11377609,14.11
9843540,9979058,2430,850500,10829558,8.52
9843541,9495665,3503,1226050,10721715,12.91
9843542,9982049,4917,1720950,11702999,17.24
9843543,9988467,3750,1312500,11300967,13.14
9843545,9967566,2902,1015700,10983266,10.19
9843547,6910934,2273,795550,7706484,11.51
9843548,7986260,3070,1074500,9060760,13.45
9843549,9976399,3428,1199800,11176199,12.03
9843551,5835368,3300,1155000,6990368,19.79
9843552,9977293,4980,1743000,11720293,17.47
9843553,9974769,4313,1509550,11484319,15.13
9843554,9962504,910,318500,10281004,3.20
9843555,9998081,2070,724500,10722581,7.25
9843556,9982372,753,263550,10245922,2.64
9843557,9982861,989,346150,10329011,3.47
9843558,9999226,1385,484750,10483976,4.85
9843559,9423707,2955,1034250,10457957,10.97
9843560,9972877,3764,1317400,11290277,13.21
9843561,9957685,2818,986300,10943985,9.90
9843562,9962383,1626,569100,10531483,5.71
9843563,9969286,2849,997150,10966436,10.00
9843564,9985736,3118,1091300,11077036,10.93
9843565,9996335,4200,1470000,11466335,14.71
9843566,9961224,5573,1950550,11911774,19.58
9843567,9965059,2703,946050,10911109,9.49
9843568,9992384,2575,901250,10893634,9.02
9843569,1755522,1000,350000,2105522,19.94
9843570,9970693,3185,1114750,11085443,11.18
9843571,9961136,4293,1502550,11463686,15.08
9843572,9968221,3925,1373750,11341971,13.78
9843573,9965281,2812,984200,10949481,9.88
9843574,9985568,4253,1488550,11474118,14.91
9843575,9987787,2500,875000,10862787,8.76
9843576,9987586,3371,1179850,11167436,11.81
9843577,9975585,2708,947800,10923385,9.50
9843578,9985285,6101,2135350,12120635,21.38
9843579,9724664,3551,1242850,10967514,12.78
9843580,9983108,2851,997850,10980958,10.00
9843581,9988385,3977,1391950,11380335,13.94
9843582,1106969,689,241150,1348119,21.78
9843583,9954487,2486,870100,10824587,8.74
9843584,9200346,2897,1013950,10214296,11.02
9843585,9962020,3085,1079750,11041770,10.84
9843586,9964778,4044,1415400,11380178,14.20
9843587,9983003,4084,1429400,11412403,14.32
9843588,9991180,3236,1132600,11123780,11.34
9843589,9987071,3786,1325100,11312171,13.27
9843590,9553445,4420,1547000,11100445,16.19
9843592,9954638,5128,1794800,11749438,18.03
9843593,9954682,2504,876400,10831082,8.80
9843594,8283736,4103,1436050,9719786,17.34
9843595,543969,221,77350,621319,14.22
9843596,9978123,1966,688100,10666223,6.90
9843597,9990443,4720,1652000,11642443,16.54
9843598,9993568,4826,1689100,11682668,16.90
9843599,9994847,5012,1754200,11749047,17.55
9843600,9935523,5858,2050300,11985823,20.64
9843601,6494444,5506,1927100,8421544,29.67
9843602,9981118,6761,2366350,12347468,23.71
9843603,8814227,3283,1149050,9963277,13.04
9843604,1934261,580,203000,2137261,10.49
9843605,9956763,3008,1052800,11009563,10.57
9843607,9961742,5440,1904000,11865742,19.11
9843608,9962725,3136,1097600,11060325,11.02
9843609,9974778,6011,2103850,12078628,21.09
9843610,9930667,5665,1982750,11913417,19.97
9843611,8957979,2525,883750,9841729,9.87
9843612,9960077,6318,2211300,12171377,22.20
9843613,9941162,3831,1340850,11282012,13.49
9843614,8962136,1550,542500,9504636,6.05
9843615,9962431,3224,1128400,11090831,11.33
9843616,9960676,2688,940800,10901476,9.45
9843617,9968441,6938,2428300,12396741,24.36
9843618,9982714,2934,1026900,11009614,10.29
9843619,9980169,4130,1445500,11425669,14.48
9843620,9982206,3444,1205400,11187606,12.08
9843621,9986680,6679,2337650,12324330,23.41
9843622,9995385,1686,590100,10585485,5.90
9843623,9982392,4390,1536500,11518892,15.39
9843624,9996740,5789,2026150,12022890,20.27
9843625,9974828,3816,1335600,11310428,13.39
9843626,9956218,5079,1777650,11733868,17.85
9843627,9923259,5825,2038750,11962009,20.55
9843628,9979833,2822,987700,10967533,9.90
9843629,9958512,3618,1266300,11224812,12.72
9843630,9985450,2941,1029350,11014800,10.31
9843631,9999188,4032,1411200,11410388,14.11
9843632,9976955,2204,771400,10748355,7.73
9843633,9991163,2166,758100,10749263,7.59
9843634,9998001,4236,1482600,11480601,14.83
9843635,9981924,3135,1097250,11079174,10.99
9843636,9978455,4184,1464400,11442855,14.68
9843637,9997342,2845,995750,10993092,9.96
9843638,9984760,4172,1460200,11444960,14.62
9843639,9984067,3637,1272950,11257017,12.75
9843640,9984145,2352,823200,10807345,8.25
9843641,9968218,1686,590100,10558318,5.92
9843642,9975014,3368,1178800,11153814,11.82
9843643,9970168,2293,802550,10772718,8.05
9843644,9988742,4186,1465100,11453842,14.67
9843646,9971273,1990,696500,10667773,6.99
9843647,9965271,2727,954450,10919721,9.58
9843648,9985305,1340,469000,10454305,4.70
9843649,9972139,2913,1019550,10991689,10.22
9843650,9958298,5341,1869350,11827648,18.77
9843651,9959273,2765,967750,10927023,9.72
9843652,9949904,957,334950,10284854,3.37
9843653,9956712,2753,963550,10920262,9.68
9843654,9965436,3368,1178800,11144236,11.83
9843655,9969653,4467,1563450,11533103,15.68
9843656,9968966,1792,627200,10596166,6.29
9843657,9948194,3025,1058750,11006944,10.64
9843658,9955046,2907,1017450,10972496,10.22
9843659,4712932,862,301700,5014632,6.40
9843660,9943565,4249,1487150,11430715,14.96
9843661,9974128,3828,1339800,11313928,13.43
9843662,9951917,3325,1163750,11115667,11.69
9843663,9946776,4837,1692950,11639726,17.02
9843664,9946237,4106,1437100,11383337,14.45
9843665,9965973,4298,1504300,11470273,15.09
9843666,9981532,2591,906850,10888382,9.09
9843667,9917914,3248,1136800,11054714,11.46
9843668,9922335,2118,741300,10663635,7.47
9843669,3762559,1558,545300,4307859,14.49
9843670,9979107,4037,1412950,11392057,14.16
9843671,9982836,4984,1744400,11727236,17.47
9843672,9983450,7788,2725800,12709250,27.30
9843673,9984785,4888,1710800,11695585,17.13
9843674,9987151,4258,1490300,11477451,14.92
9843675,9982813,3309,1158150,11140963,11.60
9843676,9934663,3215,1125250,11059913,11.33
9843677,9953014,4028,1409800,11362814,14.16
9843678,9977667,4509,1578150,11555817,15.82
9843679,9994398,3795,1328250,11322648,13.29
9843680,9976500,3861,1351350,11327850,13.55
9843681,9999187,5345,1870750,11869937,18.71
9843682,9987208,5220,1827000,11814208,18.29
9843683,9983424,4200,1470000,11453424,14.72
9843684,9993264,3136,1097600,11090864,10.98
9843685,6085378,1732,606200,6691578,9.96
9843686,9998919,2547,891450,10890369,8.92
9843687,9972082,2699,944650,10916732,9.47
9843688,9909909,3917,1370950,11280859,13.83
9843689,9970658,1537,537950,10508608,5.40
9843690,9477721,6344,2220400,11698121,23.43
9843691,9983353,2730,955500,10938853,9.57
9843692,9981662,3119,1091650,11073312,10.94
9843693,2204527,1229,430150,2634677,19.51
9843694,9959797,3042,1064700,11024497,10.69
9843695,9953142,5106,1787100,11740242,17.96
9843696,9960875,2953,1033550,10994425,10.38
9843697,9955177,2703,946050,10901227,9.50
9843698,9833163,5516,1930600,11763763,19.63
9843699,9978473,3158,1105300,11083773,11.08
9843700,9846119,3317,1160950,11007069,11.79
9843701,9982561,1308,457800,10440361,4.59
9843702,9997883,2084,729400,10727283,7.30
9843703,9980373,1364,477400,10457773,4.78
9843704,9976342,1275,446250,10422592,4.47
9843705,9983147,1857,649950,10633097,6.51
9843706,9986147,758,265300,10251447,2.66
9843707,9996166,2623,918050,10914216,9.18
9843708,9982657,1906,667100,10649757,6.68
9843709,9987266,4554,1593900,11581166,15.96
9843710,9638191,3060,1071000,10709191,11.11
9843711,9979944,5506,1927100,11907044,19.31
9843712,9974924,3105,1086750,11061674,10.89
9843714,9968988,2960,1036000,11004988,10.39
9843715,9974017,1707,597450,10571467,5.99
9843716,9991056,4851,1697850,11688906,16.99
9843717,9331800,3570,1249500,10581300,13.39
9843718,9923722,2057,719950,10643672,7.25
9843719,9994448,4237,1482950,11477398,14.84
9843720,9970936,2669,934150,10905086,9.37
9843721,9975536,6416,2245600,12221136,22.51
9843722,8809546,1693,592550,9402096,6.73
9843723,9944633,3578,1252300,11196933,12.59
9843724,9930418,3322,1162700,11093118,11.71
9843725,9800148,2731,955850,10755998,9.75
9843726,9956870,6492,2272200,12229070,22.82
9843727,9967458,3671,1284850,11252308,12.89
9843728,9798469,2533,886550,10685019,9.05
9843729,163849,118,41300,205149,25.21
9843730,9948228,4300,1505000,11453228,15.13
9843731,9944064,4069,1424150,11368214,14.32
9843732,9948245,4109,1438150,11386395,14.46
9843733,9929009,5340,1869000,11798009,18.82
9843734,9956707,3053,1068550,11025257,10.73
9843735,9955215,3256,1139600,11094815,11.45
9843736,9948940,5923,2073050,12021990,20.84
9843737,9621066,2338,818300,10439366,8.51
9843738,9945664,5152,1803200,11748864,18.13
9843739,9950282,3243,1135050,11085332,11.41
9843740,9949110,4809,1683150,11632260,16.92
9843741,9940109,4405,1541750,11481859,15.51
9843742,9942423,4028,1409800,11352223,14.18
9843743,9941336,4545,1590750,11532086,16.00
9843744,8414062,1894,662900,9076962,7.88
9843746,2396410,1972,690200,3086610,28.80
9843747,9958052,5320,1862000,11820052,18.70
9843748,9969188,4783,1674050,11643238,16.79
9843749,9960577,2775,971250,10931827,9.75
9843750,9971059,1987,695450,10666509,6.97
9843751,9987295,5042,1764700,11751995,17.67
9843752,9992678,2654,928900,10921578,9.30
9843753,9984986,3560,1246000,11230986,12.48
9843754,9999100,4606,1612100,11611200,16.12
9843755,9986065,4449,1557150,11543215,15.59
9843756,9868325,3043,1065050,10933375,10.79
9843757,9842559,4533,1586550,11429109,16.12
9843758,9997272,2905,1016750,11014022,10.17
9843759,9976664,4541,1589350,11566014,15.93
9843760,9979634,7447,2606450,12586084,26.12
9843761,9996728,3195,1118250,11114978,11.19
9843762,9984537,2767,968450,10952987,9.70
9843763,9983359,3809,1333150,11316509,13.35
9843764,9993227,5878,2057300,12050527,20.59
9843765,7416020,3264,1142400,8558420,15.40
9843766,1494705,436,152600,1647305,10.21
9843767,9984903,4199,1469650,11454553,14.72
9843768,9971186,5547,1941450,11912636,19.47
9843769,9993901,2520,882000,10875901,8.83
9843770,9989218,3874,1355900,11345118,13.57
9843771,9980782,4951,1732850,11713632,17.36
9843772,9982175,3299,1154650,11136825,11.57
9843773,9993788,3379,1182650,11176438,11.83
9843774,9973058,4207,1472450,11445508,14.76
9843775,9975240,4426,1549100,11524340,15.53
9843776,9993342,3148,1101800,11095142,11.03
9843777,6573114,2757,964950,7538064,14.68
9843778,9846214,4616,1615600,11461814,16.41
9843780,9985993,3349,1172150,11158143,11.74
9843781,9967795,3775,1321250,11289045,13.26
9843782,9967162,3875,1356250,11323412,13.61
9843783,9964219,3496,1223600,11187819,12.28
9843784,9003352,1972,690200,9693552,7.67
9843785,9977976,3777,1321950,11299926,13.25
9843786,9981886,3181,1113350,11095236,11.15
9843787,9991697,4096,1433600,11425297,14.35
9843788,9994588,6365,2227750,12222338,22.29
9843789,9998467,2652,928200,10926667,9.28
9843791,9988767,2868,1003800,10992567,10.05
9843792,9990110,4069,1424150,11414260,14.26
9843793,4897875,1350,472500,5370375,9.65
9843794,9981978,3710,1298500,11280478,13.01
9843795,9961279,4931,1725850,11687129,17.33
9843796,5076008,2150,752500,5828508,14.82
9843797,9949969,2337,817950,10767919,8.22
9843798,9804800,3149,1102150,10906950,11.24
9843799,9828097,6565,2297750,12125847,23.38
9843800,9960702,2842,994700,10955402,9.99
9843801,9954843,4471,1564850,11519693,15.72
9843802,9970254,5037,1762950,11733204,17.68
9843803,9960431,3053,1068550,11028981,10.73
9843804,9961459,2353,823550,10785009,8.27
9843805,1808322,1208,422800,2231122,23.38
9843806,4007013,2910,1018500,5025513,25.42
9843807,4143084,3254,1138900,5281984,27.49
9843808,9958409,3107,1087450,11045859,10.92
9843809,9958461,5200,1820000,11778461,18.28
9843810,9938390,5707,1997450,11935840,20.10
9843811,5558383,2906,1017100,6575483,18.30
9843812,5145432,3935,1377250,6522682,26.77
9843813,9953521,3087,1080450,11033971,10.85
9843814,9936786,5857,2049950,11986736,20.63
9843815,9950283,3205,1121750,11072033,11.27
9843816,9941123,6164,2157400,12098523,21.70
9843817,9854599,2096,733600,10588199,7.44
9843818,9940145,3967,1388450,11328595,13.97
9843819,9949349,3374,1180900,11130249,11.87
9843820,6798986,2635,922250,7721236,13.56
9843821,9950077,4281,1498350,11448427,15.06
9843822,9948290,4465,1562750,11511040,15.71
9843823,9956013,2129,745150,10701163,7.48
9843824,9952589,3382,1183700,11136289,11.89
9843825,9973282,3631,1270850,11244132,12.74
9843826,9975079,2860,1001000,10976079,10.04
9843827,9973764,4186,1465100,11438864,14.69
9843828,9975557,4605,1611750,11587307,16.16
9843829,9919037,3957,1384950,11303987,13.96
9843830,9984588,4006,1402100,11386688,14.04
9843831,9998875,4273,1495550,11494425,14.96
9843832,9983819,5393,1887550,11871369,18.91
9843833,9987634,4824,1688400,11676034,16.90
9843834,9985140,1831,640850,10625990,6.42
9843835,9986074,4866,1703100,11689174,17.05
9843836,9990457,4436,1552600,11543057,15.54
9843837,9965252,2156,754600,10719852,7.57
9843838,9974195,5271,1844850,11819045,18.50
9843839,9960104,3927,1374450,11334554,13.80
9843840,9976288,4047,1416450,11392738,14.20
9843841,9974872,4479,1567650,11542522,15.72
9843842,9993537,3123,1093050,11086587,10.94
9843843,9977646,3471,1214850,11192496,12.18
9843844,9979321,4852,1698200,11677521,17.02
9843845,9992714,1690,591500,10584214,5.92
9843846,9996233,1883,659050,10655283,6.59
9843847,8999822,4274,1495900,10495722,16.62
9843848,9446581,4510,1578500,11025081,16.71
9843849,9986651,4911,1718850,11705501,17.21
9843850,9997035,3653,1278550,11275585,12.79
9843851,9695251,3394,1187900,10883151,12.25
9843852,9988435,3688,1290800,11279235,12.92
9843853,9996861,4513,1579550,11576411,15.80
9843854,2383099,1269,444150,2827249,18.64
9843855,9988054,4485,1569750,11557804,15.72
9843856,9970688,3865,1352750,11323438,13.57
9843857,9785938,3989,1396150,11182088,14.27
9843858,9980464,2866,1003100,10983564,10.05
9843859,9991649,6468,2263800,12255449,22.66
9843860,9996435,4142,1449700,11446135,14.50
9843861,9988813,2882,1008700,10997513,10.10
9843862,9980650,4558,1595300,11575950,15.98
9843863,9991876,5978,2092300,12084176,20.94
9843864,9984085,3506,1227100,11211185,12.29
9843865,9991796,4560,1596000,11587796,15.97
9843866,9991754,2587,905450,10897204,9.06
9843867,9993286,3276,1146600,11139886,11.47
9843868,9985121,5060,1771000,11756121,17.74
9843869,9994083,2117,740950,10735033,7.41
9843870,9983124,3830,1340500,11323624,13.43
9843871,9975281,3747,1311450,11286731,13.15
9843872,9993808,2757,964950,10958758,9.66
9843873,9997538,5779,2022650,12020188,20.23
9843874,9979499,1393,487550,10467049,4.89
9843875,9984713,4141,1449350,11434063,14.52
9843876,9978290,2911,1018850,10997140,10.21
9843877,9977313,1685,589750,10567063,5.91
9843878,9983841,3820,1337000,11320841,13.39
9843879,9611652,3257,1139950,10751602,11.86
9843880,9975692,3149,1102150,11077842,11.05
9843881,9974828,3962,1386700,11361528,13.90
9843882,9987384,4052,1418200,11405584,14.20
9843883,9980578,1575,551250,10531828,5.52
9843884,9972659,6318,2211300,12183959,22.17
9843885,9992582,3087,1080450,11073032,10.81
9843886,9992844,2451,857850,10850694,8.58
9843887,9972455,5172,1810200,11782655,18.15
9843888,9980019,5964,2087400,12067419,20.92
9843889,9928446,3417,1195950,11124396,12.05
9843890,9970612,4577,1601950,11572562,16.07
9843891,9975669,2285,799750,10775419,8.02
9843892,9991491,2724,953400,10944891,9.54
9843893,9978354,3907,1367450,11345804,13.70
9843894,9978682,1535,537250,10515932,5.38
9843895,363919,162,56700,420619,15.58
9843896,9963744,2321,812350,10776094,8.15
9843897,9964842,1741,609350,10574192,6.11
9843898,9970494,3038,1063300,11033794,10.66
9843899,9964595,3853,1348550,11313145,13.53
9843900,9967451,2789,976150,10943601,9.79
9843901,9965366,4970,1739500,11704866,17.46
9843902,9994089,4387,1535450,11529539,15.36
9843903,9991540,6101,2135350,12126890,21.37
9843904,2484225,1752,613200,3097425,24.68
9843905,1995537,1241,434350,2429887,21.77
9843906,9968108,3316,1160600,11128708,11.64
9843907,9965712,3354,1173900,11139612,11.78
9843908,9953019,6050,2117500,12070519,21.27
9843909,9947545,2779,972650,10920195,9.78
9843910,9950838,5752,2013200,11964038,20.23
9843911,5247788,2356,824600,6072388,15.71
9843912,9942678,3883,1359050,11301728,13.67
9843913,9956380,5492,1922200,11878580,19.31
9843914,9886285,3750,1312500,11198785,13.28
9843915,9963848,4603,1611050,11574898,16.17
9843916,9981746,3992,1397200,11378946,14.00
9843917,9987575,2075,726250,10713825,7.27
9843918,9984791,4351,1522850,11507641,15.25
9843919,9986148,5309,1858150,11844298,18.61
9843920,2327354,940,329000,2656354,14.14
9843921,9973586,3253,1138550,11112136,11.42
9843922,9994356,3256,1139600,11133956,11.40
9843923,9977362,5353,1873550,11850912,18.78
9843924,6849239,2145,750750,7599989,10.96
9843925,9974023,6900,2415000,12389023,24.21
9843926,9986554,4807,1682450,11669004,16.85
9843927,9975667,4410,1543500,11519167,15.47
9843928,9993264,3344,1170400,11163664,11.71
9843929,9992262,3961,1386350,11378612,13.87
9843930,9208069,3927,1374450,10582519,14.93
9843931,4088571,1531,535850,4624421,13.11
9843932,9974706,6661,2331350,12306056,23.37
9843933,9985486,3992,1397200,11382686,13.99
9843934,9967049,4885,1709750,11676799,17.15
9843935,9977776,5364,1877400,11855176,18.82
9843937,2695332,840,294000,2989332,10.91
9843938,747335,289,101150,848485,13.53
9843939,9987024,4286,1500100,11487124,15.02
9843940,9987857,3280,1148000,11135857,11.49
9843941,9974510,1474,515900,10490410,5.17
9843942,9208356,853,298550,9506906,3.24
9843943,8958896,2444,855400,9814296,9.55
9843944,5985543,2776,971600,6957143,16.23
9843945,4988620,3039,1063650,6052270,21.32
9843946,9220579,4782,1673700,10894279,18.15
9843947,9993345,4901,1715350,11708695,17.16
9843948,2139726,584,204400,2344126,9.55
9843949,9988237,3285,1149750,11137987,11.51
9843950,9972968,5177,1811950,11784918,18.17
9843951,9238630,4382,1533700,10772330,16.60
9843952,9977584,3909,1368150,11345734,13.71
9843954,9901695,2979,1042650,10944345,10.53
9843955,9859801,4613,1614550,11474351,16.38
9843956,9693283,4838,1693300,11386583,17.47
9843957,9959188,4354,1523900,11483088,15.30
9843958,9910211,3390,1186500,11096711,11.97
9843959,9970675,5005,1751750,11722425,17.57
9843960,1033513,448,156800,1190313,15.17
9843961,9969776,4441,1554350,11524126,15.59
9843962,9965623,4335,1517250,11482873,15.22
9843963,9974155,3037,1062950,11037105,10.66
9843964,9990213,2925,1023750,11013963,10.25
9843965,9978292,5634,1971900,11950192,19.76
9843966,9981282,2973,1040550,11021832,10.43
9843967,9987573,4503,1576050,11563623,15.78
9843968,9989530,3036,1062600,11052130,10.64
9843969,9981124,2962,1036700,11017824,10.39
9843970,9984519,3710,1298500,11283019,13.01
9843971,9972927,4476,1566600,11539527,15.71
9843972,9981773,1718,601300,10583073,6.02
9843973,9972890,4449,1557150,11530040,15.61
9843974,9975122,3772,1320200,11295322,13.23
9843975,9966611,2990,1046500,11013111,10.50
9843976,9980404,4704,1646400,11626804,16.50
9843977,9978451,2239,783650,10762101,7.85
9843978,9982001,2462,861700,10843701,8.63
9843979,9972901,1513,529550,10502451,5.31
9843980,9977336,3122,1092700,11070036,10.95
9843981,9997009,2162,756700,10753709,7.57
9843982,9981264,5207,1822450,11803714,18.26
9843983,9982202,3565,1247750,11229952,12.50
9843984,9986442,4082,1428700,11415142,14.31
9843985,9972324,3782,1323700,11296024,13.27
9843986,9975605,2283,799050,10774655,8.01
9843987,9982785,5198,1819300,11802085,18.22
9843988,9984419,2696,943600,10928019,9.45
9843989,9977625,2177,761950,10739575,7.64
9843990,9974878,2920,1022000,10996878,10.25
9843991,9980579,3596,1258600,11239179,12.61
9843992,9984269,2124,743400,10727669,7.45
9843993,9977759,1392,487200,10464959,4.88
9843994,9964187,2346,821100,10785287,8.24
9843995,9973256,2227,779450,10752706,7.82
9843996,9988552,3064,1072400,11060952,10.74
9843997,9974356,4049,1417150,11391506,14.21
9843998,9983428,3519,1231650,11215078,12.34
9843999,9996212,4720,1652000,11648212,16.53
9844000,9980914,4113,1439550,11420464,14.42
9844001,9983329,3498,1224300,11207629,12.26
9844002,7854566,2215,775250,8629816,9.87
9844003,4401685,629,220150,4621835,5.00
9844004,5098684,1740,609000,5707684,11.94
9844005,9905983,4344,1520400,11426383,15.35
9844006,9668254,5001,1750350,11418604,18.10
9844007,9821453,3499,1224650,11046103,12.47
9844008,9985416,2508,877800,10863216,8.79
9844009,3324697,949,332150,3656847,9.99
9844010,9975675,3858,1350300,11325975,13.54
9844011,2330678,871,304850,2635528,13.08
9844012,9979071,4616,1615600,11594671,16.19
9844013,9965139,5924,2073400,12038539,20.81
9844014,9998819,3151,1102850,11101669,11.03
9844015,9999392,3116,1090600,11089992,10.91
9844016,9987678,3658,1280300,11267978,12.82
9844017,9986583,4183,1464050,11450633,14.66
9844018,9984698,3902,1365700,11350398,13.68
9844019,9957776,1238,433300,10391076,4.35
9844020,9946785,4366,1528100,11474885,15.36
9844021,9955519,3634,1271900,11227419,12.78
9844022,3521741,1865,652750,4174491,18.53
9844023,9954334,7401,2590350,12544684,26.02
9844024,9970443,2498,874300,10844743,8.77
9844025,7142560,1874,655900,7798460,9.18
9844026,9477923,3376,1181600,10659523,12.47
9844027,9984334,5157,1804950,11789284,18.08
9844028,9982897,5825,2038750,12021647,20.42
9844029,9985609,3741,1309350,11294959,13.11
9844030,9985293,3233,1131550,11116843,11.33
9844031,9979054,3103,1086050,11065104,10.88
9844032,9910677,3706,1297100,11207777,13.09
9844033,9976710,2583,904050,10880760,9.06
9844034,9990994,2144,750400,10741394,7.51
9844035,9984534,2965,1037750,11022284,10.39
9844036,9985520,2920,1022000,11007520,10.23
9844037,9988581,3830,1340500,11329081,13.42
9844038,9999969,4002,1400700,11400669,14.01
9844039,9982609,3398,1189300,11171909,11.91
9844040,9981848,3415,1195250,11177098,11.97
9844041,9979397,4808,1682800,11662197,16.86
9844042,9954709,3300,1155000,11109709,11.60
9844043,9972613,4490,1571500,11544113,15.76
9844044,9970561,4680,1638000,11608561,16.43
9844045,9959330,4850,1697500,11656830,17.04
9844046,9958051,2681,938350,10896401,9.42
9844047,9923846,3406,1192100,11115946,12.01
9844048,9947389,3195,1118250,11065639,11.24
9844049,9965445,3346,1171100,11136545,11.75
9844050,9951679,2217,775950,10727629,7.80
9844051,9959811,2910,1018500,10978311,10.23
9844052,9964381,5064,1772400,11736781,17.79
9844053,9972366,3479,1217650,11190016,12.21
9844054,9973408,3057,1069950,11043358,10.73
9844055,9983421,2724,953400,10936821,9.55
9844056,9993502,3760,1316000,11309502,13.17
9844058,9975447,2641,924350,10899797,9.27
9844059,9975674,4042,1414700,11390374,14.18
9844060,9707146,4466,1563100,11270246,16.10
9844061,9960029,2573,900550,10860579,9.04
9844062,9922031,2896,1013600,10935631,10.22
9844064,9508221,3000,1050000,10558221,11.04
9844065,9996075,3677,1286950,11283025,12.87
9844066,3375456,240,84000,3459456,2.49
9844067,9981092,3676,1286600,11267692,12.89
9844068,9993077,4088,1430800,11423877,14.32
9844070,732426,319,111650,844076,15.24
9844071,9949867,5269,1844150,11794017,18.53
9844072,9968229,4072,1425200,11393429,14.30
9844073,9970748,2875,1006250,10976998,10.09
9844074,9980104,4507,1577450,11557554,15.81
9844075,9983234,5944,2080400,12063634,20.84
9844076,9970811,4606,1612100,11582911,16.17
9844077,9984338,4382,1533700,11518038,15.36
9844078,9976791,3731,1305850,11282641,13.09
9844079,9978164,5089,1781150,11759314,17.85
9844080,9985642,5493,1922550,11908192,19.25
9844081,9984774,4592,1607200,11591974,16.10
9844082,5973478,2957,1034950,7008428,17.33
9844083,9982891,3374,1180900,11163791,11.83
9844084,9983355,5811,2033850,12017205,20.37
9844085,9974594,4073,1425550,11400144,14.29
9844086,9975303,4206,1472100,11447403,14.76
9844087,9997172,4500,1575000,11572172,15.75
9844088,9984391,2899,1014650,10999041,10.16
9844089,9642486,4094,1432900,11075386,14.86
9844090,9975403,5284,1849400,11824803,18.54
9844091,7107479,1354,473900,7581379,6.67
9844093,9960843,4212,1474200,11435043,14.80
9844094,9441998,3630,1270500,10712498,13.46
9844095,9983630,4766,1668100,11651730,16.71
9844096,9999674,4958,1735300,11734974,17.35
9844097,9979853,6108,2137800,12117653,21.42
9844098,9985596,3092,1082200,11067796,10.84
9844099,2252570,623,218050,2470620,9.68
9844100,9249180,3504,1226400,10475580,13.26
9844101,9972537,5092,1782200,11754737,17.87
9844102,9900723,3819,1336650,11237373,13.50
9844103,9980563,2598,909300,10889863,9.11
9844104,9991619,3213,1124550,11116169,11.25
9844105,9998115,3658,1280300,11278415,12.81
9844106,9973440,4430,1550500,11523940,15.55
9844107,9993164,3434,1201900,11195064,12.03
9844108,9975329,3787,1325450,11300779,13.29
9844109,9984053,2878,1007300,10991353,10.09
9844111,9999875,4387,1535450,11535325,15.35
9844112,9984826,4307,1507450,11492276,15.10
9844113,9986315,5205,1821750,11808065,18.24
9844114,9978894,3405,1191750,11170644,11.94
9844115,9989012,2302,805700,10794712,8.07
9844116,9997081,2738,958300,10955381,9.59
9844117,9979857,3531,1235850,11215707,12.38
9844118,9982597,3648,1276800,11259397,12.79
9844119,9985830,4758,1665300,11651130,16.68
9844120,673684,814,284900,958584,42.29
9844121,9981930,3282,1148700,11130630,11.51
9844122,9981020,4330,1515500,11496520,15.18
9844123,9979865,4044,1415400,11395265,14.18
9844124,3903812,1269,444150,4347962,11.38
9844125,9994837,3439,1203650,11198487,12.04
9844126,9965976,4414,1544900,11510876,15.50
9844127,9959556,4781,1673350,11632906,16.80
9844128,9967372,3902,1365700,11333072,13.70
9844129,9976520,2531,885850,10862370,8.88
9844131,9979659,3976,1391600,11371259,13.94
9844132,9977131,3477,1216950,11194081,12.20
9844133,9989909,2756,964600,10954509,9.66
9844134,9974164,4080,1428000,11402164,14.32
9844135,9988614,4077,1426950,11415564,14.29
9844136,9965820,3780,1323000,11288820,13.28
9844137,9972451,3219,1126650,11099101,11.30
9844138,9969425,3823,1338050,11307475,13.42
9844139,3701803,990,346500,4048303,9.36
9844140,9959891,4828,1689800,11649691,16.97
9844141,9946693,4102,1435700,11382393,14.43
9844142,9951118,974,340900,10292018,3.43
9844143,9959586,3004,1051400,11010986,10.56
9844144,9968130,3864,1352400,11320530,13.57
9844145,9986909,3610,1263500,11250409,12.65
9844146,9991767,1816,635600,10627367,6.36
9844147,9985282,1523,533050,10518332,5.34
9844148,9987290,4943,1730050,11717340,17.32
9844149,9993257,7280,2548000,12541257,25.50
9844150,9504789,5453,1908550,11413339,20.08
9844151,9992507,5663,1982050,11974557,19.84
9844152,474434,277,96950,571384,20.43
9844153,9975174,6568,2298800,12273974,23.05
9844154,9978004,4723,1653050,11631054,16.57
9844155,9954545,6079,2127650,12082195,21.37
9844156,9940658,3383,1184050,11124708,11.91
9844158,9950679,4305,1506750,11457429,15.14
9844159,9945990,5175,1811250,11757240,18.21
9844160,9943516,5074,1775900,11719416,17.86
9844161,9957643,3210,1123500,11081143,11.28
9844162,9955788,3596,1258600,11214388,12.64
9844163,1223355,94,32900,1256255,2.69
9844164,9962491,4618,1616300,11578791,16.22
9844165,9959646,4042,1414700,11374346,14.20
9844166,9971776,1926,674100,10645876,6.76
9844167,9962353,3058,1070300,11032653,10.74
9844168,2856845,1143,400050,3256895,14.00
9844169,557792,177,61950,619742,11.11
9844170,9971359,1882,658700,10630059,6.61
9844171,9960522,2857,999950,10960472,10.04
9844172,9965577,5401,1890350,11855927,18.97
9844173,9971501,2638,923300,10894801,9.26
9844174,9964687,2155,754250,10718937,7.57
9844175,9075049,3254,1138900,10213949,12.55
9844176,9963983,2043,715050,10679033,7.18
9844177,9971989,2803,981050,10953039,9.84
9844178,9980782,4395,1538250,11519032,15.41
9844179,7601002,2803,981050,8582052,12.91
9844180,9990133,3401,1190350,11180483,11.92
9844181,9995749,4988,1745800,11741549,17.47
9844182,9979907,4646,1626100,11606007,16.29
9844183,9994894,4388,1535800,11530694,15.37
9844184,9991374,3930,1375500,11366874,13.77
9844185,8917303,2398,839300,9756603,9.41
9844186,9984629,3252,1138200,11122829,11.40
9844187,9989793,4873,1705550,11695343,17.07
9844188,9854405,2285,799750,10654155,8.12
9844189,9995008,2531,885850,10880858,8.86
9844190,9993774,3924,1373400,11367174,13.74
9844191,9991165,4174,1460900,11452065,14.62
9844192,9990708,6038,2113300,12104008,21.15
9844193,9409351,1657,579950,9989301,6.16
9844194,9985021,3785,1324750,11309771,13.27
9844195,9980705,5462,1911700,11892405,19.15
9844196,9987386,3047,1066450,11053836,10.68
9844197,9978648,2883,1009050,10987698,10.11
9844198,9996705,2925,1023750,11020455,10.24
9844199,9999433,3010,1053500,11052933,10.54
9844201,9979831,3389,1186150,11165981,11.89
9844202,9970143,2667,933450,10903593,9.36
9844203,9986906,6495,2273250,12260156,22.76
9844204,6603266,434,151900,6755166,2.30
9844205,9980788,4996,1748600,11729388,17.52
9844206,9981442,3698,1294300,11275742,12.97
9844207,9981700,3809,1333150,11314850,13.36
9844208,9996942,5170,1809500,11806442,18.10
9844209,9975090,4776,1671600,11646690,16.76
9844210,9981569,2839,993650,10975219,9.95
9844211,9984720,3304,1156400,11141120,11.58
9844212,9959044,2914,1019900,10978944,10.24
9844213,9992240,4321,1512350,11504590,15.14
9844214,9973890,5655,1979250,11953140,19.84
9844215,9977012,2903,1016050,10993062,10.18
9844216,9960667,3883,1359050,11319717,13.64
9844217,5086182,3394,1187900,6274082,23.36
9844218,627322,345,120750,748072,19.25
9844219,9970228,3999,1399650,11369878,14.04
9844220,9989823,3835,1342250,11332073,13.44
9844221,9993370,5042,1764700,11758070,17.66
9844222,9987446,4709,1648150,11635596,16.50
9844223,9982077,3566,1248100,11230177,12.50
9844224,9902839,4670,1634500,11537339,16.51
9844225,9992343,4296,1503600,11495943,15.05
9844226,9999590,2806,982100,10981690,9.82
9844227,9431576,3833,1341550,10773126,14.22
9844228,9980416,2694,942900,10923316,9.45
9844229,9966861,3064,1072400,11039261,10.76
9844230,9970855,4554,1593900,11564755,15.99
9844231,9970871,3055,1069250,11040121,10.72
9844232,9963312,2804,981400,10944712,9.85
9844233,9958269,3394,1187900,11146169,11.93
9844234,9962876,3698,1294300,11257176,12.99
9844235,9715613,4941,1729350,11444963,17.80
9844236,9960262,3090,1081500,11041762,10.86
9844237,9961555,4627,1619450,11581005,16.26
9844238,9983693,3543,1240050,11223743,12.42
9844239,5066874,2645,925750,5992624,18.27
9844240,9969244,4689,1641150,11610394,16.46
9844241,6847868,3407,1192450,8040318,17.41
9844242,5372831,1121,392350,5765181,7.30
9844243,6809855,2436,852600,7662455,12.52
9844245,9968746,5083,1779050,11747796,17.85
9844246,9985331,4289,1501150,11486481,15.03
9844248,9992647,3193,1117550,11110197,11.18
9844249,9995911,4296,1503600,11499511,15.04
9844250,9970161,3025,1058750,11028911,10.62
9844251,9989798,2047,716450,10706248,7.17
9844252,9980408,2422,847700,10828108,8.49
9844253,2281573,249,87150,2368723,3.82
9844254,9967538,5060,1771000,11738538,17.77
9844255,9984096,4287,1500450,11484546,15.03
9844256,6441040,2844,995400,7436440,15.45
9844258,9970356,5961,2086350,12056706,20.93
9844259,1596694,346,121100,1717794,7.58
9844260,9965215,3127,1094450,11059665,10.98
9844261,1545147,531,185850,1730997,12.03
9844262,1998410,1165,407750,2406160,20.40
9844263,9960237,2385,834750,10794987,8.38
9844264,9952569,2596,908600,10861169,9.13
9844265,9938421,2600,910000,10848421,9.16
9844266,9937800,4064,1422400,11360200,14.31
9844267,3483274,584,204400,3687674,5.87
9844268,9957684,3209,1123150,11080834,11.28
9844269,9961530,3941,1379350,11340880,13.85
9844270,9971220,5312,1859200,11830420,18.65
9844271,2970409,965,337750,3308159,11.37
9844272,9947291,3317,1160950,11108241,11.67
9844273,9941546,3719,1301650,11243196,13.09
9844274,9948384,3098,1084300,11032684,10.90
9844275,9944997,2557,894950,10839947,9.00
9844276,9966326,3994,1397900,11364226,14.03
9844277,9965555,3694,1292900,11258455,12.97
9844279,9968253,5358,1875300,11843553,18.81
9844280,1609506,539,188650,1798156,11.72
9844281,9944361,3674,1285900,11230261,12.93
9844282,9944208,3572,1250200,11194408,12.57
9844283,9967603,3147,1101450,11069053,11.05
9844284,9959894,5506,1927100,11886994,19.35
9844285,9959165,3813,1334550,11293715,13.40
9844287,9977521,6293,2202550,12180071,22.08
9844288,2540009,823,288050,2828059,11.34
9844289,9976896,2953,1033550,11010446,10.36
9844290,9983838,3106,1087100,11070938,10.89
9844291,9962883,4530,1585500,11548383,15.91
9844292,9988543,3737,1307950,11296493,13.09
9844293,9969660,3339,1168650,11138310,11.72
9844294,9720510,2076,726600,10447110,7.47
9844295,9977230,3775,1321250,11298480,13.24
9844296,9973260,3123,1093050,11066310,10.96
9844297,9986260,2323,813050,10799310,8.14
9844298,9977650,4466,1563100,11540750,15.67
9844299,2345564,769,269150,2614714,11.47
9844300,9971056,2983,1044050,11015106,10.47
9844301,9973559,2794,977900,10951459,9.80
9844302,9979268,3674,1285900,11265168,12.89
9844303,9966778,5836,2042600,12009378,20.49
9844304,7119617,2683,939050,8058667,13.19
9844305,9996522,3606,1262100,11258622,12.63
9844306,9994744,4074,1425900,11420644,14.27
9844307,2323190,1230,430500,2753690,18.53
9844308,8761361,3843,1345050,10106411,15.35
9844309,2869812,1554,543900,3413712,18.95
9844311,9992562,3687,1290450,11283012,12.91
9844312,9977674,4074,1425900,11403574,14.29
9844313,9978461,4767,1668450,11646911,16.72
9844314,9960278,3767,1318450,11278728,13.24
9844316,9950101,3743,1310050,11260151,13.17
9844317,9967467,6188,2165800,12133267,21.73
9844318,9957565,2904,1016400,10973965,10.21
9844320,9955694,3884,1359400,11315094,13.65
9844321,3505959,221,77350,3583309,2.21
9844322,4600187,1876,656600,5256787,14.27
9844323,9885267,2986,1045100,10930367,10.57
9844324,867752,486,170100,1037852,19.60
9844325,3669442,921,322350,3991792,8.78
9844326,9962285,3178,1112300,11074585,11.17
9844327,9954613,3313,1159550,11114163,11.65
9844328,9947148,4514,1579900,11527048,15.88
9844329,9967141,1824,638400,10605541,6.41
9844330,9975152,2695,943250,10918402,9.46
9844331,9973166,2690,941500,10914666,9.44
9844332,9963652,5690,1991500,11955152,19.99
9844333,9970893,2682,938700,10909593,9.41
9844334,9951723,4794,1677900,11629623,16.86
9844335,9973095,3861,1351350,11324445,13.55
9844336,9978272,3151,1102850,11081122,11.05
9844337,5808139,2264,792400,6600539,13.64
9844338,9965078,3281,1148350,11113428,11.52
9844339,9969386,4440,1554000,11523386,15.59
9844340,9995256,6838,2393300,12388556,23.94
9844341,9991295,1966,688100,10679395,6.89
9844343,9975095,3168,1108800,11083895,11.12
9844344,9994829,3451,1207850,11202679,12.08
9844345,4880017,2101,735350,5615367,15.07
9844346,9965006,4137,1447950,11412956,14.53
9844347,9971799,3641,1274350,11246149,12.78
9844348,9968909,1149,402150,10371059,4.03
9844349,1379675,480,168000,1547675,12.18
9844350,9962992,2734,956900,10919892,9.60
9844352,3757574,2109,738150,4495724,19.64
9844353,9967809,3672,1285200,11253009,12.89
9844354,9954781,5491,1921850,11876631,19.31
9844355,1853460,161,56350,1909810,3.04
9844356,2490155,1102,385700,2875855,15.49
9844357,9986262,3946,1381100,11367362,13.83
9844358,9997005,2191,766850,10763855,7.67
9844359,9990309,3732,1306200,11296509,13.07
9844360,9989409,3818,1336300,11325709,13.38
9844361,9988698,5359,1875650,11864348,18.78
9844362,9986148,4484,1569400,11555548,15.72
9844363,9898375,3477,1216950,11115325,12.29
9844364,9995983,4251,1487850,11483833,14.88
9844365,9995863,3182,1113700,11109563,11.14
9844366,9984052,6920,2422000,12406052,24.26
9844367,9980075,5802,2030700,12010775,20.35
9844368,2209967,708,247800,2457767,11.21
9844369,9998080,6241,2184350,12182430,21.85
9844370,9984221,5611,1963850,11948071,19.67
9844371,3874637,4954,1733900,5608537,44.75
9844372,9966214,3354,1173900,11140114,11.78
9844373,9937605,3956,1384600,11322205,13.93
9844374,9974028,4949,1732150,11706178,17.37
9844375,9958503,6452,2258200,12216703,22.68
9844376,9958984,2935,1027250,10986234,10.31
9844377,9958193,3608,1262800,11220993,12.68
9844378,9972566,3427,1199450,11172016,12.03
9844379,6599181,2537,887950,7487131,13.46
9844380,9981692,3183,1114050,11095742,11.16
9844381,9987752,3271,1144850,11132602,11.46
9844382,9979556,1646,576100,10555656,5.77
9844383,9975783,3509,1228150,11203933,12.31
9844384,299214,145,50750,349964,16.96
9844385,9990552,4531,1585850,11576402,15.87
9844386,9971463,1732,606200,10577663,6.08
9844387,9994571,1691,591850,10586421,5.92
9844388,9998842,2231,780850,10779692,7.81
9844389,1428043,582,203700,1631743,14.26
9844390,9962376,3510,1228500,11190876,12.33
9844391,9981515,4419,1546650,11528165,15.50
9844392,9980426,5423,1898050,11878476,19.02
9844393,9970244,2483,869050,10839294,8.72
9844394,3357993,2110,738500,4096493,21.99
9844395,9921237,4980,1743000,11664237,17.57
9844396,9981285,3233,1131550,11112835,11.34
9844397,9992798,3205,1121750,11114548,11.23
9844398,9977958,5516,1930600,11908558,19.35
9844399,9985158,2063,722050,10707208,7.23
9844400,9987373,4084,1429400,11416773,14.31
9844401,9996729,3052,1068200,11064929,10.69
9844402,9981706,2641,924350,10906056,9.26
9844403,9976979,3550,1242500,11219479,12.45
9844404,9689741,3607,1262450,10952191,13.03
9844405,9984846,2965,1037750,11022596,10.39
9844406,4391274,3735,1307250,5698524,29.77
9844407,473347,262,91700,565047,19.37
9844408,4382093,1578,552300,4934393,12.60
9844409,9978573,3597,1258950,11237523,12.62
9844410,9988130,6517,2280950,12269080,22.84
9844411,5101878,2502,875700,5977578,17.16
9844412,9979425,4727,1654450,11633875,16.58
9844413,4762050,2055,719250,5481300,15.10
9844414,218045,42,14700,232745,6.74
9844415,9957375,4812,1684200,11641575,16.91
9844416,7437188,2057,719950,8157138,9.68
9844417,9972881,5692,1992200,11965081,19.98
9844418,9991409,4717,1650950,11642359,16.52
9844419,9998260,4299,1504650,11502910,15.05
9844420,9997599,2809,983150,10980749,9.83
9844421,9987938,4001,1400350,11388288,14.02
9844422,9965903,4998,1749300,11715203,17.55
9844423,9983642,4106,1437100,11420742,14.39
9844424,9986172,4846,1696100,11682272,16.98
9844425,9969930,3170,1109500,11079430,11.13
9844426,5352911,1986,695100,6048011,12.99
9844427,9969387,2014,704900,10674287,7.07
9844428,9981406,7972,2790200,12771606,27.95
9844429,9983116,3477,1216950,11200066,12.19
9844430,9980717,6389,2236150,12216867,22.40
9844431,9981059,4799,1679650,11660709,16.83
9844432,6709020,2575,901250,7610270,13.43
9844433,9970053,3676,1286600,11256653,12.90
9844434,450157,224,78400,528557,17.42
9844435,9967988,3985,1394750,11362738,13.99
9844436,2793641,1083,379050,3172691,13.57
9844437,9964822,4263,1492050,11456872,14.97
9844438,351447,201,70350,421797,20.02
9844439,9965510,4552,1593200,11558710,15.99
9844440,9967004,5215,1825250,11792254,18.31
9844441,9949643,2216,775600,10725243,7.80
9844442,9946172,3270,1144500,11090672,11.51
9844443,9948525,5556,1944600,11893125,19.55
9844444,9950111,3494,1222900,11173011,12.29
9844445,9955747,5327,1864450,11820197,18.73
9844446,9964798,2437,852950,10817748,8.56
9844447,9962472,4236,1482600,11445072,14.88
9844448,9976138,5116,1790600,11766738,17.95
9844449,9978724,3626,1269100,11247824,12.72
9844450,1429255,788,275800,1705055,19.30
9844451,9896397,3366,1178100,11074497,11.90
9844452,6132011,4203,1471050,7603061,23.99
9844453,9966028,3715,1300250,11266278,13.05
9844454,9979114,3769,1319150,11298264,13.22
9844455,9979230,4012,1404200,11383430,14.07
9844456,9986881,5241,1834350,11821231,18.37
9844457,9987157,3054,1068900,11056057,10.70
9844458,8056154,3030,1060500,9116654,13.16
9844459,9961163,3639,1273650,11234813,12.79
9844460,9958996,4382,1533700,11492696,15.40
9844461,354551,135,47250,401801,13.33
9844462,9941698,5556,1944600,11886298,19.56
9844463,9953473,3502,1225700,11179173,12.31
9844464,9951166,4018,1406300,11357466,14.13
9844465,9969128,649,227150,10196278,2.28
9844466,9964401,238,83300,10047701,0.84
9844467,9973352,2804,981400,10954752,9.84
9844468,9985703,1748,611800,10597503,6.13
9844469,9978561,196,68600,10047161,0.69
9844470,9979093,3249,1137150,11116243,11.40
9844471,9970791,1054,368900,10339691,3.70
9844472,9967886,3851,1347850,11315736,13.52
9844473,9948322,4509,1578150,11526472,15.86
9844474,9886026,3866,1353100,11239126,13.69
9844476,9928710,4005,1401750,11330460,14.12
9844477,9948323,3233,1131550,11079873,11.37
9844478,9862022,3252,1138200,11000222,11.54
9844479,9949102,5433,1901550,11850652,19.11
9844480,9941262,3118,1091300,11032562,10.98
9844481,9863025,4374,1530900,11393925,15.52
9844482,9946438,6203,2171050,12117488,21.83
9844483,1740894,1437,502950,2243844,28.89
9844484,9450322,3936,1377600,10827922,14.58
9844485,9901147,4239,1483650,11384797,14.98
9844486,9966879,4472,1565200,11532079,15.70
9844487,9970347,1673,585550,10555897,5.87
9844488,9963813,5138,1798300,11762113,18.05
9844489,1120083,473,165550,1285633,14.78
9844490,9929827,4589,1606150,11535977,16.18
9844491,2437691,506,177100,2614791,7.27
9844492,9926228,4398,1539300,11465528,15.51
9844493,821398,204,71400,892798,8.69
9844494,9942805,3144,1100400,11043205,11.07
9844495,9888430,4315,1510250,11398680,15.27
9844496,9886198,4801,1680350,11566548,17.00
9844497,4690038,2112,739200,5429238,15.76
9844498,308033,42,14700,322733,4.77
9844499,9970633,4539,1588650,11559283,15.93
9844500,9970139,2289,801150,10771289,8.04
9844501,9984589,3789,1326150,11310739,13.28
9844502,9985213,5730,2005500,11990713,20.08
9844503,9987613,3155,1104250,11091863,11.06
9844504,9977417,1727,604450,10581867,6.06
9844505,9966320,2994,1047900,11014220,10.51
9844506,3571141,1736,607600,4178741,17.01
9844507,9987381,2343,820050,10807431,8.21
9844508,9782265,2116,740600,10522865,7.57
9844509,5718342,2998,1049300,6767642,18.35
9844510,217936,110,38500,256436,17.67
9844511,9740362,6588,2305800,12046162,23.67
9844512,9995075,3288,1150800,11145875,11.51
9844513,9659300,2063,722050,10381350,7.48
9844514,9905649,2386,835100,10740749,8.43
9844515,9981220,5296,1853600,11834820,18.57
9844516,9349312,5128,1794800,11144112,19.20
9844517,9924584,2999,1049650,10974234,10.58
9844518,9964974,2855,999250,10964224,10.03
9844519,9974464,4092,1432200,11406664,14.36
9844520,9986433,3295,1153250,11139683,11.55
9844521,9984961,5225,1828750,11813711,18.32
9844523,9982624,3699,1294650,11277274,12.97
9844524,9935299,2081,728350,10663649,7.33
9844525,9980062,4219,1476650,11456712,14.80
9844526,9978582,2834,991900,10970482,9.94
9844527,9979653,3638,1273300,11252953,12.76
9844528,9570802,785,274750,9845552,2.87
9844529,2596966,1004,351400,2948366,13.53
9844530,9978455,3832,1341200,11319655,13.44
9844531,9984568,2989,1046150,11030718,10.48
9844532,9987342,3837,1342950,11330292,13.45
9844533,9959591,4800,1680000,11639591,16.87
9844534,9969369,3105,1086750,11056119,10.90
9844535,9947644,5170,1809500,11757144,18.19
9844536,9957358,2965,1037750,10995108,10.42
9844537,9952766,3514,1229900,11182666,12.36
9844538,9852194,1544,540400,10392594,5.49
9844539,9953448,6392,2237200,12190648,22.48
9844540,1989740,556,194600,2184340,9.78
9844541,9980130,4223,1478050,11458180,14.81
9844542,9975029,3817,1335950,11310979,13.39
9844543,9966428,2116,740600,10707028,7.43
9844544,9963631,3544,1240400,11204031,12.45
9844545,9948671,4155,1454250,11402921,14.62
9844546,9962829,2600,910000,10872829,9.13
9844547,9971022,3420,1197000,11168022,12.00
9844548,9967787,2844,995400,10963187,9.99
9844549,9979963,4041,1414350,11394313,14.17
9844550,9993796,2852,998200,10991996,9.99
9844551,9977699,305,106750,10084449,1.07
9844552,9983358,4244,1485400,11468758,14.88
9844553,9982337,5263,1842050,11824387,18.45
9844554,9986520,2868,1003800,10990320,10.05
9844556,8796220,3678,1287300,10083520,14.63
9844557,4443625,2034,711900,5155525,16.02
9844558,9973261,3701,1295350,11268611,12.99
9844559,9992183,4063,1422050,11414233,14.23
9844560,9900256,3877,1356950,11257206,13.71
9844561,9945957,1629,570150,10516107,5.73
9844562,2910136,1339,468650,3378786,16.10
9844563,9993844,5210,1823500,11817344,18.25
9844564,9965944,1573,550550,10516494,5.52
9844565,9984199,3350,1172500,11156699,11.74
9844566,9994989,2790,976500,10971489,9.77
9844567,9987592,2717,950950,10938542,9.52
9844568,9991624,4301,1505350,11496974,15.07
9844569,9978366,2601,910350,10888716,9.12
9844570,9978134,1036,362600,10340734,3.63
9844571,9979603,6698,2344300,12323903,23.49
9844572,9799507,2433,851550,10651057,8.69
9844573,9741541,4513,1579550,11321091,16.21
9844574,9990030,4543,1590050,11580080,15.92
9844575,9984348,1011,353850,10338198,3.54
9844576,9993831,4896,1713600,11707431,17.15
9844577,9986139,3013,1054550,11040689,10.56
9844578,9978028,4331,1515850,11493878,15.19
9844579,9996651,4189,1466150,11462801,14.67
9844580,6624457,2675,936250,7560707,14.13
9844581,1241682,565,197750,1439432,15.93
9844582,9940242,2947,1031450,10971692,10.38
9844583,6468794,2915,1020250,7489044,15.77
9844584,9989748,3688,1290800,11280548,12.92
9844585,9709530,3560,1246000,10955530,12.83
9844586,9984818,4088,1430800,11415618,14.33
9844587,9992178,3488,1220800,11212978,12.22
9844588,9996408,2656,929600,10926008,9.30
9844589,9971680,1773,620550,10592230,6.22
9844590,9981065,2007,702450,10683515,7.04
9844591,9979565,4845,1695750,11675315,16.99
9844592,9981818,5990,2096500,12078318,21.00
9844593,9985395,2159,755650,10741045,7.57
9844594,9990630,2710,948500,10939130,9.49
9844596,9985716,3851,1347850,11333566,13.50
9844597,9970217,4839,1693650,11663867,16.99
9844598,7161564,2160,756000,7917564,10.56
9844599,9993750,4443,1555050,11548800,15.56
9844600,9998332,3338,1168300,11166632,11.68
9844601,9978497,3280,1148000,11126497,11.50
9844602,9495928,2605,911750,10407678,9.60
9844603,9993816,3173,1110550,11104366,11.11
9844604,9985444,3099,1084650,11070094,10.86
9844605,757855,131,45850,803705,6.05
9844606,9987672,3203,1121050,11108722,11.22
9844607,4172851,1527,534450,4707301,12.81
9844608,9981829,3787,1325450,11307279,13.28
9844609,9994230,3409,1193150,11187380,11.94
9844610,9976434,4405,1541750,11518184,15.45
9844611,9956947,4125,1443750,11400697,14.50
9844612,9971973,5500,1925000,11896973,19.30
9844613,9959432,4250,1487500,11446932,14.94
9844614,9967205,2932,1026200,10993405,10.30
9844615,9966083,3221,1127350,11093433,11.31
9844616,9793993,3779,1322650,11116643,13.50
9844617,3756040,2545,890750,4646790,23.72
9844618,1245990,518,181300,1427290,14.55
9844619,9952020,5749,2012150,11964170,20.22
9844620,126349,75,26250,152599,20.78
9844621,9965413,2647,926450,10891863,9.30
9844622,9967528,4366,1528100,11495628,15.33
9844623,9880347,6083,2129050,12009397,21.55
9844624,9989988,3950,1382500,11372488,13.84
9844625,9970626,3884,1359400,11330026,13.63
9844626,9983014,3603,1261050,11244064,12.63
9844627,9998984,4186,1465100,11464084,14.65
9844628,9989705,4132,1446200,11435905,14.48
9844629,9987616,2656,929600,10917216,9.31
9844630,9735751,5007,1752450,11488201,18.00
9844631,9978985,3177,1111950,11090935,11.14
9844632,9981171,3494,1222900,11204071,12.25
9844633,4711565,883,309050,5020615,6.56
9844634,9970451,4610,1613500,11583951,16.18
9844636,9968080,4112,1439200,11407280,14.44
9844637,9967064,4694,1642900,11609964,16.48
9844638,1465139,310,108500,1573639,7.41
9844639,9955998,4596,1608600,11564598,16.16
9844640,9971611,6396,2238600,12210211,22.45
9844641,9986888,4002,1400700,11387588,14.03
9844642,9979086,4662,1631700,11610786,16.35
9844643,9943572,3044,1065400,11008972,10.71
9844644,9991618,3702,1295700,11287318,12.97
9844645,9996564,2122,742700,10739264,7.43
9844646,9998605,3085,1079750,11078355,10.80
9844647,9980225,3084,1079400,11059625,10.82
9844648,5370977,1383,484050,5855027,9.01
9844649,9957382,4559,1595650,11553032,16.02
9844650,7144301,2070,724500,7868801,10.14
9844651,9941172,3727,1304450,11245622,13.12
9844652,9961084,4120,1442000,11403084,14.48
9844653,9938557,8010,2803500,12742057,28.21
9844654,9928681,3095,1083250,11011931,10.91
9844655,9941358,4473,1565550,11506908,15.75
9844656,9952442,2442,854700,10807142,8.59
9844657,9951068,2547,891450,10842518,8.96
9844658,9976160,4098,1434300,11410460,14.38
9844659,9970133,3428,1199800,11169933,12.03
9844660,9990098,3668,1283800,11273898,12.85
9844661,9986285,3932,1376200,11362485,13.78
9844662,9986722,4056,1419600,11406322,14.21
9844663,9996154,3360,1176000,11172154,11.76
9844664,9998811,3698,1294300,11293111,12.94
9844665,9987961,2659,930650,10918611,9.32
9844666,3828445,528,184800,4013245,4.83
9844667,9977147,2323,813050,10790197,8.15
9844668,9976896,3956,1384600,11361496,13.88
9844669,9985725,4668,1633800,11619525,16.36
9844670,9975997,5445,1905750,11881747,19.10
9844671,9976332,2677,936950,10913282,9.39
9844672,9999579,4451,1557850,11557429,15.58
9844673,9961536,2233,781550,10743086,7.85
9844674,9993899,4591,1606850,11600749,16.08
9844675,9977753,1497,523950,10501703,5.25
9844676,9985941,2981,1043350,11029291,10.45
9844677,9987338,4168,1458800,11446138,14.61
9844678,9993549,2825,988750,10982299,9.89
9844679,9982923,2503,876050,10858973,8.78
9844680,9986057,4320,1512000,11498057,15.14
9844681,9995383,4054,1418900,11414283,14.20
9844682,9973777,4013,1404550,11378327,14.08
9844683,9966560,3460,1211000,11177560,12.15
9844684,9980477,3077,1076950,11057427,10.79
9844685,9969487,3895,1363250,11332737,13.67
9844686,9952480,3849,1347150,11299630,13.54
9844688,9949434,2858,1000300,10949734,10.05
9844689,9959860,2768,968800,10928660,9.73
9844690,9975617,3966,1388100,11363717,13.91
9844691,9987213,2703,946050,10933263,9.47
9844692,9978344,2668,933800,10912144,9.36
9844693,9983395,3220,1127000,11110395,11.29
9844694,9964496,3996,1398600,11363096,14.04
9844695,9142172,3105,1086750,10228922,11.89
9844697,7748650,2607,912450,8661100,11.78
9844698,9956474,3317,1160950,11117424,11.66
9844699,9970725,4473,1565550,11536275,15.70
9844700,9975140,3952,1383200,11358340,13.87
9844701,9979457,3684,1289400,11268857,12.92
9844702,9953915,2441,854350,10808265,8.58
9844703,9971993,3706,1297100,11269093,13.01
9844704,9508585,1783,624050,10132635,6.56
9844705,9986545,5289,1851150,11837695,18.54
9844706,9737627,4270,1494500,11232127,15.35
9844707,9993313,4125,1443750,11437063,14.45
9844708,2185678,1250,437500,2623178,20.02
9844709,1905709,663,232050,2137759,12.18
9844710,1900158,1745,610750,2510908,32.14
9844711,9997822,3797,1328950,11326772,13.29
9844712,2182349,586,205100,2387449,9.40
9844713,9997131,3723,1303050,11300181,13.03
9844714,9982553,4203,1471050,11453603,14.74
9844715,9990653,2752,963200,10953853,9.64
9844716,9989016,2959,1035650,11024666,10.37
9844717,9988331,3607,1262450,11250781,12.64
9844718,9986161,1799,629650,10615811,6.31
9844719,9987253,3910,1368500,11355753,13.70
9844720,9991069,3285,1149750,11140819,11.51
9844721,9979241,3054,1068900,11048141,10.71
9844722,9980251,4228,1479800,11460051,14.83
9844724,9984667,3597,1258950,11243617,12.61
9844725,9974713,221,77350,10052063,0.78
9844726,9983517,4117,1440950,11424467,14.43
9844727,9991895,3802,1330700,11322595,13.32
9844728,9985204,4158,1455300,11440504,14.57
9844729,9990563,4091,1431850,11422413,14.33
9844730,9989988,2882,1008700,10998688,10.10
9844731,9769200,4112,1439200,11208400,14.73
9844732,3169408,2279,797650,3967058,25.17
9844733,9984793,3789,1326150,11310943,13.28
9844734,9987361,4674,1635900,11623261,16.38
9844735,9973644,3543,1240050,11213694,12.43
9844736,9988693,3673,1285550,11274243,12.87
9844737,6419778,1448,506800,6926578,7.89
9844738,9984494,4810,1683500,11667994,16.86
9844739,2195740,487,170450,2366190,7.76
9844740,9986758,2992,1047200,11033958,10.49
9844741,9972439,2808,982800,10955239,9.86
9844742,9994401,3487,1220450,11214851,12.21
9844744,9983610,4086,1430100,11413710,14.32
9844745,9991012,3043,1065050,11056062,10.66
9844746,9980389,3953,1383550,11363939,13.86
9844747,9970734,4200,1470000,11440734,14.74
9844748,9984791,3053,1068550,11053341,10.70
9844749,9991288,4081,1428350,11419638,14.30
9844750,9992477,3404,1191400,11183877,11.92
9844751,9911559,4655,1629250,11540809,16.44
9844752,9969559,4897,1713950,11683509,17.19
9844753,9971229,3783,1324050,11295279,13.28
9844754,9994739,4084,1429400,11424139,14.30
9844755,9625105,3102,1085700,10710805,11.28
9844756,9980189,5587,1955450,11935639,19.59
9844757,9998335,4338,1518300,11516635,15.19
9844758,9999747,3490,1221500,11221247,12.22
9844759,9972973,2766,968100,10941073,9.71
9844760,9999512,3275,1146250,11145762,11.46
9844761,9991061,6190,2166500,12157561,21.68
9844762,945647,221,77350,1022997,8.18
9844763,9905343,4089,1431150,11336493,14.45
9844764,9974837,3304,1156400,11131237,11.59
9844765,9965529,3358,1175300,11140829,11.79
9844766,9969918,3902,1365700,11335618,13.70
9844767,9974687,3702,1295700,11270387,12.99
9844769,9982572,4457,1559950,11542522,15.63
9844770,5293551,4297,1503950,6797501,28.41
9844772,9980550,4108,1437800,11418350,14.41
9844773,9972275,3659,1280650,11252925,12.84
9844774,9980538,3008,1052800,11033338,10.55
9844775,9623770,4721,1652350,11276120,17.17
9844776,9967886,4947,1731450,11699336,17.37
9844777,9944540,4971,1739850,11684390,17.50
9844778,9938407,3153,1103550,11041957,11.10
9844779,9958450,5192,1817200,11775650,18.25
9844780,948433,214,74900,1023333,7.90
9844781,5295737,1079,377650,5673387,7.13
9844782,9971166,3317,1160950,11132116,11.64
9844783,9952348,3794,1327900,11280248,13.34
9844784,9967458,3977,1391950,11359408,13.96
9844785,9973736,5130,1795500,11769236,18.00
9844786,9958358,3021,1057350,11015708,10.62
9844787,9961994,4797,1678950,11640944,16.85
9844788,9969659,4302,1505700,11475359,15.10
9844789,9958897,4470,1564500,11523397,15.71
9844790,9852463,1142,399700,10252163,4.06
9844791,9788983,2122,742700,10531683,7.59
9844793,9947833,4654,1628900,11576733,16.37
9844794,9953215,4676,1636600,11589815,16.44
9844795,9951047,3762,1316700,11267747,13.23
9844796,9965345,5274,1845900,11811245,18.52
9844799,9748865,2648,926800,10675665,9.51
9844800,9975085,4210,1473500,11448585,14.77
9844801,9969418,3490,1221500,11190918,12.25
9844803,9973674,3983,1394050,11367724,13.98
9844804,264835,117,40950,305785,15.46
9844805,9945773,4735,1657250,11603023,16.66
9844806,9957924,5572,1950200,11908124,19.58
9844807,9953185,4625,1618750,11571935,16.26
9844808,9949622,3829,1340150,11289772,13.47
9844809,8920794,3677,1286950,10207744,14.43
9844810,9927657,2395,838250,10765907,8.44
9844811,9918141,1374,480900,10399041,4.85
9844812,671476,628,219800,891276,32.73
9844813,9900726,3558,1245300,11146026,12.58
9844814,9905306,3708,1297800,11203106,13.10
9844815,9844719,5355,1874250,11718969,19.04
9844816,9920044,5808,2032800,11952844,20.49
9844817,9944803,5337,1867950,11812753,18.78
9844818,9690684,2330,815500,10506184,8.42
9844819,9950909,4896,1713600,11664509,17.22
9844820,9965876,2771,969850,10935726,9.73
9844821,9958821,3333,1166550,11125371,11.71
9844822,9972864,3708,1297800,11270664,13.01
9844823,9968034,3427,1199450,11167484,12.03
9844824,9965282,6266,2193100,12158382,22.01
9844825,9965050,2856,999600,10964650,10.03
9844826,9973300,666,233100,10206400,2.34
9844827,9987431,3667,1283450,11270881,12.85
9844828,9984146,1443,505050,10489196,5.06
9844829,3173993,1043,365050,3539043,11.50
9844830,9971854,4063,1422050,11393904,14.26
9844831,8961033,3575,1251250,10212283,13.96
9844832,9974307,3086,1080100,11054407,10.83
9844833,9959449,2682,938700,10898149,9.43
9844834,9969975,3424,1198400,11168375,12.02
9844835,9981830,2654,928900,10910730,9.31
9844836,7123404,2663,932050,8055454,13.08
9844837,9984385,4227,1479450,11463835,14.82
9844838,9972373,4369,1529150,11501523,15.33
9844839,9954595,6193,2167550,12122145,21.77
9844840,9955271,2530,885500,10840771,8.89
9844841,9972360,4937,1727950,11700310,17.33
9844842,9971531,4836,1692600,11664131,16.97
9844843,9977430,3353,1173550,11150980,11.76
9844844,9981760,1468,513800,10495560,5.15
9844845,9988377,2421,847350,10835727,8.48
9844846,9979212,3927,1374450,11353662,13.77
9844847,9997886,3276,1146600,11144486,11.47
9844848,9986920,3917,1370950,11357870,13.73
9844849,9957662,3633,1271550,11229212,12.77
9844850,9981731,5220,1827000,11808731,18.30
9844851,9999879,4028,1409800,11409679,14.10
9844852,9985920,3843,1345050,11330970,13.47
9844853,9974120,3646,1276100,11250220,12.79
9844854,9992720,4643,1625050,11617770,16.26
9844855,9977800,3620,1267000,11244800,12.70
9844856,9964772,4675,1636250,11601022,16.42
9844857,9969997,2513,879550,10849547,8.82
9844858,9985563,4453,1558550,11544113,15.61
9844859,9979280,5251,1837850,11817130,18.42
9844860,3728411,1449,507150,4235561,13.60
9844862,9967442,4759,1665650,11633092,16.71
9844863,9990975,7031,2460850,12451825,24.63
9844864,9997509,7672,2685200,12682709,26.86
9844865,9969403,4271,1494850,11464253,14.99
9844866,9994374,5436,1902600,11896974,19.04
9844867,1159890,374,130900,1290790,11.29
9844868,7479527,2342,819700,8299227,10.96
9844869,9970018,5388,1885800,11855818,18.91
9844870,9974474,4177,1461950,11436424,14.66
9844871,9982736,4790,1676500,11659236,16.79
9844872,9857240,4698,1644300,11501540,16.68
9844873,9933142,4573,1600550,11533692,16.11
9844874,9932327,5350,1872500,11804827,18.85
9844875,9962100,5194,1817900,11780000,18.25
9844876,7266512,2380,833000,8099512,11.46
9844877,139406,42,14700,154106,10.54
9844878,8840104,1395,488250,9328354,5.52
9844879,9949990,4424,1548400,11498390,15.56
9844880,9952201,6468,2263800,12216001,22.75
9844881,9945715,5423,1898050,11843765,19.08
9844882,9952634,5667,1983450,11936084,19.93
9844883,9972144,4722,1652700,11624844,16.57
9844884,9973843,4791,1676850,11650693,16.81
9844885,9981594,5194,1817900,11799494,18.21
9844886,9915474,5324,1863400,11778874,18.79
9844887,1617098,1712,599200,2216298,37.05
9844888,7309167,1759,615650,7924817,8.42
9844889,9800181,3166,1108100,10908281,11.31
9844890,9979364,3557,1244950,11224314,12.48
9844891,5229157,2825,988750,6217907,18.91
9844892,8416287,7290,2551500,10967787,30.32
9844893,9966915,4603,1611050,11577965,16.16
9844894,9987260,3623,1268050,11255310,12.70
9844895,9991229,3388,1185800,11177029,11.87
9844896,2447968,1434,501900,2949868,20.50
9844897,9986073,2928,1024800,11010873,10.26
9844898,9971435,5248,1836800,11808235,18.42
9844899,9980591,2802,980700,10961291,9.83
9844900,9722926,5326,1864100,11587026,19.17
9844902,9969959,5275,1846250,11816209,18.52
9844903,9963504,5004,1751400,11714904,17.58
9844904,9977016,3726,1304100,11281116,13.07
9844905,9987781,4250,1487500,11475281,14.89
9844906,9989722,4675,1636250,11625972,16.38
9844908,9970553,5291,1851850,11822403,18.57
9844909,9667467,7162,2506700,12174167,25.93
9844910,7371225,3405,1191750,8562975,16.17
9844911,9998889,3445,1205750,11204639,12.06
9844912,9980287,2445,855750,10836037,8.57
9844913,9968731,4218,1476300,11445031,14.81
9844914,9980611,3256,1139600,11120211,11.42
9844915,6814643,4499,1574650,8389293,23.11
9844916,9989885,3899,1364650,11354535,13.66
9844917,9997579,7272,2545200,12542779,25.46
9844918,9981491,5033,1761550,11743041,17.65
9844919,9978055,3629,1270150,11248205,12.73
9844920,9979854,6603,2311050,12290904,23.16
9844921,9990105,3834,1341900,11332005,13.43
9844922,9983087,2388,835800,10818887,8.37
9844923,9996104,2208,772800,10768904,7.73
9844924,9986321,3869,1354150,11340471,13.56
9844925,9983635,1542,539700,10523335,5.41
9844926,9985444,4896,1713600,11699044,17.16
9844927,9977076,3729,1305150,11282226,13.08
9844928,9994732,4690,1641500,11636232,16.42
9844929,9985124,5483,1919050,11904174,19.22
9844930,9979636,5675,1986250,11965886,19.90
9844932,9960974,5305,1856750,11817724,18.64
9844933,9956207,4632,1621200,11577407,16.28
9844934,9956513,4687,1640450,11596963,16.48
9844935,9976319,2980,1043000,11019319,10.45
9844936,2404412,1960,686000,3090412,28.53
9844937,9959410,4352,1523200,11482610,15.29
9844938,9955503,2066,723100,10678603,7.26
9844939,9959450,4103,1436050,11395500,14.42
9844940,3323270,1294,452900,3776170,13.63
9844941,1037486,363,127050,1164536,12.25
9844942,9984571,5499,1924650,11909221,19.28
9844943,9982700,5322,1862700,11845400,18.66
9844944,9984720,4114,1439900,11424620,14.42
9844945,9990431,5819,2036650,12027081,20.39
9844946,9984604,6473,2265550,12250154,22.69
9844947,9986458,5252,1838200,11824658,18.41
9844948,9977301,4129,1445150,11422451,14.48
9844949,9986314,5979,2092650,12078964,20.96
9844950,9979476,4104,1436400,11415876,14.39
9844951,3243171,1084,379400,3622571,11.70
9844952,9982560,3644,1275400,11257960,12.78
9844953,9977333,4810,1683500,11660833,16.87
9844954,9983538,2062,721700,10705238,7.23
9844956,9972196,5532,1936200,11908396,19.42
9844957,2896029,1666,583100,3479129,20.13
9844958,9983613,4313,1509550,11493163,15.12
9844959,9977746,4599,1609650,11587396,16.13
9844960,9978488,4455,1559250,11537738,15.63
9844961,9981379,4121,1442350,11423729,14.45
9844962,9982904,3479,1217650,11200554,12.20
9844963,9985369,4422,1547700,11533069,15.50
9844964,9975312,4027,1409450,11384762,14.13
9844965,9999358,3886,1360100,11359458,13.60
9844966,9972260,7101,2485350,12457610,24.92
9844967,9986208,3900,1365000,11351208,13.67
9844969,9982568,4149,1452150,11434718,14.55
9844970,9987933,4216,1475600,11463533,14.77
9844971,9997830,3198,1119300,11117130,11.20
9844972,9983527,3958,1385300,11368827,13.88
9844973,9980907,4319,1511650,11492557,15.15
9844975,9952221,3934,1376900,11329121,13.84
9844976,7360150,1966,688100,8048250,9.35
9844977,9978379,5156,1804600,11782979,18.09
9844978,9970076,5411,1893850,11863926,19.00
9844979,9969963,4757,1664950,11634913,16.70
9844980,4155858,1450,507500,4663358,12.21
9844981,9976653,5214,1824900,11801553,18.29
9844982,9976723,4248,1486800,11463523,14.90
9844983,9968383,5534,1936900,11905283,19.43
9844984,9828920,4745,1660750,11489670,16.90
9844985,9972716,3856,1349600,11322316,13.53
9844986,5080176,1026,359100,5439276,7.07
9844987,9986599,5914,2069900,12056499,20.73
9844988,9986232,6283,2199050,12185282,22.02
9844989,8065521,1553,543550,8609071,6.74
9844990,9976761,5682,1988700,11965461,19.93
9844991,9998708,5119,1791650,11790358,17.92
9844992,9994431,3874,1355900,11350331,13.57
9844993,9988203,4563,1597050,11585253,15.99
9844994,9991631,3170,1109500,11101131,11.10
9844995,9972451,3504,1226400,11198851,12.30
9844996,9982302,3982,1393700,11376002,13.96
9844997,9980182,2737,957950,10938132,9.60
9844998,9965055,4764,1667400,11632455,16.73
9844999,9966802,2341,819350,10786152,8.22
9845000,9956880,4814,1684900,11641780,16.92
9845001,9978783,5040,1764000,11742783,17.68
9845002,9969808,3876,1356600,11326408,13.61
9845003,9982486,4388,1535800,11518286,15.38
9845004,9999793,3124,1093400,11093193,10.93
9845005,9994930,4887,1710450,11705380,17.11
9845006,9980666,2144,750400,10731066,7.52
9845008,9106420,4516,1580600,10687020,17.36
9845009,9940815,4864,1702400,11643215,17.13
9845010,2125913,959,335650,2461563,15.79
9845011,9939540,3436,1202600,11142140,12.10
9845012,9940044,4703,1646050,11586094,16.56
9845013,839654,347,121450,961104,14.46
9845014,9930065,4388,1535800,11465865,15.47
9845015,9952460,6200,2170000,12122460,21.80
9845016,9946432,2180,763000,10709432,7.67
9845017,9937538,6047,2116450,12053988,21.30
9845018,9939900,6177,2161950,12101850,21.75
9845019,9953626,4035,1412250,11365876,14.19
9845020,257848,42,14700,272548,5.70
9845021,9916237,5817,2035950,11952187,20.53
9845023,6274413,1108,387800,6662213,6.18
9845024,9928621,4261,1491350,11419971,15.02
9845025,5175107,3588,1255800,6430907,24.27
9845026,5569771,3818,1336300,6906071,23.99
9845027,9942060,6127,2144450,12086510,21.57
9845028,9955450,4393,1537550,11493000,15.44
9845029,9976649,3338,1168300,11144949,11.71
9845030,9974049,4024,1408400,11382449,14.12
9845031,9975763,3186,1115100,11090863,11.18
9845032,9977130,4626,1619100,11596230,16.23
9845033,9981447,3127,1094450,11075897,10.96
9845034,9997440,3580,1253000,11250440,12.53
9845035,3419515,966,338100,3757615,9.89
9845036,1928336,649,227150,2155486,11.78
9845037,9956988,4700,1645000,11601988,16.52
9845038,9972804,3176,1111600,11084404,11.15
9845039,9496009,6270,2194500,11690509,23.11
9845041,9981356,4008,1402800,11384156,14.05
9845042,9964406,4196,1468600,11433006,14.74
9845043,9973221,2358,825300,10798521,8.28
9845044,5872756,2094,732900,6605656,12.48
9845045,9980976,2769,969150,10950126,9.71
9845046,1489694,805,281750,1771444,18.91
9845047,9977030,5535,1937250,11914280,19.42
9845048,9981741,4053,1418550,11400291,14.21
9845049,2219961,1067,373450,2593411,16.82
9845050,9989787,4599,1609650,11599437,16.11
9845051,9976510,3553,1243550,11220060,12.46
9845052,9999590,4789,1676150,11675740,16.76
9845053,3582368,935,327250,3909618,9.14
9845054,9980279,3558,1245300,11225579,12.48
9845055,9974674,3981,1393350,11368024,13.97
9845056,9989369,3304,1156400,11145769,11.58
9845057,9989902,3128,1094800,11084702,10.96
9845058,9991246,3754,1313900,11305146,13.15
9845059,9988476,3077,1076950,11065426,10.78
9845060,9980950,3558,1245300,11226250,12.48
9845061,9993098,6727,2354450,12347548,23.56
9845062,9987998,4526,1584100,11572098,15.86
9845063,3915838,1332,466200,4382038,11.91
9845064,9998395,2876,1006600,11004995,10.07
9845065,9994002,2836,992600,10986602,9.93
9845066,9977213,3622,1267700,11244913,12.71
9845067,9976347,3196,1118600,11094947,11.21
9845068,9979424,2182,763700,10743124,7.65
9845069,9970520,3241,1134350,11104870,11.38
9845070,9970281,3677,1286950,11257231,12.91
9845071,9971998,5539,1938650,11910648,19.44
9845072,9865788,876,306600,10172388,3.11
9845073,9950187,2361,826350,10776537,8.30
9845074,9964974,4977,1741950,11706924,17.48
9845075,9937079,3031,1060850,10997929,10.68
9845077,9937644,2728,954800,10892444,9.61
9845078,9956625,3400,1190000,11146625,11.95
9845079,9955556,6642,2324700,12280256,23.35
9845080,9921155,2631,920850,10842005,9.28
9845081,9964260,4842,1694700,11658960,17.01
9845082,9977670,3665,1282750,11260420,12.86
9845083,9993350,5523,1933050,11926400,19.34
9845084,9960455,2932,1026200,10986655,10.30
9845085,9941286,4832,1691200,11632486,17.01
9845086,9972303,4473,1565550,11537853,15.70
9845087,9959166,3943,1380050,11339216,13.86
9845088,9883923,4269,1494150,11378073,15.12
9845089,9978311,3859,1350650,11328961,13.54
9845090,9991686,3789,1326150,11317836,13.27
9845091,9974567,4755,1664250,11638817,16.68
9845092,9971294,4347,1521450,11492744,15.26
9845093,9977061,5369,1879150,11856211,18.83
9845094,9981355,1903,666050,10647405,6.67
9845095,9989434,2476,866600,10856034,8.68
9845096,9977760,2792,977200,10954960,9.79
9845097,9979321,2908,1017800,10997121,10.20
9845098,9995932,3550,1242500,11238432,12.43
9845099,9996310,4397,1538950,11535260,15.40
9845100,9985923,2393,837550,10823473,8.39
9845101,9992594,3820,1337000,11329594,13.38
9845102,9917681,5009,1753150,11670831,17.68
9845103,9997815,2125,743750,10741565,7.44
9845104,9969809,4768,1668800,11638609,16.74
9845105,5852304,1545,540750,6393054,9.24
9845106,9966122,4704,1646400,11612522,16.52
9845107,9968422,3497,1223950,11192372,12.28
9845108,9983882,4071,1424850,11408732,14.27
9845109,9998300,4895,1713250,11711550,17.14
9845110,9982306,2966,1038100,11020406,10.40
9845111,9985216,4733,1656550,11641766,16.59
9845112,9967928,6463,2262050,12229978,22.69
9845113,9984415,3260,1141000,11125415,11.43
9845114,9994562,3275,1146250,11140812,11.47
9845115,9982620,4176,1461600,11444220,14.64
9845116,7190712,2494,872900,8063612,12.14
9845117,9984968,4843,1695050,11680018,16.98
9845118,5864732,2932,1026200,6890932,17.50
9845119,9965685,3351,1172850,11138535,11.77
9845120,9961095,4488,1570800,11531895,15.77
9845121,9964523,3091,1081850,11046373,10.86
9845122,9956189,3527,1234450,11190639,12.40
9845123,9971607,4126,1444100,11415707,14.48
9845124,9963055,3750,1312500,11275555,13.17
9845125,8978522,2883,1009050,9987572,11.24
9845126,9975524,1827,639450,10614974,6.41
9845127,9976682,4997,1748950,11725632,17.53
9845128,9954788,3007,1052450,11007238,10.57
9845129,9981704,4080,1428000,11409704,14.31
9845130,9988157,5778,2022300,12010457,20.25
9845131,9995040,3758,1315300,11310340,13.16
9845132,9993935,3858,1350300,11344235,13.51
9845133,9979116,6438,2253300,12232416,22.58
9845134,9977036,2349,822150,10799186,8.24
9845135,9973124,4726,1654100,11627224,16.59
9845136,9982598,2500,875000,10857598,8.77
9845137,9982959,5767,2018450,12001409,20.22
9845138,9991293,3091,1081850,11073143,10.83
9845139,9984419,4546,1591100,11575519,15.94
9845140,9987597,4359,1525650,11513247,15.28
9845141,9997314,3174,1110900,11108214,11.11
9845142,9981588,5811,2033850,12015438,20.38
9845143,9997269,3733,1306550,11303819,13.07
9845144,9986331,5150,1802500,11788831,18.05
9845145,9970831,4825,1688750,11659581,16.94
9845147,9987221,4140,1449000,11436221,14.51
9845148,9970084,4453,1558550,11528634,15.63
9845150,4414220,2675,936250,5350470,21.21
9845151,1152098,287,100450,1252548,8.72
9845152,9968009,4276,1496600,11464609,15.01
9845153,9970366,3682,1288700,11259066,12.93
9845154,9965631,6009,2103150,12068781,21.10
9845155,9962319,4949,1732150,11694469,17.39
9845156,9976169,3961,1386350,11362519,13.90
9845157,9982612,5227,1829450,11812062,18.33
9845158,9979773,4167,1458450,11438223,14.61
9845159,9991925,6397,2238950,12230875,22.41
9845160,5970856,2924,1023400,6994256,17.14
9845161,9992879,4126,1444100,11436979,14.45
9845163,9988023,7071,2474850,12462873,24.78
9845164,9979537,5249,1837150,11816687,18.41
9845165,9986832,3817,1335950,11322782,13.38
9845166,9981986,4947,1731450,11713436,17.35
9845167,9981149,3486,1220100,11201249,12.22
9845168,9990485,4774,1670900,11661385,16.72
9845170,9986548,3560,1246000,11232548,12.48
9845171,9970871,4592,1607200,11578071,16.12
9845173,9987295,3559,1245650,11232945,12.47
9845174,9986627,3246,1136100,11122727,11.38
9845175,9996257,3537,1237950,11234207,12.38
9845176,9993875,5893,2062550,12056425,20.64
9845177,9971161,4193,1467550,11438711,14.72
9845178,9739615,4835,1692250,11431865,17.37
9845179,9988050,5710,1998500,11986550,20.01
9845180,9999028,6330,2215500,12214528,22.16
9845181,9973816,6025,2108750,12082566,21.14
9845182,9990126,6974,2440900,12431026,24.43
9845183,3587744,1632,571200,4158944,15.92
9845184,9976774,5082,1778700,11755474,17.83
9845185,1128433,146,51100,1179533,4.53
9845186,9987051,5904,2066400,12053451,20.69
9845187,9972016,6451,2257850,12229866,22.64
9845188,9971545,7412,2594200,12565745,26.02
9845189,9961973,4837,1692950,11654923,16.99
9845190,9980772,4221,1477350,11458122,14.80
9845191,9971120,4318,1511300,11482420,15.16
9845192,9974754,4382,1533700,11508454,15.38
9845193,9982270,7285,2549750,12532020,25.54
9845194,9983068,2293,802550,10785618,8.04
9845196,9977101,4352,1523200,11500301,15.27
9845197,4320649,1860,651000,4971649,15.07
9845198,9935036,5304,1856400,11791436,18.69
9845199,5149150,1807,632450,5781600,12.28
9845200,9968267,5641,1974350,11942617,19.81
9845201,9511136,3646,1276100,10787236,13.42
9845202,9929306,3620,1267000,11196306,12.76
9845203,9967934,3428,1199800,11167734,12.04
9845205,9944483,4912,1719200,11663683,17.29
9845206,9951625,5860,2051000,12002625,20.61
9845207,9950676,5829,2040150,11990826,20.50
9845208,9947279,2857,999950,10947229,10.05
9845209,9924824,2930,1025500,10950324,10.33
9845210,9922126,3465,1212750,11134876,12.22
9845211,9934109,5159,1805650,11739759,18.18
9845212,9935464,6679,2337650,12273114,23.53
9845213,5573614,3598,1259300,6832914,22.59
9845214,9955312,3432,1201200,11156512,12.07
9845215,9971351,5099,1784650,11756001,17.90
9845216,9635726,3610,1263500,10899226,13.11
9845217,9954841,4878,1707300,11662141,17.15
9845218,9987624,6396,2238600,12226224,22.41
9845219,9982170,3489,1221150,11203320,12.23
9845220,9988869,4993,1747550,11736419,17.49
9845221,8870955,1672,585200,9456155,6.60
9845222,9991482,5669,1984150,11975632,19.86
9845223,9987775,2764,967400,10955175,9.69
9845224,9709799,3245,1135750,10845549,11.70
9845225,9986757,5508,1927800,11914557,19.30
9845226,9989363,5273,1845550,11834913,18.48
9845227,9997791,4826,1689100,11686891,16.89
9845228,9986880,4895,1713250,11700130,17.16
9845229,9982291,3045,1065750,11048041,10.68
9845230,9972805,2497,873950,10846755,8.76
9845231,9991905,3722,1302700,11294605,13.04
9845232,9973109,6244,2185400,12158509,21.91
9845233,9988967,3415,1195250,11184217,11.97
9845234,9980254,5532,1936200,11916454,19.40
9845235,9988979,2719,951650,10940629,9.53
9845236,5001623,3567,1248450,6250073,24.96
9845237,9967585,5102,1785700,11753285,17.92
9845238,9991980,3660,1281000,11272980,12.82
9845239,9986657,5647,1976450,11963107,19.79
9845240,9989168,4589,1606150,11595318,16.08
9845241,5105292,4064,1422400,6527692,27.86
9845242,9970554,6744,2360400,12330954,23.67
9845243,9994117,5122,1792700,11786817,17.94
9845244,9990349,2908,1017800,11008149,10.19
9845245,9996018,4923,1723050,11719068,17.24
9845246,9367424,2418,846300,10213724,9.03
9845247,9981285,3270,1144500,11125785,11.47
9845248,9994205,4072,1425200,11419405,14.26
9845249,9893271,5493,1922550,11815821,19.43
9845250,9979464,4978,1742300,11721764,17.46
9845251,9989580,3938,1378300,11367880,13.80
9845252,9989621,5944,2080400,12070021,20.83
9845253,8992416,5434,1901900,10894316,21.15
9845254,9606720,4456,1559600,11166320,16.23
9845255,9966242,3039,1063650,11029892,10.67
9845256,9968640,4127,1444450,11413090,14.49
9845257,9961441,4017,1405950,11367391,14.11
9845258,2874801,873,305550,3180351,10.63
9845259,9958621,4297,1503950,11462571,15.10
9845260,9969888,3817,1335950,11305838,13.40
9845261,9949819,8084,2829400,12779219,28.44
9845262,9963812,5265,1842750,11806562,18.49
9845263,9896070,6337,2217950,12114020,22.41
9845264,9954047,4988,1745800,11699847,17.54
9845265,4176298,1077,376950,4553248,9.03
9845266,9988173,4502,1575700,11563873,15.78
9845267,9522329,2964,1037400,10559729,10.89
9845268,9997329,4536,1587600,11584929,15.88
9845269,9920346,7200,2520000,12440346,25.40
9845270,9983834,4221,1477350,11461184,14.80
9845271,1225705,641,224350,1450055,18.30
9845272,9988402,3159,1105650,11094052,11.07
9845273,9992703,4066,1423100,11415803,14.24
9845274,9973012,216,75600,10048612,0.76
9845275,9969984,637,222950,10192934,2.24
9845276,9983234,940,329000,10312234,3.30
9845277,9971453,1631,570850,10542303,5.72
9845278,9986234,1606,562100,10548334,5.63
9845279,9977274,2105,736750,10714024,7.38
9845281,9959819,2052,718200,10678019,7.21
9845282,9956774,2061,721350,10678124,7.24
9845283,9973952,2074,725900,10699852,7.28
9845284,9974286,2996,1048600,11022886,10.51
9845285,9960672,6131,2145850,12106522,21.54
9845287,8953147,4942,1729700,10682847,19.32
9845288,9952912,4859,1700650,11653562,17.09
9845289,9954699,5443,1905050,11859749,19.14
9845290,9953214,4867,1703450,11656664,17.11
9845291,9958297,6010,2103500,12061797,21.12
9845292,9955477,5277,1846950,11802427,18.55
9845293,9937040,3108,1087800,11024840,10.95
9845294,2456551,869,304150,2760701,12.38
9845295,9920100,6136,2147600,12067700,21.65
9845296,9927571,4323,1513050,11440621,15.24
9845297,9927772,3958,1385300,11313072,13.95
9845298,9938488,7361,2576350,12514838,25.92
9845299,9942046,3126,1094100,11036146,11.00
9845300,9949671,5377,1881950,11831621,18.91
9845301,9950319,5166,1808100,11758419,18.17
9845302,9960578,3271,1144850,11105428,11.49
9845303,9958115,7168,2508800,12466915,25.19
9845304,9961491,5343,1870050,11831541,18.77
9845305,9960812,4053,1418550,11379362,14.24
9845306,9969317,4051,1417850,11387167,14.22
9845307,2508383,1479,517650,3026033,20.64
9845308,9957736,4144,1450400,11408136,14.57
9845309,9950640,4751,1662850,11613490,16.71
9845310,9554027,4548,1591800,11145827,16.66
9845311,8966558,7173,2510550,11477108,28.00
9845312,9964217,4889,1711150,11675367,17.17
9845313,1779247,875,306250,2085497,17.21
9845314,9979777,3849,1347150,11326927,13.50
9845315,9977067,7130,2495500,12472567,25.01
9845316,9981487,3763,1317050,11298537,13.19
9845317,9980684,7905,2766750,12747434,27.72
9845318,9985337,4392,1537200,11522537,15.39
9845319,9623782,5418,1896300,11520082,19.70
9845320,9968882,3048,1066800,11035682,10.70
9845321,9956926,5049,1767150,11724076,17.75
9845322,9958202,5135,1797250,11755452,18.05
9845323,9941518,4894,1712900,11654418,17.23
9845324,9947788,5575,1951250,11899038,19.61
9845325,9955454,6956,2434600,12390054,24.45
9845326,9943231,4034,1411900,11355131,14.20
9845327,7494804,2391,836850,8331654,11.17
9845328,9959635,6250,2187500,12147135,21.96
9845329,9969939,4740,1659000,11628939,16.64
9845330,9960446,5439,1903650,11864096,19.11
9845331,8969821,3794,1327900,10297721,14.80
9845332,9969019,4941,1729350,11698369,17.35
9845333,9834498,4482,1568700,11403198,15.95
9845334,9856640,5124,1793400,11650040,18.19
9845335,9958576,4162,1456700,11415276,14.63
9845336,9986099,4317,1510950,11497049,15.13
9845337,9987593,7299,2554650,12542243,25.58
9845338,9977945,5453,1908550,11886495,19.13
9845339,9982208,3766,1318100,11300308,13.20
9845340,9994489,4131,1445850,11440339,14.47
9845341,9982579,4708,1647800,11630379,16.51
9845342,9979832,4536,1587600,11567432,15.91
9845343,9898707,5135,1797250,11695957,18.16
9845344,9968970,4724,1653400,11622370,16.59
9845345,9971232,5484,1919400,11890632,19.25
9845346,9979240,5094,1782900,11762140,17.87
9845347,9978635,4986,1745100,11723735,17.49
9845348,9974578,5804,2031400,12005978,20.37
9845349,9973874,3202,1120700,11094574,11.24
9845350,9964498,4541,1589350,11553848,15.95
9845351,9966771,6211,2173850,12140621,21.81
9845352,9983541,5412,1894200,11877741,18.97
9845353,9983307,5254,1838900,11822207,18.42
9845354,9969446,3395,1188250,11157696,11.92
9845355,7143591,3257,1139950,8283541,15.96
9845356,9967046,4638,1623300,11590346,16.29
9845357,9984542,3904,1366400,11350942,13.69
9845358,9998889,4653,1628550,11627439,16.29
9845359,2347441,1808,632800,2980241,26.96
9845360,9965471,6758,2365300,12330771,23.73
9845361,9969050,5822,2037700,12006750,20.44
9845362,9970669,4584,1604400,11575069,16.09
9845363,9975174,4826,1689100,11664274,16.93
9845364,9965349,6652,2328200,12293549,23.36
9845365,9966321,5641,1974350,11940671,19.81
9845366,9980014,4594,1607900,11587914,16.11
9845367,9980082,3263,1142050,11122132,11.44
9845368,9983764,4638,1623300,11607064,16.26
9845369,9995055,6034,2111900,12106955,21.13
9845370,9985533,4670,1634500,11620033,16.37
9845371,9969744,5321,1862350,11832094,18.68
9845372,9975978,3511,1228850,11204828,12.32
9845373,8993623,5819,2036650,11030273,22.65
9845375,9994352,5115,1790250,11784602,17.91
9845376,9994674,6747,2361450,12356124,23.63
9845377,9976070,5694,1992900,11968970,19.98
9845378,9986148,6210,2173500,12159648,21.77
9845379,9981624,4512,1579200,11560824,15.82
9845380,9968807,6442,2254700,12223507,22.62
9845381,9972315,4774,1670900,11643215,16.76
9845382,9961173,5035,1762250,11723423,17.69
9845383,9982403,5409,1893150,11875553,18.96
9845385,9959919,9529,3335150,13295069,33.49
9845386,9980976,5907,2067450,12048426,20.71
9845387,9969717,4179,1462650,11432367,14.67
9845388,9976431,5328,1864800,11841231,18.69
9845389,9998289,5023,1758050,11756339,17.58
9845390,9992748,5550,1942500,11935248,19.44
9845391,9981782,6106,2137100,12118882,21.41
9845392,9987743,4451,1557850,11545593,15.60
9845393,9986699,6704,2346400,12333099,23.50
9845394,9986953,5267,1843450,11830403,18.46
9845395,9995112,5277,1846950,11842062,18.48
9845396,9981891,5998,2099300,12081191,21.03
9845397,9087639,4039,1413650,10501289,15.56
9845398,9982886,7382,2583700,12566586,25.88
9845399,9984427,4656,1629600,11614027,16.32
9845400,9978187,4864,1702400,11680587,17.06
9845401,9986814,4605,1611750,11598564,16.14
9845402,9981430,4337,1517950,11499380,15.21
9845403,9991579,5453,1908550,11900129,19.10
9845404,9995603,3818,1336300,11331903,13.37
9845405,9980767,3099,1084650,11065417,10.87
9845406,9999729,4799,1679650,11679379,16.80
9845407,9774678,5635,1972250,11746928,20.18
9845408,3595371,1772,620200,4215571,17.25
9845409,9991849,6386,2235100,12226949,22.37
9845410,9978977,3984,1394400,11373377,13.97
9845411,9969066,5449,1907150,11876216,19.13
9845412,9978591,3697,1293950,11272541,12.97
9845413,9987652,7991,2796850,12784502,28.00
9845414,9998380,5441,1904350,11902730,19.05
9845415,9972769,3827,1339450,11312219,13.43
9845416,9993970,5345,1870750,11864720,18.72
9845418,9989838,3855,1349250,11339088,13.51
9845419,9987998,5502,1925700,11913698,19.28
9845420,9991835,4796,1678600,11670435,16.80
9845421,9974227,1855,649250,10623477,6.51
9845422,9996823,4245,1485750,11482573,14.86
9845423,9984694,4204,1471400,11456094,14.74
9845424,9972675,4635,1622250,11594925,16.27
9845425,9984557,4413,1544550,11529107,15.47
9845426,9998335,4170,1459500,11457835,14.60
9845427,9987216,3338,1168300,11155516,11.70
9845428,9980638,5199,1819650,11800288,18.23
9845429,6464800,2220,777000,7241800,12.02
9845430,9980327,2136,747600,10727927,7.49
9845431,9980655,5430,1900500,11881155,19.04
9845432,9997591,3112,1089200,11086791,10.89
9845433,9990667,6215,2175250,12165917,21.77
9845434,9975253,426,149100,10124353,1.49
9845435,9978923,774,270900,10249823,2.71
9845436,9988504,501,175350,10163854,1.76
9845437,9984940,2218,776300,10761240,7.77
9845438,9994203,1823,638050,10632253,6.38
9845439,9860142,1238,433300,10293442,4.39
9845440,9989487,7626,2669100,12658587,26.72
9845441,9999020,6551,2292850,12291870,22.93
9845442,9985277,4301,1505350,11490627,15.08
9845443,9998902,6080,2128000,12126902,21.28
9845444,9966706,5040,1764000,11730706,17.70
9845445,9982867,3832,1341200,11324067,13.44
9845446,9990994,4021,1407350,11398344,14.09
9845447,9991448,7482,2618700,12610148,26.21
9845448,9978307,4638,1623300,11601607,16.27
9845449,9198336,3295,1153250,10351586,12.54
9845450,9968856,5769,2019150,11988006,20.25
9845451,9964720,4815,1685250,11649970,16.91
9845452,1071952,341,119350,1191302,11.13
9845453,8938725,5813,2034550,10973275,22.76
9845454,9948592,3979,1392650,11341242,14.00
9845455,9946834,4267,1493450,11440284,15.01
9845456,9918752,5649,1977150,11895902,19.93
9845457,9727614,7199,2519650,12247264,25.90
9845458,9973847,6993,2447550,12421397,24.54
9845459,9976386,5565,1947750,11924136,19.52
9845460,9978585,4446,1556100,11534685,15.59
9845462,9967535,4405,1541750,11509285,15.47
9845463,9977976,3263,1142050,11120026,11.45
9845464,9986063,1979,692650,10678713,6.94
9845465,9980401,5810,2033500,12013901,20.37
9845466,9980199,7325,2563750,12543949,25.69
9845467,9977765,7229,2530150,12507915,25.36
9845468,3710964,3412,1194200,4905164,32.18
9845469,9958312,8452,2958200,12916512,29.71
9845470,9992956,4394,1537900,11530856,15.39
9845471,9991963,4321,1512350,11504313,15.14
9845472,9987361,5641,1974350,11961711,19.77
9845473,9991735,4690,1641500,11633235,16.43
9845474,9992684,5218,1826300,11818984,18.28
9845475,9990078,5632,1971200,11961278,19.73
9845476,9957476,5636,1972600,11930076,19.81
9845477,9990793,3883,1359050,11349843,13.60
9845478,9983097,5858,2050300,12033397,20.54
9845479,9983212,6169,2159150,12142362,21.63
9845480,9961876,5047,1766450,11728326,17.73
9845481,9989043,6424,2248400,12237443,22.51
9845482,9987801,4433,1551550,11539351,15.53
9845483,9984093,6360,2226000,12210093,22.30
9845484,9994990,5531,1935850,11930840,19.37
9845485,9979013,5924,2073400,12052413,20.78
9845486,9982278,5335,1867250,11849528,18.71
9845487,9982359,4246,1486100,11468459,14.89
9845488,9969485,6002,2100700,12070185,21.07
9845489,9982454,3417,1195950,11178404,11.98
9845490,9976475,5120,1792000,11768475,17.96
9845491,9975938,3941,1379350,11355288,13.83
9845492,9976245,4079,1427650,11403895,14.31
9845493,9982153,4050,1417500,11399653,14.20
9845494,9984069,5742,2009700,11993769,20.13
9845495,9983416,6205,2171750,12155166,21.75
9845496,9988132,2953,1033550,11021682,10.35
9845497,9998154,4109,1438150,11436304,14.38
9845498,9980173,4550,1592500,11572673,15.96
9845499,9520340,5304,1856400,11376740,19.50
9845500,9514885,4306,1507100,11021985,15.84
9845501,9984464,5921,2072350,12056814,20.76
9845502,9986097,5115,1790250,11776347,17.93
9845503,9963189,6083,2129050,12092239,21.37
9845504,9966103,6489,2271150,12237253,22.79
9845505,9963448,6827,2389450,12352898,23.98
9845506,9863728,6957,2434950,12298678,24.69
9845507,9954460,3799,1329650,11284110,13.36
9845508,9966503,4361,1526350,11492853,15.31
9845509,9959192,7136,2497600,12456792,25.08
9845511,9928315,5187,1815450,11743765,18.29
9845512,9945056,4713,1649550,11594606,16.59
9845513,8930478,3257,1139950,10070428,12.76
9845515,9925871,5345,1870750,11796621,18.85
9845516,9634980,4971,1739850,11374830,18.06
9845517,9948045,6172,2160200,12108245,21.71
9845518,9923735,5483,1919050,11842785,19.34
9845519,9936566,3068,1073800,11010366,10.81
9845520,9937709,3591,1256850,11194559,12.65
9845521,9949280,5161,1806350,11755630,18.16
9845522,9946032,4046,1416100,11362132,14.24
9845523,9950750,2549,892150,10842900,8.97
9845524,9970039,4598,1609300,11579339,16.14
9845525,9962097,3924,1373400,11335497,13.79
9845526,9991249,4817,1685950,11677199,16.87
9845527,9989468,5145,1800750,11790218,18.03
9845528,9983255,3308,1157800,11141055,11.60
9845529,9988706,4593,1607550,11596256,16.09
9845530,9904373,2035,712250,10616623,7.19
9845531,9671421,2745,960750,10632171,9.93
9845532,9989368,5048,1766800,11756168,17.69
9845534,9974111,6785,2374750,12348861,23.81
9845535,1078440,372,130200,1208640,12.07
9845536,9973741,5424,1898400,11872141,19.03
9845537,9973190,5514,1929900,11903090,19.35
9845538,1019776,754,263900,1283676,25.88
9845539,9963009,5163,1807050,11770059,18.14
9845540,9983304,5698,1994300,11977604,19.98
9845541,9978238,9275,3246250,13224488,32.53
9845542,9929898,1641,574350,10504248,5.78
9845543,9981088,3295,1153250,11134338,11.55
9845544,9998618,6247,2186450,12185068,21.87
9845545,9961956,1240,434000,10395956,4.36
9845546,9996062,3678,1287300,11283362,12.88
9845547,9999111,6304,2206400,12205511,22.07
9845548,9977601,6963,2437050,12414651,24.43
9845549,6094143,1100,385000,6479143,6.32
9845550,9965363,4078,1427300,11392663,14.32
9845551,9977223,5819,2036650,12013873,20.41
9845552,9992312,3971,1389850,11382162,13.91
9845553,9993697,3762,1316700,11310397,13.18
9845554,9951221,5226,1829100,11780321,18.38
9845555,9975504,5032,1761200,11736704,17.66
9845556,9972171,4020,1407000,11379171,14.11
9845557,9920533,5862,2051700,11972233,20.68
9845558,9983562,4137,1447950,11431512,14.50
9845559,9941753,6501,2275350,12217103,22.89
9845560,9983170,4034,1411900,11395070,14.14
9845561,9960921,2773,970550,10931471,9.74
9845562,9981329,5250,1837500,11818829,18.41
9845563,1286223,469,164150,1450373,12.76
9845564,9949688,2513,879550,10829238,8.84
9845565,9963944,5710,1998500,11962444,20.06
9845566,9977168,3899,1364650,11341818,13.68
9845567,9344340,4900,1715000,11059340,18.35
9845568,9974819,7113,2489550,12464369,24.96
9845569,9955344,2943,1030050,10985394,10.35
9845570,9977528,5555,1944250,11921778,19.49
9845571,9590000,5162,1806700,11396700,18.84
9845572,9975893,3580,1253000,11228893,12.56
9845573,9991612,2815,985250,10976862,9.86
9845574,9998896,5820,2037000,12035896,20.37
9845575,9985381,4982,1743700,11729081,17.46
9845576,9975191,6032,2111200,12086391,21.16
9845577,9975938,4014,1404900,11380838,14.08
9845578,9994822,6074,2125900,12120722,21.27
9845579,4246159,3058,1070300,5316459,25.21
9845580,9989192,3940,1379000,11368192,13.80
9845581,7917386,4063,1422050,9339436,17.96
9845582,9970166,4284,1499400,11469566,15.04
9845583,9978978,7898,2764300,12743278,27.70
9845584,9987514,3844,1345400,11332914,13.47
9845585,9022018,4401,1540350,10562368,17.07
9845586,9971325,4821,1687350,11658675,16.92
9845587,9985118,5786,2025100,12010218,20.28
9845588,9989885,7768,2718800,12708685,27.22
9845589,9979838,6687,2340450,12320288,23.45
9845590,9980991,6986,2445100,12426091,24.50
9845591,9956345,2400,840000,10796345,8.44
9845592,9994477,5028,1759800,11754277,17.61
9845593,9992431,3946,1381100,11373531,13.82
9845594,9982649,4566,1598100,11580749,16.01
9845595,9960947,3098,1084300,11045247,10.89
9845596,9991468,3234,1131900,11123368,11.33
9845597,9990107,5504,1926400,11916507,19.28
9845598,9991464,3588,1255800,11247264,12.57
9845599,9974407,5529,1935150,11909557,19.40
9845600,9866368,6556,2294600,12160968,23.26
9845601,9994025,4838,1693300,11687325,16.94
9845602,9983658,5468,1913800,11897458,19.17
9845603,9983151,4832,1691200,11674351,16.94
9845605,9983456,4065,1422750,11406206,14.25
9845606,9982839,3362,1176700,11159539,11.79
9845607,9996881,6099,2134650,12131531,21.35
9845608,9992977,3921,1372350,11365327,13.73
9845609,9972313,4259,1490650,11462963,14.95
9845610,9988460,2863,1002050,10990510,10.03
9845611,9982876,6204,2171400,12154276,21.75
9845612,9930543,5072,1775200,11705743,17.88
9845613,9990451,4389,1536150,11526601,15.38
9845614,9982054,1878,657300,10639354,6.58
9845615,9965938,3122,1092700,11058638,10.96
9845616,2815241,1141,399350,3214591,14.19
9845617,9981457,6283,2199050,12180507,22.03
9845618,9991540,6036,2112600,12104140,21.14
9845619,9901262,3302,1155700,11056962,11.67
9845620,9912324,4761,1666350,11578674,16.81
9845621,9997053,6005,2101750,12098803,21.02
9845622,9996725,2712,949200,10945925,9.50
9845623,9999884,5116,1790600,11790484,17.91
9845624,9973641,9056,3169600,13143241,31.78
9845625,9979162,4986,1745100,11724262,17.49
9845626,9978455,4407,1542450,11520905,15.46
9845627,9982920,6003,2101050,12083970,21.05
9845628,9982553,2715,950250,10932803,9.52
9845629,9977238,5470,1914500,11891738,19.19
9845630,9982942,4480,1568000,11550942,15.71
9845631,9245446,3143,1100050,10345496,11.90
9845632,9997107,2907,1017450,11014557,10.18
9845633,9970597,1185,414750,10385347,4.16
9845634,9979767,2319,811650,10791417,8.13
9845635,9970349,627,219450,10189799,2.20
9845636,9977367,2322,812700,10790067,8.15
9845637,9973477,8152,2853200,12826677,28.61
9845638,9992369,2694,942900,10935269,9.44
9845639,9993524,3735,1307250,11300774,13.08
9845640,9992592,5309,1858150,11850742,18.60
9845641,9981796,3829,1340150,11321946,13.43
9845642,1773823,1403,491050,2264873,27.68
9845643,9967310,1957,684950,10652260,6.87
9845644,9971379,4440,1554000,11525379,15.58
9845645,9958340,5185,1814750,11773090,18.22
9845647,9945065,4458,1560300,11505365,15.69
9845648,9945798,4869,1704150,11649948,17.13
9845649,9967576,5798,2029300,11996876,20.36
9845650,9974760,3691,1291850,11266610,12.95
9845651,9987812,6603,2311050,12298862,23.14
9845652,9999839,6590,2306500,12306339,23.07
9845653,9988875,2970,1039500,11028375,10.41
9845654,9969978,4975,1741250,11711228,17.46
9845655,9969413,3411,1193850,11163263,11.98
9845656,9939576,5898,2064300,12003876,20.77
9845657,9984992,5325,1863750,11848742,18.67
9845658,9982733,5752,2013200,11995933,20.17
9845659,9977885,4743,1660050,11637935,16.64
9845660,9748957,3524,1233400,10982357,12.65
9845661,9313447,3453,1208550,10521997,12.98
9845662,9993168,3509,1228150,11221318,12.29
9845663,9977953,2762,966700,10944653,9.69
9845664,7473561,1802,630700,8104261,8.44
9845665,6585862,1436,502600,7088462,7.63
9845666,9969485,4655,1629250,11598735,16.34
9845667,9925020,2568,898800,10823820,9.06
9845668,9962802,4183,1464050,11426852,14.70
9845669,9723171,3047,1066450,10789621,10.97
9845670,9953269,6188,2165800,12119069,21.76
9845671,9959923,4928,1724800,11684723,17.32
9845672,9913883,2538,888300,10802183,8.96
9845673,9964153,5377,1881950,11846103,18.89
9845674,9967486,2868,1003800,10971286,10.07
9845675,9973159,5161,1806350,11779509,18.11
9845676,9985042,5194,1817900,11802942,18.21
9845677,4176298,3489,1221150,5397448,29.24
9845678,9981271,6135,2147250,12128521,21.51
9845679,9987305,7137,2497950,12485255,25.01
9845680,9980400,4135,1447250,11427650,14.50
9845681,9960693,6022,2107700,12068393,21.16
9845682,9975585,1905,666750,10642335,6.68
9845683,9980468,3075,1076250,11056718,10.78
9845684,8979654,1441,504350,9484004,5.62
9845685,9982963,3658,1280300,11263263,12.82
9845686,9986766,6575,2301250,12288016,23.04
9845687,9156697,1592,557200,9713897,6.09
9845688,9985335,2862,1001700,10987035,10.03
9845689,9963729,4615,1615250,11578979,16.21
9845690,9963729,3577,1251950,11215679,12.57
9845691,9963137,4286,1500100,11463237,15.06
9845692,9978130,5118,1791300,11769430,17.95
9845693,9977917,5314,1859900,11837817,18.64
9845694,9988046,5931,2075850,12063896,20.78
9845695,9986014,6144,2150400,12136414,21.53
9845696,9983463,4680,1638000,11621463,16.41
9845697,9972058,5145,1800750,11772808,18.06
9845699,9900909,3245,1135750,11036659,11.47
9845700,9967674,4134,1446900,11414574,14.52
9845701,9962436,5457,1909950,11872386,19.17
9845702,9983624,3184,1114400,11098024,11.16
9845703,9904103,5153,1803550,11707653,18.21
9845704,9957529,5147,1801450,11758979,18.09
9845705,9963643,5806,2032100,11995743,20.40
9845706,9977131,4895,1713250,11690381,17.17
9845707,9990797,6893,2412550,12403347,24.15
9845708,9998689,5902,2065700,12064389,20.66
9845709,807014,68,23800,830814,2.95
9845710,9976653,4829,1690150,11666803,16.94
9845711,9969549,7909,2768150,12737699,27.77
9845712,9964088,4477,1566950,11531038,15.73
9845713,9966802,5937,2077950,12044752,20.85
9845714,9957946,6349,2222150,12180096,22.32
9845715,9956160,3782,1323700,11279860,13.30
9845716,9980986,4833,1691550,11672536,16.95
9845717,9970407,5613,1964550,11934957,19.70
9845718,9982115,4978,1742300,11724415,17.45
9845719,9991407,5037,1762950,11754357,17.64
9845720,837923,502,175700,1013623,20.97
9845722,9968479,5915,2070250,12038729,20.77
9845723,9993937,4894,1712900,11706837,17.14
9845724,9973150,4208,1472800,11445950,14.77
9845725,9988300,1798,629300,10617600,6.30
9845727,9977288,4579,1602650,11579938,16.06
9845728,9965791,4290,1501500,11467291,15.07
9845729,9750886,4827,1689450,11440336,17.33
9845730,9985614,4296,1503600,11489214,15.06
9845732,9995691,4206,1472100,11467791,14.73
9845733,9273317,3289,1151150,10424467,12.41
9845734,9988179,1845,645750,10633929,6.47
9845735,9728101,3748,1311800,11039901,13.48
9845736,9722061,1152,403200,10125261,4.15
9845737,9738165,4984,1744400,11482565,17.91
9845738,9713430,1823,638050,10351480,6.57
9845739,9975415,3546,1241100,11216515,12.44
9845740,9989401,2003,701050,10690451,7.02
9845741,9485405,2599,909650,10395055,9.59
9845742,7743790,4540,1589000,9332790,20.52
9845743,9981784,5007,1752450,11734234,17.56
9845744,9960855,3247,1136450,11097305,11.41
9845745,9954120,6284,2199400,12153520,22.10
9845746,9967709,6166,2158100,12125809,21.65
9845747,9983107,3648,1276800,11259907,12.79
9845748,9984696,6790,2376500,12361196,23.80
9845749,9985325,4954,1733900,11719225,17.36
9845750,9984526,5592,1957200,11941726,19.60
9845751,9994411,3506,1227100,11221511,12.28
9845752,9976282,4949,1732150,11708432,17.36
9845753,9481941,3600,1260000,10741941,13.29
9845754,7564538,2065,722750,8287288,9.55
9845755,9976122,4332,1516200,11492322,15.20
9845756,9987451,5097,1783950,11771401,17.86
9845757,9980974,3345,1170750,11151724,11.73
9845758,9980475,3582,1253700,11234175,12.56
9845760,9983712,3281,1148350,11132062,11.50
9845761,9975883,4750,1662500,11638383,16.67
9845762,9983261,5125,1793750,11777011,17.97
9845763,9994187,3250,1137500,11131687,11.38
9845764,9996310,5686,1990100,11986410,19.91
9845766,9983983,3929,1375150,11359133,13.77
9845767,9979514,4759,1665650,11645164,16.69
9845768,9980815,2817,985950,10966765,9.88
9845769,9489026,3090,1081500,10570526,11.40
9845770,9999582,3372,1180200,11179782,11.80
9845771,9242077,2969,1039150,10281227,11.24
9845772,9046880,1625,568750,9615630,6.29
9845773,9993888,5479,1917650,11911538,19.19
9845774,6731005,2082,728700,7459705,10.83
9845775,153073,101,35350,188423,23.09
9845776,9962310,2720,952000,10914310,9.56
9845777,9080040,3395,1188250,10268290,13.09
9845778,9402247,3335,1167250,10569497,12.41
9845779,9957580,4455,1559250,11516830,15.66
9845780,9987394,2048,716800,10704194,7.18
9845781,9982244,1208,422800,10405044,4.24
9845782,9986792,3241,1134350,11121142,11.36
9845783,9988202,2399,839650,10827852,8.41
9845784,9990098,1807,632450,10622548,6.33
9845786,9951921,2837,992950,10944871,9.98
9845787,8960048,1333,466550,9426598,5.21
9845788,9969392,2402,840700,10810092,8.43
9845789,9969569,2266,793100,10762669,7.96
9845790,9981634,4568,1598800,11580434,16.02
9845791,9973179,4990,1746500,11719679,17.51
9845792,9987168,2709,948150,10935318,9.49
9845793,9914934,2967,1038450,10953384,10.47
9845794,9996336,4130,1445500,11441836,14.46
9845795,9998797,5519,1931650,11930447,19.32
9845797,7778298,3287,1150450,8928748,14.79
9845798,9952324,4957,1734950,11687274,17.43
9845799,9945793,5327,1864450,11810243,18.75
9845800,9948286,4411,1543850,11492136,15.52
9845801,9975172,7650,2677500,12652672,26.84
9845802,9956940,5332,1866200,11823140,18.74
9845803,9967080,4706,1647100,11614180,16.53
9845804,9950957,1427,499450,10450407,5.02
9845805,9949428,4952,1733200,11682628,17.42
9845806,9956109,5234,1831900,11788009,18.40
9845807,9949925,2534,886900,10836825,8.91
9845808,9895237,5514,1929900,11825137,19.50
9845809,9950519,4100,1435000,11385519,14.42
9845810,9955548,4093,1432550,11388098,14.39
9845811,9964999,3055,1069250,11034249,10.73
9845812,9973984,4755,1664250,11638234,16.69
9845813,9952948,2779,972650,10925598,9.77
9845814,9935761,3816,1335600,11271361,13.44
9845815,9949869,4257,1489950,11439819,14.97
9845816,9953052,5180,1813000,11766052,18.22
9845817,9955803,4919,1721650,11677453,17.29
9845818,9950014,2658,930300,10880314,9.35
9845819,9969216,2797,978950,10948166,9.82
9845820,9975271,565,197750,10173021,1.98
9845821,9959843,3652,1278200,11238043,12.83
9845822,9974417,5745,2010750,11985167,20.16
9845823,9380224,2210,773500,10153724,8.25
9845824,7462425,1161,406350,7868775,5.45
9845825,9948911,972,340200,10289111,3.42
9845826,7452617,669,234150,7686767,3.14
9845827,9950350,4445,1555750,11506100,15.64
9845828,9943080,3884,1359400,11302480,13.67
9845829,9949483,6581,2303350,12252833,23.15
9845830,9024413,3479,1217650,10242063,13.49
9845831,2401595,993,347550,2749145,14.47
9845832,3282250,1870,654500,3936750,19.94
9845833,9884115,5133,1796550,11680665,18.18
9845834,9940416,4992,1747200,11687616,17.58
9845835,9960898,5177,1811950,11772848,18.19
9845836,9968029,5378,1882300,11850329,18.88
9845837,9974827,3840,1344000,11318827,13.47
9845838,9980062,8284,2899400,12879462,29.05
9845839,9987594,4734,1656900,11644494,16.59
9845840,9999458,3366,1178100,11177558,11.78
9845841,8761563,3930,1375500,10137063,15.70
9845843,3498619,1308,457800,3956419,13.09
9845844,9978925,4466,1563100,11542025,15.66
9845845,9969437,1826,639100,10608537,6.41
9845846,9983712,3298,1154300,11138012,11.56
9845847,7385537,596,208600,7594137,2.82
9845848,9981881,1890,661500,10643381,6.63
9845849,9993277,4605,1611750,11605027,16.13
9845850,9739864,3723,1303050,11042914,13.38
9845851,9983494,2516,880600,10864094,8.82
9845852,9960288,4925,1723750,11684038,17.31
9845853,9972138,3421,1197350,11169488,12.01
9845854,9988875,6806,2382100,12370975,23.85
9845855,9983192,2666,933100,10916292,9.35
9845856,9975002,4351,1522850,11497852,15.27
9845857,9947960,3708,1297800,11245760,13.05
9845858,9972734,5949,2082150,12054884,20.88
9845859,9965695,3211,1123850,11089545,11.28
9845860,9253081,3441,1204350,10457431,13.02
9845862,9983024,2880,1008000,10991024,10.10
9845863,9983747,4392,1537200,11520947,15.40
9845864,9986784,4032,1411200,11397984,14.13
9845865,9992468,4326,1514100,11506568,15.15
9845866,9949256,1560,546000,10495256,5.49
9845867,9992976,5895,2063250,12056226,20.65
9845868,9966355,5065,1772750,11739105,17.79
9845869,634362,230,80500,714862,12.69
9845870,6240859,4977,1741950,7982809,27.91
9845871,921629,613,214550,1136179,23.28
9845872,9968805,5232,1831200,11800005,18.37
9845873,9990536,8819,3086650,13077186,30.90
9845874,9967503,2242,784700,10752203,7.87
9845875,9972384,4466,1563100,11535484,15.67
9845877,9970649,4879,1707650,11678299,17.13
9845878,9970924,1866,653100,10624024,6.55
9845879,712491,234,81900,794391,11.49
9845880,9989987,3302,1155700,11145687,11.57
9845881,9963281,5254,1838900,11802181,18.46
9845882,9978288,4332,1516200,11494488,15.19
9845883,9976897,5657,1979950,11956847,19.85
9845885,9974150,4645,1625750,11599900,16.30
9845886,9969646,4574,1600900,11570546,16.06
9845887,9962521,2819,986650,10949171,9.90
9845888,9551280,3409,1193150,10744430,12.49
9845889,6819058,448,156800,6975858,2.30
9845890,1294176,759,265650,1559826,20.53
9845891,9943315,3202,1120700,11064015,11.27
9845892,9880712,5500,1925000,11805712,19.48
9845893,9944353,2560,896000,10840353,9.01
9845894,9967958,4052,1418200,11386158,14.23
9845895,9973795,4805,1681750,11655545,16.86
9845896,5043523,4065,1422750,6466273,28.21
9845897,9964212,3840,1344000,11308212,13.49
9845898,9970723,5063,1772050,11742773,17.77
9845899,9987894,3982,1393700,11381594,13.95
9845900,9983376,6035,2112250,12095626,21.16
9845901,9981748,4892,1712200,11693948,17.15
9845902,9952374,5690,1991500,11943874,20.01
9845903,9989497,5701,1995350,11984847,19.97
9845904,9996164,6144,2150400,12146564,21.51
9845905,9979476,5108,1787800,11767276,17.91
9845906,9897219,1222,427700,10324919,4.32
9845907,9951274,4241,1484350,11435624,14.92
9845908,9977723,4036,1412600,11390323,14.16
9845909,9974155,7493,2622550,12596705,26.29
9845910,9969665,4690,1641500,11611165,16.46
9845911,9499482,4161,1456350,10955832,15.33
9845912,9981662,4202,1470700,11452362,14.73
9845913,9989632,6411,2243850,12233482,22.46
9845914,9985259,5387,1885450,11870709,18.88
9845915,9973204,3185,1114750,11087954,11.18
9845916,9985636,7773,2720550,12706186,27.24
9845917,8973039,3346,1171100,10144139,13.05
9845918,9984065,1204,421400,10405465,4.22
9845919,9991560,792,277200,10268760,2.77
9845920,9993283,3243,1135050,11128333,11.36
9845921,9985799,2143,750050,10735849,7.51
9845922,9989169,2113,739550,10728719,7.40
9845923,9984304,2057,719950,10704254,7.21
9845924,9892152,1651,577850,10470002,5.84
9845925,9986314,3066,1073100,11059414,10.75
9845926,9988529,3202,1120700,11109229,11.22
9845927,9983808,3928,1374800,11358608,13.77
9845928,9989859,3921,1372350,11362209,13.74
9845929,9999899,1558,545300,10545199,5.45
9845931,9980080,3371,1179850,11159930,11.82
9845932,9971490,1840,644000,10615490,6.46
9845933,9986306,2024,708400,10694706,7.09
9845934,9983531,2655,929250,10912781,9.31
9845935,9990942,2738,958300,10949242,9.59
9845936,9977667,3838,1343300,11320967,13.46
9845937,9997839,3679,1287650,11285489,12.88
9845938,9308426,5359,1875650,11184076,20.15
9845939,9959776,2440,854000,10813776,8.57
9845940,9953100,4864,1702400,11655500,17.10
9845941,9959098,5598,1959300,11918398,19.67
9845942,9953574,2744,960400,10913974,9.65
9845943,9936323,5802,2030700,11967023,20.44
9845944,9953830,3167,1108450,11062280,11.14
9845945,9955452,1538,538300,10493752,5.41
9845946,9941299,4784,1674400,11615699,16.84
9845947,9968746,4649,1627150,11595896,16.32
9845948,9951274,1616,565600,10516874,5.68
9845949,9954367,4944,1730400,11684767,17.38
9845950,9942078,4088,1430800,11372878,14.39
9845951,9945345,2882,1008700,10954045,10.14
9845952,9934789,2979,1042650,10977439,10.49
9845953,8732780,3401,1190350,9923130,13.63
9845954,9925673,5598,1959300,11884973,19.74
9845955,9927117,3614,1264900,11192017,12.74
9845956,9905471,4095,1433250,11338721,14.47
9845957,9926176,5820,2037000,11963176,20.52
9845958,9809950,4590,1606500,11416450,16.38
9845959,9900500,4500,1575000,11475500,15.91
9845960,9931401,4128,1444800,11376201,14.55
9845961,9934219,4986,1745100,11679319,17.57
9845962,9948598,4622,1617700,11566298,16.26
9845963,9937795,4024,1408400,11346195,14.17
9845964,9730892,5132,1796200,11527092,18.46
9845965,9959162,3708,1297800,11256962,13.03
9845966,9967071,4903,1716050,11683121,17.22
9845967,9961601,5669,1984150,11945751,19.92
9845968,9960726,4422,1547700,11508426,15.54
9845969,9959609,3817,1335950,11295559,13.41
9845970,9959806,2689,941150,10900956,9.45
9845971,7351482,1141,399350,7750832,5.43
9845972,9948215,4055,1419250,11367465,14.27
9845973,9953751,3488,1220800,11174551,12.26
9845974,9983939,5388,1885800,11869739,18.89
9845975,9951904,2688,940800,10892704,9.45
9845976,9922429,5180,1813000,11735429,18.27
9845977,9543540,4857,1699950,11243490,17.81
9845978,3732866,1493,522550,4255416,14.00
9845979,9954842,2493,872550,10827392,8.77
9845980,9959984,3734,1306900,11266884,13.12
9845981,9978992,1759,615650,10594642,6.17
9845982,9965300,2344,820400,10785700,8.23
9845983,9969262,4978,1742300,11711562,17.48
9845984,9974055,4685,1639750,11613805,16.44
9845985,9826036,5434,1901900,11727936,19.36
9845986,9951000,4226,1479100,11430100,14.86
9845987,9864774,4196,1468600,11333374,14.89
9845988,1806414,48,16800,1823214,0.93
9845989,9976527,8377,2931950,12908477,29.39
9845990,9980891,2666,933100,10913991,9.35
9845991,9973704,2489,871150,10844854,8.73
9845992,9962862,4190,1466500,11429362,14.72
9845993,9963248,3732,1306200,11269448,13.11
9845994,9954943,3653,1278550,11233493,12.84
9845995,9975505,2451,857850,10833355,8.60
9845996,9183421,3389,1186150,10369571,12.92
9845997,9893547,4320,1512000,11405547,15.28
9845998,9974441,4907,1717450,11691891,17.22
9845999,6127990,2386,835100,6963090,13.63
9846000,9982476,5045,1765750,11748226,17.69
9846001,9983516,6053,2118550,12102066,21.22
9846002,2791111,2552,893200,3684311,32.00
9846003,9968831,3432,1201200,11170031,12.05
9846004,9980945,3616,1265600,11246545,12.68
9846005,9979629,5898,2064300,12043929,20.69
9846006,9954166,5252,1838200,11792366,18.47
9846007,9976038,5944,2080400,12056438,20.85
9846008,9962970,4642,1624700,11587670,16.31
9846009,9958462,2928,1024800,10983262,10.29
9846010,9943310,2844,995400,10938710,10.01
9846011,9950330,3489,1221150,11171480,12.27
9846012,9930333,1649,577150,10507483,5.81
9846013,8927235,5905,2066750,10993985,23.15
9846014,9944680,4842,1694700,11639380,17.04
9846015,9955448,4110,1438500,11393948,14.45
9846016,9961307,4396,1538600,11499907,15.45
9846017,1070315,444,155400,1225715,14.52
9846018,3758418,2087,730450,4488868,19.44
9846019,8375338,3678,1287300,9662638,15.37
9846020,9974282,4808,1682800,11657082,16.87
9846021,9954388,4855,1699250,11653638,17.07
9846022,9974167,5970,2089500,12063667,20.95
9846023,9969606,2860,1001000,10970606,10.04
9846024,6923045,422,147700,7070745,2.13
9846025,7513086,998,349300,7862386,4.65
9846026,9963244,4186,1465100,11428344,14.71
9846027,9954562,2352,823200,10777762,8.27
9846028,9945872,4428,1549800,11495672,15.58
9846029,9951206,4565,1597750,11548956,16.06
9846030,9947020,5349,1872150,11819170,18.82
9846032,9944062,4719,1651650,11595712,16.61
9846033,9943348,4667,1633450,11576798,16.43
9846034,9926277,2242,784700,10710977,7.91
9846035,9486022,5987,2095450,11581472,22.09
9846036,9877108,1165,407750,10284858,4.13
9846037,9916503,3515,1230250,11146753,12.41
9846038,9938361,1924,673400,10611761,6.78
9846039,9934816,4381,1533350,11468166,15.43
9846040,9864493,3904,1366400,11230893,13.85
9846041,6061136,1447,506450,6567586,8.36
9846042,9936552,5047,1766450,11703002,17.78
9846043,9952005,3991,1396850,11348855,14.04
9846044,7691795,4659,1630650,9322445,21.20
9846045,9516142,4644,1625400,11141542,17.08
9846046,9882202,5216,1825600,11707802,18.47
9846047,9939392,2637,922950,10862342,9.29
9846048,9980121,6242,2184700,12164821,21.89
9846049,9978936,7443,2605050,12583986,26.11
9846050,9986478,3924,1373400,11359878,13.75
9846051,9636045,2463,862050,10498095,8.95
9846052,9973491,2531,885850,10859341,8.88
9846053,9981432,5251,1837850,11819282,18.41
9846054,9979013,2532,886200,10865213,8.88
9846055,9967289,2578,902300,10869589,9.05
9846056,9994444,4614,1614900,11609344,16.16
9846057,9982935,4555,1594250,11577185,15.97
9846058,9971170,2075,726250,10697420,7.28
9846059,9993478,3664,1282400,11275878,12.83
9846060,9980423,5370,1879500,11859923,18.83
9846061,5410368,1300,455000,5865368,8.41
9846062,9971495,5702,1995700,11967195,20.01
9846063,9966114,4899,1714650,11680764,17.20
9846064,9981786,3342,1169700,11151486,11.72
9846065,1831288,1084,379400,2210688,20.72
9846066,9963517,6365,2227750,12191267,22.36
9846067,3331099,2372,830200,4161299,24.92
9846068,7774867,3862,1351700,9126567,17.39
9846069,9979606,4234,1481900,11461506,14.85
9846070,9806641,5885,2059750,11866391,21.00
9846072,9830608,4244,1485400,11316008,15.11
9846073,9989138,4344,1520400,11509538,15.22
9846074,9996177,5279,1847650,11843827,18.48
9846075,9974723,5797,2028950,12003673,20.34
9846076,9990277,3367,1178450,11168727,11.80
9846077,1410350,483,169050,1579400,11.99
9846078,9976441,5891,2061850,12038291,20.67
9846079,9982466,5198,1819300,11801766,18.22
9846080,9887143,5388,1885800,11772943,19.07
9846081,904389,642,224700,1129089,24.85
9846082,9978829,4972,1740200,11719029,17.44
9846083,9976059,4850,1697500,11673559,17.02
9846084,9967666,4674,1635900,11603566,16.41
9846085,5967111,2861,1001350,6968461,16.78
9846086,9964618,6186,2165100,12129718,21.73
9846087,9991205,4775,1671250,11662455,16.73
9846088,9998301,5498,1924300,11922601,19.25
9846089,9989889,5683,1989050,11978939,19.91
9846090,9995330,4446,1556100,11551430,15.57
9846091,9984741,4619,1616650,11601391,16.19
9846092,9977848,3115,1090250,11068098,10.93
9846093,9989503,6142,2149700,12139203,21.52
9846094,8964572,3911,1368850,10333422,15.27
9846095,9990684,3205,1121750,11112434,11.23
9846096,9994701,4919,1721650,11716351,17.23
9846097,8989233,4858,1700300,10689533,18.91
9846098,9975759,5984,2094400,12070159,20.99
9846099,8987920,6129,2145150,11133070,23.87
9846100,9746956,7230,2530500,12277456,25.96
9846101,9974130,3354,1173900,11148030,11.77
9846102,9970711,3079,1077650,11048361,10.81
9846103,9968529,4552,1593200,11561729,15.98
9846105,3186443,2260,791000,3977443,24.82
9846106,9974931,2968,1038800,11013731,10.41
9846107,9999455,6148,2151800,12151255,21.52
9846108,9985376,3183,1114050,11099426,11.16
9846109,534610,396,138600,673210,25.93
9846110,9648844,3074,1075900,10724744,11.15
9846111,9993906,3517,1230950,11224856,12.32
9846112,9994775,4552,1593200,11587975,15.94
9846113,7939706,4277,1496950,9436656,18.85
9846114,9974459,6413,2244550,12219009,22.50
9846115,9994105,5675,1986250,11980355,19.87
9846116,9989305,7924,2773400,12762705,27.76
9846117,3749284,2261,791350,4540634,21.11
9846118,9977122,3479,1217650,11194772,12.20
9846119,9987010,4955,1734250,11721260,17.37
9846120,1116153,95,33250,1149403,2.98
9846121,9991011,4548,1591800,11582811,15.93
9846122,9947607,5614,1964900,11912507,19.75
9846123,9989128,2508,877800,10866928,8.79
9846124,9994053,4283,1499050,11493103,15.00
9846125,9949150,4612,1614200,11563350,16.22
9846126,2192322,1817,635950,2828272,29.01
9846127,9269487,4102,1435700,10705187,15.49
9846128,3567166,1987,695450,4262616,19.50
9846129,9971718,4534,1586900,11558618,15.91
9846130,9992637,5140,1799000,11791637,18.00
9846131,9982203,6671,2334850,12317053,23.39
9846132,9985595,7143,2500050,12485645,25.04
9846133,7063314,2363,827050,7890364,11.71
9846134,9995280,6959,2435650,12430930,24.37
9846135,9988049,2518,881300,10869349,8.82
9846137,3424599,1631,570850,3995449,16.67
9846138,9976742,3606,1262100,11238842,12.65
9846139,9981904,5072,1775200,11757104,17.78
9846140,9998768,2859,1000650,10999418,10.01
9846142,9970524,873,305550,10276074,3.06
9846143,1758911,1370,479500,2238411,27.26
9846144,9845953,1893,662550,10508503,6.73
9846145,9980242,2481,868350,10848592,8.70
9846146,9984274,4080,1428000,11412274,14.30
9846147,9996301,5836,2042600,12038901,20.43
9846148,9987738,3008,1052800,11040538,10.54
9846149,998265,510,178500,1176765,17.88
9846150,2950167,1609,563150,3513317,19.09
9846151,2413192,1870,654500,3067692,27.12
9846152,1238368,475,166250,1404618,13.42
9846153,9969327,5754,2013900,11983227,20.20
9846154,9971196,1414,494900,10466096,4.96
9846155,9973259,2137,747950,10721209,7.50
9846157,9968768,3129,1095150,11063918,10.99
9846159,9966921,3108,1087800,11054721,10.91
9846160,9979807,1299,454650,10434457,4.56
9846161,9984681,4334,1516900,11501581,15.19
9846162,9969588,4191,1466850,11436438,14.71
9846163,3018909,1691,591850,3610759,19.60
9846164,9986086,6351,2222850,12208936,22.26
9846165,9994549,1563,547050,10541599,5.47
9846166,2536889,1839,643650,3180539,25.37
9846167,9958485,2768,968800,10927285,9.73
9846169,9968043,1345,470750,10438793,4.72
9846171,6130342,3407,1192450,7322792,19.45
9846172,9962186,3414,1194900,11157086,11.99
9846173,9960270,3946,1381100,11341370,13.87
9846176,9938991,3502,1225700,11164691,12.33
9846177,9935152,4853,1698550,11633702,17.10
9846178,916034,1032,361200,1277234,39.43
9846179,9938394,2022,707700,10646094,7.12
9846180,9934555,4118,1441300,11375855,14.51
9846181,3649501,1817,635950,4285451,17.43
9846182,9936173,5383,1884050,11820223,18.96
9846183,367389,182,63700,431089,17.34
9846184,9950659,4118,1441300,11391959,14.48
9846185,9948620,2585,904750,10853370,9.09
9846186,9950656,4027,1409450,11360106,14.16
9846187,9947357,3779,1322650,11270007,13.30
9846188,9968092,4626,1619100,11587192,16.24
9846189,9973387,2698,944300,10917687,9.47
9846190,9983385,500,175000,10158385,1.75
9846191,9972429,1961,686350,10658779,6.88
9846192,3420493,1179,412650,3833143,12.06
9846193,9963259,4949,1732150,11695409,17.39
9846194,9668489,3638,1273300,10941789,13.17
9846195,7060542,3258,1140300,8200842,16.15
9846196,9880833,4801,1680350,11561183,17.01
9846197,9952232,2846,996100,10948332,10.01
9846198,9945181,5718,2001300,11946481,20.12
9846199,1996007,1013,354550,2350557,17.76
9846200,1957804,1371,479850,2437654,24.51
9846201,9932800,4109,1438150,11370950,14.48
9846202,9938422,697,243950,10182372,2.45
9846203,9908164,2941,1029350,10937514,10.39
9846205,9922136,5898,2064300,11986436,20.80
9846206,779168,343,120050,899218,15.41
9846207,9904937,3586,1255100,11160037,12.67
9846208,8900831,3816,1335600,10236431,15.01
9846209,9894332,4462,1561700,11456032,15.78
9846210,9893912,3469,1214150,11108062,12.27
9846211,9916803,3687,1290450,11207253,13.01
9846212,9915779,5306,1857100,11772879,18.73
9846213,9907015,4797,1678950,11585965,16.95
9846214,9930983,6123,2143050,12074033,21.58
9846215,9927433,3366,1178100,11105533,11.87
9846216,9920102,4666,1633100,11553202,16.46
9846217,9918300,5106,1787100,11705400,18.02
9846218,9918603,3830,1340500,11259103,13.52
9846219,9943157,1948,681800,10624957,6.86
9846220,9938026,4375,1531250,11469276,15.41
9846221,9964766,2207,772450,10737216,7.75
9846222,9964172,636,222600,10186772,2.23
9846223,9974862,2610,913500,10888362,9.16
9846224,9977902,3735,1307250,11285152,13.10
9846225,9966923,6167,2158450,12125373,21.66
9846226,9991629,4321,1512350,11503979,15.14
9846227,9986822,2960,1036000,11022822,10.37
9846228,8979245,2497,873950,9853195,9.73
9846229,9979709,6181,2163350,12143059,21.68
9846230,3157574,1338,468300,3625874,14.83
9846231,785197,61,21350,806547,2.72
9846232,9971390,6958,2435300,12406690,24.42
9846233,316627,205,71750,388377,22.66
9846234,9974598,2597,908950,10883548,9.11
9846235,9979840,1854,648900,10628740,6.50
9846236,9970265,3618,1266300,11236565,12.70
9846237,9960364,4932,1726200,11686564,17.33
9846238,9870931,299,104650,9975581,1.06
9846239,9937412,3136,1097600,11035012,11.05
9846240,9959030,4686,1640100,11599130,16.47
9846241,9964968,1846,646100,10611068,6.48
9846242,9969763,4510,1578500,11548263,15.83
9846244,9956440,1821,637350,10593790,6.40
9846245,3942475,1992,697200,4639675,17.68
9846246,9962501,1693,592550,10555051,5.95
9846247,9977480,1680,588000,10565480,5.89
9846248,9981574,1575,551250,10532824,5.52
9846249,9973802,1003,351050,10324852,3.52
9846250,9989597,4317,1510950,11500547,15.13
9846251,9985144,4938,1728300,11713444,17.31
9846252,9986138,673,235550,10221688,2.36
9846253,9986633,2384,834400,10821033,8.36
9846254,9975643,6126,2144100,12119743,21.49
9846255,9987325,2953,1033550,11020875,10.35
9846256,9985351,5676,1986600,11971951,19.90
9846257,9986112,1560,546000,10532112,5.47
9846258,9989298,1129,395150,10384448,3.96
9846259,9979417,3614,1264900,11244317,12.68
9846260,9998091,3241,1134350,11132441,11.35
9846261,9986874,429,150150,10137024,1.50
9846262,9980048,3696,1293600,11273648,12.96
9846263,9979009,5797,2028950,12007959,20.33
9846264,9992544,446,156100,10148644,1.56
9846265,603711,301,105350,709061,17.45
9846266,2207032,1738,608300,2815332,27.56
9846267,9977072,2843,995050,10972122,9.97
9846268,9974628,1850,647500,10622128,6.49
9846269,9982594,2690,941500,10924094,9.43
9846270,9988443,355,124250,10112693,1.24
9846271,9975517,529,185150,10160667,1.86
9846272,8988757,4423,1548050,10536807,17.22
9846273,9991346,2884,1009400,11000746,10.10
9846274,5332097,691,241850,5573947,4.54
9846275,9968623,4973,1740550,11709173,17.46
9846276,9965021,3076,1076600,11041621,10.80
9846277,9970705,234,81900,10052605,0.82
9846278,9962523,1851,647850,10610373,6.50
9846279,9963043,1249,437150,10400193,4.39
9846280,368651,286,100100,468751,27.15
9846281,9943886,4362,1526700,11470586,15.35
9846282,9941454,456,159600,10101054,1.61
9846283,7760319,2680,938000,8698319,12.09
9846284,9924711,3773,1320550,11245261,13.31
9846285,9922269,4591,1606850,11529119,16.19
9846286,9911489,4334,1516900,11428389,15.30
9846287,9934980,3177,1111950,11046930,11.19
9846290,9934191,2931,1025850,10960041,10.33
9846291,9935109,6233,2181550,12116659,21.96
9846292,9933291,4662,1631700,11564991,16.43
9846293,9936721,3644,1275400,11212121,12.84
9846294,242943,39,13650,256593,5.62
9846295,9946489,5500,1925000,11871489,19.35
9846296,9933829,4813,1684550,11618379,16.96
9846297,4023375,2146,751100,4774475,18.67
9846298,9935300,4716,1650600,11585900,16.61
9846299,9949026,5507,1927450,11876476,19.37
9846300,3840777,1556,544600,4385377,14.18
9846301,9719056,4223,1478050,11197106,15.21
9846302,1283757,1247,436450,1720207,34.00
9846303,9897692,4147,1451450,11349142,14.66
9846304,9915510,5552,1943200,11858710,19.60
9846305,9914443,5312,1859200,11773643,18.75
9846306,4023878,1497,523950,4547828,13.02
9846307,9901066,5961,2086350,11987416,21.07
9846308,8549827,4577,1601950,10151777,18.74
9846309,9913587,3079,1077650,10991237,10.87
9846310,9644035,1133,396550,10040585,4.11
9846311,9889450,3716,1300600,11190050,13.15
9846312,9903376,4460,1561000,11464376,15.76
9846313,9905177,4408,1542800,11447977,15.58
9846314,9922638,5958,2085300,12007938,21.02
9846315,9926661,4310,1508500,11435161,15.20
9846316,9932389,4482,1568700,11501089,15.79
9846317,1589173,782,273700,1862873,17.22
9846318,8725826,4032,1411200,10137026,16.17
9846319,9886869,6092,2132200,12019069,21.57
9846320,9909621,2937,1027950,10937571,10.37
9846321,9924520,5452,1908200,11832720,19.23
9846322,9918825,3834,1341900,11260725,13.53
9846323,9913885,3030,1060500,10974385,10.70
9846324,9821150,3614,1264900,11086050,12.88
9846325,9932274,4663,1632050,11564324,16.43
9846326,9922481,1915,670250,10592731,6.75
9846327,4183834,3441,1204350,5388184,28.79
9846328,9926038,3153,1103550,11029588,11.12
9846329,9913522,1877,656950,10570472,6.63
9846330,9913723,6221,2177350,12091073,21.96
9846331,9919196,4882,1708700,11627896,17.23
9846332,217879,151,52850,270729,24.26
9846333,9919854,4189,1466150,11386004,14.78
9846334,9908738,3395,1188250,11096988,11.99
9846335,9904846,1927,674450,10579296,6.81
9846336,9913414,3583,1254050,11167464,12.65
9846337,9919329,5284,1849400,11768729,18.64
9846338,1255155,1493,522550,1777705,41.63
9846339,9896955,2627,919450,10816405,9.29
9846340,9904229,5324,1863400,11767629,18.81
9846341,9917782,3491,1221850,11139632,12.32
9846342,9919306,4704,1646400,11565706,16.60
9846343,9920805,4989,1746150,11666955,17.60
9846344,9928748,4358,1525300,11454048,15.36
9846345,9924414,4772,1670200,11594614,16.83
9846346,3422181,2023,708050,4130231,20.69
9846347,2513743,933,326550,2840293,12.99
9846348,9922957,7681,2688350,12611307,27.09
9846349,9908355,5194,1817900,11726255,18.35
9846351,9952121,3885,1359750,11311871,13.66
9846352,9946475,6980,2443000,12389475,24.56
9846353,9950057,3327,1164450,11114507,11.70
9846354,9950356,4758,1665300,11615656,16.74
9846355,9947062,4551,1592850,11539912,16.01
9846356,9969529,4534,1586900,11556429,15.92
9846357,9969670,5030,1760500,11730170,17.66
9846358,9970173,3916,1370600,11340773,13.75
9846359,9960218,4456,1559600,11519818,15.66
9846360,9952972,1569,549150,10502122,5.52
9846361,9966410,5497,1923950,11890360,19.30
9846362,9949014,1456,509600,10458614,5.12
9846363,9965581,2496,873600,10839181,8.77
9846364,9968497,375,131250,10099747,1.32
9846365,9967486,3445,1205750,11173236,12.10
9846366,9990191,1521,532350,10522541,5.33
9846367,9961959,497,173950,10135909,1.75
9846368,1499498,956,334600,1834098,22.31
9846369,9668820,4744,1660400,11329220,17.17
9846370,1702587,779,272650,1975237,16.01
9846371,9947816,6845,2395750,12343566,24.08
9846372,9956063,4642,1624700,11580763,16.32
9846373,9968542,4365,1527750,11496292,15.33
9846375,2044424,1374,480900,2525324,23.52
9846376,9955638,3859,1350650,11306288,13.57
9846377,9964784,3561,1246350,11211134,12.51
9846378,9944929,1940,679000,10623929,6.83
9846379,5085503,3263,1142050,6227553,22.46
9846380,264408,190,66500,330908,25.15
9846381,9920934,5200,1820000,11740934,18.35
9846382,9932947,2684,939400,10872347,9.46
9846383,9937022,536,187600,10124622,1.89
9846384,5404939,3436,1202600,6607539,22.25
9846385,9923105,3636,1272600,11195705,12.82
9846386,9931993,1786,625100,10557093,6.29
9846387,9933569,1320,462000,10395569,4.65
9846388,9931098,3351,1172850,11103948,11.81
9846389,9930918,948,331800,10262718,3.34
9846390,9945963,5157,1804950,11750913,18.15
9846391,2844463,2088,730800,3575263,25.69
9846392,9938164,3595,1258250,11196414,12.66
9846393,9945955,5521,1932350,11878305,19.43
9846394,9965027,3507,1227450,11192477,12.32
9846395,515824,339,118650,634474,23.00
9846396,1549347,762,266700,1816047,17.21
9846398,9920613,4685,1639750,11560363,16.53
9846399,9917717,3088,1080800,10998517,10.90
9846400,9908586,2112,739200,10647786,7.46
9846401,9929558,4731,1655850,11585408,16.68
9846402,9940821,4699,1644650,11585471,16.54
9846404,9935258,5669,1984150,11919408,19.97
9846405,9941725,4762,1666700,11608425,16.76
9846407,9934294,4680,1638000,11572294,16.49
9846408,2374107,1091,381850,2755957,16.08
9846409,9915526,797,278950,10194476,2.81
9846410,9919795,5216,1825600,11745395,18.40
9846411,9910938,6279,2197650,12108588,22.17
9846412,9895858,5649,1977150,11873008,19.98
9846413,9929138,4568,1598800,11527938,16.10
9846414,2277198,1304,456400,2733598,20.04
9846415,9920382,2198,769300,10689682,7.75
9846416,511507,38,13300,524807,2.60
9846418,9902844,5537,1937950,11840794,19.57
9846419,9913790,5693,1992550,11906340,20.10
9846420,9905004,5298,1854300,11759304,18.72
9846421,5117024,3236,1132600,6249624,22.13
9846422,7268191,4031,1410850,8679041,19.41
9846423,9888177,5379,1882650,11770827,19.04
9846424,9866100,5559,1945650,11811750,19.72
9846425,9897860,4210,1473500,11371360,14.89
9846426,1172720,1690,591500,1764220,50.44
9846427,9897518,4864,1702400,11599918,17.20
9846428,9896785,4826,1689100,11585885,17.07
9846429,9918932,6214,2174900,12093832,21.93
9846430,855237,689,241150,1096387,28.20
9846431,9904592,5419,1896650,11801242,19.15
9846432,9901033,431,150850,10051883,1.52
9846433,9905573,3281,1148350,11053923,11.59
9846434,1072222,1518,531300,1603522,49.55
9846435,9881299,4395,1538250,11419549,15.57
9846436,387870,416,145600,533470,37.54
9846437,9895977,5232,1831200,11727177,18.50
9846438,9906061,5487,1920450,11826511,19.39
9846439,9915104,4429,1550150,11465254,15.63
9846440,9911202,3592,1257200,11168402,12.68
9846441,9913191,5294,1852900,11766091,18.69
9846442,9933651,6730,2355500,12289151,23.71
9846443,9924062,5755,2014250,11938312,20.30
9846444,1399860,712,249200,1649060,17.80
9846445,252790,145,50750,303540,20.08
9846446,1640847,670,234500,1875347,14.29
9846447,9909440,5957,2084950,11994390,21.04
9846448,1091083,941,329350,1420433,30.19
9846449,9887493,4602,1610700,11498193,16.29
9846450,9906684,6162,2156700,12063384,21.77
9846451,9911768,5543,1940050,11851818,19.57
9846452,9925996,5601,1960350,11886346,19.75
9846453,808756,424,148400,957156,18.35
9846454,9913339,1502,525700,10439039,5.30
9846455,9922903,5105,1786750,11709653,18.01
9846456,9916151,4180,1463000,11379151,14.75
9846457,2165565,495,173250,2338815,8.00
9846458,9895205,4476,1566600,11461805,15.83
9846459,9900032,4238,1483300,11383332,14.98
9846460,9906953,2950,1032500,10939453,10.42
9846461,9917833,1412,494200,10412033,4.98
9846462,9922046,3439,1203650,11125696,12.13
9846463,9927147,3221,1127350,11054497,11.36
9846464,2065655,1681,588350,2654005,28.48
9846465,9899606,3144,1100400,11000006,11.12
9846466,9907378,4691,1641850,11549228,16.57
9846467,9899960,1890,661500,10561460,6.68
9846468,9908230,450,157500,10065730,1.59
9846469,9907372,5261,1841350,11748722,18.59
9846470,9911236,2792,977200,10888436,9.86
9846471,9918367,4289,1501150,11419517,15.14
9846472,3060557,2513,879550,3940107,28.74
9846474,4116935,1736,607600,4724535,14.76
9846475,9887513,3964,1387400,11274913,14.03
9846476,9892822,1733,606550,10499372,6.13
9846477,9904279,4747,1661450,11565729,16.78
9846478,1080760,609,213150,1293910,19.72
9846479,9907775,4121,1442350,11350125,14.56
9846480,3636151,1371,479850,4116001,13.20
9846481,9884054,3946,1381100,11265154,13.97
9846482,9899349,3084,1079400,10978749,10.90
9846483,7657121,3735,1307250,8964371,17.07
9846484,9895235,5652,1978200,11873435,19.99
9846485,514032,139,48650,562682,9.46
9846486,9876725,4023,1408050,11284775,14.26
9846487,9869579,3607,1262450,11132029,12.79
9846488,9870501,4064,1422400,11292901,14.41
9846489,9875686,3169,1109150,10984836,11.23
9846490,9892109,6323,2213050,12105159,22.37
9846491,9896841,1374,480900,10377741,4.86
9846492,9910762,3364,1177400,11088162,11.88
9846493,1786266,498,174300,1960566,9.76
9846494,9928504,2637,922950,10851454,9.30
9846495,1272457,214,74900,1347357,5.89
9846496,9892225,3119,1091650,10983875,11.04
9846497,9916097,3920,1372000,11288097,13.84
9846498,9922717,2815,985250,10907967,9.93
9846499,9919287,937,327950,10247237,3.31
9846500,9902813,2098,734300,10637113,7.42
9846501,9845898,2997,1048950,10894848,10.65
9846502,9888120,4497,1573950,11462070,15.92
9846503,9910243,1798,629300,10539543,6.35
9846504,9924390,1117,390950,10315340,3.94
9846505,9928551,2242,784700,10713251,7.90
9846506,929605,807,282450,1212055,30.38
9846507,9937091,3063,1072050,11009141,10.79
9846508,9945231,5678,1987300,11932531,19.98
9846509,9932430,1993,697550,10629980,7.02
9846510,9925619,3027,1059450,10985069,10.67
9846511,9852237,4313,1509550,11361787,15.32
9846512,783575,379,132650,916225,16.93
9846513,9930873,4655,1629250,11560123,16.41
9846514,9506378,4333,1516550,11022928,15.95
9846515,9945821,3097,1083950,11029771,10.90
9846516,9952580,3715,1300250,11252830,13.06
9846517,9970366,592,207200,10177566,2.08
9846518,9944827,190,66500,10011327,0.67
9846519,9885409,3999,1399650,11285059,14.16
9846520,9876623,1061,371350,10247973,3.76
9846521,6764875,3152,1103200,7868075,16.31
9846522,9949709,2203,771050,10720759,7.75
9846523,672342,152,53200,725542,7.91
9846524,9937239,2617,915950,10853189,9.22
9846525,9923141,531,185850,10108991,1.87
9846526,9938775,3418,1196300,11135075,12.04
9846527,9871851,3996,1398600,11270451,14.17
9846528,126633,117,40950,167583,32.34
9846530,9908673,5936,2077600,11986273,20.97
9846531,9915372,3726,1304100,11219472,13.15
9846532,9921777,4685,1639750,11561527,16.53
9846533,9919670,4239,1483650,11403320,14.96
9846534,9928941,5276,1846600,11775541,18.60
9846535,418553,275,96250,514803,23.00
9846536,9901703,4979,1742650,11644353,17.60
9846537,9911625,2321,812350,10723975,8.20
9846538,9838597,3264,1142400,10980997,11.61
9846539,9914112,5282,1848700,11762812,18.65
9846540,975287,639,223650,1198937,22.93
9846541,9860070,2553,893550,10753620,9.06
9846542,2331059,1673,585550,2916609,25.12
9846543,9812397,5241,1834350,11646747,18.69
9846544,9879785,3729,1305150,11184935,13.21
9846545,9844066,7710,2698500,12542566,27.41
9846546,9808479,6962,2436700,12245179,24.84
9846547,9879833,4817,1685950,11565783,17.06
9846548,9900119,3382,1183700,11083819,11.96
9846549,9908393,1212,424200,10332593,4.28
9846550,9512210,4169,1459150,10971360,15.34
9846551,9893285,3294,1152900,11046185,11.65
9846552,9905535,2125,743750,10649285,7.51
9846553,9915374,5160,1806000,11721374,18.21
9846554,9923855,4751,1662850,11586705,16.76
9846555,9946297,660,231000,10177297,2.32
9846556,9936799,3053,1068550,11005349,10.75
9846557,9928833,6251,2187850,12116683,22.04
9846558,9930871,3130,1095500,11026371,11.03
9846559,9947251,4853,1698550,11645801,17.08
9846560,9949526,3478,1217300,11166826,12.23
9846561,7564277,3176,1111600,8675877,14.70
9846562,9863663,6162,2156700,12020363,21.87
9846563,9678684,4987,1745450,11424134,18.03
9846564,93193,59,20650,113843,22.16
9846565,9947144,7351,2572850,12519994,25.87
9846566,4243819,2185,764750,5008569,18.02
9846567,9921911,5085,1779750,11701661,17.94
9846568,9943070,5046,1766100,11709170,17.76
9846569,9940257,680,238000,10178257,2.39
9846570,9919119,1623,568050,10487169,5.73
9846571,9931590,755,264250,10195840,2.66
9846572,9945154,5129,1795150,11740304,18.05
9846573,9944174,4909,1718150,11662324,17.28
9846575,1449198,749,262150,1711348,18.09
9846576,9975836,3367,1178450,11154286,11.81
9846577,9975789,1025,358750,10334539,3.60
9846578,9979345,7761,2716350,12695695,27.22
9846579,104901,58,20300,125201,19.35
9846580,9971024,3679,1287650,11258674,12.91
9846581,9984295,3179,1112650,11096945,11.14
9846582,9985742,1561,546350,10532092,5.47
9846583,9974604,4287,1500450,11475054,15.04
9846584,9982719,2158,755300,10738019,7.57
9846585,9992833,5818,2036300,12029133,20.38
9846586,9974810,2589,906150,10880960,9.08
9846587,9987884,3556,1244600,11232484,12.46
9846588,9974775,2590,906500,10881275,9.09
9846589,3340609,2141,749350,4089959,22.43
9846590,9904102,3990,1396500,11300602,14.10
9846591,9977513,1619,566650,10544163,5.68
9846592,9992160,5630,1970500,11962660,19.72
9846593,56185,42,14700,70885,26.16
9846594,9961913,1550,542500,10504413,5.45
9846595,9973773,419,146650,10120423,1.47
9846596,5985307,2206,772100,6757407,12.90
9846597,9978356,4752,1663200,11641556,16.67
9846598,1234307,372,130200,1364507,10.55
9846599,5134382,3579,1252650,6387032,24.40
9846600,9989579,6120,2142000,12131579,21.44
9846601,9990430,2142,749700,10740130,7.50
9846602,9971413,3327,1164450,11135863,11.68
9846603,207688,128,44800,252488,21.57
9846604,9967964,3840,1344000,11311964,13.48
9846606,2703838,2065,722750,3426588,26.73
9846607,3408230,810,283500,3691730,8.32
9846608,9999148,5061,1771350,11770498,17.72
9846609,9987971,3287,1150450,11138421,11.52
9846610,9976617,2936,1027600,11004217,10.30
9846611,9980422,1844,645400,10625822,6.47
9846612,9974264,3036,1062600,11036864,10.65
9846613,9960191,3448,1206800,11166991,12.12
9846614,9970297,1213,424550,10394847,4.26
9846615,682112,339,118650,800762,17.39
9846616,9942227,4714,1649900,11592127,16.59
9846617,1388294,527,184450,1572744,13.29
9846618,9927399,1684,589400,10516799,5.94
9846619,9907121,1853,648550,10555671,6.55
9846620,27062,35,12250,39312,45.27
9846621,9827055,6829,2390150,12217205,24.32
9846622,9918147,3040,1064000,10982147,10.73
9846623,9935522,1058,370300,10305822,3.73
9846624,9931680,2496,873600,10805280,8.80
9846625,9956092,3582,1253700,11209792,12.59
9846626,9948910,2331,815850,10764760,8.20
9846627,9959255,491,171850,10131105,1.73
9846628,9957622,1458,510300,10467922,5.12
9846629,9974424,2326,814100,10788524,8.16
9846630,9976880,1690,591500,10568380,5.93
9846631,9984877,5130,1795500,11780377,17.98
9846632,9979376,4262,1491700,11471076,14.95
9846633,9993384,2471,864850,10858234,8.65
9846634,9982372,4774,1670900,11653272,16.74
9846635,9986991,691,241850,10228841,2.42
9846636,1999242,814,284900,2284142,14.25
9846637,9978438,3271,1144850,11123288,11.47
9846638,9970918,1447,506450,10477368,5.08
9846639,9980814,2692,942200,10923014,9.44
9846640,9971976,316,110600,10082576,1.11
9846641,9982463,4797,1678950,11661413,16.82
9846642,9628353,3660,1281000,10909353,13.30
9846643,9996244,6056,2119600,12115844,21.20
9846644,9979329,4301,1505350,11484679,15.08
9846646,9970635,1096,383600,10354235,3.85
9846648,9202618,3516,1230600,10433218,13.37
9846649,9980519,5785,2024750,12005269,20.29
9846650,9983769,5859,2050650,12034419,20.54
9846651,9978011,655,229250,10207261,2.30
9846652,9993742,1805,631750,10625492,6.32
9846653,9982988,2338,818300,10801288,8.20
9846654,9988255,438,153300,10141555,1.53
9846655,9979170,2832,991200,10970370,9.93
9846656,9999562,1146,401100,10400662,4.01
9846657,9971174,3155,1104250,11075424,11.07
9846658,617228,434,151900,769128,24.61
9846659,230843,85,29750,260593,12.89
9846660,329552,223,78050,407602,23.68
9846661,4325316,3034,1061900,5387216,24.55
9846662,9965847,7191,2516850,12482697,25.25
9846663,9983868,396,138600,10122468,1.39
9846664,9985679,3557,1244950,11230629,12.47
9846665,9980305,4130,1445500,11425805,14.48
9846666,9986539,6570,2299500,12286039,23.03
9846667,9962349,4085,1429750,11392099,14.35
9846668,9981817,487,170450,10152267,1.71
9846670,9983669,5300,1855000,11838669,18.58
9846671,9980624,3055,1069250,11049874,10.71
9846672,9990724,470,164500,10155224,1.65
9846673,9980295,517,180950,10161245,1.81
9846674,9987307,1359,475650,10462957,4.76
9846675,9981671,1011,353850,10335521,3.54
9846676,9989638,1190,416500,10406138,4.17
9846677,9974035,2479,867650,10841685,8.70
9846678,9961321,3272,1145200,11106521,11.50
9846679,9923434,2740,959000,10882434,9.66
9846680,354681,246,86100,440781,24.28
9846681,9990368,5205,1821750,11812118,18.24
9846682,9990887,2275,796250,10787137,7.97
9846683,546270,297,103950,650220,19.03
9846684,9993411,6331,2215850,12209261,22.17
9846685,9978946,1537,537950,10516896,5.39
9846686,9992342,899,314650,10306992,3.15
9846687,9991873,947,331450,10323323,3.32
9846688,9990354,461,161350,10151704,1.62
9846689,9991388,1479,517650,10509038,5.18
9846690,9963904,1959,685650,10649554,6.88
9846691,2086849,1237,432950,2519799,20.75
9846692,839213,344,120400,959613,14.35
9846694,9984462,4729,1655150,11639612,16.58
9846695,453509,310,108500,562009,23.92
9846696,9971322,649,227150,10198472,2.28
9846697,9963046,1111,388850,10351896,3.90
9846698,9967849,3164,1107400,11075249,11.11
9846699,772475,332,116200,888675,15.04
9846700,9954429,2316,810600,10765029,8.14
9846701,9952724,467,163450,10116174,1.64
9846703,9969241,1710,598500,10567741,6.00
9846704,9986713,974,340900,10327613,3.41
9846705,9965251,2061,721350,10686601,7.24
9846706,1882466,339,118650,2001116,6.30
9846708,9967929,4519,1581650,11549579,15.87
9846709,9979292,1263,442050,10421342,4.43
9846710,9984257,1682,588700,10572957,5.90
9846712,9989625,1789,626150,10615775,6.27
9846713,9991480,776,271600,10263080,2.72
9846714,9980805,4947,1731450,11712255,17.35
9846715,9984919,4834,1691900,11676819,16.94
9846716,9995462,2430,850500,10845962,8.51
9846717,9991374,2101,735350,10726724,7.36
9846719,9972830,3717,1300950,11273780,13.04
9846720,9969428,3861,1351350,11320778,13.55
9846721,9985991,5415,1895250,11881241,18.98
9846722,9959775,393,137550,10097325,1.38
9846723,9971916,3864,1352400,11324316,13.56
9846724,9989483,3896,1363600,11353083,13.65
9846725,137435,101,35350,172785,25.72
9846726,9949018,4301,1505350,11454368,15.13
9846727,9965869,3962,1386700,11352569,13.91
9846728,9970522,6339,2218650,12189172,22.25
9846729,9970633,135,47250,10017883,0.47
9846730,2208785,833,291550,2500335,13.20
9846731,9954018,2772,970200,10924218,9.75
9846732,9947890,3107,1087450,11035340,10.93
9846733,9952160,3169,1109150,11061310,11.14
9846734,9946076,2267,793450,10739526,7.98
9846735,9961006,4323,1513050,11474056,15.19
9846736,9958811,1007,352450,10311261,3.54
9846737,6482187,3651,1277850,7760037,19.71
9846738,9705233,3139,1098650,10803883,11.32
9846739,9973341,2410,843500,10816841,8.46
9846740,9971366,3458,1210300,11181666,12.14
9846741,9921535,5845,2045750,11967285,20.62
9846742,8983696,4536,1587600,10571296,17.67
9846743,3379400,1358,475300,3854700,14.06
9846744,77709,42,14700,92409,18.92
9846745,829746,532,186200,1015946,22.44
9846746,9926399,3808,1332800,11259199,13.43
9846747,9986607,930,325500,10312107,3.26
9846748,851604,438,153300,1004904,18.00
9846749,9999925,3628,1269800,11269725,12.70
9846750,9983740,1014,354900,10338640,3.55
9846751,9981153,2008,702800,10683953,7.04
9846752,9976269,144,50400,10026669,0.51
9846753,571457,135,47250,618707,8.27
9846754,5904744,2305,806750,6711494,13.66
9846755,1152008,116,40600,1192608,3.52
9846756,9954824,3179,1112650,11067474,11.18
9846757,9961249,5908,2067800,12029049,20.76
9846758,1699821,2174,760900,2460721,44.76
9846759,9979424,3973,1390550,11369974,13.93
9846760,9986882,5905,2066750,12053632,20.69
9846761,1309699,67,23450,1333149,1.79
9846762,9971457,4357,1524950,11496407,15.29
9846763,9972214,1024,358400,10330614,3.59
9846764,9981518,1797,628950,10610468,6.30
9846765,9983094,3458,1210300,11193394,12.12
9846766,9976276,1375,481250,10457526,4.82
9846768,9988864,1618,566300,10555164,5.67
9846769,2244322,1582,553700,2798022,24.67
9846770,9952125,1948,681800,10633925,6.85
9846771,9963391,1275,446250,10409641,4.48
9846772,3293047,1612,564200,3857247,17.13
9846773,1214478,334,116900,1331378,9.63
9846774,556566,668,233800,790366,42.01
9846775,9970168,4970,1739500,11709668,17.45
9846776,314047,245,85750,399797,27.30
9846777,9945903,539,188650,10134553,1.90
9846778,5821791,2080,728000,6549791,12.50
9846780,9824340,3690,1291500,11115840,13.15
9846781,9905160,839,293650,10198810,2.96
9846782,9910607,5917,2070950,11981557,20.90
9846783,9914357,2770,969500,10883857,9.78
9846784,9933239,3779,1322650,11255889,13.32
9846785,2232889,300,105000,2337889,4.70
9846786,3070502,2018,706300,3776802,23.00
9846787,1453767,390,136500,1590267,9.39
9846788,9947637,6464,2262400,12210037,22.74
9846789,9960565,4097,1433950,11394515,14.40
9846790,9952179,3260,1141000,11093179,11.46
9846791,9968568,629,220150,10188718,2.21
9846792,1089127,768,268800,1357927,24.68
9846793,9966640,4432,1551200,11517840,15.56
9846794,9971244,2100,735000,10706244,7.37
9846795,1705561,794,277900,1983461,16.29
9846796,9992915,3550,1242500,11235415,12.43
9846797,9990126,3268,1143800,11133926,11.45
9846798,9964152,3614,1264900,11229052,12.69
9846799,4978470,3784,1324400,6302870,26.60
9846800,1633210,1224,428400,2061610,26.23
9846801,9972739,2661,931350,10904089,9.34
9846802,6922886,3026,1059100,7981986,15.30
9846803,9951195,1218,426300,10377495,4.28
9846804,9925322,1938,678300,10603622,6.83
9846805,1647832,1144,400400,2048232,24.30
9846806,9909803,5141,1799350,11709153,18.16
9846807,460863,230,80500,541363,17.47
9846808,2424432,1499,524650,2949082,21.64
9846809,9889592,4912,1719200,11608792,17.38
9846810,9872279,4206,1472100,11344379,14.91
9846811,9862232,910,318500,10180732,3.23
9846812,9877980,4221,1477350,11355330,14.96
9846813,9880185,3093,1082550,10962735,10.96
9846814,2568237,375,131250,2699487,5.11
9846815,9849255,3788,1325800,11175055,13.46
9846817,9859936,2179,762650,10622586,7.73
9846818,9860982,5407,1892450,11753432,19.19
9846819,9870456,5006,1752100,11622556,17.75
9846820,9850877,5640,1974000,11824877,20.04
9846821,9838169,5745,2010750,11848919,20.44
9846822,9874077,5201,1820350,11694427,18.44
9846823,9858087,7587,2655450,12513537,26.94
9846824,9855840,3465,1212750,11068590,12.30
9846825,9874388,5500,1925000,11799388,19.49
9846826,8908750,1043,365050,9273800,4.10
9846827,333672,339,118650,452322,35.56
9846828,9874620,5392,1887200,11761820,19.11
9846829,9895629,4497,1573950,11469579,15.91
9846830,9892243,2098,734300,10626543,7.42
9846831,1733133,3155,1104250,2837383,63.71
9846832,9888086,5990,2096500,11984586,21.20
9846833,9901232,359,125650,10026882,1.27
9846834,9913709,428,149800,10063509,1.51
9846836,607954,519,181650,789604,29.88
9846837,5882893,3253,1138550,7021443,19.35
9846838,3581261,2521,882350,4463611,24.64
9846839,9873794,6055,2119250,11993044,21.46
9846840,9883443,3055,1069250,10952693,10.82
9846841,9870110,2897,1013950,10884060,10.27
9846842,9875209,3070,1074500,10949709,10.88
9846843,9855825,1736,607600,10463425,6.16
9846844,834007,768,268800,1102807,32.23
9846846,9824394,5812,2034200,11858594,20.71
9846847,1191556,1301,455350,1646906,38.21
9846848,9797537,5841,2044350,11841887,20.87
9846849,9802000,7706,2697100,12499100,27.52
9846850,9821807,4443,1555050,11376857,15.83
9846851,9819029,4849,1697150,11516179,17.28
9846852,9818648,5677,1986950,11805598,20.24
9846853,1062755,1227,429450,1492205,40.41
9846854,9831065,7442,2604700,12435765,26.49
9846855,9859835,8581,3003350,12863185,30.46
9846856,9865041,6984,2444400,12309441,24.78
9846857,9872467,5525,1933750,11806217,19.59
9846858,1243948,1961,686350,1930298,55.18
9846859,9861274,6840,2394000,12255274,24.28
9846860,9879463,5224,1828400,11707863,18.51
9846861,9880660,6341,2219350,12100010,22.46
9846862,9906061,5513,1929550,11835611,19.48
9846863,9893336,5338,1868300,11761636,18.88
9846864,9895779,1735,607250,10503029,6.14
9846865,5238900,3082,1078700,6317600,20.59
9846866,9909064,8534,2986900,12895964,30.14
9846867,9918125,5159,1805650,11723775,18.21
9846868,6354274,4307,1507450,7861724,23.72
9846869,2736330,1284,449400,3185730,16.42
9846870,9913618,3987,1395450,11309068,14.08
9846871,298695,104,36400,335095,12.19
9846872,2615600,1354,473900,3089500,18.12
9846873,9914213,4744,1660400,11574613,16.75
9846874,9844480,4090,1431500,11275980,14.54
9846875,563443,365,127750,691193,22.67
9846876,9936706,5382,1883700,11820406,18.96
9846877,9942330,6652,2328200,12270530,23.42
9846878,9951482,1783,624050,10575532,6.27
9846879,9952712,1199,419650,10372362,4.22
9846880,9959162,5064,1772400,11731562,17.80
9846881,9969211,2442,854700,10823911,8.57
9846882,1117026,964,337400,1454426,30.21
9846883,9944807,5157,1804950,11749757,18.15
9846884,9958248,1991,696850,10655098,7.00
9846885,9708316,4610,1613500,11321816,16.62
9846886,2968002,1110,388500,3356502,13.09
9846887,9948681,5550,1942500,11891181,19.53
9846888,9959808,3002,1050700,11010508,10.55
9846889,9965178,2182,763700,10728878,7.66
9846890,9974849,4138,1448300,11423149,14.52
9846891,9986214,1528,534800,10521014,5.36
9846893,9977643,372,130200,10107843,1.30
9846894,9980941,4144,1450400,11431341,14.53
9846895,9992396,3406,1192100,11184496,11.93
9846896,9982996,486,170100,10153096,1.70
9846897,9979566,4194,1467900,11447466,14.71
9846898,6247182,177,61950,6309132,0.99
9846899,9969973,826,289100,10259073,2.90
9846900,9973218,2825,988750,10961968,9.91
9846901,9967161,4009,1403150,11370311,14.08
9846902,268204,93,32550,300754,12.14
9846903,9978125,3200,1120000,11098125,11.22
9846904,9983205,682,238700,10221905,2.39
9846905,9103859,3512,1229200,10333059,13.50
9846906,335706,276,96600,432306,28.78
9846907,9948229,2414,844900,10793129,8.49
9846908,9961650,952,333200,10294850,3.34
9846909,9966224,2623,918050,10884274,9.21
9846910,1706843,565,197750,1904593,11.59
9846911,9937853,4908,1717800,11655653,17.29
9846912,9950136,3811,1333850,11283986,13.41
9846913,9979150,1019,356650,10335800,3.57
9846914,739197,352,123200,862397,16.67
9846915,2047475,1431,500850,2548325,24.46
9846916,9952582,6520,2282000,12234582,22.93
9846917,9966372,2962,1036700,11003072,10.40
9846918,9967275,933,326550,10293825,3.28
9846919,9972683,4367,1528450,11501133,15.33
9846920,1880331,1282,448700,2329031,23.86
9846921,573335,312,109200,682535,19.05
9846922,9693959,4489,1571150,11265109,16.21
9846923,9942664,2005,701750,10644414,7.06
9846924,1124652,378,132300,1256952,11.76
9846925,9959898,5957,2084950,12044848,20.93
9846926,572590,127,44450,617040,7.76
9846927,9854702,4061,1421350,11276052,14.42
9846928,316852,233,81550,398402,25.74
9846929,9945261,1117,390950,10336211,3.93
9846931,6109363,2511,878850,6988213,14.39
9846932,4929575,836,292600,5222175,5.94
9846933,9964713,5084,1779400,11744113,17.86
9846934,9958647,1063,372050,10330697,3.74
9846935,2678914,1620,567000,3245914,21.17
9846936,9702349,5250,1837500,11539849,18.94
9846937,9958854,2201,770350,10729204,7.74
9846938,1280511,350,122500,1403011,9.57
9846939,610040,462,161700,771740,26.51
9846940,9955560,6602,2310700,12266260,23.21
9846943,7240098,2874,1005900,8245998,13.89
9846944,4159322,1074,375900,4535222,9.04
9846945,9941204,3075,1076250,11017454,10.83
9846946,9956409,4040,1414000,11370409,14.20
9846947,9962213,5132,1796200,11758413,18.03
9846948,3931622,590,206500,4138122,5.25
9846949,9958476,4094,1432900,11391376,14.39
9846950,9957922,5497,1923950,11881872,19.32
9846951,9942803,2750,962500,10905303,9.68
9846952,9945131,3612,1264200,11209331,12.71
9846953,413153,77,26950,440103,6.52
9846954,8737981,1009,353150,9091131,4.04
9846955,9922390,438,153300,10075690,1.54
9846956,9934988,1265,442750,10377738,4.46
9846957,9939134,4704,1646400,11585534,16.56
9846958,9956633,4435,1552250,11508883,15.59
9846959,9967763,2947,1031450,10999213,10.35
9846960,7761611,760,266000,8027611,3.43
9846961,9948001,5459,1910650,11858651,19.21
9846962,9948613,4441,1554350,11502963,15.62
9846963,9961517,445,155750,10117267,1.56
9846964,8954682,4123,1443050,10397732,16.12
9846965,8635864,623,218050,8853914,2.52
9846966,8393680,4597,1608950,10002630,19.17
9846967,9975406,1719,601650,10577056,6.03
9846968,9976037,4724,1653400,11629437,16.57
9846969,9964293,3948,1381800,11346093,13.87
9846970,9980802,3215,1125250,11106052,11.27
9846971,2916087,500,175000,3091087,6.00
9846972,9976720,5229,1830150,11806870,18.34
9846973,9984206,2219,776650,10760856,7.78
9846974,9995504,3940,1379000,11374504,13.80
9846975,9990792,4240,1484000,11474792,14.85
9846976,9983073,2184,764400,10747473,7.66
9846977,2961224,937,327950,3289174,11.07
9846978,6506511,1140,399000,6905511,6.13
9846979,9985839,3904,1366400,11352239,13.68
9846980,98403,23,8050,106453,8.18
9846981,9944736,1483,519050,10463786,5.22
9846982,9960586,2902,1015700,10976286,10.20
9846983,9962180,5756,2014600,11976780,20.22
9846984,9977252,3964,1387400,11364652,13.91
9846986,9985365,6444,2255400,12240765,22.59
9846987,9598350,3845,1345750,10944100,14.02
9846988,9979604,3706,1297100,11276704,13.00
9846989,9973795,1627,569450,10543245,5.71
9846990,9977193,5463,1912050,11889243,19.16
9846991,4679469,797,278950,4958419,5.96
9846992,9690931,5664,1982400,11673331,20.46
9846993,9977012,4648,1626800,11603812,16.31
9846994,9964006,4737,1657950,11621956,16.64
9846995,9981317,6487,2270450,12251767,22.75
9846996,9969930,5108,1787800,11757730,17.93
9846997,9987813,5868,2053800,12041613,20.56
9846998,2333114,450,157500,2490614,6.75
9846999,9963643,6413,2244550,12208193,22.53
9847000,9940290,3132,1096200,11036490,11.03
9847001,3115295,1471,514850,3630145,16.53
9847002,9938865,5578,1952300,11891165,19.64
9847003,2768407,953,333550,3101957,12.05
9847004,4381288,2290,801500,5182788,18.29
9847005,9942777,6385,2234750,12177527,22.48
9847006,9947820,6308,2207800,12155620,22.19
9847007,9929240,6012,2104200,12033440,21.19
9847008,9922442,3879,1357650,11280092,13.68
9847009,9952432,4580,1603000,11555432,16.11
9847010,9953431,5454,1908900,11862331,19.18
9847011,9944144,5742,2009700,11953844,20.21
9847012,9947931,6259,2190650,12138581,22.02
9847013,9951055,6880,2408000,12359055,24.20
9847014,9952288,3267,1143450,11095738,11.49
9847015,9948611,3767,1318450,11267061,13.25
9847016,9932987,3507,1227450,11160437,12.36
9847017,9933670,5139,1798650,11732320,18.11
9847018,9930958,6558,2295300,12226258,23.11
9847019,9944126,6405,2241750,12185876,22.54
9847020,9968426,609,213150,10181576,2.14
9847021,9959721,1740,609000,10568721,6.11
9847022,9957629,4448,1556800,11514429,15.63
9847023,9874323,4685,1639750,11514073,16.61
9847024,9934852,5896,2063600,11998452,20.77
9847025,9966699,1337,467950,10434649,4.70
9847026,9958549,1364,477400,10435949,4.79
9847027,9959455,2482,868700,10828155,8.72
9847028,9969497,4203,1471050,11440547,14.76
9847029,9946625,1370,479500,10426125,4.82
9847030,3077394,1856,649600,3726994,21.11
9847031,9988320,4530,1585500,11573820,15.87
9847032,9992874,2724,953400,10946274,9.54
9847033,9983838,589,206150,10189988,2.06
9847034,9981595,643,225050,10206645,2.25
9847035,9970154,5587,1955450,11925604,19.61
9847036,9983032,1863,652050,10635082,6.53
9847037,9987724,2256,789600,10777324,7.91
9847038,9740007,625,218750,9958757,2.25
9847039,9995039,4354,1523900,11518939,15.25
9847040,9988157,4365,1527750,11515907,15.30
9847041,1911749,353,123550,2035299,6.46
9847042,9968609,2418,846300,10814909,8.49
9847043,9966671,1582,553700,10520371,5.56
9847044,539918,520,182000,721918,33.71
9847045,9977323,1943,680050,10657373,6.82
9847046,9958736,3530,1235500,11194236,12.41
9847047,9990796,3556,1244600,11235396,12.46
9847048,1445385,889,311150,1756535,21.53
9847049,9969445,3225,1128750,11098195,11.32
9847050,9950453,940,329000,10279453,3.31
9847051,9948874,1760,616000,10564874,6.19
9847052,9946787,4150,1452500,11399287,14.60
9847053,9938414,1706,597100,10535514,6.01
9847054,9926770,3742,1309700,11236470,13.19
9847055,9960078,409,143150,10103228,1.44
9847056,9967937,4141,1449350,11417287,14.54
9847057,9973880,3153,1103550,11077430,11.06
9847058,9961925,1318,461300,10423225,4.63
9847059,9979030,5683,1989050,11968080,19.93
9847061,123779,42,14700,138479,11.88
9847062,9953334,5975,2091250,12044584,21.01
9847063,9960997,3369,1179150,11140147,11.84
9847064,9953118,5891,2061850,12014968,20.72
9847065,3111529,2462,861700,3973229,27.69
9847066,9936466,2079,727650,10664116,7.32
9847067,9932710,1908,667800,10600510,6.72
9847068,9946837,4436,1552600,11499437,15.61
9847069,9961978,3904,1366400,11328378,13.72
9847070,197919,85,29750,227669,15.03
9847071,9937153,6108,2137800,12074953,21.51
9847072,1218317,994,347900,1566217,28.56
9847073,9931638,1618,566300,10497938,5.70
9847074,9847853,5573,1950550,11798403,19.81
9847075,3125653,1990,696500,3822153,22.28
9847076,9948262,1396,488600,10436862,4.91
9847077,9937852,604,211400,10149252,2.13
9847078,9959428,807,282450,10241878,2.84
9847079,9960792,1674,585900,10546692,5.88
9847080,9967908,4727,1654450,11622358,16.60
9847081,9971108,1158,405300,10376408,4.06
9847082,9985133,3120,1092000,11077133,10.94
9847083,9990438,1192,417200,10407638,4.18
9847084,9979835,4037,1412950,11392785,14.16
9847085,9974365,690,241500,10215865,2.42
9847086,1313307,385,134750,1448057,10.26
9847087,9976539,917,320950,10297489,3.22
9847088,2221515,929,325150,2546665,14.64
9847089,9966784,1894,662900,10629684,6.65
9847090,9982919,3632,1271200,11254119,12.73
9847091,9981293,3177,1111950,11093243,11.14
9847092,9994990,4901,1715350,11710340,17.16
9847093,9971969,1687,590450,10562419,5.92
9847094,9983425,3934,1376900,11360325,13.79
9847095,9969936,4102,1435700,11405636,14.40
9847096,9984312,2797,978950,10963262,9.80
9847097,9992473,4347,1521450,11513923,15.23
9847098,9979147,4949,1732150,11711297,17.36
9847099,9991313,3896,1363600,11354913,13.65
9847100,9970246,6332,2216200,12186446,22.23
9847101,9979031,250,87500,10066531,0.88
9847102,9976784,4836,1692600,11669384,16.97
9847103,9709623,1989,696150,10405773,7.17
9847104,3941286,1701,595350,4536636,15.11
9847105,9989510,2416,845600,10835110,8.46
9847107,414130,312,109200,523330,26.37
9847108,9902082,5233,1831550,11733632,18.50
9847109,9946047,1402,490700,10436747,4.93
9847110,9958161,4635,1622250,11580411,16.29
9847111,9947770,2331,815850,10763620,8.20
9847112,9951675,4467,1563450,11515125,15.71
9847113,9958254,4890,1711500,11669754,17.19
9847114,9956152,3847,1346450,11302602,13.52
9847115,9960689,1828,639800,10600489,6.42
9847116,9921130,4490,1571500,11492630,15.84
9847117,9936771,853,298550,10235321,3.00
9847118,9958502,2177,761950,10720452,7.65
9847119,1565175,37,12950,1578125,0.83
9847120,9944932,627,219450,10164382,2.21
9847121,3638112,834,291900,3930012,8.02
9847122,9952097,2451,857850,10809947,8.62
9847123,1767890,1857,649950,2417840,36.76
9847124,9947465,3944,1380400,11327865,13.88
9847126,9960303,1725,603750,10564053,6.06
9847127,9968227,3141,1099350,11067577,11.03
9847128,9969583,1208,422800,10392383,4.24
9847129,192454,297,103950,296404,54.01
9847130,2278522,2192,767200,3045722,33.67
9847131,9967234,5749,2012150,11979384,20.19
9847132,9966476,4653,1628550,11595026,16.34
9847133,730973,383,134050,865023,18.34
9847134,9961383,7782,2723700,12685083,27.34
9847135,9960697,5168,1808800,11769497,18.16
9847136,9965428,2715,950250,10915678,9.54
9847137,4413603,2957,1034950,5448553,23.45
9847138,278601,452,158200,436801,56.78
9847139,1743947,802,280700,2024647,16.10
9847140,9950091,4257,1489950,11440041,14.97
9847142,9928875,2091,731850,10660725,7.37
9847143,9952901,4150,1452500,11405401,14.59
9847144,9960003,6011,2103850,12063853,21.12
9847145,9968087,944,330400,10298487,3.31
9847146,9975767,2411,843850,10819617,8.46
9847147,9980113,5331,1865850,11845963,18.70
9847149,9961303,4512,1579200,11540503,15.85
9847150,9967094,3320,1162000,11129094,11.66
9847151,9974335,6637,2322950,12297285,23.29
9847152,9963683,2461,861350,10825033,8.64
9847153,9975113,920,322000,10297113,3.23
9847154,9982877,4732,1656200,11639077,16.59
9847155,9972838,4995,1748250,11721088,17.53
9847156,1503401,1836,642600,2146001,42.74
9847157,9975166,3016,1055600,11030766,10.58
9847158,9997802,2887,1010450,11008252,10.11
9847159,9974261,1898,664300,10638561,6.66
9847160,9985478,2392,837200,10822678,8.38
9847161,9976369,5171,1809850,11786219,18.14
9847162,9956842,4864,1702400,11659242,17.10
9847163,9974223,3983,1394050,11368273,13.98
9847164,3280179,3084,1079400,4359579,32.91
9847165,9968081,3458,1210300,11178381,12.14
9847166,9964722,3817,1335950,11300672,13.41
9847167,9976779,3088,1080800,11057579,10.83
9847168,9963840,3535,1237250,11201090,12.42
9847169,9981927,3037,1062950,11044877,10.65
9847170,9965230,1228,429800,10395030,4.31
9847171,633525,223,78050,711575,12.32
9847172,1339948,535,187250,1527198,13.97
9847173,9959179,5909,2068150,12027329,20.77
9847174,2696611,1293,452550,3149161,16.78
9847175,9960622,4357,1524950,11485572,15.31
9847176,9964550,2987,1045450,11010000,10.49
9847177,9980830,2948,1031800,11012630,10.34
9847178,9980912,2278,797300,10778212,7.99
9847179,3019469,2397,838950,3858419,27.78
9847180,9986074,4402,1540700,11526774,15.43
9847181,1908466,1040,364000,2272466,19.07
9847182,9973241,3445,1205750,11178991,12.09
9847183,9977973,4333,1516550,11494523,15.20
9847184,9999177,3783,1324050,11323227,13.24
9847185,9985863,4561,1596350,11582213,15.99
9847186,3850915,1749,612150,4463065,15.90
9847187,9963362,4709,1648150,11611512,16.54
9847188,9960352,3142,1099700,11060052,11.04
9847189,9970154,3185,1114750,11084904,11.18
9847190,9977950,2603,911050,10889000,9.13
9847192,9970402,3844,1345400,11315802,13.49
9847193,1163531,458,160300,1323831,13.78
9847194,9991007,5083,1779050,11770057,17.81
9847195,9989034,2758,965300,10954334,9.66
9847196,296949,111,38850,335799,13.08
9847197,9974911,4769,1669150,11644061,16.73
9847198,9958592,435,152250,10110842,1.53
9847199,9957962,991,346850,10304812,3.48
9847200,9978238,5363,1877050,11855288,18.81
9847201,9987588,572,200200,10187788,2.00
9847202,9974135,3224,1128400,11102535,11.31
9847203,9973359,5689,1991150,11964509,19.96
9847204,9983434,5992,2097200,12080634,21.01
9847205,9977758,1872,655200,10632958,6.57
9847206,9988607,1259,440650,10429257,4.41
9847207,1273570,853,298550,1572120,23.44
9847208,9973046,5005,1751750,11724796,17.56
9847209,330440,216,75600,406040,22.88
9847210,9986664,3015,1055250,11041914,10.57
9847211,9990542,3842,1344700,11335242,13.46
9847212,9996688,3750,1312500,11309188,13.13
9847213,9979162,1499,524650,10503812,5.26
9847214,1703320,2241,784350,2487670,46.05
9847215,9997056,3697,1293950,11291006,12.94
9847216,9972255,3822,1337700,11309955,13.41
9847217,9979655,3630,1270500,11250155,12.73
9847218,5540308,4726,1654100,7194408,29.86
9847219,9982089,2407,842450,10824539,8.44
9847220,524827,523,183050,707877,34.88
9847221,9966081,5394,1887900,11853981,18.94
9847222,413542,241,84350,497892,20.40
9847223,9941132,3195,1118250,11059382,11.25
9847224,3928676,1634,571900,4500576,14.56
9847225,4936277,1192,417200,5353477,8.45
9847226,9927273,4335,1517250,11444523,15.28
9847227,9931874,4189,1466150,11398024,14.76
9847228,1781793,346,121100,1902893,6.80
9847229,9950768,4436,1552600,11503368,15.60
9847230,677609,517,180950,858559,26.70
9847231,9939460,3083,1079050,11018510,10.86
9847232,9938864,4781,1673350,11612214,16.84
9847233,381245,114,39900,421145,10.47
9847234,9733405,3648,1276800,11010205,13.12
9847235,9919016,3915,1370250,11289266,13.81
9847236,3975550,2315,810250,4785800,20.38
9847237,9937430,5555,1944250,11881680,19.56
9847238,9925442,6663,2332050,12257492,23.50
9847239,9857125,5496,1923600,11780725,19.51
9847240,9947014,3208,1122800,11069814,11.29
9847241,9941131,4128,1444800,11385931,14.53
9847242,4403553,3368,1178800,5582353,26.77
9847243,9943471,5256,1839600,11783071,18.50
9847244,848530,279,97650,946180,11.51
9847245,9914253,5237,1832950,11747203,18.49
9847246,9925086,4100,1435000,11360086,14.46
9847247,9918906,1926,674100,10593006,6.80
9847248,863465,360,126000,989465,14.59
9847249,9934345,5272,1845200,11779545,18.57
9847250,9940042,2858,1000300,10940342,10.06
9847251,9943662,637,222950,10166612,2.24
9847252,9965389,3766,1318100,11283489,13.23
9847253,9953974,5401,1890350,11844324,18.99
9847254,944391,461,161350,1105741,17.09
9847255,9965034,4055,1419250,11384284,14.24
9847256,9939680,813,284550,10224230,2.86
9847257,9956917,1461,511350,10468267,5.14
9847258,9950240,1670,584500,10534740,5.87
9847259,9963453,971,339850,10303303,3.41
9847260,9963503,4829,1690150,11653653,16.96
9847261,9942807,4085,1429750,11372557,14.38
9847262,8938888,3699,1294650,10233538,14.48
9847263,9926560,2865,1002750,10929310,10.10
9847264,645525,202,70700,716225,10.95
9847265,9903228,3780,1323000,11226228,13.36
9847266,9924987,4636,1622600,11547587,16.35
9847267,3973340,4288,1500800,5474140,37.77
9847268,9935620,3475,1216250,11151870,12.24
9847269,9900495,2572,900200,10800695,9.09
9847270,9664690,2858,1000300,10664990,10.35
9847271,9945437,1598,559300,10504737,5.62
9847272,9936477,4465,1562750,11499227,15.73
9847274,2598003,1234,431900,3029903,16.62
9847275,9930142,3494,1222900,11153042,12.32
9847277,9628499,4194,1467900,11096399,15.25
9847278,9930152,5515,1930250,11860402,19.44
9847279,9915693,3225,1128750,11044443,11.38
9847280,9923132,4491,1571850,11494982,15.84
9847281,9925102,4819,1686650,11611752,16.99
9847282,9939217,3440,1204000,11143217,12.11
9847283,348196,254,88900,437096,25.53
9847284,9937201,1838,643300,10580501,6.47
9847285,820344,436,152600,972944,18.60
9847286,9938406,3048,1066800,11005206,10.73
9847287,9934494,3352,1173200,11107694,11.81
9847288,9945676,6391,2236850,12182526,22.49
9847289,9962348,5106,1787100,11749448,17.94
9847290,9970871,3619,1266650,11237521,12.70
9847291,1656421,2027,709450,2365871,42.83
9847292,9984759,4351,1522850,11507609,15.25
9847293,9983857,4446,1556100,11539957,15.59
9847294,9987815,3067,1073450,11061265,10.75
9847295,9979124,3941,1379350,11358474,13.82
9847297,543091,441,154350,697441,28.42
9847298,9957161,6516,2280600,12237761,22.90
9847299,103444,66,23100,126544,22.33
9847300,6662238,1955,684250,7346488,10.27
9847301,3692153,2142,749700,4441853,20.31
9847302,9953590,4270,1494500,11448090,15.01
9847303,9975555,3027,1059450,11035005,10.62
9847304,9979316,4939,1728650,11707966,17.32
9847305,9984140,5692,1992200,11976340,19.95
9847306,141342,86,30100,171442,21.30
9847307,9969419,3651,1277850,11247269,12.82
9847308,9965437,5763,2017050,11982487,20.24
9847309,9953458,5063,1772050,11725508,17.80
9847310,9728582,4067,1423450,11152032,14.63
9847311,9931962,245,85750,10017712,0.86
9847312,9951747,3936,1377600,11329347,13.84
9847313,9950868,6169,2159150,12110018,21.70
9847314,9954276,3749,1312150,11266426,13.18
9847315,9944946,7137,2497950,12442896,25.12
9847316,2971840,1651,577850,3549690,19.44
9847317,9967820,4794,1677900,11645720,16.83
9847318,9982715,2674,935900,10918615,9.38
9847319,9979783,4631,1620850,11600633,16.24
9847320,9990445,5105,1786750,11777195,17.88
9847322,1385449,396,138600,1524049,10.00
9847323,3542063,3552,1243200,4785263,35.10
9847324,9987048,4391,1536850,11523898,15.39
9847325,3262382,769,269150,3531532,8.25
9847326,9998544,2681,938350,10936894,9.38
9847327,9978437,5514,1929900,11908337,19.34
9847328,3209977,1471,514850,3724827,16.04
9847329,4069635,2207,772450,4842085,18.98
9847330,9982480,4617,1615950,11598430,16.19
9847331,3309918,1851,647850,3957768,19.57
9847333,3656353,2087,730450,4386803,19.98
9847335,9975329,4570,1599500,11574829,16.03
9847336,9985300,4011,1403850,11389150,14.06
9847337,9969143,3404,1191400,11160543,11.95
9847338,9953911,3597,1258950,11212861,12.65
9847339,9960763,3014,1054900,11015663,10.59
9847340,9937551,1940,679000,10616551,6.83
9847341,9942983,4092,1432200,11375183,14.40
9847342,1869135,1156,404600,2273735,21.65
9847343,9946218,4053,1418550,11364768,14.26
9847344,9941303,3982,1393700,11335003,14.02
9847345,9952016,1586,555100,10507116,5.58
9847346,9968019,3099,1084650,11052669,10.88
9847347,9972292,992,347200,10319492,3.48
9847348,9954049,2678,937300,10891349,9.42
9847349,5601160,2346,821100,6422260,14.66
9847350,9956210,2409,843150,10799360,8.47
9847351,9957834,5082,1778700,11736534,17.86
9847352,9961237,2413,844550,10805787,8.48
9847353,1486443,883,309050,1795493,20.79
9847355,9945584,3038,1063300,11008884,10.69
9847356,9949660,3511,1228850,11178510,12.35
9847357,9968015,4792,1677200,11645215,16.83
9847358,9964126,2860,1001000,10965126,10.05
9847359,9980301,4939,1728650,11708951,17.32
9847360,9940796,4424,1548400,11489196,15.58
9847361,9979255,2479,867650,10846905,8.69
9847363,9995726,3686,1290100,11285826,12.91
9847364,9980263,3616,1265600,11245863,12.68
9847365,554419,285,99750,654169,17.99
9847366,9962002,2233,781550,10743552,7.85
9847367,9992122,3089,1081150,11073272,10.82
9847368,9996773,5157,1804950,11801723,18.06
9847369,9999093,929,325150,10324243,3.25
9847370,1887231,1312,459200,2346431,24.33
9847371,327136,336,117600,444736,35.95
9847372,9979411,5095,1783250,11762661,17.87
9847373,9959636,2029,710150,10669786,7.13
9847374,260197,84,29400,289597,11.30
9847375,9969313,5674,1985900,11955213,19.92
9847376,9952925,2531,885850,10838775,8.90
9847377,9986537,5433,1901550,11888087,19.04
9847378,3890922,2153,753550,4644472,19.37
9847379,9989605,2925,1023750,11013355,10.25
9847380,302343,226,79100,381443,26.16
9847381,1011163,1378,482300,1493463,47.70
9847382,9952375,4213,1474550,11426925,14.82
9847383,9953609,6731,2355850,12309459,23.67
9847384,9100851,4504,1576400,10677251,17.32
9847385,1027675,1500,525000,1552675,51.09
9847386,9313158,5762,2016700,11329858,21.65
9847387,9918750,4255,1489250,11408000,15.01
9847388,2185858,1512,529200,2715058,24.21
9847389,9909864,4496,1573600,11483464,15.88
9847390,9919909,3624,1268400,11188309,12.79
9847391,9905656,4325,1513750,11419406,15.28
9847392,9921588,4197,1468950,11390538,14.81
9847393,9903304,1779,622650,10525954,6.29
9847394,376866,237,82950,459816,22.01
9847395,9895139,4602,1610700,11505839,16.28
9847396,9913131,4805,1681750,11594881,16.96
9847397,9911158,5577,1951950,11863108,19.69
9847398,9903933,5156,1804600,11708533,18.22
9847399,9916368,3999,1399650,11316018,14.11
9847400,5485889,1889,661150,6147039,12.05
9847401,9935680,4107,1437450,11373130,14.47
9847402,9943464,5025,1758750,11702214,17.69
9847403,9946487,4826,1689100,11635587,16.98
9847404,9954988,5382,1883700,11838688,18.92
9847405,9944027,4696,1643600,11587627,16.53
9847406,9935460,3434,1201900,11137360,12.10
9847407,9945346,5564,1947400,11892746,19.58
9847408,9963047,2769,969150,10932197,9.73
9847409,9961111,1552,543200,10504311,5.45
9847410,9963498,5354,1873900,11837398,18.81
9847411,9977296,5232,1831200,11808496,18.35
9847412,9977360,4513,1579550,11556910,15.83
9847413,9977460,5082,1778700,11756160,17.83
9847414,9894986,3624,1268400,11163386,12.82
9847416,1948260,1745,610750,2559010,31.35
9847417,8820474,3581,1253350,10073824,14.21
9847418,9983451,3520,1232000,11215451,12.34
9847419,9988016,4845,1695750,11683766,16.98
9847420,2290631,1739,608650,2899281,26.57
9847421,9990540,4777,1671950,11662490,16.74
9847422,9979997,1581,553350,10533347,5.54
9847423,9991199,2228,779800,10770999,7.80
9847424,933040,1099,384650,1317690,41.23
9847425,8730140,3163,1107050,9837190,12.68
9847426,8693830,5353,1873550,10567380,21.55
9847427,9814333,3927,1374450,11188783,14.00
9847428,9981607,5257,1839950,11821557,18.43
9847429,9977634,3970,1389500,11367134,13.93
9847430,1543035,1025,358750,1901785,23.25
9847431,9748204,1408,492800,10241004,5.06
9847432,9979830,1539,538650,10518480,5.40
9847433,9972481,3040,1064000,11036481,10.67
9847434,538740,221,77350,616090,14.36
9847435,2631433,2844,995400,3626833,37.83
9847436,9982923,5483,1919050,11901973,19.22
9847437,1567632,770,269500,1837132,17.19
9847438,9983934,3157,1104950,11088884,11.07
9847439,9168492,2195,768250,9936742,8.38
9847440,6395401,2181,763350,7158751,11.94
9847441,9980220,1530,535500,10515720,5.37
9847442,9984688,5057,1769950,11754638,17.73
9847443,9988543,2917,1020950,11009493,10.22
9847444,9874779,2362,826700,10701479,8.37
9847445,9992506,2406,842100,10834606,8.43
9847446,9976752,1995,698250,10675002,7.00
9847447,9966311,1607,562450,10528761,5.64
9847448,9973583,1514,529900,10503483,5.31
9847449,9937288,561,196350,10133638,1.98
9847450,9964527,1690,591500,10556027,5.94
9847451,9962795,2748,961800,10924595,9.65
9847452,1039822,597,208950,1248772,20.09
9847453,9953226,4533,1586550,11539776,15.94
9847454,9963553,5572,1950200,11913753,19.57
9847455,9963142,3864,1352400,11315542,13.57
9847456,9952099,2762,966700,10918799,9.71
9847457,9960563,3250,1137500,11098063,11.42
9847458,1047445,1345,470750,1518195,44.94
9847459,9978243,5520,1932000,11910243,19.36
9847460,1499658,648,226800,1726458,15.12
9847461,9943709,5037,1762950,11706659,17.73
9847462,9964130,2611,913850,10877980,9.17
9847463,9967875,4851,1697850,11665725,17.03
9847464,9954133,2433,851550,10805683,8.55
9847465,9970378,3447,1206450,11176828,12.10
9847466,9973110,3245,1135750,11108860,11.39
9847467,9993764,2015,705250,10699014,7.06
9847468,9989378,4432,1551200,11540578,15.53
9847469,9995627,3969,1389150,11384777,13.90
9847470,9970730,4033,1411550,11382280,14.16
9847471,9722576,2067,723450,10446026,7.44
9847472,9970694,4005,1401750,11372444,14.06
9847473,9978850,2052,718200,10697050,7.20
9847474,2601027,768,268800,2869827,10.33
9847475,9954782,6002,2100700,12055482,21.10
9847476,9969292,4270,1494500,11463792,14.99
9847477,95946,88,30800,126746,32.10
9847478,9936109,6450,2257500,12193609,22.72
9847479,9977351,4444,1555400,11532751,15.59
9847480,9968711,6950,2432500,12401211,24.40
9847481,9971968,4890,1711500,11683468,17.16
9847482,9992192,4464,1562400,11554592,15.64
9847484,9960660,2316,810600,10771260,8.14
9847485,9961797,4441,1554350,11516147,15.60
9847486,2912219,1666,583100,3495319,20.02
9847487,9962791,3570,1249500,11212291,12.54
9847488,9178960,5096,1783600,10962560,19.43
9847489,9644034,1559,545650,10189684,5.66
9847490,9952467,2705,946750,10899217,9.51
9847491,9953780,2792,977200,10930980,9.82
9847492,9964682,1413,494550,10459232,4.96
9847493,9964962,4437,1552950,11517912,15.58
9847494,9986216,4535,1587250,11573466,15.89
9847495,9696861,3206,1122100,10818961,11.57
9847496,9985422,3606,1262100,11247522,12.64
9847497,9986691,2922,1022700,11009391,10.24
9847498,9975937,4682,1638700,11614637,16.43
9847499,1013017,334,116900,1129917,11.54
9847500,9980111,2954,1033900,11014011,10.36
9847501,9993498,2706,947100,10940598,9.48
9847502,9971137,3136,1097600,11068737,11.01
9847503,9966115,775,271250,10237365,2.72
9847504,9976328,5163,1807050,11783378,18.11
9847505,9960223,2678,937300,10897523,9.41
9847506,9979215,3781,1323350,11302565,13.26
9847507,9968479,2304,806400,10774879,8.09
9847508,9974421,3920,1372000,11346421,13.76
9847509,9974652,3622,1267700,11242352,12.71
9847510,9958472,1570,549500,10507972,5.52
9847511,9965681,7366,2578100,12543781,25.87
9847512,73200,33,11550,84750,15.78
9847513,151795,123,43050,194845,28.36
9847515,9982704,4256,1489600,11472304,14.92
9847516,8974967,3893,1362550,10337517,15.18
9847517,9990823,2577,901950,10892773,9.03
9847518,523377,355,124250,647627,23.74
9847519,9953392,4035,1412250,11365642,14.19
9847520,9978458,4888,1710800,11689258,17.14
9847521,9965588,1569,549150,10514738,5.51
9847522,9978562,3645,1275750,11254312,12.78
9847523,4056612,2383,834050,4890662,20.56
9847524,9770475,1906,667100,10437575,6.83
9847525,9970738,3314,1159900,11130638,11.63
9847526,9969230,3563,1247050,11216280,12.51
9847527,9955995,3379,1182650,11138645,11.88
9847529,1131878,752,263200,1395078,23.25
9847530,9942988,2662,931700,10874688,9.37
9847531,9948621,2272,795200,10743821,7.99
9847532,9950392,6097,2133950,12084342,21.45
9847533,3287440,2216,775600,4063040,23.59
9847534,9927168,5101,1785350,11712518,17.98
9847535,9930590,5891,2061850,11992440,20.76
9847536,390615,243,85050,475665,21.77
9847537,9919020,4427,1549450,11468470,15.62
9847538,9933866,2640,924000,10857866,9.30
9847539,3144252,1069,374150,3518402,11.90
9847540,9915054,4783,1674050,11589104,16.88
9847541,9919589,1832,641200,10560789,6.46
9847542,972234,997,348950,1321184,35.89
9847543,9930025,3678,1287300,11217325,12.96
9847544,9953973,2409,843150,10797123,8.47
9847545,9943065,2152,753200,10696265,7.58
9847546,9948594,4514,1579900,11528494,15.88
9847547,1111519,444,155400,1266919,13.98
9847548,9964608,4791,1676850,11641458,16.83
9847549,9929952,2156,754600,10684552,7.60
9847550,9921966,6055,2119250,12041216,21.36
9847552,9948280,3404,1191400,11139680,11.98
9847553,9947055,4789,1676150,11623205,16.85
9847554,1681088,1635,572250,2253338,34.04
9847555,9940819,3440,1204000,11144819,12.11
9847557,9940651,2484,869400,10810051,8.75
9847558,9953892,2727,954450,10908342,9.59
9847559,1395934,819,286650,1682584,20.53
9847560,9937368,4434,1551900,11489268,15.62
9847561,9943326,3948,1381800,11325126,13.90
9847562,9949350,3161,1106350,11055700,11.12
9847563,9958747,4741,1659350,11618097,16.66
9847564,9957643,1756,614600,10572243,6.17
9847565,9960840,511,178850,10139690,1.80
9847566,9962784,569,199150,10161934,2.00
9847567,790401,400,140000,930401,17.71
9847568,8211827,2789,976150,9187977,11.89
9847569,9968384,3238,1133300,11101684,11.37
9847570,9970192,2687,940450,10910642,9.43
9847571,9989959,719,251650,10241609,2.52
9847572,9981278,1565,547750,10529028,5.49
9847573,9886363,5326,1864100,11750463,18.86
9847574,9985018,5412,1894200,11879218,18.97
9847575,9979434,1329,465150,10444584,4.66
9847576,9984985,4165,1457750,11442735,14.60
9847577,9982125,3098,1084300,11066425,10.86
9847578,1057949,218,76300,1134249,7.21
9847579,524165,249,87150,611315,16.63
9847580,9996533,2875,1006250,11002783,10.07
9847581,9972477,3695,1293250,11265727,12.97
9847582,9974533,2801,980350,10954883,9.83
9847583,9985803,1636,572600,10558403,5.73
9847584,9983283,919,321650,10304933,3.22
9847585,500914,275,96250,597164,19.21
9847586,9964727,3403,1191050,11155777,11.95
9847587,9949209,4441,1554350,11503559,15.62
9847588,9959487,4078,1427300,11386787,14.33
9847589,3812053,901,315350,4127403,8.27
9847590,9956757,1032,361200,10317957,3.63
9847591,1291076,557,194950,1486026,15.10
9847592,9972007,2300,805000,10777007,8.07
9847593,9706591,1849,647150,10353741,6.67
9847594,9968617,4061,1421350,11389967,14.26
9847595,9970732,1868,653800,10624532,6.56
9847596,9990296,2441,854350,10844646,8.55
9847597,9978244,2338,818300,10796544,8.20
9847598,147627,125,43750,191377,29.64
9847599,1737427,908,317800,2055227,18.29
9847600,387248,265,92750,479998,23.95
9847601,9956953,1895,663250,10620203,6.66
9847602,9955198,1024,358400,10313598,3.60
9847603,9967137,4932,1726200,11693337,17.32
9847604,9964768,1930,675500,10640268,6.78
9847605,9974092,2702,945700,10919792,9.48
9847606,9966158,1336,467600,10433758,4.69
9847607,9985904,6198,2169300,12155204,21.72
9847608,9974716,2158,755300,10730016,7.57
9847609,9993107,1823,638050,10631157,6.38
9847610,2994417,657,229950,3224367,7.68
9847611,9980787,1875,656250,10637037,6.58
9847612,9954354,2154,753900,10708254,7.57
9847613,9988334,1287,450450,10438784,4.51
9847615,9961321,4471,1564850,11526171,15.71
9847616,806729,525,183750,990479,22.78
9847617,9915211,3539,1238650,11153861,12.49
9847619,9958147,2061,721350,10679497,7.24
9847620,9961403,909,318150,10279553,3.19
9847621,9976212,1747,611450,10587662,6.13
9847622,9996680,585,204750,10201430,2.05
9847623,9993121,1203,421050,10414171,4.21
9847624,1349723,562,196700,1546423,14.57
9847625,1696642,926,324100,2020742,19.10
9847626,9962219,3682,1288700,11250919,12.94
9847627,9972568,5472,1915200,11887768,19.20
9847628,4996596,2770,969500,5966096,19.40
9847629,9998529,2383,834050,10832579,8.34
9847631,9976455,2405,841750,10818205,8.44
9847632,9984279,3382,1183700,11167979,11.86
9847633,9987801,4452,1558200,11546001,15.60
9847634,9981923,1866,653100,10635023,6.54
9847636,1474991,1285,449750,1924741,30.49
9847637,9963822,4347,1521450,11485272,15.27
9847638,9965359,3769,1319150,11284509,13.24
9847639,427111,153,53550,480661,12.54
9847640,9962178,4526,1584100,11546278,15.90
9847641,9966781,3359,1175650,11142431,11.80
9847642,1320971,953,333550,1654521,25.25
9847643,9972629,4909,1718150,11690779,17.23
9847644,9974944,2958,1035300,11010244,10.38
9847645,9985435,3753,1313550,11298985,13.15
9847646,9976503,4190,1466500,11443003,14.70
9847647,9998716,962,336700,10335416,3.37
9847648,9994715,1537,537950,10532665,5.38
9847649,9988874,3792,1327200,11316074,13.29
9847650,9413748,818,286300,9700048,3.04
9847651,9984274,3695,1293250,11277524,12.95
9847652,9997881,1691,591850,10589731,5.92
9847653,9994424,3005,1051750,11046174,10.52
9847655,9970669,4174,1460900,11431569,14.65
9847656,746717,82,28700,775417,3.84
9847657,9966022,1442,504700,10470722,5.06
9847658,9978150,2890,1011500,10989650,10.14
9847659,1230391,611,213850,1444241,17.38
9847660,9986435,2715,950250,10936685,9.52
9847661,9979827,2414,844900,10824727,8.47
9847662,9978840,3675,1286250,11265090,12.89
9847663,3701502,1835,642250,4343752,17.35
9847664,9971518,2886,1010100,10981618,10.13
9847665,9986410,4572,1600200,11586610,16.02
9847666,9986151,5228,1829800,11815951,18.32
9847667,9999554,6845,2395750,12395304,23.96
9847668,9992291,2130,745500,10737791,7.46
9847669,9972692,4808,1682800,11655492,16.87
9847670,3281019,1446,506100,3787119,15.43
9847671,9982294,4248,1486800,11469094,14.89
9847672,9974455,3222,1127700,11102155,11.31
9847673,9978675,3506,1227100,11205775,12.30
9847674,9988671,3241,1134350,11123021,11.36
9847675,694235,412,144200,838435,20.77
9847676,648294,572,200200,848494,30.88
9847678,9876913,4542,1589700,11466613,16.10
9847679,9879167,4533,1586550,11465717,16.06
9847680,9951076,2595,908250,10859326,9.13
9847681,9941268,3024,1058400,10999668,10.65
9847682,962714,546,191100,1153814,19.85
9847684,9954642,2956,1034600,10989242,10.39
9847685,9967038,4138,1448300,11415338,14.53
9847686,9962752,5610,1963500,11926252,19.71
9847687,9955263,3158,1105300,11060563,11.10
9847688,4045237,1576,551600,4596837,13.64
9847689,9952497,4030,1410500,11362997,14.17
9847690,257868,220,77000,334868,29.86
9847691,9981241,3148,1101800,11083041,11.04
9847692,9982030,3255,1139250,11121280,11.41
9847693,9969919,1740,609000,10578919,6.11
9847694,9966352,2427,849450,10815802,8.52
9847695,9979413,4602,1610700,11590113,16.14
9847696,9980268,4953,1733550,11713818,17.37
9847697,9984387,3622,1267700,11252087,12.70
9847698,1380191,608,212800,1592991,15.42
9847699,1962682,667,233450,2196132,11.89
9847700,9987681,3451,1207850,11195531,12.09
9847701,9993701,5879,2057650,12051351,20.59
9847702,1080580,1037,362950,1443530,33.59
9847703,9983408,4765,1667750,11651158,16.71
9847704,9982490,3377,1181950,11164440,11.84
9847705,9994429,3645,1275750,11270179,12.76
9847706,1554634,1174,410900,1965534,26.43
9847707,9971642,4842,1694700,11666342,17.00
9847708,9965009,5324,1863400,11828409,18.70
9847709,9967013,4713,1649550,11616563,16.55
9847710,9965998,5063,1772050,11738048,17.78
9847711,1327866,244,85400,1413266,6.43
9847712,9983248,3092,1082200,11065448,10.84
9847713,9980730,6448,2256800,12237530,22.61
9847714,407520,267,93450,500970,22.93
9847715,9971025,3715,1300250,11271275,13.04
9847716,9988583,4423,1548050,11536633,15.50
9847717,9988425,4180,1463000,11451425,14.65
9847718,9988380,6028,2109800,12098180,21.12
9847719,9987397,3183,1114050,11101447,11.15
9847720,9991719,1046,366100,10357819,3.66
9847721,857661,542,189700,1047361,22.12
9847722,9979761,4317,1510950,11490711,15.14
9847723,9991132,5787,2025450,12016582,20.27
9847724,9985508,5434,1901900,11887408,19.05
9847725,9986750,4831,1690850,11677600,16.93
9847726,9987587,4855,1699250,11686837,17.01
9847727,4376926,1519,531650,4908576,12.15
9847729,9965636,2953,1033550,10999186,10.37
9847730,9976641,209,73150,10049791,0.73
9847731,9982960,5230,1830500,11813460,18.34
9847732,9986307,1670,584500,10570807,5.85
9847733,9995466,141,49350,10044816,0.49
9847735,9975640,3553,1243550,11219190,12.47
9847736,9966877,1515,530250,10497127,5.32
9847737,9985010,3249,1137150,11122160,11.39
9847739,7438227,2514,879900,8318127,11.83
9847740,6137248,541,189350,6326598,3.09
9847741,9957482,4419,1546650,11504132,15.53
9847742,4288433,1673,585550,4873983,13.65
9847743,9941013,4696,1643600,11584613,16.53
9847744,9954656,2035,712250,10666906,7.15
9847745,9962475,7300,2555000,12517475,25.65
9847746,1398571,508,177800,1576371,12.71
9847747,9960935,2457,859950,10820885,8.63
9847748,9961996,2038,713300,10675296,7.16
9847749,9973669,5442,1904700,11878369,19.10
9847750,1410683,1312,459200,1869883,32.55
9847751,9961499,3622,1267700,11229199,12.73
9847752,78087,161,56350,134437,72.16
9847753,9963105,2414,844900,10808005,8.48
9847754,9974920,4501,1575350,11550270,15.79
9847755,9992009,4479,1567650,11559659,15.69
9847756,9995965,4873,1705550,11701515,17.06
9847757,9974620,3141,1099350,11073970,11.02
9847758,9978473,3204,1121400,11099873,11.24
9847759,9966080,2355,824250,10790330,8.27
9847760,2789639,1858,650300,3439939,23.31
9847761,9990681,4099,1434650,11425331,14.36
9847762,8037832,1894,662900,8700732,8.25
9847763,9989321,3385,1184750,11174071,11.86
9847764,2752732,636,222600,2975332,8.09
9847765,9974637,3815,1335250,11309887,13.39
9847766,6087761,1984,694400,6782161,11.41
9847767,5075288,977,341950,5417238,6.74
9847768,9963123,4188,1465800,11428923,14.71
9847769,9950986,3742,1309700,11260686,13.16
9847770,9949907,4428,1549800,11499707,15.58
9847771,9946491,3812,1334200,11280691,13.41
9847772,9949243,2485,869750,10818993,8.74
9847773,9954057,2531,885850,10839907,8.90
9847774,505238,113,39550,544788,7.83
9847775,6822744,3138,1098300,7921044,16.10
9847776,9967851,4248,1486800,11454651,14.92
9847777,9975470,3177,1111950,11087420,11.15
9847778,9965944,3782,1323700,11289644,13.28
9847779,9973437,3315,1160250,11133687,11.63
9847780,9975883,2397,838950,10814833,8.41
9847781,9984490,1867,653450,10637940,6.54
9847782,1812908,752,263200,2076108,14.52
9847783,9980118,2538,888300,10868418,8.90
9847784,9969368,1116,390600,10359968,3.92
9847785,9991633,4208,1472800,11464433,14.74
9847786,3336510,1552,543200,3879710,16.28
9847787,129842,52,18200,148042,14.02
9847788,9983450,3897,1363950,11347400,13.66
9847789,6072791,1664,582400,6655191,9.59
9847790,9973836,4868,1703800,11677636,17.08
9847791,9995071,4496,1573600,11568671,15.74
9847792,9987997,2495,873250,10861247,8.74
9847793,9982382,4078,1427300,11409682,14.30
9847794,9960690,5498,1924300,11884990,19.32
9847795,9977352,3828,1339800,11317152,13.43
9847796,9979544,2949,1032150,11011694,10.34
9847797,1714294,331,115850,1830144,6.76
9847798,9979686,3167,1108450,11088136,11.11
9847799,9980308,3944,1380400,11360708,13.83
9847800,9973707,5547,1941450,11915157,19.47
9847801,2060767,553,193550,2254317,9.39
9847802,5830153,2770,969500,6799653,16.63
9847803,9972189,3157,1104950,11077139,11.08
9847804,2994792,1752,613200,3607992,20.48
9847805,9985368,4096,1433600,11418968,14.36
9847806,9985391,3345,1170750,11156141,11.72
9847807,9990863,3573,1250550,11241413,12.52
9847808,9987973,4670,1634500,11622473,16.36
9847809,9998062,5517,1930950,11929012,19.31
9847810,9986436,4166,1458100,11444536,14.60
9847811,1024012,576,201600,1225612,19.69
9847812,9989840,3348,1171800,11161640,11.73
9847813,9985535,4237,1482950,11468485,14.85
9847814,9977143,4640,1624000,11601143,16.28
9847815,9983727,3494,1222900,11206627,12.25
9847816,9983169,4375,1531250,11514419,15.34
9847817,9984156,5022,1757700,11741856,17.60
9847818,1944866,1404,491400,2436266,25.27
9847819,9975234,5649,1977150,11952384,19.82
9847820,9985228,3732,1306200,11291428,13.08
9847821,9988623,3389,1186150,11174773,11.88
9847822,9987622,5713,1999550,11987172,20.02
9847824,9971185,3736,1307600,11278785,13.11
9847825,9972939,7054,2468900,12441839,24.76
9847826,170006,165,57750,227756,33.97
9847827,5973185,4720,1652000,7625185,27.66
9847828,9976876,4047,1416450,11393326,14.20
9847829,9981074,4474,1565900,11546974,15.69
9847830,9979129,4159,1455650,11434779,14.59
9847831,9996384,2413,844550,10840934,8.45
9847832,9990196,5227,1829450,11819646,18.31
9847833,1072808,841,294350,1367158,27.44
9847834,9975415,2204,771400,10746815,7.73
9847835,9983162,3709,1298150,11281312,13.00
9847836,9968181,2719,951650,10919831,9.55
9847837,9980781,4091,1431850,11412631,14.35
9847838,9972521,5066,1773100,11745621,17.78
9847839,9981933,1478,517300,10499233,5.18
9847840,9986297,4344,1520400,11506697,15.22
9847841,9984804,2843,995050,10979854,9.97
9847842,9980367,2459,860650,10841017,8.62
9847843,9981337,2167,758450,10739787,7.60
9847844,9996316,3893,1362550,11358866,13.63
9847845,1111244,666,233100,1344344,20.98
9847846,9978045,3181,1113350,11091395,11.16
9847847,3391318,2283,799050,4190368,23.56
9847848,9993289,3510,1228500,11221789,12.29
9847849,9989561,3657,1279950,11269511,12.81
9847850,9994047,1743,610050,10604097,6.10
9847851,1590743,869,304150,1894893,19.12
9847852,9994271,3200,1120000,11114271,11.21
9847853,2637287,509,178150,2815437,6.76
9847854,9964198,2941,1029350,10993548,10.33
9847855,2815480,826,289100,3104580,10.27
9847856,9960539,5249,1837150,11797689,18.44
9847857,9954149,2906,1017100,10971249,10.22
9847858,9975428,2290,801500,10776928,8.03
9847859,2092095,1398,489300,2581395,23.39
9847860,9949090,3247,1136450,11085540,11.42
9847861,2940333,1742,609700,3550033,20.74
9847862,9958181,2970,1039500,10997681,10.44
9847863,9969534,3053,1068550,11038084,10.72
9847864,9992373,3952,1383200,11375573,13.84
9847865,9985692,4058,1420300,11405992,14.22
9847866,9961484,4146,1451100,11412584,14.57
9847867,9996232,3604,1261400,11257632,12.62
9847868,9970828,5874,2055900,12026728,20.62
9847869,164810,142,49700,214510,30.16
9847870,9958803,5410,1893500,11852303,19.01
9847871,9965083,2445,855750,10820833,8.59
9847872,9968545,4550,1592500,11561045,15.98
9847873,9977126,5066,1773100,11750226,17.77
9847874,9988573,2783,974050,10962623,9.75
9847875,9981105,5382,1883700,11864805,18.87
9847876,9987277,6258,2190300,12177577,21.93
9847877,9957824,4629,1620150,11577974,16.27
9847878,1662928,425,148750,1811678,8.95
9847879,9966598,3362,1176700,11143298,11.81
9847880,9965210,4510,1578500,11543710,15.84
9847881,9970531,2911,1018850,10989381,10.22
9847882,9966013,3479,1217650,11183663,12.22
9847883,9982054,2656,929600,10911654,9.31
9847884,9975858,4103,1436050,11411908,14.40
9847885,9961146,3314,1159900,11121046,11.64
9847886,2991286,1689,591150,3582436,19.76
9847887,9978784,4408,1542800,11521584,15.46
9847888,417607,212,74200,491807,17.77
9847889,9984835,4684,1639400,11624235,16.42
9847890,9975046,2908,1017800,10992846,10.20
9847891,9992267,5096,1783600,11775867,17.85
9847892,9966112,2065,722750,10688862,7.25
9847893,5543653,1893,662550,6206203,11.95
9847894,8652218,3387,1185450,9837668,13.70
9847895,9970011,3151,1102850,11072861,11.06
9847897,9965661,6643,2325050,12290711,23.33
9847898,9983244,3764,1317400,11300644,13.20
9847899,9992273,1163,407050,10399323,4.07
9847900,9985445,2517,880950,10866395,8.82
9847901,9987582,3742,1309700,11297282,13.11
9847902,9993442,257,89950,10083392,0.90
9847903,9989255,2302,805700,10794955,8.07
9847904,6450090,1557,544950,6995040,8.45
9847905,9974393,2886,1010100,10984493,10.13
9847906,9994337,2732,956200,10950537,9.57
9847907,9993476,4269,1494150,11487626,14.95
9847908,9981190,5135,1797250,11778440,18.01
9847909,9976826,734,256900,10233726,2.57
9847910,9986566,1809,633150,10619716,6.34
9847911,9996915,3182,1113700,11110615,11.14
9847912,9990269,2440,854000,10844269,8.55
9847913,1515922,477,166950,1682872,11.01
9847914,625826,106,37100,662926,5.93
9847915,9983130,3393,1187550,11170680,11.90
9847916,4112471,2501,875350,4987821,21.29
9847917,9988539,4309,1508150,11496689,15.10
9847918,9978698,2388,835800,10814498,8.38
9847919,9548062,3642,1274700,10822762,13.35
9847920,393522,233,81550,475072,20.72
9847921,9980935,884,309400,10290335,3.10
9847922,1036567,608,212800,1249367,20.53
9847923,9982881,2697,943950,10926831,9.46
9847924,188460,81,28350,216810,15.04
9847925,9991968,4271,1494850,11486818,14.96
9847926,9995216,4029,1410150,11405366,14.11
9847927,9998655,1681,588350,10587005,5.88
9847928,9995793,3952,1383200,11378993,13.84
9847929,9988781,3506,1227100,11215881,12.28
9847930,9989059,2749,962150,10951209,9.63
9847931,631575,336,117600,749175,18.62
9847932,9969709,3402,1190700,11160409,11.94
9847933,4618751,2291,801850,5420601,17.36
9847934,9967575,3528,1234800,11202375,12.39
9847935,9972740,4860,1701000,11673740,17.06
9847936,9977356,3892,1362200,11339556,13.65
9847937,9969923,2130,745500,10715423,7.48
9847938,9982917,3406,1192100,11175017,11.94
9847939,9994582,2677,936950,10931532,9.37
9847940,9985644,4375,1531250,11516894,15.33
9847941,874064,270,94500,968564,10.81
9847942,9979845,4234,1481900,11461745,14.85
9847943,9974306,3005,1051750,11026056,10.54
9847944,9990870,2087,730450,10721320,7.31
9847945,9994665,4433,1551550,11546215,15.52
9847946,9972502,4631,1620850,11593352,16.25
9847947,9981493,3390,1186500,11167993,11.89
9847948,9999497,3563,1247050,11246547,12.47
9847949,9994555,3420,1197000,11191555,11.98
9847950,9929279,1601,560350,10489629,5.64
9847951,9990615,562,196700,10187315,1.97
9847952,1438501,739,258650,1697151,17.98
9847953,9973399,4492,1572200,11545599,15.76
9847954,9980557,4862,1701700,11682257,17.05
9847955,9994518,3861,1351350,11345868,13.52
9847956,1557928,723,253050,1810978,16.24
9847957,2753592,1013,354550,3108142,12.88
9847958,3566066,1644,575400,4141466,16.14
9847959,9869160,6750,2362500,12231660,23.94
9847960,9868450,5319,1861650,11730100,18.86
9847961,9959471,3441,1204350,11163821,12.09
9847962,9953016,4202,1470700,11423716,14.78
9847963,9975365,4463,1562050,11537415,15.66
9847964,9948140,2846,996100,10944240,10.01
9847965,9977656,2295,803250,10780906,8.05
9847966,9976602,5169,1809150,11785752,18.13
9847967,9963719,2466,863100,10826819,8.66
9847968,9975953,4863,1702050,11678003,17.06
9847969,9968975,2428,849800,10818775,8.52
9847971,9947509,3719,1301650,11249159,13.09
9847972,9959433,3420,1197000,11156433,12.02
9847973,2605398,773,270550,2875948,10.38
9847974,9951922,4203,1471050,11422972,14.78
9847975,9935023,4835,1692250,11627273,17.03
9847976,9949704,2377,831950,10781654,8.36
9847977,9956333,1430,500500,10456833,5.03
9847978,3057187,2158,755300,3812487,24.71
9847979,9954132,3253,1138550,11092682,11.44
9847980,9932229,1364,477400,10409629,4.81
9847981,9966345,4253,1488550,11454895,14.94
9847982,9964858,3155,1104250,11069108,11.08
9847983,9967411,3639,1273650,11241061,12.78
9847985,9964985,1183,414050,10379035,4.16
9847986,9980771,4400,1540000,11520771,15.43
9847987,9989483,1139,398650,10388133,3.99
9847988,9982252,4496,1573600,11555852,15.76
9847989,9984540,4766,1668100,11652640,16.71
9847990,9988433,3023,1058050,11046483,10.59
9847991,9969265,3736,1307600,11276865,13.12
9847992,9988691,2760,966000,10954691,9.67
9847993,9994569,3222,1127700,11122269,11.28
9847994,9993732,2125,743750,10737482,7.44
9847995,9984036,3542,1239700,11223736,12.42
9847996,9988437,4173,1460550,11448987,14.62
9847997,9991133,3841,1344350,11335483,13.46
9847998,9986366,3681,1288350,11274716,12.90
9847999,9991918,4673,1635550,11627468,16.37
9848000,9980460,3621,1267350,11247810,12.70
9848001,227898,77,26950,254848,11.83
9848002,1156640,553,193550,1350190,16.73
9848003,9969302,4748,1661800,11631102,16.67
9848004,9968120,3564,1247400,11215520,12.51
9848005,9969411,2584,904400,10873811,9.07
9848006,9985406,5183,1814050,11799456,18.17
9848007,908915,248,86800,995715,9.55
9848008,9968863,2804,981400,10950263,9.84
9848009,1610520,410,143500,1754020,8.91
9848010,9969629,4228,1479800,11449429,14.84
9848011,9970844,2141,749350,10720194,7.52
9848012,9987096,2587,905450,10892546,9.07
9848013,9996888,2764,967400,10964288,9.68
9848014,542875,65,22750,565625,4.19
9848015,2819174,670,234500,3053674,8.32
9848016,9961229,3049,1067150,11028379,10.71
9848018,9980399,2770,969500,10949899,9.71
9848019,3334461,773,270550,3605011,8.11
9848020,9949535,4405,1541750,11491285,15.50
9848021,9950495,4142,1449700,11400195,14.57
9848022,9954429,2535,887250,10841679,8.91
9848023,9949804,3203,1121050,11070854,11.27
9848024,234724,133,46550,281274,19.83
9848025,9933469,3938,1378300,11311769,13.88
9848027,9927941,3601,1260350,11188291,12.69
9848028,9942129,887,310450,10252579,3.12
9848029,9949861,2430,850500,10800361,8.55
9848030,9958076,1305,456750,10414826,4.59
9848031,761206,172,60200,821406,7.91
9848032,9962449,4018,1406300,11368749,14.12
9848033,9963073,3147,1101450,11064523,11.06
9848034,9953012,2694,942900,10895912,9.47
9848035,9963204,3992,1397200,11360404,14.02
9848036,9969226,3409,1193150,11162376,11.97
9848037,56209,42,14700,70909,26.15
9848038,9963310,3416,1195600,11158910,12.00
9848039,9967326,2719,951650,10918976,9.55
9848040,9972505,1886,660100,10632605,6.62
9848041,9990530,3969,1389150,11379680,13.90
9848042,9993267,3103,1086050,11079317,10.87
9848043,9995538,962,336700,10332238,3.37
9848044,9870974,1099,384650,10255624,3.90
9848045,4273842,1223,428050,4701892,10.02
9848046,9960345,3315,1160250,11120595,11.65
9848047,9969564,3597,1258950,11228514,12.63
9848048,9978797,2889,1011150,10989947,10.13
9848049,9976139,2311,808850,10784989,8.11
9848050,9986088,2246,786100,10772188,7.87
9848051,9972845,3794,1327900,11300745,13.32
9848052,9990889,2874,1005900,10996789,10.07
9848053,9981402,1876,656600,10638002,6.58
9848054,1089531,500,175000,1264531,16.06
9848055,4978405,1651,577850,5556255,11.61
9848056,9987541,4577,1601950,11589491,16.04
9848057,9985366,3368,1178800,11164166,11.81
9848058,9991880,4785,1674750,11666630,16.76
9848059,9993273,2514,879900,10873173,8.80
9848060,9984555,3565,1247750,11232305,12.50
9848061,9984169,3320,1162000,11146169,11.64
9848062,9972321,1870,654500,10626821,6.56
9848063,9971559,3121,1092350,11063909,10.95
9848064,9981437,2610,913500,10894937,9.15
9848065,9991442,920,322000,10313442,3.22
9848066,9984024,3169,1109150,11093174,11.11
9848067,9981030,3065,1072750,11053780,10.75
9848068,1392870,469,164150,1557020,11.79
9848069,9969237,3911,1368850,11338087,13.73
9848070,9977785,2556,894600,10872385,8.97
9848071,9973239,925,323750,10296989,3.25
9848072,9984687,3229,1130150,11114837,11.32
9848073,827235,293,102550,929785,12.40
9848074,3862459,943,330050,4192509,8.55
9848075,9977094,2164,757400,10734494,7.59
9848076,9992382,5629,1970150,11962532,19.72
9848077,9989249,4077,1426950,11416199,14.28
9848078,9994492,4775,1671250,11665742,16.72
9848079,9995845,2827,989450,10985295,9.90
9848080,9976666,1424,498400,10475066,5.00
9848081,9977532,2546,891100,10868632,8.93
9848082,9959369,2715,950250,10909619,9.54
9848083,9945443,557,194950,10140393,1.96
9848084,1918879,970,339500,2258379,17.69
9848085,9924879,4719,1651650,11576529,16.64
9848086,9916492,4201,1470350,11386842,14.83
9848087,9939532,3669,1284150,11223682,12.92
9848088,9919937,4004,1401400,11321337,14.13
9848089,89831,96,33600,123431,37.40
9848090,9944868,4168,1458800,11403668,14.67
9848092,9971692,2991,1046850,11018542,10.50
9848093,9967783,3753,1313550,11281333,13.18
9848094,672976,179,62650,735626,9.31
9848095,9997170,3150,1102500,11099670,11.03
9848096,9976015,3979,1392650,11368665,13.96
9848097,1089689,352,123200,1212889,11.31
9848098,2040700,1095,383250,2423950,18.78
9848099,9970794,3288,1150800,11121594,11.54
9848100,1619531,751,262850,1882381,16.23
9848101,9955625,4556,1594600,11550225,16.02
9848102,9956974,3032,1061200,11018174,10.66
9848103,8966290,2437,852950,9819240,9.51
9848104,9976358,2129,745150,10721508,7.47
9848105,9971977,3103,1086050,11058027,10.89
9848106,9948351,3525,1233750,11182101,12.40
9848107,2019255,398,139300,2158555,6.90
9848108,9954207,4876,1706600,11660807,17.14
9848109,9958771,5948,2081800,12040571,20.90
9848110,9973124,3204,1121400,11094524,11.24
9848111,9959296,3797,1328950,11288246,13.34
9848112,9952123,2935,1027250,10979373,10.32
9848113,9972167,4576,1601600,11573767,16.06
9848114,9983372,2248,786800,10770172,7.88
9848115,9979518,4785,1674750,11654268,16.78
9848116,9976697,2370,829500,10806197,8.31
9848117,769521,223,78050,847571,10.14
9848118,9963532,3724,1303400,11266932,13.08
9848120,9952711,3252,1138200,11090911,11.44
9848121,9954412,3645,1275750,11230162,12.82
9848122,9966706,3761,1316350,11283056,13.21
9848123,3873284,1233,431550,4304834,11.14
9848124,9965971,4174,1460900,11426871,14.66
9848125,9974296,3209,1123150,11097446,11.26
9848126,9984810,4201,1470350,11455160,14.73
9848127,9987865,3096,1083600,11071465,10.85
9848128,3922439,1207,422450,4344889,10.77
9848129,6253583,2741,959350,7212933,15.34
9848130,9992997,5581,1953350,11946347,19.55
9848131,9969283,3893,1362550,11331833,13.67
9848132,9982141,3725,1303750,11285891,13.06
9848133,9979641,3770,1319500,11299141,13.22
9848134,9972004,243,85050,10057054,0.85
9848135,9991738,4210,1473500,11465238,14.75
9848136,9993476,4088,1430800,11424276,14.32
9848137,9198080,4437,1552950,10751030,16.88
9848138,9973625,5378,1882300,11855925,18.87
9848139,9954826,3938,1378300,11333126,13.85
9848140,9979048,5126,1794100,11773148,17.98
9848141,9982424,5825,2038750,12021174,20.42
9848142,9969148,4100,1435000,11404148,14.39
9848143,9979573,1709,598150,10577723,5.99
9848144,9977316,2030,710500,10687816,7.12
9848145,9966636,2133,746550,10713186,7.49
9848146,9977439,2345,820750,10798189,8.23
9848147,9981527,3990,1396500,11378027,13.99
9848148,9979732,1538,538300,10518032,5.39
9848149,9995010,3032,1061200,11056210,10.62
9848150,6808582,566,198100,7006682,2.91
9848151,9979383,3422,1197700,11177083,12.00
9848153,9989722,5800,2030000,12019722,20.32
9848154,9994376,2960,1036000,11030376,10.37
9848155,9983798,3713,1299550,11283348,13.02
9848156,9986587,4315,1510250,11496837,15.12
9848157,9983773,3738,1308300,11292073,13.10
9848158,9974031,5253,1838550,11812581,18.43
9848159,9992496,2990,1046500,11038996,10.47
9848160,9977788,2401,840350,10818138,8.42
9848161,9959553,4412,1544200,11503753,15.50
9848162,9981294,3913,1369550,11350844,13.72
9848163,9973479,5964,2087400,12060879,20.93
9848164,9976829,4701,1645350,11622179,16.49
9848165,9975432,3469,1214150,11189582,12.17
9848166,9981318,878,307300,10288618,3.08
9848167,9991051,1440,504000,10495051,5.04
9848168,9986058,2428,849800,10835858,8.51
9848169,1041650,521,182350,1224000,17.51
9848170,9990316,4517,1580950,11571266,15.82
9848171,8988398,2225,778750,9767148,8.66
9848172,9988391,4903,1716050,11704441,17.18
9848173,6589148,2197,768950,7358098,11.67
9848174,9974826,5459,1910650,11885476,19.15
9848175,8565616,1745,610750,9176366,7.13
9848176,9997051,2232,781200,10778251,7.81
9848177,9975268,4581,1603350,11578618,16.07
9848178,9963097,3535,1237250,11200347,12.42
9848179,9981487,6671,2334850,12316337,23.39
9848181,9945037,5168,1808800,11753837,18.19
9848182,1032101,321,112350,1144451,10.89
9848183,9931402,2448,856800,10788202,8.63
9848184,9933234,5546,1941100,11874334,19.54
9848185,4027575,1064,372400,4399975,9.25
9848186,9953110,3294,1152900,11106010,11.58
9848187,9952389,3153,1103550,11055939,11.09
9848188,9943504,3448,1206800,11150304,12.14
9848189,9960407,4683,1639050,11599457,16.46
9848190,9969116,5093,1782550,11751666,17.88
9848191,9956382,4196,1468600,11424982,14.75
9848192,9953263,2561,896350,10849613,9.01
9848193,9933917,5160,1806000,11739917,18.18
9848194,9940476,5655,1979250,11919726,19.91
9848195,9945798,6600,2310000,12255798,23.23
9848196,93640,53,18550,112190,19.81
9848197,9927245,2368,828800,10756045,8.35
9848198,9921447,4169,1459150,11380597,14.71
9848199,9935935,4293,1502550,11438485,15.12
9848200,9944120,3043,1065050,11009170,10.71
9848201,9942941,2780,973000,10915941,9.79
9848202,9923694,2905,1016750,10940444,10.25
9848203,9966100,2539,888650,10854750,8.92
9848204,9958348,3578,1252300,11210648,12.58
9848205,9967509,4450,1557500,11525009,15.63
9848206,9978912,2847,996450,10975362,9.99
9848207,9977446,2892,1012200,10989646,10.14
9848208,9967484,2768,968800,10936284,9.72
9848209,9979187,3431,1200850,11180037,12.03
9848210,9997447,3799,1329650,11327097,13.30
9848211,9982921,3772,1320200,11303121,13.22
9848212,9996579,2661,931350,10927929,9.32
9848213,9987419,2531,885850,10873269,8.87
9848214,2777567,759,265650,3043217,9.56
9848215,9972777,5446,1906100,11878877,19.11
9848216,9977009,6708,2347800,12324809,23.53
9848217,9989486,1385,484750,10474236,4.85
9848218,9969656,3530,1235500,11205156,12.39
9848219,9349211,1983,694050,10043261,7.42
9848220,9973712,3296,1153600,11127312,11.57
9848221,9987246,2833,991550,10978796,9.93
9848222,9994487,5005,1751750,11746237,17.53
9848223,9993364,5034,1761900,11755264,17.63
9848224,9992515,5723,2003050,11995565,20.05
9848225,9976582,5145,1800750,11777332,18.05
9848226,9961195,3741,1309350,11270545,13.14
9848227,9960697,2554,893900,10854597,8.97
9848228,9967788,2943,1030050,10997838,10.33
9848229,740257,555,194250,934507,26.24
9848230,3751367,1411,493850,4245217,13.16
9848232,9978683,2407,842450,10821133,8.44
9848233,9978187,3655,1279250,11257437,12.82
9848234,9985890,2646,926100,10911990,9.27
9848235,9985598,3900,1365000,11350598,13.67
9848236,9970993,2921,1022350,10993343,10.25
9848237,3410157,683,239050,3649207,7.01
9848238,461960,321,112350,574310,24.32
9848239,9969235,3170,1109500,11078735,11.13
9848240,3327974,1806,632100,3960074,18.99
9848241,9990043,3296,1153600,11143643,11.55
9848242,9985246,2626,919100,10904346,9.20
9848243,9970179,2880,1008000,10978179,10.11
9848244,9961109,3610,1263500,11224609,12.68
9848245,5783593,1763,617050,6400643,10.67
9848246,9986094,2648,926800,10912894,9.28
9848247,9989276,4701,1645350,11634626,16.47
9848248,9999339,3962,1386700,11386039,13.87
9848249,9983583,3181,1113350,11096933,11.15
9848250,4428438,3022,1057700,5486138,23.88
9848251,9880696,2558,895300,10775996,9.06
9848252,9591556,2805,981750,10573306,10.24
9848253,9977023,3994,1397900,11374923,14.01
9848254,2696927,3125,1093750,3790677,40.56
9848255,9977579,3232,1131200,11108779,11.34
9848256,9871780,2485,869750,10741530,8.81
9848257,9984111,2734,956900,10941011,9.58
9848258,9984018,3564,1247400,11231418,12.49
9848259,9955375,2930,1025500,10980875,10.30
9848260,8833479,1292,452200,9285679,5.12
9848261,9975304,2682,938700,10914004,9.41
9848262,9975867,3259,1140650,11116517,11.43
9848263,9990341,3883,1359050,11349391,13.60
9848264,8467657,2132,746200,9213857,8.81
9848265,9984300,4513,1579550,11563850,15.82
9848266,6996295,2892,1012200,8008495,14.47
9848267,9124105,3809,1333150,10457255,14.61
9848268,9986769,2665,932750,10919519,9.34
9848269,9997841,3626,1269100,11266941,12.69
9848270,9979798,3231,1130850,11110648,11.33
9848271,9192077,2476,866600,10058677,9.43
9848272,9983089,3625,1268750,11251839,12.71
9848273,4691991,2149,752150,5444141,16.03
9848274,9961466,2269,794150,10755616,7.97
9848275,3424760,772,270200,3694960,7.89
9848276,3094367,1801,630350,3724717,20.37
9848277,9960457,3421,1197350,11157807,12.02
9848278,9931887,2645,925750,10857637,9.32
9848279,9958380,2784,974400,10932780,9.78
9848280,9970564,3366,1178100,11148664,11.82
9848281,968081,198,69300,1037381,7.16
9848282,9974206,4357,1524950,11499156,15.29
9848283,9969217,2568,898800,10868017,9.02
9848284,9976683,3226,1129100,11105783,11.32
9848285,9977033,2676,936600,10913633,9.39
9848286,9989142,3396,1188600,11177742,11.90
9848287,9979647,4407,1542450,11522097,15.46
9848288,9978861,4718,1651300,11630161,16.55
9848289,9976181,3930,1375500,11351681,13.79
9848290,9985448,2594,907900,10893348,9.09
9848291,9990452,3099,1084650,11075102,10.86
9848292,2912119,795,278250,3190369,9.55
9848293,9974354,4333,1516550,11490904,15.20
9848294,9983823,3041,1064350,11048173,10.66
9848295,1053146,234,81900,1135046,7.78
9848296,9964765,3149,1102150,11066915,11.06
9848297,1955553,442,154700,2110253,7.91
9848298,9946857,3997,1398950,11345807,14.06
9848299,9951202,2223,778050,10729252,7.82
9848300,4214764,2365,827750,5042514,19.64
9848301,9968782,4146,1451100,11419882,14.56
9848302,8088999,2556,894600,8983599,11.06
9848303,9968014,3044,1065400,11033414,10.69
9848304,9978780,1148,401800,10380580,4.03
9848306,9967523,1902,665700,10633223,6.68
9848307,9975315,2857,999950,10975265,10.02
9848310,9954823,5638,1973300,11928123,19.82
9848311,2258810,672,235200,2494010,10.41
9848312,9950721,4473,1565550,11516271,15.73
9848314,9947130,2448,856800,10803930,8.61
9848315,9927797,1939,678650,10606447,6.84
9848316,9922454,2329,815150,10737604,8.22
9848317,686756,253,88550,775306,12.89
9848318,9947027,4265,1492750,11439777,15.01
9848319,4957645,1076,376600,5334245,7.60
9848320,9960587,4668,1633800,11594387,16.40
9848321,9960178,4276,1496600,11456778,15.03
9848322,9960948,2258,790300,10751248,7.93
9848323,672589,105,36750,709339,5.46
9848324,9952741,4154,1453900,11406641,14.61
9848325,784104,1193,417550,1201654,53.25
9848326,9954601,3711,1298850,11253451,13.05
9848327,9941257,2578,902300,10843557,9.08
9848328,2629890,992,347200,2977090,13.20
9848329,9917503,1647,576450,10493953,5.81
9848330,9921722,3188,1115800,11037522,11.25
9848331,7054861,531,185850,7240711,2.63
9848332,9929343,3404,1191400,11120743,12.00
9848333,894894,578,202300,1097194,22.61
9848334,9914411,2611,913850,10828261,9.22
9848335,9905757,3980,1393000,11298757,14.06
9848336,9915842,2775,971250,10887092,9.79
9848337,9927395,3252,1138200,11065595,11.47
9848338,1177113,656,229600,1406713,19.51
9848339,9928001,3235,1132250,11060251,11.40
9848340,9927051,1914,669900,10596951,6.75
9848341,9936976,3334,1166900,11103876,11.74
9848342,9918777,3266,1143100,11061877,11.52
9848343,9918852,4394,1537900,11456752,15.50
9848344,9945708,4122,1442700,11388408,14.51
9848345,9941954,64,22400,9964354,0.23
9848346,1704842,576,201600,1906442,11.83
9848347,5472375,1875,656250,6128625,11.99
9848348,9689842,4016,1405600,11095442,14.51
9848349,9918966,3035,1062250,10981216,10.71
9848350,1283143,193,67550,1350693,5.26
9848351,3041252,936,327600,3368852,10.77
9848352,9929813,2147,751450,10681263,7.57
9848353,9941622,3507,1227450,11169072,12.35
9848354,9934142,1944,680400,10614542,6.85
9848355,9946535,3095,1083250,11029785,10.89
9848356,9949464,3195,1118250,11067714,11.24
9848357,9957112,1055,369250,10326362,3.71
9848358,9948354,2821,987350,10935704,9.92
9848359,9957218,1397,488950,10446168,4.91
9848360,9960272,2529,885150,10845422,8.89
9848361,9962882,1739,608650,10571532,6.11
9848362,9953571,1705,596750,10550321,6.00
9848363,9938929,2759,965650,10904579,9.72
9848364,9942239,2711,948850,10891089,9.54
9848365,9302457,4066,1423100,10725557,15.30
9848366,9934652,2417,845950,10780602,8.52
9848367,976223,335,117250,1093473,12.01
9848368,9904694,2885,1009750,10914444,10.19
9848369,9896452,2228,779800,10676252,7.88
9848370,9881739,3832,1341200,11222939,13.57
9848371,9883403,2538,888300,10771703,8.99
9848372,9888236,2606,912100,10800336,9.22
9848373,9889987,73,25550,9915537,0.26
9848374,2442783,588,205800,2648583,8.42
9848375,9900848,2828,989800,10890648,10.00
9848376,9898179,3594,1257900,11156079,12.71
9848377,9893445,169,59150,9952595,0.60
9848378,9891393,1744,610400,10501793,6.17
9848379,9892183,62,21700,9913883,0.22
9848380,7781598,2720,952000,8733598,12.23
9848381,5097186,1544,540400,5637586,10.60
9848382,5654671,1604,561400,6216071,9.93
9848383,9898524,3378,1182300,11080824,11.94
9848384,4399468,2017,705950,5105418,16.05
9848385,9905693,2447,856450,10762143,8.65
9848386,9914195,3359,1175650,11089845,11.86
9848387,9922458,4105,1436750,11359208,14.48
9848388,9918606,1595,558250,10476856,5.63
9848389,9922180,1590,556500,10478680,5.61
9848390,9929901,2959,1035650,10965551,10.43
9848391,9941254,3579,1252650,11193904,12.60
9848392,9924753,4730,1655500,11580253,16.68
9848393,9938524,2594,907900,10846424,9.14
9848394,9945304,3096,1083600,11028904,10.90
9848395,9942968,2930,1025500,10968468,10.31
9848396,9855115,1413,494550,10349665,5.02
9848397,9932511,1824,638400,10570911,6.43
9848398,9929176,2315,810250,10739426,8.16
9848399,104544,72,25200,129744,24.10
9848400,9923036,3553,1243550,11166586,12.53
9848401,9929286,4042,1414700,11343986,14.25
9848402,9897410,2106,737100,10634510,7.45
9848403,9911206,3083,1079050,10990256,10.89
9848404,9924896,4372,1530200,11455096,15.42
9848405,1203136,1383,484050,1687186,40.23
9848406,9919456,36,12600,9932056,0.13
9848407,9904858,4051,1417850,11322708,14.31
9848408,9910781,2721,952350,10863131,9.61
9848409,9909505,2567,898450,10807955,9.07
9848410,9924011,2182,763700,10687711,7.70
9848411,9911713,3013,1054550,10966263,10.64
9848412,9900983,5356,1874600,11775583,18.93
9848414,9909783,2627,919450,10829233,9.28
9848415,9917968,3309,1158150,11076118,11.68
9848416,9927038,2009,703150,10630188,7.08
9848417,9930058,2919,1021650,10951708,10.29
9848418,4240372,77,26950,4267322,0.64
9848419,283927,85,29750,313677,10.48
9848420,9943567,3918,1371300,11314867,13.79
9848421,9964681,2015,705250,10669931,7.08
9848422,6586025,2630,920500,7506525,13.98
9848423,141038,57,19950,160988,14.15
9848424,9953357,2399,839650,10793007,8.44
9848425,9951604,2182,763700,10715304,7.67
9848426,1861386,414,144900,2006286,7.78
9848427,9915572,4510,1578500,11494072,15.92
9848428,4272190,2685,939750,5211940,22.00
9848429,9912920,3524,1233400,11146320,12.44
9848430,335636,96,33600,369236,10.01
9848431,9913509,2607,912450,10825959,9.20
9848432,9907325,4292,1502200,11409525,15.16
9848433,9921596,4450,1557500,11479096,15.70
9848434,951703,673,235550,1187253,24.75
9848435,3382233,1488,520800,3903033,15.40
9848436,3649664,674,235900,3885564,6.46
9848437,9949400,3583,1254050,11203450,12.60
9848438,9955852,4547,1591450,11547302,15.99
9848439,9962142,4131,1445850,11407992,14.51
9848440,9949883,2678,937300,10887183,9.42
9848441,9955597,4009,1403150,11358747,14.09
9848442,462058,72,25200,487258,5.45
9848444,9952251,2999,1049650,11001901,10.55
9848445,4209639,811,283850,4493489,6.74
9848446,9938454,4145,1450750,11389204,14.60
9848447,4837128,2509,878150,5715278,18.15
9848448,9966092,2023,708050,10674142,7.10
9848449,1323106,581,203350,1526456,15.37
9848450,9986525,2208,772800,10759325,7.74
9848452,9969483,3197,1118950,11088433,11.22
9848453,9961687,4812,1684200,11645887,16.91
9848454,9977377,3591,1256850,11234227,12.60
9848455,9985381,4388,1535800,11521181,15.38
9848456,9981945,2665,932750,10914695,9.34
9848457,9997481,3183,1114050,11111531,11.14
9848458,1814945,930,325500,2140445,17.93
9848459,9969869,4085,1429750,11399619,14.34
9848460,9984631,3885,1359750,11344381,13.62
9848461,9648872,3471,1214850,10863722,12.59
9848462,8948857,3212,1124200,10073057,12.56
9848463,9985090,3242,1134700,11119790,11.36
9848464,9986512,4151,1452850,11439362,14.55
9848465,9992666,4240,1484000,11476666,14.85
9848466,9984640,3674,1285900,11270540,12.88
9848467,9984854,2699,944650,10929504,9.46
9848468,9979130,2696,943600,10922730,9.46
9848469,9994932,1639,573650,10568582,5.74
9848470,6641028,2635,922250,7563278,13.89
9848471,3086147,888,310800,3396947,10.07
9848472,9967136,2319,811650,10778786,8.14
9848473,8644146,3651,1277850,9921996,14.78
9848474,9979212,3584,1254400,11233612,12.57
9848475,1565479,630,220500,1785979,14.09
9848476,9715132,4293,1502550,11217682,15.47
9848477,2431950,1288,450800,2882750,18.54
9848478,9931679,3972,1390200,11321879,14.00
9848479,9922045,2242,784700,10706745,7.91
9848480,9938382,3623,1268050,11206432,12.76
9848481,9943456,3777,1321950,11265406,13.29
9848482,4398026,2547,891450,5289476,20.27
9848483,9923665,5216,1825600,11749265,18.40
9848484,3088266,1062,371700,3459966,12.04
9848485,9923695,3916,1370600,11294295,13.81
9848486,9407130,4495,1573250,10980380,16.72
9848487,9813152,4017,1405950,11219102,14.33
9848488,9937373,2966,1038100,10975473,10.45
9848489,9927356,714,249900,10177256,2.52
9848490,379321,226,79100,458421,20.85
9848491,9928371,3373,1180550,11108921,11.89
9848492,9932587,5797,2028950,11961537,20.43
9848493,9925768,3090,1081500,11007268,10.90
9848494,9941121,1794,627900,10569021,6.32
9848495,230568,102,35700,266268,15.48
9848496,9926946,2330,815500,10742446,8.22
9848497,9930934,3034,1061900,10992834,10.69
9848498,9924452,4125,1443750,11368202,14.55
9848500,8488075,2836,992600,9480675,11.69
9848501,9899682,541,189350,10089032,1.91
9848502,9914270,2369,829150,10743420,8.36
9848503,9915213,4098,1434300,11349513,14.47
9848504,9921090,3781,1323350,11244440,13.34
9848505,9923874,3380,1183000,11106874,11.92
9848506,9946956,4580,1603000,11549956,16.12
9848507,9944686,6561,2296350,12241036,23.09
9848508,9352118,1365,477750,9829868,5.11
9848509,9966044,3187,1115450,11081494,11.19
9848510,1003794,272,95200,1098994,9.48
9848511,5414258,2354,823900,6238158,15.22
9848512,9967181,4147,1451450,11418631,14.56
9848513,9972911,3235,1132250,11105161,11.35
9848514,9890656,3080,1078000,10968656,10.90
9848515,9979483,3827,1339450,11318933,13.42
9848516,9964270,2433,851550,10815820,8.55
9848517,9955420,2982,1043700,10999120,10.48
9848518,9961463,3272,1145200,11106663,11.50
9848519,9958414,2285,799750,10758164,8.03
9848520,9967165,3479,1217650,11184815,12.22
9848522,9975295,2825,988750,10964045,9.91
9848523,9969029,3329,1165150,11134179,11.69
9848524,9972772,4281,1498350,11471122,15.02
9848525,9980434,2611,913850,10894284,9.16
9848526,9989408,1629,570150,10559558,5.71
9848527,9999250,2175,761250,10760500,7.61
9848528,9982622,1974,690900,10673522,6.92
9848529,9964048,4713,1649550,11613598,16.56
9848530,9960762,3213,1124550,11085312,11.29
9848531,9968335,3990,1396500,11364835,14.01
9848532,5059440,3163,1107050,6166490,21.88
9848533,9990514,2740,959000,10949514,9.60
9848534,669223,383,134050,803273,20.03
9848535,9980349,3308,1157800,11138149,11.60
9848536,9983146,2795,978250,10961396,9.80
9848537,9981297,4490,1571500,11552797,15.74
9848538,9972960,1314,459900,10432860,4.61
9848539,9991382,1904,666400,10657782,6.67
9848540,9994503,495,173250,10167753,1.73
9848541,9995069,758,265300,10260369,2.65
9848542,9985515,4800,1680000,11665515,16.82
9848543,9987245,3763,1317050,11304295,13.19
9848544,9981663,3310,1158500,11140163,11.61
9848545,9984588,2443,855050,10839638,8.56
9848546,9983423,3036,1062600,11046023,10.64
9848547,9979877,2705,946750,10926627,9.49
9848548,9974491,3779,1322650,11297141,13.26
9848549,615146,444,155400,770546,25.26
9848550,9987192,2034,711900,10699092,7.13
9848551,905366,298,104300,1009666,11.52
9848552,9978573,5209,1823150,11801723,18.27
9848553,9951107,3197,1118950,11070057,11.24
9848554,9994429,2502,875700,10870129,8.76
9848555,9996843,3587,1255450,11252293,12.56
9848556,2553078,1140,399000,2952078,15.63
9848557,9968062,3915,1370250,11338312,13.75
9848558,9982170,2894,1012900,10995070,10.15
9848559,9970792,2530,885500,10856292,8.88
9848560,9973079,3176,1111600,11084679,11.15
9848561,9981745,2638,923300,10905045,9.25
9848562,9981082,3606,1262100,11243182,12.64
9848564,9979980,3303,1156050,11136030,11.58
9848565,9963192,3194,1117900,11081092,11.22
9848566,9971974,2046,716100,10688074,7.18
9848567,9982004,592,207200,10189204,2.08
9848568,9972058,1808,632800,10604858,6.35
9848569,1455013,335,117250,1572263,8.06
9848570,9966236,3185,1114750,11080986,11.19
9848571,9973860,4965,1737750,11711610,17.42
9848572,9988417,2203,771050,10759467,7.72
9848573,9975355,3968,1388800,11364155,13.92
9848574,377683,100,35000,412683,9.27
9848575,9991137,5882,2058700,12049837,20.61
9848576,9971641,3802,1330700,11302341,13.34
9848577,9873138,2531,885850,10758988,8.97
9848578,9996204,4012,1404200,11400404,14.05
9848579,6534488,1603,561050,7095538,8.59
9848580,7006281,2041,714350,7720631,10.20
9848581,9961643,2817,985950,10947593,9.90
9848582,9836545,3138,1098300,10934845,11.17
9848583,9968789,4325,1513750,11482539,15.18
9848584,9969154,2855,999250,10968404,10.02
9848585,9978246,5008,1752800,11731046,17.57
9848586,1213585,336,117600,1331185,9.69
9848587,9960189,3530,1235500,11195689,12.40
9848588,9937259,4438,1553300,11490559,15.63
9848589,9947741,3089,1081150,11028891,10.87
9848590,9934917,3617,1265950,11200867,12.74
9848591,375406,74,25900,401306,6.90
9848592,9961839,2493,872550,10834389,8.76
9848593,9940861,4136,1447600,11388461,14.56
9848594,9942887,2956,1034600,10977487,10.41
9848595,9423584,1474,515900,9939484,5.47
9848596,9923141,3359,1175650,11098791,11.85
9848597,9456692,3694,1292900,10749592,13.67
9848598,2087920,1748,611800,2699720,29.30
9848599,9941245,4205,1471750,11412995,14.80
9848600,9446786,2375,831250,10278036,8.80
9848601,8933497,2018,706300,9639797,7.91
9848602,9944542,2991,1046850,10991392,10.53
9848603,9453310,2180,763000,10216310,8.07
9848604,9959546,3762,1316700,11276246,13.22
9848605,9932833,3776,1321600,11254433,13.31
9848606,9972472,2937,1027950,11000422,10.31
9848607,4980236,988,345800,5326036,6.94
9848608,9993038,3291,1151850,11144888,11.53
9848609,9971540,3659,1280650,11252190,12.84
9848610,9974242,3759,1315650,11289892,13.19
9848611,9964911,2767,968450,10933361,9.72
9848612,9965471,2674,935900,10901371,9.39
9848613,9993726,2469,864150,10857876,8.65
9848614,9981514,1013,354550,10336064,3.55
9848615,9998696,1023,358050,10356746,3.58
9848616,9972256,4955,1734250,11706506,17.39
9848617,83209,42,14700,97909,17.67
9848618,9953828,3987,1395450,11349278,14.02
9848620,9986650,3428,1199800,11186450,12.01
9848621,9971350,2029,710150,10681500,7.12
9848622,9970479,1329,465150,10435629,4.67
9848623,9984509,3493,1222550,11207059,12.24
9848624,9969517,1714,599900,10569417,6.02
9848625,1199857,354,123900,1323757,10.33
9848626,9952669,4404,1541400,11494069,15.49
9848627,9954233,1725,603750,10557983,6.07
9848628,9957882,1176,411600,10369482,4.13
9848630,4849752,2093,732550,5582302,15.10
9848631,9951232,3738,1308300,11259532,13.15
9848632,9575583,4187,1465450,11041033,15.30
9848633,9949498,4602,1610700,11560198,16.19
9848634,9950791,2618,916300,10867091,9.21
9848635,9943062,3298,1154300,11097362,11.61
9848636,9973956,3159,1105650,11079606,11.09
9848637,9977722,686,240100,10217822,2.41
9848638,9981168,3777,1321950,11303118,13.24
9848639,9961534,2140,749000,10710534,7.52
9848640,9986104,2967,1038450,11024554,10.40
9848641,9971659,1607,562450,10534109,5.64
9848643,9956299,2248,786800,10743099,7.90
9848644,9932346,3037,1062950,10995296,10.70
9848645,1345193,572,200200,1545393,14.88
9848646,9963213,2721,952350,10915563,9.56
9848647,9966030,5519,1931650,11897680,19.38
9848648,9968913,3831,1340850,11309763,13.45
9848649,9974668,4030,1410500,11385168,14.14
9848650,9974691,1745,610750,10585441,6.12
9848651,9966677,2114,739900,10706577,7.42
9848652,5090125,2523,883050,5973175,17.35
9848653,3766181,2463,862050,4628231,22.89
9848654,9964005,4196,1468600,11432605,14.74
9848655,9972505,4455,1559250,11531755,15.64
9848656,9971082,1354,473900,10444982,4.75
9848657,9978591,1510,528500,10507091,5.30
9848658,9965813,1592,557200,10523013,5.59
9848659,9960601,1338,468300,10428901,4.70
9848660,9971834,1959,685650,10657484,6.88
9848661,9968954,862,301700,10270654,3.03
9848662,9988149,3008,1052800,11040949,10.54
9848663,3021641,647,226450,3248091,7.49
9848664,3725116,1048,366800,4091916,9.85
9848665,9974353,3047,1066450,11040803,10.69
9848666,9969443,4315,1510250,11479693,15.15
9848668,9979664,2637,922950,10902614,9.25
9848669,9984863,4285,1499750,11484613,15.02
9848670,540687,438,153300,693987,28.35
9848671,9967299,3311,1158850,11126149,11.63
9848672,9953238,5268,1843800,11797038,18.52
9848673,9965669,2550,892500,10858169,8.96
9848674,9950145,2761,966350,10916495,9.71
9848675,9966391,3777,1321950,11288341,13.26
9848676,1280279,514,179900,1460179,14.05
9848677,9933649,4939,1728650,11662299,17.40
9848678,77209,42,14700,91909,19.04
9848679,9913933,5482,1918700,11832633,19.35
9848680,9916677,3255,1139250,11055927,11.49
9848681,9908757,1866,653100,10561857,6.59
9848682,9924254,3260,1141000,11065254,11.50
9848683,1871629,406,142100,2013729,7.59
9848684,9590284,1704,596400,10186684,6.22
9848685,9941098,4745,1660750,11601848,16.71
9848686,9943256,2060,721000,10664256,7.25
9848687,9958878,2574,900900,10859778,9.05
9848688,9969881,2548,891800,10861681,8.94
9848689,9976185,3812,1334200,11310385,13.37
9848690,9975070,3591,1256850,11231920,12.60
9848691,9989654,3015,1055250,11044904,10.56
9848692,9979788,3359,1175650,11155438,11.78
9848694,576438,309,108150,684588,18.76
9848695,2501929,1023,358050,2859979,14.31
9848696,1603685,474,165900,1769585,10.34
9848697,9992192,3665,1282750,11274942,12.84
9848698,9986210,2742,959700,10945910,9.61
9848699,9974456,1991,696850,10671306,6.99
9848700,9984584,2782,973700,10958284,9.75
9848701,9981825,3578,1252300,11234125,12.55
9848702,9980348,3573,1250550,11230898,12.53
9848703,9988283,2077,726950,10715233,7.28
9848704,9998697,4722,1652700,11651397,16.53
9848705,9987970,4890,1711500,11699470,17.14
9848706,9987586,3113,1089550,11077136,10.91
9848707,9986981,2612,914200,10901181,9.15
9848708,5200560,2380,833000,6033560,16.02
9848710,1678980,636,222600,1901580,13.26
9848711,9984699,3825,1338750,11323449,13.41
9848712,9987529,5860,2051000,12038529,20.54
9848713,9986314,5434,1901900,11888214,19.05
9848714,9987710,3281,1148350,11136060,11.50
9848715,3124519,1008,352800,3477319,11.29
9848716,9999573,4242,1484700,11484273,14.85
9848717,9975763,4983,1744050,11719813,17.48
9848718,4430751,926,324100,4754851,7.31
9848719,9995668,4632,1621200,11616868,16.22
9848720,9983455,5182,1813700,11797155,18.17
9848721,2315203,849,297150,2612353,12.83
9848722,8393445,1825,638750,9032195,7.61
9848723,9666533,1003,351050,10017583,3.63
9848724,9959887,4573,1600550,11560437,16.07
9848725,3480802,1057,369950,3850752,10.63
9848726,9975431,4109,1438150,11413581,14.42
9848727,9984253,1284,449400,10433653,4.50
9848728,9973767,4059,1420650,11394417,14.24
9848729,9990299,6377,2231950,12222249,22.34
9848730,9986857,3123,1093050,11079907,10.94
9848731,9984274,2639,923650,10907924,9.25
9848732,1955443,2180,763000,2718443,39.02
9848733,9972504,3916,1370600,11343104,13.74
9848734,1238217,382,133700,1371917,10.80
9848735,5376798,2519,881650,6258448,16.40
9848736,9981021,4512,1579200,11560221,15.82
9848737,9988538,4879,1707650,11696188,17.10
9848738,935052,379,132650,1067702,14.19
9848739,9602611,4768,1668800,11271411,17.38
9848740,9969842,2350,822500,10792342,8.25
9848741,1340518,650,227500,1568018,16.97
9848742,9979897,2300,805000,10784897,8.07
9848743,9991132,3689,1291150,11282282,12.92
9848744,9945407,4467,1563450,11508857,15.72
9848745,9984812,2710,948500,10933312,9.50
9848747,9989335,4271,1494850,11484185,14.96
9848748,9981036,942,329700,10310736,3.30
9848749,9983703,2663,932050,10915753,9.34
9848750,9988360,3873,1355550,11343910,13.57
9848751,9976722,1901,665350,10642072,6.67
9848752,2668357,1520,532000,3200357,19.94
9848753,9974682,2095,733250,10707932,7.35
9848754,9997756,3821,1337350,11335106,13.38
9848755,9986152,3655,1279250,11265402,12.81
9848756,9976607,4667,1633450,11610057,16.37
9848757,9988213,2867,1003450,10991663,10.05
9848758,9999914,5111,1788850,11788764,17.89
9848759,9989583,5118,1791300,11780883,17.93
9848760,9980743,3176,1111600,11092343,11.14
9848761,9980351,2740,959000,10939351,9.61
9848762,6722726,1706,597100,7319826,8.88
9848763,9975391,3535,1237250,11212641,12.40
9848764,9758836,3763,1317050,11075886,13.50
9848765,9986310,3792,1327200,11313510,13.29
9848766,9965721,3479,1217650,11183371,12.22
9848767,9989845,2248,786800,10776645,7.88
9848768,9986369,3569,1249150,11235519,12.51
9848769,9999253,5302,1855700,11854953,18.56
9848770,9991924,2984,1044400,11036324,10.45
9848771,9970472,1816,635600,10606072,6.37
9848772,9999553,1013,354550,10354103,3.55
9848773,9990981,2004,701400,10692381,7.02
9848774,9972723,3360,1176000,11148723,11.79
9848775,9991751,3737,1307950,11299701,13.09
9848776,2287456,1404,491400,2778856,21.48
9848777,9984733,3417,1195950,11180683,11.98
9848778,9972961,2523,883050,10856011,8.85
9848779,9982770,2042,714700,10697470,7.16
9848780,9981027,5680,1988000,11969027,19.92
9848781,7403703,1934,676900,8080603,9.14
9848782,9970029,3478,1217300,11187329,12.21
9848783,4509268,1328,464800,4974068,10.31
9848784,9973266,3231,1130850,11104116,11.34
9848786,9943771,3947,1381450,11325221,13.89
9848787,9956076,4738,1658300,11614376,16.66
9848788,9957283,2151,752850,10710133,7.56
9848789,9952713,3962,1386700,11339413,13.93
9848790,9931179,2745,960750,10891929,9.67
9848791,9937753,4378,1532300,11470053,15.42
9848792,9951033,4406,1542100,11493133,15.50
9848793,2027457,554,193900,2221357,9.56
9848794,9955808,3690,1291500,11247308,12.97
9848795,9940960,4036,1412600,11353560,14.21
9848796,9944159,2907,1017450,10961609,10.23
9848797,9951189,3604,1261400,11212589,12.68
9848799,9942607,4000,1400000,11342607,14.08
9848800,9966499,3138,1098300,11064799,11.02
9848801,9966497,4900,1715000,11681497,17.21
9848802,9981278,3835,1342250,11323528,13.45
9848803,9987046,4448,1556800,11543846,15.59
9848804,9983070,2829,990150,10973220,9.92
9848805,507374,279,97650,605024,19.25
9848806,2918504,660,231000,3149504,7.92
9848807,1613603,899,314650,1928253,19.50
9848808,2304065,804,281400,2585465,12.21
9848809,9955561,5372,1880200,11835761,18.89
9848810,9970499,3176,1111600,11082099,11.15
9848811,9954883,3910,1368500,11323383,13.75
9848812,9964753,3479,1217650,11182403,12.22
9848813,2069410,1270,444500,2513910,21.48
9848814,558782,383,134050,692832,23.99
9848815,9975182,3780,1323000,11298182,13.26
9848816,9974070,6580,2303000,12277070,23.09
9848817,9984610,4392,1537200,11521810,15.40
9848818,9978354,3311,1158850,11137204,11.61
9848819,2073518,941,329350,2402868,15.88
9848820,9975010,3182,1113700,11088710,11.16
9848821,5385806,1179,412650,5798456,7.66
9848822,9977718,4719,1651650,11629368,16.55
9848823,9980844,3479,1217650,11198494,12.20
9848824,9982171,3552,1243200,11225371,12.45
9848825,9995686,5159,1805650,11801336,18.06
9848826,9987540,3351,1172850,11160390,11.74
9848827,9993046,3779,1322650,11315696,13.24
9848828,9994888,4785,1674750,11669638,16.76
9848829,9977265,1838,643300,10620565,6.45
9848830,9975694,3951,1382850,11358544,13.86
9848831,9979412,5002,1750700,11730112,17.54
9848834,9983516,2223,778050,10761566,7.79
9848835,9991782,4196,1468600,11460382,14.70
9848836,9985909,2314,809900,10795809,8.11
9848837,9962384,2540,889000,10851384,8.92
9848838,9994148,746,261100,10255248,2.61
9848840,3837491,1414,494900,4332391,12.90
9848841,9985496,1313,459550,10445046,4.60
9848842,1483777,591,206850,1690627,13.94
9848843,9967087,4440,1554000,11521087,15.59
9848844,9973065,3729,1305150,11278215,13.09
9848845,9978538,3395,1188250,11166788,11.91
9848846,6260368,2233,781550,7041918,12.48
9848847,9948866,3669,1284150,11233016,12.91
9848848,325509,185,64750,390259,19.89
9848849,3708800,538,188300,3897100,5.08
9848850,9981867,4638,1623300,11605167,16.26
9848851,1241093,467,163450,1404543,13.17
9848852,8392159,2888,1010800,9402959,12.04
9848853,9982757,667,233450,10216207,2.34
9848854,9992907,2480,868000,10860907,8.69
9848855,9987032,4022,1407700,11394732,14.10
9848856,9690973,3741,1309350,11000323,13.51
9848857,9980649,4400,1540000,11520649,15.43
9848858,9978517,3132,1096200,11074717,10.99
9848859,9975840,2978,1042300,11018140,10.45
9848860,9970607,320,112000,10082607,1.12
9848861,9955478,5786,2025100,11980578,20.34
9848862,9980371,3049,1067150,11047521,10.69
9848863,9979485,3372,1180200,11159685,11.83
9848864,8373343,2177,761950,9135293,9.10
9848865,1577449,810,283500,1860949,17.97
9848866,2259206,1151,402850,2662056,17.83
9848867,9963994,3549,1242150,11206144,12.47
9848868,3763279,1935,677250,4440529,18.00
9848870,9971650,3874,1355900,11327550,13.60
9848871,9968845,3897,1363950,11332795,13.68
9848872,9959300,1762,616700,10576000,6.19
9848873,9963282,2921,1022350,10985632,10.26
9848874,9958794,5097,1783950,11742744,17.91
9848875,9984290,4632,1621200,11605490,16.24
9848876,9971794,3473,1215550,11187344,12.19
9848877,9997085,2663,932050,10929135,9.32
9848878,9991209,1926,674100,10665309,6.75
9848879,9992980,3739,1308650,11301630,13.10
9848880,9979187,4284,1499400,11478587,15.03
9848881,9868816,2125,743750,10612566,7.54
9848882,9965581,4290,1501500,11467081,15.07
9848883,9973353,3270,1144500,11117853,11.48
9848884,9984580,5219,1826650,11811230,18.29
9848885,9981607,3935,1377250,11358857,13.80
9848886,341111,570,199500,540611,58.49
9848887,9230282,5264,1842400,11072682,19.96
9848888,998362,584,204400,1202762,20.47
9848889,295323,200,70000,365323,23.70
9848890,9974468,4624,1618400,11592868,16.23
9848891,9659376,5903,2066050,11725426,21.39
9848892,9960698,2823,988050,10948748,9.92
9848893,9976701,3826,1339100,11315801,13.42
9848894,9973511,2678,937300,10910811,9.40
9848895,9979772,5615,1965250,11945022,19.69
9848896,2708729,1207,422450,3131179,15.60
9848897,9964833,5062,1771700,11736533,17.78
9848898,9974105,3876,1356600,11330705,13.60
9848899,9979130,3969,1389150,11368280,13.92
9848900,9985652,4623,1618050,11603702,16.20
9848901,9999238,2011,703850,10703088,7.04
9848902,9995716,5641,1974350,11970066,19.75
9848903,9997833,4556,1594600,11592433,15.95
9848904,3707576,1862,651700,4359276,17.58
9848905,9965976,3406,1192100,11158076,11.96
9848906,5489533,1192,417200,5906733,7.60
9848907,9965972,4006,1402100,11368072,14.07
9848908,9981428,4651,1627850,11609278,16.31
9848909,9990358,3302,1155700,11146058,11.57
9848910,2843262,576,201600,3044862,7.09
9848911,9924047,1363,477050,10401097,4.81
9848912,9996475,643,225050,10221525,2.25
9848913,3433325,789,276150,3709475,8.04
9848914,9984608,2307,807450,10792058,8.09
9848915,4471979,1988,695800,5167779,15.56
9848916,9966733,6081,2128350,12095083,21.35
9848917,9978578,3172,1110200,11088778,11.13
9848918,9986072,2041,714350,10700422,7.15
9848919,9994915,2736,957600,10952515,9.58
9848920,9980378,4636,1622600,11602978,16.26
9848921,428241,354,123900,552141,28.93
9848922,9962324,1211,423850,10386174,4.25
9848923,2995201,1212,424200,3419401,14.16
9848924,527366,312,109200,636566,20.71
9848925,9994773,3613,1264550,11259323,12.65
9848926,9981861,2121,742350,10724211,7.44
9848927,841443,330,115500,956943,13.73
9848928,9979097,5648,1976800,11955897,19.81
9848929,894971,421,147350,1042321,16.46
9848931,9946563,3659,1280650,11227213,12.88
9848932,4245676,1638,573300,4818976,13.50
9848933,9932944,1777,621950,10554894,6.26
9848934,9943246,4067,1423450,11366696,14.32
9848935,9928497,3851,1347850,11276347,13.58
9848936,9924008,5044,1765400,11689408,17.79
9848937,9803360,4572,1600200,11403560,16.32
9848938,9922482,5264,1842400,11764882,18.57
9848939,9858840,4122,1442700,11301540,14.63
9848940,9933434,840,294000,10227434,2.96
9848941,9943365,2895,1013250,10956615,10.19
9848942,9941489,3904,1366400,11307889,13.74
9848943,1274189,399,139650,1413839,10.96
9848944,1142582,492,172200,1314782,15.07
9848945,9918201,3904,1366400,11284601,13.78
9848946,9831811,4187,1465450,11297261,14.91
9848947,1415320,761,266350,1681670,18.82
9848948,9914826,4802,1680700,11595526,16.95
9848950,1556514,749,262150,1818664,16.84
9848951,9916703,4612,1614200,11530903,16.28
9848952,9920878,2974,1040900,10961778,10.49
9848954,9915267,4142,1449700,11364967,14.62
9848955,9894684,2753,963550,10858234,9.74
9848956,4866353,1633,571550,5437903,11.74
9848957,9305385,4451,1557850,10863235,16.74
9848958,9914249,4181,1463350,11377599,14.76
9848959,9916895,3617,1265950,11182845,12.77
9848960,9937510,4623,1618050,11555560,16.28
9848961,9945827,3360,1176000,11121827,11.82
9848962,9949174,2532,886200,10835374,8.91
9848963,9960336,5866,2053100,12013436,20.61
9848964,1071689,714,249900,1321589,23.32
9848965,9948228,3727,1304450,11252678,13.11
9848966,9969584,5593,1957550,11927134,19.64
9848967,9962972,2634,921900,10884872,9.25
9848968,9971315,4197,1468950,11440265,14.73
9848969,9976327,4584,1604400,11580727,16.08
9848970,9982669,3219,1126650,11109319,11.29
9848971,9975587,674,235900,10211487,2.36
9848972,9972820,2397,838950,10811770,8.41
9848973,9979438,2409,843150,10822588,8.45
9848974,9994361,3316,1160600,11154961,11.61
9848975,9974693,1855,649250,10623943,6.51
9848976,362661,10,3500,366161,0.97
9848977,2819930,1134,396900,3216830,14.07
9848978,9978563,3348,1171800,11150363,11.74
9848979,9996865,3567,1248450,11245315,12.49
9848980,9980164,3154,1103900,11084064,11.06
9848981,9974962,3401,1190350,11165312,11.93
9848982,9982049,2699,944650,10926699,9.46
9848983,9987314,507,177450,10164764,1.78
9848984,9981598,2251,787850,10769448,7.89
9848985,9975525,229,80150,10055675,0.80
9848986,9976608,4233,1481550,11458158,14.85
9848987,9987232,1586,555100,10542332,5.56
9848988,9998490,2447,856450,10854940,8.57
9848989,9970097,4850,1697500,11667597,17.03
9848990,9976250,2725,953750,10930000,9.56
9848991,727388,325,113750,841138,15.64
9848992,9948398,2194,767900,10716298,7.72
9848993,9965779,3349,1172150,11137929,11.76
9848994,9970831,3571,1249850,11220681,12.54
9848995,9941894,4472,1565200,11507094,15.74
9848996,463779,166,58100,521879,12.53
9848997,9979250,3255,1139250,11118500,11.42
9848998,9977830,3107,1087450,11065280,10.90
9848999,599134,199,69650,668784,11.63
9849000,9957251,2319,811650,10768901,8.15
9849001,9975808,1981,693350,10669158,6.95
9849002,9967523,2215,775250,10742773,7.78
9849003,9990303,5416,1895600,11885903,18.97
9849004,9988078,1344,470400,10458478,4.71
9849005,9998632,3623,1268050,11266682,12.68
9849006,8642067,2415,845250,9487317,9.78
9849007,322217,146,51100,373317,15.86
9849008,9220391,5071,1774850,10995241,19.25
9849009,9971221,2498,874300,10845521,8.77
9849010,135627,42,14700,150327,10.84
9849011,1902763,2312,809200,2711963,42.53
9849012,9997471,3528,1234800,11232271,12.35
9849013,9998511,1138,398300,10396811,3.98
9849014,1742758,691,241850,1984608,13.88
9849015,9978956,2533,886550,10865506,8.88
9849016,2473271,644,225400,2698671,9.11
9849017,9967558,3891,1361850,11329408,13.66
9849018,88406,42,14700,103106,16.63
9849019,9963250,2070,724500,10687750,7.27
9849020,9965436,455,159250,10124686,1.60
9849021,9962709,5466,1913100,11875809,19.20
9849022,8981666,4097,1433950,10415616,15.97
9849023,9980541,3872,1355200,11335741,13.58
9849024,9985034,4414,1544900,11529934,15.47
9849026,9986753,4159,1455650,11442403,14.58
9849027,9974035,4083,1429050,11403085,14.33
9849028,9989601,4960,1736000,11725601,17.38
9849029,9994982,2350,822500,10817482,8.23
9849030,9655583,715,250250,9905833,2.59
9849031,9985509,730,255500,10241009,2.56
9849032,9985538,3671,1284850,11270388,12.87
9849033,5029941,1124,393400,5423341,7.82
9849034,9968383,3119,1091650,11060033,10.95
9849035,511299,152,53200,564499,10.40
9849036,750132,422,147700,897832,19.69
9849037,9971656,1593,557550,10529206,5.59
9849038,9977633,4111,1438850,11416483,14.42
9849039,9966074,3262,1141700,11107774,11.46
9849040,1658091,710,248500,1906591,14.99
9849041,9974216,4049,1417150,11391366,14.21
9849042,9966503,3812,1334200,11300703,13.39
9849043,9966267,4834,1691900,11658167,16.98
9849044,9961472,3223,1128050,11089522,11.32
9849045,9940641,3934,1376900,11317541,13.85
9849046,9946059,3415,1195250,11141309,12.02
9849047,3227513,739,258650,3486163,8.01
9849048,1089249,439,153650,1242899,14.11
9849049,9970979,4607,1612450,11583429,16.17
9849050,9974401,3240,1134000,11108401,11.37
9849051,9976595,2807,982450,10959045,9.85
9849052,9970972,4637,1622950,11593922,16.28
9849053,2117000,1262,441700,2558700,20.86
9849054,9985242,3584,1254400,11239642,12.56
9849055,1541887,422,147700,1689587,9.58
9849056,9959410,1628,569800,10529210,5.72
9849057,9962302,3618,1266300,11228602,12.71
9849058,1548540,417,145950,1694490,9.43
9849059,7359828,2985,1044750,8404578,14.20
9849060,9645056,4888,1710800,11355856,17.74
9849062,9956642,3701,1295350,11251992,13.01
9849063,352267,197,68950,421217,19.57
9849064,9947539,3695,1293250,11240789,13.00
9849065,6052715,1109,388150,6440865,6.41
9849066,9957722,4144,1450400,11408122,14.57
9849067,1577523,637,222950,1800473,14.13
9849068,9910744,2679,937650,10848394,9.46
9849069,9481838,4456,1559600,11041438,16.45
9849070,9979937,3665,1282750,11262687,12.85
9849071,9995627,2801,980350,10975977,9.81
9849072,2197144,1292,452200,2649344,20.58
9849073,9992244,3250,1137500,11129744,11.38
9849074,9986365,3254,1138900,11125265,11.40
9849075,9718287,3129,1095150,10813437,11.27
9849077,9957533,2067,723450,10680983,7.27
9849078,9938746,2743,960050,10898796,9.66
9849079,6605669,2045,715750,7321419,10.84
9849080,9948630,1604,561400,10510030,5.64
9849081,9963019,4429,1550150,11513169,15.56
9849082,9436571,2955,1034250,10470821,10.96
9849083,9941149,3687,1290450,11231599,12.98
9849084,9966587,4529,1585150,11551737,15.90
9849085,9965694,2067,723450,10689144,7.26
9849086,9961385,3713,1299550,11260935,13.05
9849087,5796229,1316,460600,6256829,7.95
9849088,3745521,1202,420700,4166221,11.23
9849090,9976320,3516,1230600,11206920,12.34
9849091,9991571,5665,1982750,11974321,19.84
9849092,3389831,1026,359100,3748931,10.59
9849093,1355269,575,201250,1556519,14.85
9849094,9985841,3900,1365000,11350841,13.67
9849095,9995931,4537,1587950,11583881,15.89
9849096,9989400,2913,1019550,11008950,10.21
9849097,9976148,3466,1213100,11189248,12.16
9849098,6835123,3153,1103550,7938673,16.15
9849099,9968067,3587,1255450,11223517,12.59
9849100,9961023,2575,901250,10862273,9.05
9849101,2936014,1382,483700,3419714,16.47
9849102,4551753,2193,767550,5319303,16.86
9849103,9964791,4314,1509900,11474691,15.15
9849104,9966828,1822,637700,10604528,6.40
9849105,9979424,3861,1351350,11330774,13.54
9849106,9976688,4023,1408050,11384738,14.11
9849107,9986177,3469,1214150,11200327,12.16
9849108,9969379,3846,1346100,11315479,13.50
9849109,9986271,1861,651350,10637621,6.52
9849110,9995126,4211,1473850,11468976,14.75
9849111,9987389,3010,1053500,11040889,10.55
9849112,9995667,2364,827400,10823067,8.28
9849113,9970199,3951,1382850,11353049,13.87
9849114,9992626,4334,1516900,11509526,15.18
9849115,9994529,2891,1011850,11006379,10.12
9849116,9994996,5150,1802500,11797496,18.03
9849117,9991410,3468,1213800,11205210,12.15
9849118,9988992,1823,638050,10627042,6.39
9849119,9995657,1079,377650,10373307,3.78
9849120,9988228,1176,411600,10399828,4.12
9849121,9985523,3241,1134350,11119873,11.36
9849122,9979227,3017,1055950,11035177,10.58
9849123,9978449,3689,1291150,11269599,12.94
9849124,9969095,1501,525350,10494445,5.27
9849125,9975023,950,332500,10307523,3.33
9849126,9980409,2638,923300,10903709,9.25
9849127,7823599,3238,1133300,8956899,14.49
9849128,9909256,2867,1003450,10912706,10.13
9849129,4261427,1583,554050,4815477,13.00
9849130,9376550,3299,1154650,10531200,12.31
9849131,9978442,2091,731850,10710292,7.33
9849132,9971956,5032,1761200,11733156,17.66
9849133,9976085,3759,1315650,11291735,13.19
9849134,9475674,2993,1047550,10523224,11.06
9849135,9957979,6405,2241750,12199729,22.51
9849136,9965010,2330,815500,10780510,8.18
9849137,9948946,5374,1880900,11829846,18.91
9849138,9940863,4967,1738450,11679313,17.49
9849139,9937602,4797,1678950,11616552,16.89
9849140,9940876,3432,1201200,11142076,12.08
9849141,5971137,1867,653450,6624587,10.94
9849142,9949111,2524,883400,10832511,8.88
9849143,9949767,3404,1191400,11141167,11.97
9849144,9967109,2275,796250,10763359,7.99
9849145,9963675,3408,1192800,11156475,11.97
9849146,9966847,3251,1137850,11104697,11.42
9849147,9947644,3330,1165500,11113144,11.72
9849148,4797302,1376,481600,5278902,10.04
9849149,9953005,1576,551600,10504605,5.54
9849150,9958872,968,338800,10297672,3.40
9849151,9964040,251,87850,10051890,0.88
9849152,9984758,3705,1296750,11281508,12.99
9849153,9976639,2208,772800,10749439,7.75
9849154,9977804,2570,899500,10877304,9.02
9849155,9982452,4169,1459150,11441602,14.62
9849156,332008,164,57400,389408,17.29
9849157,9953532,3142,1099700,11053232,11.05
9849158,9938341,5640,1974000,11912341,19.86
9849159,9933536,3317,1160950,11094486,11.69
9849160,9935667,1803,631050,10566717,6.35
9849161,9918389,4440,1554000,11472389,15.67
9849162,9918410,3118,1091300,11009710,11.00
9849163,9928067,5163,1807050,11735117,18.20
9849164,9933209,3397,1188950,11122159,11.97
9849165,9916324,3800,1330000,11246324,13.41
9849166,9928307,4486,1570100,11498407,15.81
9849167,9910310,3405,1191750,11102060,12.03
9849168,9947353,3538,1238300,11185653,12.45
9849169,9948379,3120,1092000,11040379,10.98
9849170,2676001,815,285250,2961251,10.66
9849171,9951204,5077,1776950,11728154,17.86
9849173,9968966,6059,2120650,12089616,21.27
9849174,9961518,3017,1055950,11017468,10.60
9849175,9946794,3042,1064700,11011494,10.70
9849176,9929568,2972,1040200,10969768,10.48
9849177,9928694,3696,1293600,11222294,13.03
9849178,9919039,5011,1753850,11672889,17.68
9849179,4032835,2058,720300,4753135,17.86
9849180,9923794,3564,1247400,11171194,12.57
9849181,1094348,393,137550,1231898,12.57
9849182,2614958,1065,372750,2987708,14.25
9849183,9877411,3786,1325100,11202511,13.42
9849184,9105765,4224,1478400,10584165,16.24
9849185,9885131,3380,1183000,11068131,11.97
9849186,9889236,3350,1172500,11061736,11.86
9849187,9908039,3706,1297100,11205139,13.09
9849188,3231595,1497,523950,3755545,16.21
9849189,9897945,4893,1712550,11610495,17.30
9849190,388363,188,65800,454163,16.94
9849191,167815,109,38150,205965,22.73
9849192,9884325,3920,1372000,11256325,13.88
9849193,9865266,2308,807800,10673066,8.19
9849194,9870856,1814,634900,10505756,6.43
9849195,3162646,925,323750,3486396,10.24
9849196,9884458,3369,1179150,11063608,11.93
9849197,9875927,3433,1201550,11077477,12.17
9849198,9871853,4028,1409800,11281653,14.28
9849199,1771428,346,121100,1892528,6.84
9849200,581383,203,71050,652433,12.22
9849201,2482311,1990,696500,3178811,28.06
9849202,9893977,2902,1015700,10909677,10.27
9849204,9895114,3953,1383550,11278664,13.98
9849205,9902432,3321,1162350,11064782,11.74
9849206,9878428,2973,1040550,10918978,10.53
9849207,9890990,2795,978250,10869240,9.89
9849208,9873513,3461,1211350,11084863,12.27
9849209,7181016,3291,1151850,8332866,16.04
9849210,6708567,2158,755300,7463867,11.26
9849211,9866929,3289,1151150,11018079,11.67
9849212,9855745,4810,1683500,11539245,17.08
9849213,4255177,1599,559650,4814827,13.15
9849214,9882545,4108,1437800,11320345,14.55
9849215,7147696,4295,1503250,8650946,21.03
9849216,5730878,3710,1298500,7029378,22.66
9849218,9864728,3874,1355900,11220628,13.74
9849219,6391165,3711,1298850,7690015,20.32
9849220,9849258,2933,1026550,10875808,10.42
9849221,9841145,4924,1723400,11564545,17.51
9849222,4897046,2253,788550,5685596,16.10
9849223,9822009,4206,1472100,11294109,14.99
9849224,9842839,2146,751100,10593939,7.63
9849225,9833641,2447,856450,10690091,8.71
9849226,8141063,1042,364700,8505763,4.48
9849227,2711640,993,347550,3059190,12.82
9849228,9842890,3476,1216600,11059490,12.36
9849229,9829123,2796,978600,10807723,9.96
9849230,9824902,2547,891450,10716352,9.07
9849231,9816110,3126,1094100,10910210,11.15
9849232,9815353,2736,957600,10772953,9.76
9849234,8187081,3689,1291150,9478231,15.77
9849235,9809162,3206,1122100,10931262,11.44
9849236,4756125,1339,468650,5224775,9.85
9849237,9786067,3334,1166900,10952967,11.92
9849238,9792398,5349,1872150,11664548,19.12
9849239,9807088,3495,1223250,11030338,12.47
9849240,460335,169,59150,519485,12.85
9849241,9778347,5748,2011800,11790147,20.57
9849242,9783655,3419,1196650,10980305,12.23
9849243,1399806,597,208950,1608756,14.93
9849244,9771067,4316,1510600,11281667,15.46
9849245,9767488,3671,1284850,11052338,13.15
9849246,9772914,3822,1337700,11110614,13.69
9849247,9766481,2115,740250,10506731,7.58
9849248,9780271,5051,1767850,11548121,18.08
9849249,9796117,3625,1268750,11064867,12.95
9849250,8174249,1201,420350,8594599,5.14
9849251,8175486,515,180250,8355736,2.20
9849252,9784590,2864,1002400,10786990,10.24
9849253,770930,304,106400,877330,13.80
9849254,9757548,2589,906150,10663698,9.29
9849255,9784598,2130,745500,10530098,7.62
9849256,9784444,1319,461650,10246094,4.72
9849257,9796032,3973,1390550,11186582,14.20
9849258,9803616,1909,668150,10471766,6.82
9849259,9791994,2592,907200,10699194,9.26
9849260,9799060,2234,781900,10580960,7.98
9849261,1398904,560,196000,1594904,14.01
9849262,9807305,2352,823200,10630505,8.39
9849263,9814774,573,200550,10015324,2.04
9849264,9814439,2797,978950,10793389,9.97
9849265,9836420,2573,900550,10736970,9.16
9849266,9836107,4205,1471750,11307857,14.96
9849267,1940362,1285,449750,2390112,23.18
9849268,9848272,3337,1167950,11016222,11.86
9849269,9797445,4658,1630300,11427745,16.64
9849270,9860558,2573,900550,10761108,9.13
9849271,368649,196,68600,437249,18.61
9849272,9831752,2616,915600,10747352,9.31
9849273,9843252,4117,1440950,11284202,14.64
9849274,9825309,2151,752850,10578159,7.66
9849275,9829325,2538,888300,10717625,9.04
9849276,9840600,2726,954100,10794700,9.70
9849277,9835873,1128,394800,10230673,4.01
9849278,9840305,4491,1571850,11412155,15.97
9849279,9849070,3199,1119650,10968720,11.37
9849280,4019104,1407,492450,4511554,12.25
9849281,9850626,5053,1768550,11619176,17.95
9849282,9839250,3300,1155000,10994250,11.74
9849283,9835163,611,213850,10049013,2.17
9849284,9860376,3361,1176350,11036726,11.93
9849285,1068204,344,120400,1188604,11.27
9849286,9847154,3073,1075550,10922704,10.92
9849287,9867802,2508,877800,10745602,8.90
9849288,3463709,1933,676550,4140259,19.53
9849289,1264174,456,159600,1423774,12.62
9849290,8894728,3877,1356950,10251678,15.26
9849291,9868180,2244,785400,10653580,7.96
9849292,8872902,5525,1933750,10806652,21.79
9849293,9428397,5112,1789200,11217597,18.98
9849294,679300,1055,369250,1048550,54.36
9849295,9862252,4212,1474200,11336452,14.95
9849296,9860499,3746,1311100,11171599,13.30
9849297,9853767,7005,2451750,12305517,24.88
9849298,9855638,3562,1246700,11102338,12.65
9849300,9860439,2785,974750,10835189,9.89
9849301,9853468,3012,1054200,10907668,10.70
9849302,9842124,2613,914550,10756674,9.29
9849303,9846290,2412,844200,10690490,8.57
9849304,9859337,3693,1292550,11151887,13.11
9849305,1454783,1506,527100,1981883,36.23
9849306,9865161,3666,1283100,11148261,13.01
9849307,9858416,3554,1243900,11102316,12.62
9849308,9839518,3503,1226050,11065568,12.46
9849309,9851110,1966,688100,10539210,6.98
9849310,4913734,2551,892850,5806584,18.17
9849311,596323,362,126700,723023,21.25
9849312,9823179,2553,893550,10716729,9.10
9849313,690335,898,314300,1004635,45.53
9849314,537939,179,62650,600589,11.65
9849315,1738471,882,308700,2047171,17.76
9849316,6234334,2474,865900,7100234,13.89
9849317,9808392,4018,1406300,11214692,14.34
9849318,8221628,2675,936250,9157878,11.39
9849319,9834058,5138,1798300,11632358,18.29
9849320,8043893,3619,1266650,9310543,15.75
9849321,8804607,4665,1632750,10437357,18.54
9849322,3356108,1725,603750,3959858,17.99
9849323,9819183,4649,1627150,11446333,16.57
9849324,9823690,3920,1372000,11195690,13.97
9849325,9792862,4926,1724100,11516962,17.61
9849326,9834011,4796,1678600,11512611,17.07
9849327,9834087,4989,1746150,11580237,17.76
9849328,9815731,6193,2167550,11983281,22.08
9849329,9826031,3800,1330000,11156031,13.54
9849330,9825401,2969,1039150,10864551,10.58
9849331,4526259,2176,761600,5287859,16.83
9849332,9829843,3289,1151150,10980993,11.71
9849333,8011251,4825,1688750,9700001,21.08
9849334,9807005,4396,1538600,11345605,15.69
9849335,9811524,4234,1481900,11293424,15.10
9849336,9807348,3815,1335250,11142598,13.61
9849337,9807043,4371,1529850,11336893,15.60
9849338,9826932,3604,1261400,11088332,12.84
9849339,9825176,2566,898100,10723276,9.14
9849340,9838157,1511,528850,10367007,5.38
9849341,9843448,5116,1790600,11634048,18.19
9849342,9852853,4397,1538950,11391803,15.62
9849343,9218400,2566,898100,10116500,9.74
9849344,9851644,4355,1524250,11375894,15.47
9849345,9866630,3708,1297800,11164430,13.15
9849346,9862818,4835,1692250,11555068,17.16
9849347,9868894,2772,970200,10839094,9.83
9849348,417416,230,80500,497916,19.29
9849349,9869570,3306,1157100,11026670,11.72
9849350,2241155,2333,816550,3057705,36.43
9849351,9852593,5320,1862000,11714593,18.90
9849352,9854248,4139,1448650,11302898,14.70
9849353,9351160,4219,1476650,10827810,15.79
9849354,9619530,4729,1655150,11274680,17.21
9849355,9848234,5824,2038400,11886634,20.70
9849356,9851384,4181,1463350,11314734,14.85
9849357,2218188,391,136850,2355038,6.17
9849358,9831999,5203,1821050,11653049,18.52
9849359,9833448,2714,949900,10783348,9.66
9849360,9341976,2694,942900,10284876,10.09
9849361,9848681,3621,1267350,11116031,12.87
9849362,9856573,4848,1696800,11553373,17.21
9849363,9848020,4442,1554700,11402720,15.79
9849364,9855650,2400,840000,10695650,8.52
9849366,9859712,4727,1654450,11514162,16.78
9849367,9039438,3685,1289750,10329188,14.27
9849368,9877734,2278,797300,10675034,8.07
9849369,9864610,3449,1207150,11071760,12.24
9849370,9839587,3056,1069600,10909187,10.87
9849371,9863452,2910,1018500,10881952,10.33
9849372,9879522,3834,1341900,11221422,13.58
9849373,9885588,2736,957600,10843188,9.69
9849374,9888808,4246,1486100,11374908,15.03
9849375,9906091,3573,1250550,11156641,12.62
9849376,9917022,3796,1328600,11245622,13.40
9849377,9895276,2711,948850,10844126,9.59
9849378,9893564,3349,1172150,11065714,11.85
9849379,9921887,4339,1518650,11440537,15.31
9849380,5799473,2786,975100,6774573,16.81
9849381,41197,42,14700,55897,35.68
9849382,9924496,3547,1241450,11165946,12.51
9849383,9862195,2847,996450,10858645,10.10
9849384,9939198,1467,513450,10452648,5.17
9849385,9944398,2295,803250,10747648,8.08
9849386,9952357,5205,1821750,11774107,18.30
9849387,9941824,5030,1760500,11702324,17.71
9849389,9923199,2658,930300,10853499,9.38
9849390,9929247,1049,367150,10296397,3.70
9849391,662473,329,115150,777623,17.38
9849392,487042,42,14700,501742,3.02
9849393,9912655,3708,1297800,11210455,13.09
9849394,9922948,3651,1277850,11200798,12.88
9849395,9929000,388,135800,10064800,1.37
9849396,9937755,806,282100,10219855,2.84
9849397,9917201,3312,1159200,11076401,11.69
9849398,9944587,3877,1356950,11301537,13.65
9849399,9947556,2026,709100,10656656,7.13
9849400,1544346,1011,353850,1898196,22.91
9849402,9960214,3839,1343650,11303864,13.49
9849403,9964644,3147,1101450,11066094,11.05
9849404,9978504,3725,1303750,11282254,13.07
9849405,4090748,1189,416150,4506898,10.17
9849406,9979576,3914,1369900,11349476,13.73
9849407,9999800,4039,1413650,11413450,14.14
9849408,9988926,1003,351050,10339976,3.51
9849409,9979574,1247,436450,10416024,4.37
9849410,1861755,784,274400,2136155,14.74
9849411,9979509,5357,1874950,11854459,18.79
9849412,9969759,1170,409500,10379259,4.11
9849413,6423326,807,282450,6705776,4.40
9849414,3103515,1167,408450,3511965,13.16
9849415,4929908,1776,621600,5551508,12.61
9849416,9974311,5255,1839250,11813561,18.44
9849417,7540629,2756,964600,8505229,12.79
9849418,560715,219,76650,637365,13.67
9849419,3380734,912,319200,3699934,9.44
9849420,4798407,1413,494550,5292957,10.31
9849421,9919298,4800,1680000,11599298,16.94
9849422,9969472,3126,1094100,11063572,10.97
9849423,962042,425,148750,1110792,15.46
9849424,9966860,4660,1631000,11597860,16.36
9849425,1683074,762,266700,1949774,15.85
9849426,9967426,2533,886550,10853976,8.89
9849427,9975506,3212,1124200,11099706,11.27
9849428,9978537,2840,994000,10972537,9.96
9849429,9858663,4560,1596000,11454663,16.19
9849430,9412659,3749,1312150,10724809,13.94
9849431,9968365,3633,1271550,11239915,12.76
9849432,9952974,3307,1157450,11110424,11.63
9849433,9963769,2264,792400,10756169,7.95
9849434,9968105,3077,1076950,11045055,10.80
9849435,9971069,2350,822500,10793569,8.25
9849436,9988781,3781,1323350,11312131,13.25
9849437,9984859,3076,1076600,11061459,10.78
9849438,9969130,2327,814450,10783580,8.17
9849439,9996173,3546,1241100,11237273,12.42
9849440,9984690,1157,404950,10389640,4.06
9849441,9975299,1810,633500,10608799,6.35
9849442,9976527,2857,999950,10976477,10.02
9849443,9975980,3231,1130850,11106830,11.34
9849444,9990248,1295,453250,10443498,4.54
9849445,1387805,1205,421750,1809555,30.39
9849446,9938147,1075,376250,10314397,3.79
9849447,9855318,277,96950,9952268,0.98
9849448,9972817,836,292600,10265417,2.93
9849449,9953723,303,106050,10059773,1.07
9849450,9944282,2078,727300,10671582,7.31
9849451,9921114,1406,492100,10413214,4.96
9849452,9943368,1021,357350,10300718,3.59
9849454,9930555,2061,721350,10651905,7.26
9849455,9941396,2330,815500,10756896,8.20
9849456,9953847,3438,1203300,11157147,12.09
9849457,9955319,1023,358050,10313369,3.60
9849458,9964470,2274,795900,10760370,7.99
9849459,9953238,2897,1013950,10967188,10.19
9849460,9956389,2918,1021300,10977689,10.26
9849461,9955907,3116,1090600,11046507,10.95
9849462,9945553,2241,784350,10729903,7.89
9849463,9947608,3908,1367800,11315408,13.75
9849464,9952347,2521,882350,10834697,8.87
9849465,9969864,3647,1276450,11246314,12.80
9849466,3331988,1410,493500,3825488,14.81
9849467,9969374,5344,1870400,11839774,18.76
9849468,9966902,3855,1349250,11316152,13.54
9849469,9956172,3497,1223950,11180122,12.29
9849470,9964436,2613,914550,10878986,9.18
9849471,9962722,5826,2039100,12001822,20.47
9849472,9973148,3369,1179150,11152298,11.82
9849473,9961188,2750,962500,10923688,9.66
9849474,557860,396,138600,696460,24.84
9849475,2545543,1627,569450,3114993,22.37
9849476,9968872,4484,1569400,11538272,15.74
9849477,9969228,4716,1650600,11619828,16.56
9849478,9968600,3595,1258250,11226850,12.62
9849480,9957502,4216,1475600,11433102,14.82
9849481,1013261,293,102550,1115811,10.12
9849482,9951551,3259,1140650,11092201,11.46
9849483,9937773,2875,1006250,10944023,10.13
9849484,9927495,2543,890050,10817545,8.97
9849485,7356899,2456,859600,8216499,11.68
9849486,9913682,4290,1501500,11415182,15.15
9849487,9919671,2159,755650,10675321,7.62
9849489,9911071,2559,895650,10806721,9.04
9849490,9899209,3080,1078000,10977209,10.89
9849491,9907114,2804,981400,10888514,9.91
9849492,1321284,1212,424200,1745484,32.11
9849493,9918019,4898,1714300,11632319,17.28
9849494,9926200,2108,737800,10664000,7.43
9849495,9921415,6013,2104550,12025965,21.21
9849497,9916299,6413,2244550,12160849,22.63
9849498,9929267,5229,1830150,11759417,18.43
9849499,9930885,4029,1410150,11341035,14.20
9849500,9942119,2157,754950,10697069,7.59
9849501,9942088,4430,1550500,11492588,15.60
9849502,9960424,4173,1460550,11420974,14.66
9849503,9939689,2737,957950,10897639,9.64
9849504,9958805,547,191450,10150255,1.92
9849505,9968565,4339,1518650,11487215,15.23
9849506,9975176,5240,1834000,11809176,18.39
9849507,9987155,4456,1559600,11546755,15.62
9849508,9977032,5826,2039100,12016132,20.44
9849509,9949101,5232,1831200,11780301,18.41
9849511,9973722,2213,774550,10748272,7.77
9849512,9972553,5890,2061500,12034053,20.67
9849513,3127603,1492,522200,3649803,16.70
9849514,2205869,1646,576100,2781969,26.12
9849515,9955210,6257,2189950,12145160,22.00
9849517,9937930,6034,2111900,12049830,21.25
9849518,9960002,3929,1375150,11335152,13.81
9849519,9962461,2811,983850,10946311,9.88
9849520,9939310,5230,1830500,11769810,18.42
9849521,1351327,985,344750,1696077,25.51
9849522,9967311,4636,1622600,11589911,16.28
9849523,9947285,3440,1204000,11151285,12.10
9849524,9946258,3656,1279600,11225858,12.87
9849525,9943408,4554,1593900,11537308,16.03
9849526,9927839,4588,1605800,11533639,16.17
9849527,9926457,6106,2137100,12063557,21.53
9849528,9926949,5442,1904700,11831649,19.19
9849529,9947132,7180,2513000,12460132,25.26
9849530,9928627,3115,1090250,11018877,10.98
9849531,9942173,2460,861000,10803173,8.66
9849532,9947611,2411,843850,10791461,8.48
9849533,9956135,2070,724500,10680635,7.28
9849534,9949313,2300,805000,10754313,8.09
9849535,9972728,2368,828800,10801528,8.31
9849536,9967618,3306,1157100,11124718,11.61
9849537,9987505,2931,1025850,11013355,10.27
9849538,9987885,3251,1137850,11125735,11.39
9849539,9997902,1225,428750,10426652,4.29
9849540,9973652,504,176400,10150052,1.77
9849541,3883664,1573,550550,4434214,14.18
9849542,9991346,3176,1111600,11102946,11.13
9849543,9985682,2944,1030400,11016082,10.32
9849544,9985282,3637,1272950,11258232,12.75
9849545,9983191,2237,782950,10766141,7.84
9849546,9967377,3224,1128400,11095777,11.32
9849547,9971758,3982,1393700,11365458,13.98
9849548,9983165,4073,1425550,11408715,14.28
9849549,1683596,311,108850,1792446,6.47
9849550,604004,215,75250,679254,12.46
9849551,9956077,3516,1230600,11186677,12.36
9849552,9972825,3528,1234800,11207625,12.38
9849553,9983818,6248,2186800,12170618,21.90
9849554,9989386,2318,811300,10800686,8.12
9849555,9995106,4599,1609650,11604756,16.10
9849556,2533180,1846,646100,3179280,25.51
9849558,9963224,5904,2066400,12029624,20.74
9849559,183081,152,53200,236281,29.06
9849560,9995128,5068,1773800,11768928,17.75
9849561,1206244,638,223300,1429544,18.51
9849562,9981946,3177,1111950,11093896,11.14
9849563,9988671,3791,1326850,11315521,13.28
9849564,9977729,5137,1797950,11775679,18.02
9849565,9957433,5313,1859550,11816983,18.67
9849566,9962324,2055,719250,10681574,7.22
9849567,9963328,3763,1317050,11280378,13.22
9849569,9961468,4437,1552950,11514418,15.59
9849570,748788,384,134400,883188,17.95
9849571,9972184,3362,1176700,11148884,11.80
9849572,9974255,3541,1239350,11213605,12.43
9849573,9998841,750,262500,10261341,2.63
9849574,479526,283,99050,578576,20.66
9849575,9985465,2644,925400,10910865,9.27
9849576,9977299,5186,1815100,11792399,18.19
9849577,9991719,2972,1040200,11031919,10.41
9849578,9987346,4390,1536500,11523846,15.38
9849579,4243215,1624,568400,4811615,13.40
9849580,9964955,4243,1485050,11450005,14.90
9849582,9955317,5026,1759100,11714417,17.67
9849583,9963644,3303,1156050,11119694,11.60
9849584,9969891,5322,1862700,11832591,18.68
9849585,1321087,962,336700,1657787,25.49
9849586,9946193,3740,1309000,11255193,13.16
9849587,9944847,5329,1865150,11809997,18.75
9849588,9923565,3566,1248100,11171665,12.58
9849591,9895973,4361,1526350,11422323,15.42
9849592,2956881,889,311150,3268031,10.52
9849593,9907808,2283,799050,10706858,8.06
9849594,9912183,2232,781200,10693383,7.88
9849595,9912661,3668,1283800,11196461,12.95
9849596,9918267,2993,1047550,10965817,10.56
9849598,9592772,371,129850,9722622,1.35
9849599,9897344,1283,449050,10346394,4.54
9849600,9918258,5205,1821750,11740008,18.37
9849601,1857214,657,229950,2087164,12.38
9849602,9889930,5853,2048550,11938480,20.71
9849603,3423177,1354,473900,3897077,13.84
9849604,9887455,1936,677600,10565055,6.85
9849605,9891767,1531,535850,10427617,5.42
9849606,9895780,4384,1534400,11430180,15.51
9849607,9899175,2926,1024100,10923275,10.35
9849608,1441970,519,181650,1623620,12.60
9849609,5828431,2510,878500,6706931,15.07
9849610,1524147,675,236250,1760397,15.50
9849611,9893383,3389,1186150,11079533,11.99
9849612,9911180,3012,1054200,10965380,10.64
9849614,805663,284,99400,905063,12.34
9849615,9912381,3212,1124200,11036581,11.34
9849616,9925393,5645,1975750,11901143,19.91
9849618,9908048,2658,930300,10838348,9.39
9849619,9896297,3979,1392650,11288947,14.07
9849620,9909097,3759,1315650,11224747,13.28
9849621,603422,214,74900,678322,12.41
9849622,9903749,1255,439250,10342999,4.44
9849623,4287455,2140,749000,5036455,17.47
9849624,9908957,493,172550,10081507,1.74
9849625,9920884,830,290500,10211384,2.93
9849626,7928603,460,161000,8089603,2.03
9849627,9901943,4305,1506750,11408693,15.22
9849628,9906217,341,119350,10025567,1.20
9849629,9905550,1019,356650,10262200,3.60
9849631,9886771,2831,990850,10877621,10.02
9849632,9897309,2048,716800,10614109,7.24
9849633,9896979,2988,1045800,10942779,10.57
9849634,9898122,2223,778050,10676172,7.86
9849635,9915762,3475,1216250,11132012,12.27
9849636,9910615,5744,2010400,11921015,20.29
9849637,9921571,3903,1366050,11287621,13.77
9849638,9936148,3086,1080100,11016248,10.87
9849639,9909873,6018,2106300,12016173,21.25
9849640,9931648,1819,636650,10568298,6.41
9849641,2599891,1062,371700,2971591,14.30
9849642,2400789,1512,529200,2929989,22.04
9849643,9930623,2844,995400,10926023,10.02
9849644,9931512,3919,1371650,11303162,13.81
9849645,9943598,4191,1466850,11410448,14.75
9849646,9943176,1825,638750,10581926,6.42
9849647,9835159,3645,1275750,11110909,12.97
9849648,9420883,5932,2076200,11497083,22.04
9849649,9929565,2766,968100,10897665,9.75
9849650,9919693,3000,1050000,10969693,10.59
9849651,9934684,3816,1335600,11270284,13.44
9849652,9941781,5109,1788150,11729931,17.99
9849653,9961120,3536,1237600,11198720,12.42
9849654,9964257,4062,1421700,11385957,14.27
9849655,9964977,4976,1741600,11706577,17.48
9849656,9969053,3401,1190350,11159403,11.94
9849657,9974551,3151,1102850,11077401,11.06
9849658,9978847,2940,1029000,11007847,10.31
9849659,9972660,4845,1695750,11668410,17.00
9849660,2634082,1118,391300,3025382,14.86
9849661,9953639,1961,686350,10639989,6.90
9849662,9638006,4143,1450050,11088056,15.05
9849663,9958738,2029,710150,10668888,7.13
9849664,9980273,2306,807100,10787373,8.09
9849665,9956941,4213,1474550,11431491,14.81
9849666,9965847,2089,731150,10696997,7.34
9849667,9973814,2553,893550,10867364,8.96
9849668,9891743,4312,1509200,11400943,15.26
9849669,9981353,1192,417200,10398553,4.18
9849670,9973930,3955,1384250,11358180,13.88
9849671,9949352,4484,1569400,11518752,15.77
9849672,9974735,5299,1854650,11829385,18.59
9849673,9989905,2930,1025500,11015405,10.27
9849674,9980952,2779,972650,10953602,9.75
9849675,3783175,1446,506100,4289275,13.38
9849676,9990124,4279,1497650,11487774,14.99
9849677,9997012,4436,1552600,11549612,15.53
9849678,9982830,3281,1148350,11131180,11.50
9849679,9979920,5262,1841700,11821620,18.45
9849680,9981382,3693,1292550,11273932,12.95
9849681,9790673,3692,1292200,11082873,13.20
9849682,9986027,5022,1757700,11743727,17.60
9849683,9976959,4046,1416100,11393059,14.19
9849684,9977506,3915,1370250,11347756,13.73
9849685,9981890,2919,1021650,11003540,10.24
9849686,9983880,4085,1429750,11413630,14.32
9849687,9988612,3445,1205750,11194362,12.07
9849688,9986625,1631,570850,10557475,5.72
9849689,5628306,3097,1083950,6712256,19.26
9849690,9983568,4535,1587250,11570818,15.90
9849691,3269298,3290,1151500,4420798,35.22
9849693,9978747,5335,1867250,11845997,18.71
9849694,9994294,4999,1749650,11743944,17.51
9849695,9987065,3514,1229900,11216965,12.31
9849696,3136616,1062,371700,3508316,11.85
9849697,9973457,4246,1486100,11459557,14.90
9849698,9996202,2309,808150,10804352,8.08
9849699,9974005,2537,887950,10861955,8.90
9849700,9987861,971,339850,10327711,3.40
9849701,9986926,3423,1198050,11184976,12.00
9849702,9980589,3914,1369900,11350489,13.73
9849703,9997938,580,203000,10200938,2.03
9849705,9980460,1601,560350,10540810,5.61
9849706,9984990,2855,999250,10984240,10.01
9849708,9969553,2215,775250,10744803,7.78
9849709,9978787,3678,1287300,11266087,12.90
9849710,9987762,3401,1190350,11178112,11.92
9849711,9977414,4710,1648500,11625914,16.52
9849712,4137874,3459,1210650,5348524,29.26
9849713,9912077,4530,1585500,11497577,16.00
9849714,9984164,1940,679000,10663164,6.80
9849715,7285766,2906,1017100,8302866,13.96
9849716,9986650,4371,1529850,11516500,15.32
9849717,5114457,2218,776300,5890757,15.18
9849718,9979073,3445,1205750,11184823,12.08
9849719,9981633,3100,1085000,11066633,10.87
9849720,9987213,4262,1491700,11478913,14.94
9849721,9987141,2235,782250,10769391,7.83
9849722,8383246,3941,1379350,9762596,16.45
9849723,9976711,2090,731500,10708211,7.33
9849724,9953366,4523,1583050,11536416,15.90
9849725,9951155,5939,2078650,12029805,20.89
9849726,9946231,3718,1301300,11247531,13.08
9849727,9943531,3665,1282750,11226281,12.90
9849728,9955314,1485,519750,10475064,5.22
9849729,9959546,2803,981050,10940596,9.85
9849730,9966939,2118,741300,10708239,7.44
9849731,9967381,3457,1209950,11177331,12.14
9849732,9988134,3965,1387750,11375884,13.89
9849733,9967798,5125,1793750,11761548,18.00
9849734,9976278,4455,1559250,11535528,15.63
9849735,4424199,1475,516250,4940449,11.67
9849736,9969662,3909,1368150,11337812,13.72
9849737,9675592,3059,1070650,10746242,11.07
9849738,9964922,3490,1221500,11186422,12.26
9849739,9975234,3840,1344000,11319234,13.47
9849740,9867973,2305,806750,10674723,8.18
9849741,9972101,3381,1183350,11155451,11.87
9849742,9984738,3728,1304800,11289538,13.07
9849743,347458,146,51100,398558,14.71
9849744,9967027,4421,1547350,11514377,15.52
9849745,9937268,5428,1899800,11837068,19.12
9849746,9980767,3802,1330700,11311467,13.33
9849747,9990750,3622,1267700,11258450,12.69
9849748,9978535,3196,1118600,11097135,11.21
9849749,9996238,2976,1041600,11037838,10.42
9849750,9980866,3121,1092350,11073216,10.94
9849752,9969531,3546,1241100,11210631,12.45
9849753,9978353,2031,710850,10689203,7.12
9849754,9980390,4260,1491000,11471390,14.94
9849755,9975994,3813,1334550,11310544,13.38
9849756,9999835,2760,966000,10965835,9.66
9849757,9973207,4732,1656200,11629407,16.61
9849758,9987409,4032,1411200,11398609,14.13
9849759,9976977,3719,1301650,11278627,13.05
9849760,9985105,4020,1407000,11392105,14.09
9849761,9970719,3067,1073450,11044169,10.77
9849762,9974844,3828,1339800,11314644,13.43
9849763,9984639,2370,829500,10814139,8.31
9849764,9970377,2938,1028300,10998677,10.31
9849765,9977044,4503,1576050,11553094,15.80
9849766,9981349,5019,1756650,11737999,17.60
9849767,9984742,4091,1431850,11416592,14.34
9849768,327528,232,81200,408728,24.79
9849769,9982379,5453,1908550,11890929,19.12
9849770,9994168,1749,612150,10606318,6.13
9849772,9986310,2946,1031100,11017410,10.33
9849773,9974713,5170,1809500,11784213,18.14
9849774,9992739,3726,1304100,11296839,13.05
9849775,9982848,2660,931000,10913848,9.33
9849776,9974452,5601,1960350,11934802,19.65
9849777,9948382,4289,1501150,11449532,15.09
9849778,792194,382,133700,925894,16.88
9849779,9968895,5822,2037700,12006595,20.44
9849780,9957735,2442,854700,10812435,8.58
9849781,9980979,6240,2184000,12164979,21.88
9849782,9976455,3322,1162700,11139155,11.65
9849783,9963560,3215,1125250,11088810,11.29
9849784,9505516,1867,653450,10158966,6.87
9849785,9985717,5343,1870050,11855767,18.73
9849786,6481709,2058,720300,7202009,11.11
9849787,9983488,1974,690900,10674388,6.92
9849789,9981575,3692,1292200,11273775,12.95
9849790,9978629,2572,900200,10878829,9.02
9849791,9997359,2959,1035650,11033009,10.36
9849792,9979843,4299,1504650,11484493,15.08
9849793,1979129,752,263200,2242329,13.30
9849794,9983918,2980,1043000,11026918,10.45
9849795,9981041,3016,1055600,11036641,10.58
9849796,9997595,2241,784350,10781945,7.85
9849797,9968982,3176,1111600,11080582,11.15
9849799,9975755,3275,1146250,11122005,11.49
9849800,9965152,3980,1393000,11358152,13.98
9849801,9967656,3032,1061200,11028856,10.65
9849802,9968785,2550,892500,10861285,8.95
9849803,9985127,4567,1598450,11583577,16.01
9849804,9964301,3614,1264900,11229201,12.69
9849805,9970547,2833,991550,10962097,9.94
9849806,9960208,3342,1169700,11129908,11.74
9849807,9962968,1073,375550,10338518,3.77
9849808,6983974,1814,634900,7618874,9.09
9849809,9961979,2754,963900,10925879,9.68
9849810,9971236,2885,1009750,10980986,10.13
9849811,9986361,1062,371700,10358061,3.72
9849812,9977724,2385,834750,10812474,8.37
9849813,9973476,3229,1130150,11103626,11.33
9849814,9976754,1571,549850,10526604,5.51
9849815,9970988,2124,743400,10714388,7.46
9849816,9981526,3749,1312150,11293676,13.15
9849817,9979895,3075,1076250,11056145,10.78
9849819,9966240,4158,1455300,11421540,14.60
9849820,4324590,251,87850,4412440,2.03
9849821,769199,347,121450,890649,15.79
9849822,9951295,2707,947450,10898745,9.52
9849823,5810784,2298,804300,6615084,13.84
9849824,5480778,2161,756350,6237128,13.80
9849825,9934314,2264,792400,10726714,7.98
9849826,9946672,3299,1154650,11101322,11.61
9849827,9945126,1894,662900,10608026,6.67
9849828,9956721,4198,1469300,11426021,14.76
9849829,9960661,3641,1274350,11235011,12.79
9849830,9965018,2528,884800,10849818,8.88
9849831,9854113,3858,1350300,11204413,13.70
9849832,9952886,2582,903700,10856586,9.08
9849833,9894718,4892,1712200,11606918,17.30
9849834,9995105,2741,959350,10954455,9.60
9849835,9981563,2538,888300,10869863,8.90
9849836,9980926,3580,1253000,11233926,12.55
9849837,9993942,4447,1556450,11550392,15.57
9849838,9999041,3268,1143800,11142841,11.44
9849839,5211888,1674,585900,5797788,11.24
9849840,9986858,4081,1428350,11415208,14.30
9849841,9975625,2490,871500,10847125,8.74
9849842,771770,357,124950,896720,16.19
9849843,9968393,2608,912800,10881193,9.16
9849844,9960730,3888,1360800,11321530,13.66
9849845,9964185,3133,1096550,11060735,11.00
9849846,9949150,4616,1615600,11564750,16.24
9849847,9960723,4069,1424150,11384873,14.30
9849848,9973852,4152,1453200,11427052,14.57
9849849,9983090,2641,924350,10907440,9.26
9849850,6087805,908,317800,6405605,5.22
9849851,9980809,3388,1185800,11166609,11.88
9849852,288239,308,107800,396039,37.40
9849853,9981064,1481,518350,10499414,5.19
9849854,1933847,748,261800,2195647,13.54
9849855,9980581,3227,1129450,11110031,11.32
9849856,9975994,1999,699650,10675644,7.01
9849857,784330,395,138250,922580,17.63
9849858,9981344,2328,814800,10796144,8.16
9849859,2576373,1322,462700,3039073,17.96
9849860,9989203,5025,1758750,11747953,17.61
9849861,9978343,2893,1012550,10990893,10.15
9849862,9965416,2870,1004500,10969916,10.08
9849863,9980741,2599,909650,10890391,9.11
9849864,9972136,4995,1748250,11720386,17.53
9849865,9994809,2771,969850,10964659,9.70
9849866,9993418,3551,1242850,11236268,12.44
9849867,496285,120,42000,538285,8.46
9849868,9977022,5844,2045400,12022422,20.50
9849869,9985533,3123,1093050,11078583,10.95
9849870,9986407,4414,1544900,11531307,15.47
9849871,9978060,3511,1228850,11206910,12.32
9849872,9987219,4972,1740200,11727419,17.42
9849873,4637770,2487,870450,5508220,18.77
9849874,9983626,3347,1171450,11155076,11.73
9849875,9974588,3598,1259300,11233888,12.63
9849876,9996239,3412,1194200,11190439,11.95
9849877,3408927,864,302400,3711327,8.87
9849878,9978264,3949,1382150,11360414,13.85
9849879,9980996,4448,1556800,11537796,15.60
9849880,9002561,1984,694400,9696961,7.71
9849881,3774158,2441,854350,4628508,22.64
9849882,9983365,1612,564200,10547565,5.65
9849883,9990252,2978,1042300,11032552,10.43
9849884,9991987,3378,1182300,11174287,11.83
9849885,9969323,2389,836150,10805473,8.39
9849886,9989015,2779,972650,10961665,9.74
9849887,9985502,3958,1385300,11370802,13.87
9849888,9969429,2174,760900,10730329,7.63
9849889,9985643,2942,1029700,11015343,10.31
9849890,9960922,2128,744800,10705722,7.48
9849891,9961836,4836,1692600,11654436,16.99
9849892,9953387,2667,933450,10886837,9.38
9849893,9957676,1899,664650,10622326,6.67
9849894,9951581,5654,1978900,11930481,19.89
9849895,9945983,1655,579250,10525233,5.82
9849896,9965075,3892,1362200,11327275,13.67
9849897,9978496,4095,1433250,11411746,14.36
9849898,9965974,2464,862400,10828374,8.65
9849899,9989987,1252,438200,10428187,4.39
9849900,9985146,4024,1408400,11393546,14.10
9849901,9989282,2230,780500,10769782,7.81
9849902,9997152,4532,1586200,11583352,15.87
9849903,9993992,3688,1290800,11284792,12.92
9849904,9987465,3883,1359050,11346515,13.61
9849905,9972513,5165,1807750,11780263,18.13
9849906,4934189,878,307300,5241489,6.23
9849907,9948678,2508,877800,10826478,8.82
9849908,9967680,3387,1185450,11153130,11.89
9849909,2854856,699,244650,3099506,8.57
9849910,9968849,2825,988750,10957599,9.92
9849911,9959561,3793,1327550,11287111,13.33
9849912,9955543,4152,1453200,11408743,14.60
9849913,9981899,4447,1556450,11538349,15.59
9849914,283462,171,59850,343312,21.11
9849915,9974805,3022,1057700,11032505,10.60
9849916,9980573,3935,1377250,11357823,13.80
9849917,9980354,4292,1502200,11482554,15.05
9849918,9984635,5670,1984500,11969135,19.88
9849919,9985433,3769,1319150,11304583,13.21
9849920,9991463,3850,1347500,11338963,13.49
9849921,2026237,642,224700,2250937,11.09
9849922,9996892,3844,1345400,11342292,13.46
9849923,8300235,3245,1135750,9435985,13.68
9849924,9970309,2901,1015350,10985659,10.18
9849925,9973241,3472,1215200,11188441,12.18
9849926,2456422,709,248150,2704572,10.10
9849927,5490593,2443,855050,6345643,15.57
9849928,9990917,3408,1192800,11183717,11.94
9849929,9985878,3854,1348900,11334778,13.51
9849930,9982456,1267,443450,10425906,4.44
9849931,9991857,3817,1335950,11327807,13.37
9849932,9990680,3081,1078350,11069030,10.79
9849933,9970811,2337,817950,10788761,8.20
9849934,9972336,2172,760200,10732536,7.62
9849935,9953138,3173,1110550,11063688,11.16
9849936,9989934,2136,747600,10737534,7.48
9849937,9979814,4631,1620850,11600664,16.24
9849938,9990939,3435,1202250,11193189,12.03
9849939,9986365,2967,1038450,11024815,10.40
9849940,9959700,3910,1368500,11328200,13.74
9849941,9974318,1278,447300,10421618,4.48
9849942,1945186,1454,508900,2454086,26.16
9849943,9800437,4574,1600900,11401337,16.33
9849944,9974364,1543,540050,10514414,5.41
9849945,9979926,338,118300,10098226,1.19
9849946,9984140,1550,542500,10526640,5.43
9849947,8702577,2372,830200,9532777,9.54
9849948,9985348,2478,867300,10852648,8.69
9849949,9985820,3460,1211000,11196820,12.13
9849950,9974769,4174,1460900,11435669,14.65
9849951,9976198,2905,1016750,10992948,10.19
9849952,900685,294,102900,1003585,11.42
9849953,9992781,4115,1440250,11433031,14.41
9849954,9979287,3425,1198750,11178037,12.01
9849955,9974381,3347,1171450,11145831,11.74
9849956,9980519,2419,846650,10827169,8.48
9849957,9975866,2952,1033200,11009066,10.36
9849958,9991532,1051,367850,10359382,3.68
9849959,9983956,2859,1000650,10984606,10.02
9849960,9987042,2622,917700,10904742,9.19
9849961,9994962,2134,746900,10741862,7.47
9849962,9989456,3271,1144850,11134306,11.46
9849963,9991377,3311,1158850,11150227,11.60
9849964,9978836,1272,445200,10424036,4.46
9849965,9979990,3385,1184750,11164740,11.87
9849966,9954158,3361,1176350,11130508,11.82
9849967,9979498,3638,1273300,11252798,12.76
9849968,9986314,4133,1446550,11432864,14.49
9849969,9988648,6626,2319100,12307748,23.22
9849970,9974779,3074,1075900,11050679,10.79
9849971,9973950,1886,660100,10634050,6.62
9849973,2212750,1732,606200,2818950,27.40
9849974,9977214,3841,1344350,11321564,13.47
9849975,9982202,3428,1199800,11182002,12.02
9849976,2040099,873,305550,2345649,14.98
9849977,9970394,3108,1087800,11058194,10.91
9849978,9964504,2762,966700,10931204,9.70
9849979,9969121,1066,373100,10342221,3.74
9849980,9965781,3075,1076250,11042031,10.80
9849981,9916916,2392,837200,10754116,8.44
9849982,9995526,1608,562800,10558326,5.63
9849983,9972574,985,344750,10317324,3.46
9849984,2348759,805,281750,2630509,12.00
9849985,4969631,1758,615300,5584931,12.38
9849986,9969906,4211,1473850,11443756,14.78
9849987,9968182,4335,1517250,11485432,15.22
9849988,9943607,3072,1075200,11018807,10.81
9849989,9950224,5213,1824550,11774774,18.34
9849990,9947180,4131,1445850,11393030,14.54
9849991,9953303,3308,1157800,11111103,11.63
9849992,9973902,3460,1211000,11184902,12.14
9849993,9983326,2531,885850,10869176,8.87
9849994,9991273,3516,1230600,11221873,12.32
9849995,9992748,782,273700,10266448,2.74
9849996,9986596,2254,788900,10775496,7.90
9849997,9981917,1563,547050,10528967,5.48
9849998,4138680,558,195300,4333980,4.72
9849999,9969946,4065,1422750,11392696,14.27
9850000,4425051,1109,388150,4813201,8.77
9850001,9969412,3743,1310050,11279462,13.14
9850002,1796573,725,253750,2050323,14.12
9850003,9948486,3794,1327900,11276386,13.35
9850004,9954959,3686,1290100,11245059,12.96
9850005,7879816,1664,582400,8462216,7.39
9850006,9967302,3334,1166900,11134202,11.71
9850007,9972282,2368,828800,10801082,8.31
9850008,892137,199,69650,961787,7.81
9850009,9954033,1910,668500,10622533,6.72
9850010,9964919,3212,1124200,11089119,11.28
9850012,9982402,5513,1929550,11911952,19.33
9850013,9980193,3773,1320550,11300743,13.23
9850015,8699666,4218,1476300,10175966,16.97
9850016,9982799,4380,1533000,11515799,15.36
9850017,1857395,609,213150,2070545,11.48
9850018,9983017,3363,1177050,11160067,11.79
9850019,9971414,3536,1237600,11209014,12.41
9850020,5328187,3792,1327200,6655387,24.91
9850021,3420040,1131,395850,3815890,11.57
9850022,9965111,3438,1203300,11168411,12.08
9850023,9963376,2100,735000,10698376,7.38
9850024,9971480,3457,1209950,11181430,12.13
9850025,9983027,3291,1151850,11134877,11.54
9850026,9975819,2279,797650,10773469,8.00
9850027,9989067,4444,1555400,11544467,15.57
9850028,9992258,4140,1449000,11441258,14.50
9850030,9998200,1561,546350,10544550,5.46
9850031,9979462,3468,1213800,11193262,12.16
9850032,9971484,4311,1508850,11480334,15.13
9850033,9989775,2506,877100,10866875,8.78
9850034,9996413,3739,1308650,11305063,13.09
9850035,9971828,1765,617750,10589578,6.19
9850036,9960154,2287,800450,10760604,8.04
9850037,9821928,3569,1249150,11071078,12.72
9850038,9588274,4040,1414000,11002274,14.75
9850039,787076,446,156100,943176,19.83
9850040,9950420,4763,1667050,11617470,16.75
9850041,9928135,3938,1378300,11306435,13.88
9850042,9967557,4522,1582700,11550257,15.88
9850043,9052960,2382,833700,9886660,9.21
9850044,9977674,2842,994700,10972374,9.97
9850045,9483370,4286,1500100,10983470,15.82
9850046,9973104,3597,1258950,11232054,12.62
9850047,9976926,3504,1226400,11203326,12.29
9850048,9983928,3930,1375500,11359428,13.78
9850049,3546591,1982,693700,4240291,19.56
9850050,9966488,5281,1848350,11814838,18.55
9850051,9962293,2863,1002050,10964343,10.06
9850052,9978015,4062,1421700,11399715,14.25
9850053,9995287,2594,907900,10903187,9.08
9850054,9993729,2472,865200,10858929,8.66
9850055,9337887,2710,948500,10286387,10.16
9850056,9975659,3065,1072750,11048409,10.75
9850057,9988075,3037,1062950,11051025,10.64
9850058,9891510,2006,702100,10593610,7.10
9850059,9978561,4468,1563800,11542361,15.67
9850060,9989007,1760,616000,10605007,6.17
9850061,6502984,2069,724150,7227134,11.14
9850062,9988942,3241,1134350,11123292,11.36
9850064,626220,98,34300,660520,5.48
9850065,9973572,2481,868350,10841922,8.71
9850066,9961842,2711,948850,10910692,9.52
9850067,9968993,3017,1055950,11024943,10.59
9850068,9951379,3128,1094800,11046179,11.00
9850069,9974077,3389,1186150,11160227,11.89
9850070,9980319,4503,1576050,11556369,15.79
9850071,411063,82,28700,439763,6.98
9850072,9960460,2817,985950,10946410,9.90
9850073,2417317,881,308350,2725667,12.76
9850074,9946416,2966,1038100,10984516,10.44
9850075,9945097,3809,1333150,11278247,13.41
9850076,9958634,3444,1205400,11164034,12.10
9850077,9960434,1922,672700,10633134,6.75
9850078,9950417,2693,942550,10892967,9.47
9850079,6350875,4557,1594950,7945825,25.11
9850080,9958331,3922,1372700,11331031,13.78
9850081,9961511,2329,815150,10776661,8.18
9850082,9962420,2361,826350,10788770,8.29
9850083,9974064,3313,1159550,11133614,11.63
9850084,9632540,3639,1273650,10906190,13.22
9850085,9981362,3946,1381100,11362462,13.84
9850086,9952618,1341,469350,10421968,4.72
9850087,9980708,2922,1022700,11003408,10.25
9850088,9979624,4435,1552250,11531874,15.55
9850089,9987409,3337,1167950,11155359,11.69
9850090,9081945,2267,793450,9875395,8.74
9850091,9982806,3298,1154300,11137106,11.56
9850092,9999655,3381,1183350,11183005,11.83
9850093,9989885,2919,1021650,11011535,10.23
9850094,9988776,4468,1563800,11552576,15.66
9850096,9956912,3323,1163050,11119962,11.68
9850097,8262759,1606,562100,8824859,6.80
9850098,9923502,2184,764400,10687902,7.70
9850099,9955901,4714,1649900,11605801,16.57
9850100,9972282,2023,708050,10680332,7.10
9850101,9966749,3334,1166900,11133649,11.71
9850102,9978938,1940,679000,10657938,6.80
9850104,9984835,3186,1115100,11099935,11.17
9850105,9931315,2770,969500,10900815,9.76
9850106,9986025,3180,1113000,11099025,11.15
9850107,9997843,4251,1487850,11485693,14.88
9850108,9982551,3289,1151150,11133701,11.53
9850109,9974903,3951,1382850,11357753,13.86
9850110,621947,215,75250,697197,12.10
9850111,9973282,4957,1734950,11708232,17.40
9850112,1575779,735,257250,1833029,16.33
9850113,9951674,2767,968450,10920124,9.73
9850114,9991170,1325,463750,10454920,4.64
9850115,9969794,2787,975450,10945244,9.78
9850117,9980761,3743,1310050,11290811,13.13
9850118,9978297,1693,592550,10570847,5.94
9850119,9975588,3716,1300600,11276188,13.04
9850120,7763189,2564,897400,8660589,11.56
9850121,9982554,3047,1066450,11049004,10.68
9850122,9997271,3781,1323350,11320621,13.24
9850123,9972505,2661,931350,10903855,9.34
9850124,9984155,2969,1039150,11023305,10.41
9850125,9991270,2656,929600,10920870,9.30
9850126,9980664,3348,1171800,11152464,11.74
9850128,9980836,2512,879200,10860036,8.81
9850129,9979455,3597,1258950,11238405,12.62
9850131,2267076,1309,458150,2725226,20.21
9850132,9935414,3993,1397550,11332964,14.07
9850133,9978753,1934,676900,10655653,6.78
9850134,9981723,3384,1184400,11166123,11.87
9850135,9977553,4027,1409450,11387003,14.13
9850136,9974887,1275,446250,10421137,4.47
9850137,9977893,2440,854000,10831893,8.56
9850138,9986578,1957,684950,10671528,6.86
9850139,7347168,4828,1689800,9036968,23.00
9850140,1333184,357,124950,1458134,9.37
9850141,9974799,5686,1990100,11964899,19.95
9850142,9979479,3991,1396850,11376329,14.00
9850143,9980255,4745,1660750,11641005,16.64
9850144,9979807,1857,649950,10629757,6.51
9850145,9995323,855,299250,10294573,2.99
9850146,9984838,2152,753200,10738038,7.54
9850147,9968842,1222,427700,10396542,4.29
9850148,9985866,3031,1060850,11046716,10.62
9850149,9977857,2275,796250,10774107,7.98
9850150,9998743,314,109900,10108643,1.10
9850151,9965318,3916,1370600,11335918,13.75
9850152,9984252,2465,862750,10847002,8.64
9850153,9991489,795,278250,10269739,2.78
9850154,9983055,3795,1328250,11311305,13.31
9850156,9975802,3581,1253350,11229152,12.56
9850157,1107111,335,117250,1224361,10.59
9850158,9791574,4155,1454250,11245824,14.85
9850160,9958637,5041,1764350,11722987,17.72
9850161,1865160,930,325500,2190660,17.45
9850162,1678268,1134,396900,2075168,23.65
9850163,9963748,1545,540750,10504498,5.43
9850164,9959443,4460,1561000,11520443,15.67
9850165,9948945,4645,1625750,11574695,16.34
9850166,9952135,1458,510300,10462435,5.13
9850167,9950196,5555,1944250,11894446,19.54
9850169,9928496,4673,1635550,11564046,16.47
9850170,9913890,3269,1144150,11058040,11.54
9850171,9932561,4004,1401400,11333961,14.11
9850172,9926679,1799,629650,10556329,6.34
9850173,9930152,3499,1224650,11154802,12.33
9850174,9899194,1736,607600,10506794,6.14
9850175,9720905,1391,486850,10207755,5.01
9850176,9946860,1040,364000,10310860,3.66
9850177,9955436,2885,1009750,10965186,10.14
9850178,5197967,2369,829150,6027117,15.95
9850179,9950191,6477,2266950,12217141,22.78
9850180,9958007,4935,1727250,11685257,17.35
9850181,9961555,813,284550,10246105,2.86
9850182,9961428,3074,1075900,11037328,10.80
9850183,9968751,884,309400,10278151,3.10
9850184,9977488,1817,635950,10613438,6.37
9850186,9978133,1512,529200,10507333,5.30
9850187,9986748,3195,1118250,11104998,11.20
9850188,9882018,4885,1709750,11591768,17.30
9850189,9969142,2840,994000,10963142,9.97
9850190,3464644,842,294700,3759344,8.51
9850191,9968275,3808,1332800,11301075,13.37
9850192,1601211,354,123900,1725111,7.74
9850193,9971353,2029,710150,10681503,7.12
9850194,9975910,651,227850,10203760,2.28
9850195,9986763,3447,1206450,11193213,12.08
9850196,98930,54,18900,117830,19.10
9850197,9951703,6554,2293900,12245603,23.05
9850198,4908913,2406,842100,5751013,17.15
9850199,920688,505,176750,1097438,19.20
9850200,4829983,2805,981750,5811733,20.33
9850201,9935226,4311,1508850,11444076,15.19
9850202,9937760,4672,1635200,11572960,16.45
9850203,8954982,3220,1127000,10081982,12.59
9850204,5059173,2027,709450,5768623,14.02
9850205,9947995,5053,1768550,11716545,17.78
9850206,9931229,2515,880250,10811479,8.86
9850207,9945699,2459,860650,10806349,8.65
9850208,9955801,1938,678300,10634101,6.81
9850209,3062798,1784,624400,3687198,20.39
9850210,5165472,2108,737800,5903272,14.28
9850211,9955659,2155,754250,10709909,7.58
9850212,9954651,4050,1417500,11372151,14.24
9850213,9938854,1842,644700,10583554,6.49
9850214,4363074,539,188650,4551724,4.32
9850215,9985942,2609,913150,10899092,9.14
9850216,9967563,4138,1448300,11415863,14.53
9850217,9984857,3831,1340850,11325707,13.43
9850218,7876949,2893,1012550,8889499,12.85
9850219,9983625,3924,1373400,11357025,13.76
9850220,9989458,2912,1019200,11008658,10.20
9850221,9984228,4063,1422050,11406278,14.24
9850222,3379322,1416,495600,3874922,14.67
9850223,5269257,970,339500,5608757,6.44
9850224,9961851,6253,2188550,12150401,21.97
9850226,9903765,3954,1383900,11287665,13.97
9850227,3534017,3054,1068900,4602917,30.25
9850228,2124924,615,215250,2340174,10.13
9850229,9941783,3037,1062950,11004733,10.69
9850230,4573443,681,238350,4811793,5.21
9850231,9478165,3768,1318800,10796965,13.91
9850232,9438312,4884,1709400,11147712,18.11
9850233,1911724,572,200200,2111924,10.47
9850234,9953160,3465,1212750,11165910,12.18
9850235,6469257,2534,886900,7356157,13.71
9850236,9927651,3094,1082900,11010551,10.91
9850237,9945368,3529,1235150,11180518,12.42
9850238,9945076,2006,702100,10647176,7.06
9850239,9963145,1900,665000,10628145,6.67
9850242,9944547,2536,887600,10832147,8.93
9850243,9961473,3007,1052450,11013923,10.57
9850244,9962517,4775,1671250,11633767,16.78
9850245,1019250,511,178850,1198100,17.55
9850246,9978583,3959,1385650,11364233,13.89
9850247,9983442,2493,872550,10855992,8.74
9850248,9826083,5487,1920450,11746533,19.54
9850249,5532662,1470,514500,6047162,9.30
9850250,9919669,3149,1102150,11021819,11.11
9850252,9631159,6132,2146200,11777359,22.28
9850253,9627730,4047,1416450,11044180,14.71
9850254,2221493,794,277900,2499393,12.51
9850255,9973751,2271,794850,10768601,7.97
9850256,9986464,3224,1128400,11114864,11.30
9850257,9978376,3485,1219750,11198126,12.22
9850258,2282969,1006,352100,2635069,15.42
9850259,9996305,2105,736750,10733055,7.37
9850260,1256113,472,165200,1421313,13.15
9850262,9984666,3199,1119650,11104316,11.21
9850263,107941,90,31500,139441,29.18
9850264,9987862,2484,869400,10857262,8.70
9850265,9987450,650,227500,10214950,2.28
9850266,9979065,1015,355250,10334315,3.56
9850268,9971917,2852,998200,10970117,10.01
9850269,9980814,673,235550,10216364,2.36
9850270,9976442,3206,1122100,11098542,11.25
9850271,3667155,1305,456750,4123905,12.46
9850272,9987155,1966,688100,10675255,6.89
9850273,9999327,4558,1595300,11594627,15.95
9850274,9986194,4130,1445500,11431694,14.47
9850275,9995034,4334,1516900,11511934,15.18
9850276,9995580,3680,1288000,11283580,12.89
9850277,9987568,3928,1374800,11362368,13.77
9850278,9984680,4404,1541400,11526080,15.44
9850279,9971516,2781,973350,10944866,9.76
9850280,9993613,4157,1454950,11448563,14.56
9850281,9992997,3340,1169000,11161997,11.70
9850282,9962416,1969,689150,10651566,6.92
9850283,1705479,902,315700,2021179,18.51
9850284,9971297,4138,1448300,11419597,14.52
9850285,9969784,4449,1557150,11526934,15.62
9850286,9974582,3810,1333500,11308082,13.37
9850287,495042,126,44100,539142,8.91
9850288,9955946,3223,1128050,11083996,11.33
9850289,4263796,1274,445900,4709696,10.46
9850290,9954359,2443,855050,10809409,8.59
9850291,9966583,3881,1358350,11324933,13.63
9850292,9950873,1690,591500,10542373,5.94
9850293,9946089,4321,1512350,11458439,15.21
9850294,9917809,3977,1391950,11309759,14.03
9850295,9963811,1702,595700,10559511,5.98
9850296,9529476,3617,1265950,10795426,13.28
9850297,9971131,6154,2153900,12125031,21.60
9850298,9946016,2272,795200,10741216,8.00
9850299,9966220,880,308000,10274220,3.09
9850300,2924200,795,278250,3202450,9.52
9850301,9957293,1230,430500,10387793,4.32
9850302,9936361,3493,1222550,11158911,12.30
9850303,9922003,3520,1232000,11154003,12.42
9850304,9946001,3752,1313200,11259201,13.20
9850305,8795825,1712,599200,9395025,6.81
9850306,9963915,3459,1210650,11174565,12.15
9850308,9960652,2887,1010450,10971102,10.14
9850309,9467856,3529,1235150,10703006,13.05
9850310,9968753,2827,989450,10958203,9.93
9850311,9972820,2603,911050,10883870,9.14
9850312,9958838,593,207550,10166388,2.08
9850313,9975437,713,249550,10224987,2.50
9850314,1544987,772,270200,1815187,17.49
9850315,9949764,2468,863800,10813564,8.68
9850316,9957970,5182,1813700,11771670,18.21
9850317,9959716,3673,1285550,11245266,12.91
9850318,9967124,2323,813050,10780174,8.16
9850319,9918886,3267,1143450,11062336,11.53
9850320,9987854,2967,1038450,11026304,10.40
9850321,9972598,4176,1461600,11434198,14.66
9850322,9979255,4659,1630650,11609905,16.34
9850323,9982882,3142,1099700,11082582,11.02
9850324,9979914,3571,1249850,11229764,12.52
9850325,9983622,1431,500850,10484472,5.02
9850326,2076995,920,322000,2398995,15.50
9850327,9965655,2772,970200,10935855,9.74
9850328,2775537,974,340900,3116437,12.28
9850329,277621,65,22750,300371,8.19
9850330,9982607,1993,697550,10680157,6.99
9850331,9982021,2795,978250,10960271,9.80
9850332,9973389,612,214200,10187589,2.15
9850333,9987604,5459,1910650,11898254,19.13
9850334,9997294,3134,1096900,11094194,10.97
9850335,9990548,2211,773850,10764398,7.75
9850336,9972772,3107,1087450,11060222,10.90
9850337,9972895,2914,1019900,10992795,10.23
9850338,9996761,3441,1204350,11201111,12.05
9850339,9987314,2017,705950,10693264,7.07
9850341,9962740,2806,982100,10944840,9.86
9850342,9969304,1558,545300,10514604,5.47
9850343,9970060,795,278250,10248310,2.79
9850344,9982943,1637,572950,10555893,5.74
9850345,9974590,847,296450,10271040,2.97
9850346,7835412,2659,930650,8766062,11.88
9850347,9960795,4440,1554000,11514795,15.60
9850348,8949792,3807,1332450,10282242,14.89
9850349,9973910,4031,1410850,11384760,14.15
9850350,9898338,4620,1617000,11515338,16.34
9850351,9975568,1805,631750,10607318,6.33
9850352,9909944,3954,1383900,11293844,13.96
9850353,9970278,709,248150,10218428,2.49
9850354,1902929,203,71050,1973979,3.73
9850355,9948723,3314,1159900,11108623,11.66
9850357,9963990,4243,1485050,11449040,14.90
9850358,9966965,5045,1765750,11732715,17.72
9850359,9969846,3802,1330700,11300546,13.35
9850360,9977367,3939,1378650,11356017,13.82
9850362,9974932,4569,1599150,11574082,16.03
9850363,9978444,5024,1758400,11736844,17.62
9850364,9985521,3695,1293250,11278771,12.95
9850365,1531200,873,305550,1836750,19.95
9850366,9977444,3160,1106000,11083444,11.09
9850367,9976078,1863,652050,10628128,6.54
9850368,9957788,1880,658000,10615788,6.61
9850369,1234469,317,110950,1345419,8.99
9850370,9906983,2043,715050,10622033,7.22
9850371,9996676,4384,1534400,11531076,15.35
9850372,9976790,1757,614950,10591740,6.16
9850373,540498,178,62300,602798,11.53
9850374,9954554,3639,1273650,11228204,12.79
9850375,9961866,2383,834050,10795916,8.37
9850376,9971163,6422,2247700,12218863,22.54
9850377,3842765,1741,609350,4452115,15.86
9850378,4599800,1355,474250,5074050,10.31
9850379,9972780,4882,1708700,11681480,17.13
9850380,9978522,3941,1379350,11357872,13.82
9850381,3262399,787,275450,3537849,8.44
9850382,9984464,2779,972650,10957114,9.74
9850383,2702318,926,324100,3026418,11.99
9850384,9979736,2398,839300,10819036,8.41
9850385,9989663,4450,1557500,11547163,15.59
9850386,9991266,2647,926450,10917716,9.27
9850387,9979037,3751,1312850,11291887,13.16
9850388,9984064,4023,1408050,11392114,14.10
9850389,9993818,3510,1228500,11222318,12.29
9850390,9981773,3767,1318450,11300223,13.21
9850391,9983130,4161,1456350,11439480,14.59
9850392,9982177,2768,968800,10950977,9.71
9850393,9985880,3116,1090600,11076480,10.92
9850394,9997809,3895,1363250,11361059,13.64
9850395,6619114,1899,664650,7283764,10.04
9850396,9974919,3991,1396850,11371769,14.00
9850397,9987103,3243,1135050,11122153,11.37
9850398,1434461,1037,362950,1797411,25.30
9850399,9975586,3845,1345750,11321336,13.49
9850400,9982480,4735,1657250,11639730,16.60
9850401,9978715,2259,790650,10769365,7.92
9850402,9992788,3539,1238650,11231438,12.40
9850403,9983545,2559,895650,10879195,8.97
9850404,9980327,3555,1244250,11224577,12.47
9850405,266727,240,84000,350727,31.49
9850406,607872,403,141050,748922,23.20
9850407,9974033,2993,1047550,11021583,10.50
9850408,9985888,4146,1451100,11436988,14.53
9850409,9979523,1309,458150,10437673,4.59
9850410,9998958,1973,690550,10689508,6.91
9850411,9985298,1207,422450,10407748,4.23
9850412,9982589,3690,1291500,11274089,12.94
9850413,328348,117,40950,369298,12.47
9850414,335317,223,78050,413367,23.28
9850415,955718,291,101850,1057568,10.66
9850416,9963754,4175,1461250,11425004,14.67
9850417,9978916,3167,1108450,11087366,11.11
9850418,9964298,3583,1254050,11218348,12.59
9850419,9971281,4758,1665300,11636581,16.70
9850420,9969375,1379,482650,10452025,4.84
9850421,9975112,387,135450,10110562,1.36
9850422,9989170,2386,835100,10824270,8.36
9850423,9995455,4084,1429400,11424855,14.30
9850424,9970134,3161,1106350,11076484,11.10
9850425,9976045,736,257600,10233645,2.58
9850426,9979941,1333,466550,10446491,4.67
9850428,9989834,1127,394450,10384284,3.95
9850429,9991189,2119,741650,10732839,7.42
9850430,9965125,955,334250,10299375,3.35
9850431,3561538,1322,462700,4024238,12.99
9850432,1845140,705,246750,2091890,13.37
9850433,1391425,459,160650,1552075,11.55
9850434,1429304,685,239750,1669054,16.77
9850435,9948678,1965,687750,10636428,6.91
9850436,844787,254,88900,933687,10.52
9850437,9937027,2408,842800,10779827,8.48
9850438,303628,124,43400,347028,14.29
9850439,9914350,956,334600,10248950,3.37
9850440,9909771,1714,599900,10509671,6.05
9850441,9921134,2358,825300,10746434,8.32
9850442,9926248,1057,369950,10296198,3.73
9850444,9927655,2071,724850,10652505,7.30
9850445,9925176,775,271250,10196426,2.73
9850446,9933022,2731,955850,10888872,9.62
9850447,242672,162,56700,299372,23.36
9850448,9872659,3699,1294650,11167309,13.11
9850449,9971173,2649,927150,10898323,9.30
9850450,9977335,3020,1057000,11034335,10.59
9850451,9984270,4817,1685950,11670220,16.89
9850452,9996544,4401,1540350,11536894,15.41
9850453,9900469,3824,1338400,11238869,13.52
9850454,9963852,2728,954800,10918652,9.58
9850455,9978988,3425,1198750,11177738,12.01
9850456,9976413,3699,1294650,11271063,12.98
9850457,9987537,2483,869050,10856587,8.70
9850459,9986632,3837,1342950,11329582,13.45
9850460,9980565,4093,1432550,11413115,14.35
9850461,5972171,1717,600950,6573121,10.06
9850462,9986483,3880,1358000,11344483,13.60
9850463,9988456,1815,635250,10623706,6.36
9850464,7112755,1487,520450,7633205,7.32
9850465,9976878,4004,1401400,11378278,14.05
9850466,9964588,5646,1976100,11940688,19.83
9850467,9953897,4435,1552250,11506147,15.59
9850468,1912245,386,135100,2047345,7.06
9850469,9969043,5318,1861300,11830343,18.67
9850470,855067,375,131250,986317,15.35
9850471,3203797,2278,797300,4001097,24.89
9850472,2143180,987,345450,2488630,16.12
9850473,9947885,4003,1401050,11348935,14.08
9850474,9950035,4876,1706600,11656635,17.15
9850475,9945707,1990,696500,10642207,7.00
9850476,9959317,2687,940450,10899767,9.44
9850477,6151684,1484,519400,6671084,8.44
9850478,9950031,5397,1888950,11838981,18.98
9850479,6357713,2421,847350,7205063,13.33
9850480,4072886,1306,457100,4529986,11.22
9850481,9809363,3991,1396850,11206213,14.24
9850482,9748441,4025,1408750,11157191,14.45
9850483,2273273,773,270550,2543823,11.90
9850484,9936020,3709,1298150,11234170,13.07
9850485,9958458,3218,1126300,11084758,11.31
9850486,9952831,3068,1073800,11026631,10.79
9850487,449227,148,51800,501027,11.53
9850488,9947447,3523,1233050,11180497,12.40
9850489,9956539,3101,1085350,11041889,10.90
9850491,723291,366,128100,851391,17.71
9850492,9934907,2340,819000,10753907,8.24
9850493,9925255,2908,1017800,10943055,10.25
9850494,9935453,3785,1324750,11260203,13.33
9850495,9941080,5228,1829800,11770880,18.41
9850496,9919973,2934,1026900,10946873,10.35
9850497,9939148,4484,1569400,11508548,15.79
9850498,9947599,6360,2226000,12173599,22.38
9850499,9949836,3701,1295350,11245186,13.02
9850500,9959012,3154,1103900,11062912,11.08
9850501,9957761,2876,1006600,10964361,10.11
9850502,9963995,1336,467600,10431595,4.69
9850503,325892,128,44800,370692,13.75
9850504,3936158,1062,371700,4307858,9.44
9850505,9992159,4198,1469300,11461459,14.70
9850506,377723,199,69650,447373,18.44
9850507,9985836,4214,1474900,11460736,14.77
9850508,9958882,1288,450800,10409682,4.53
9850509,2424835,1243,435050,2859885,17.94
9850510,9965367,3992,1397200,11362567,14.02
9850511,9982856,1861,651350,10634206,6.52
9850512,9979937,3312,1159200,11139137,11.62
9850513,779195,762,266700,1045895,34.23
9850514,1078850,1136,397600,1476450,36.85
9850515,9985447,2016,705600,10691047,7.07
9850516,9993355,4254,1488900,11482255,14.90
9850517,9991226,3681,1288350,11279576,12.89
9850518,9995582,2885,1009750,11005332,10.10
9850519,9637265,2657,929950,10567215,9.65
9850520,9962135,3971,1389850,11351985,13.95
9850521,9965573,3703,1296050,11261623,13.01
9850522,9982425,4872,1705200,11687625,17.08
9850523,1635477,466,163100,1798577,9.97
9850524,9968683,3995,1398250,11366933,14.03
9850525,9972171,1841,644350,10616521,6.46
9850526,9967583,5600,1960000,11927583,19.66
9850527,9963796,2187,765450,10729246,7.68
9850528,9960216,2306,807100,10767316,8.10
9850529,7174220,1460,511000,7685220,7.12
9850530,9988873,3902,1365700,11354573,13.67
9850531,9925879,2605,911750,10837629,9.19
9850532,9978802,4350,1522500,11501302,15.26
9850533,9993822,3796,1328600,11322422,13.29
9850534,9975736,5018,1756300,11732036,17.61
9850535,9983900,3717,1300950,11284850,13.03
9850536,9980209,4917,1720950,11701159,17.24
9850537,763817,299,104650,868467,13.70
9850538,9992118,3686,1290100,11282218,12.91
9850539,9996726,4565,1597750,11594476,15.98
9850540,9992391,2011,703850,10696241,7.04
9850541,959331,1030,360500,1319831,37.58
9850542,9976876,3387,1185450,11162326,11.88
9850543,9971081,6070,2124500,12095581,21.31
9850544,9977149,4104,1436400,11413549,14.40
9850545,9982639,1133,396550,10379189,3.97
9850546,9977535,1012,354200,10331735,3.55
9850547,9978906,3541,1239350,11218256,12.42
9850548,9980355,1441,504350,10484705,5.05
9850549,9987058,384,134400,10121458,1.35
9850550,9992094,514,179900,10171994,1.80
9850551,9990213,4136,1447600,11437813,14.49
9850552,9983026,4339,1518650,11501676,15.21
9850553,9988859,4587,1605450,11594309,16.07
9850554,9953316,5717,2000950,11954266,20.10
9850555,9972015,4700,1645000,11617015,16.50
9850556,9630962,4867,1703450,11334412,17.69
9850557,9988857,3613,1264550,11253407,12.66
9850558,2850569,966,338100,3188669,11.86
9850559,414697,184,64400,479097,15.53
9850560,9970449,3356,1174600,11145049,11.78
9850561,9989733,5849,2047150,12036883,20.49
9850562,9992451,2165,757750,10750201,7.58
9850563,9987611,3679,1287650,11275261,12.89
9850564,833668,288,100800,934468,12.09
9850565,9985950,1330,465500,10451450,4.66
9850566,4699462,2448,856800,5556262,18.23
9850567,9973285,4500,1575000,11548285,15.79
9850568,9991102,6368,2228800,12219902,22.31
9850569,9979623,1752,613200,10592823,6.14
9850570,9989579,1684,589400,10578979,5.90
9850571,9992269,789,276150,10268419,2.76
9850572,9988220,2151,752850,10741070,7.54
9850573,1215524,194,67900,1283424,5.59
9850574,9963354,1484,519400,10482754,5.21
9850575,9973683,4087,1430450,11404133,14.34
9850576,9951160,3971,1389850,11341010,13.97
9850577,9948299,1029,360150,10308449,3.62
9850578,9948849,3527,1234450,11183299,12.41
9850581,9920820,3907,1367450,11288270,13.78
9850582,5352792,1999,699650,6052442,13.07
9850583,9921383,4378,1532300,11453683,15.44
9850584,9935355,2189,766150,10701505,7.71
9850585,9918513,1449,507150,10425663,5.11
9850586,9930126,2033,711550,10641676,7.17
9850587,9941441,3207,1122450,11063891,11.29
9850588,9946832,2665,932750,10879582,9.38
9850589,207405,182,63700,271105,30.71
9850590,9935817,1880,658000,10593817,6.62
9850591,9963316,3545,1240750,11204066,12.45
9850592,9967416,1374,480900,10448316,4.82
9850593,6519916,1979,692650,7212566,10.62
9850594,9940147,3214,1124900,11065047,11.32
9850595,9950427,4290,1501500,11451927,15.09
9850596,9941893,3658,1280300,11222193,12.88
9850597,9959146,5258,1840300,11799446,18.48
9850599,9931957,3576,1251600,11183557,12.60
9850600,9944513,3108,1087800,11032313,10.94
9850601,9957440,2620,917000,10874440,9.21
9850602,9943447,4423,1548050,11491497,15.57
9850603,4761865,1462,511700,5273565,10.75
9850604,9939631,3808,1332800,11272431,13.41
9850605,9922153,2637,922950,10845103,9.30
9850606,9904110,4212,1474200,11378310,14.88
9850607,9915384,2700,945000,10860384,9.53
9850608,3877331,2394,837900,4715231,21.61
9850609,9938542,4928,1724800,11663342,17.35
9850610,9948356,2170,759500,10707856,7.63
9850611,9956463,4861,1701350,11657813,17.09
9850612,9959965,3522,1232700,11192665,12.38
9850613,9973500,4099,1434650,11408150,14.38
9850614,9983520,2876,1006600,10990120,10.08
9850615,108642,63,22050,130692,20.30
9850616,9988264,2426,849100,10837364,8.50
9850618,9970616,4278,1497300,11467916,15.02
9850619,9956676,2733,956550,10913226,9.61
9850620,9945490,1587,555450,10500940,5.58
9850621,9987451,1978,692300,10679751,6.93
9850622,9993501,4513,1579550,11573051,15.81
9850623,9976119,4858,1700300,11676419,17.04
9850624,9993307,4503,1576050,11569357,15.77
9850625,9981518,4646,1626100,11607618,16.29
9850626,9985741,1904,666400,10652141,6.67
9850627,9989916,3107,1087450,11077366,10.89
9850628,9992476,3892,1362200,11354676,13.63
9850629,9970587,4082,1428700,11399287,14.33
9850630,9970337,4384,1534400,11504737,15.39
9850631,9960790,4111,1438850,11399640,14.45
9850632,6839150,4328,1514800,8353950,22.15
9850633,9949252,5105,1786750,11736002,17.96
9850634,9951407,3038,1063300,11014707,10.68
9850635,9942362,3258,1140300,11082662,11.47
9850636,9921888,4859,1700650,11622538,17.14
9850637,87048,33,11550,98598,13.27
9850638,9937637,2872,1005200,10942837,10.12
9850639,3075887,1208,422800,3498687,13.75
9850640,1204594,335,117250,1321844,9.73
9850641,9975686,1720,602000,10577686,6.03
9850642,9974205,3418,1196300,11170505,11.99
9850643,9971645,4649,1627150,11598795,16.32
9850644,9982559,4095,1433250,11415809,14.36
9850646,1626112,1335,467250,2093362,28.73
9850647,9966927,3798,1329300,11296227,13.34
9850648,9976217,4387,1535450,11511667,15.39
9850649,9986165,5847,2046450,12032615,20.49
9850650,9985800,3218,1126300,11112100,11.28
9850651,9969178,3100,1085000,11054178,10.88
9850652,9970349,2167,758450,10728799,7.61
9850653,5677683,3570,1249500,6927183,22.01
9850654,4327662,1295,453250,4780912,10.47
9850655,9962401,5212,1824200,11786601,18.31
9850656,9975203,3780,1323000,11298203,13.26
9850657,497934,188,65800,563734,13.21
9850659,9965480,3480,1218000,11183480,12.22
9850660,9951881,2310,808500,10760381,8.12
9850661,9956921,4328,1514800,11471721,15.21
9850662,9974087,3746,1311100,11285187,13.15
9850663,9963784,4793,1677550,11641334,16.84
9850664,9918359,4767,1668450,11586809,16.82
9850665,9975138,2716,950600,10925738,9.53
9850666,9990850,2334,816900,10807750,8.18
9850667,1269123,541,189350,1458473,14.92
9850668,9957767,3596,1258600,11216367,12.64
9850669,9949237,4181,1463350,11412587,14.71
9850670,9969303,2761,966350,10935653,9.69
9850671,9959613,3897,1363950,11323563,13.69
9850672,2479992,1497,523950,3003942,21.13
9850673,9972521,3096,1083600,11056121,10.87
9850675,4569148,1457,509950,5079098,11.16
9850676,9949680,3109,1088150,11037830,10.94
9850677,606421,269,94150,700571,15.53
9850678,9943593,4535,1587250,11530843,15.96
9850679,5752764,2527,884450,6637214,15.37
9850680,8211241,4507,1577450,9788691,19.21
9850681,2249043,1257,439950,2688993,19.56
9850682,9937108,2694,942900,10880008,9.49
9850683,9922323,3174,1110900,11033223,11.20
9850684,3899456,1423,498050,4397506,12.77
9850685,9854021,5234,1831900,11685921,18.59
9850686,9957537,3704,1296400,11253937,13.02
9850687,9958882,3265,1142750,11101632,11.47
9850688,1693828,745,260750,1954578,15.39
9850689,3593083,628,219800,3812883,6.12
9850691,3101945,380,133000,3234945,4.29
9850692,9914943,3743,1310050,11224993,13.21
9850693,9905437,2834,991900,10897337,10.01
9850694,9905540,4164,1457400,11362940,14.71
9850695,9896955,4194,1467900,11364855,14.83
9850696,9918828,4774,1670900,11589728,16.85
9850697,1397787,618,216300,1614087,15.47
9850698,9905549,3656,1279600,11185149,12.92
9850699,9917303,2993,1047550,10964853,10.56
9850700,9934918,3420,1197000,11131918,12.05
9850701,9917811,1241,434350,10352161,4.38
9850702,9921230,4584,1604400,11525630,16.17
9850703,9940783,3431,1200850,11141633,12.08
9850704,9937696,3457,1209950,11147646,12.18
9850705,8960984,3258,1140300,10101284,12.73
9850706,9878565,4895,1713250,11591815,17.34
9850707,9956208,3959,1385650,11341858,13.92
9850708,9978741,3613,1264550,11243291,12.67
9850709,9965556,3181,1113350,11078906,11.17
9850710,9991458,2394,837900,10829358,8.39
9850712,7709094,2336,817600,8526694,10.61
9850714,9957008,4508,1577800,11534808,15.85
9850715,9970802,1462,511700,10482502,5.13
9850716,9956235,1842,644700,10600935,6.48
9850717,9973971,4283,1499050,11473021,15.03
9850718,1409448,863,302050,1711498,21.43
9850719,9956076,2244,785400,10741476,7.89
9850720,9390849,2907,1017450,10408299,10.83
9850721,9990367,3348,1171800,11162167,11.73
9850722,9988656,4870,1704500,11693156,17.06
9850723,9999732,2455,859250,10858982,8.59
9850724,1910679,524,183400,2094079,9.60
9850725,9176079,3655,1279250,10455329,13.94
9850726,9987778,2967,1038450,11026228,10.40
9850727,9988550,6583,2304050,12292600,23.07
9850728,7597688,3412,1194200,8791888,15.72
9850729,7025356,3393,1187550,8212906,16.90
9850730,9967508,3796,1328600,11296108,13.33
9850731,4614442,2612,914200,5528642,19.81
9850732,8951933,2774,970900,9922833,10.85
9850733,9958018,6057,2119950,12077968,21.29
9850734,9973295,5586,1955100,11928395,19.60
9850735,9976542,3675,1286250,11262792,12.89
9850736,9990206,2894,1012900,11003106,10.14
9850737,507940,272,95200,603140,18.74
9850738,9966468,4700,1645000,11611468,16.51
9850739,6413944,915,320250,6734194,4.99
9850740,9966768,3698,1294300,11261068,12.99
9850741,9945848,4339,1518650,11464498,15.27
9850742,9955954,4808,1682800,11638754,16.90
9850743,9962971,5224,1828400,11791371,18.35
9850744,9956019,3983,1394050,11350069,14.00
9850745,9955344,3367,1178450,11133794,11.84
9850746,8949479,4550,1592500,10541979,17.79
9850748,9940177,6084,2129400,12069577,21.42
9850749,9957794,3476,1216600,11174394,12.22
9850750,9974109,2600,910000,10884109,9.12
9850751,9973473,3954,1383900,11357373,13.88
9850752,9974195,2087,730450,10704645,7.32
9850753,9972886,3226,1129100,11101986,11.32
9850754,9977608,5426,1899100,11876708,19.03
9850755,9978837,3097,1083950,11062787,10.86
9850756,2844634,570,199500,3044134,7.01
9850757,9900550,3736,1307600,11208150,13.21
9850758,6189267,3662,1281700,7470967,20.71
9850759,9971930,4548,1591800,11563730,15.96
9850760,4566008,1982,693700,5259708,15.19
9850761,9981084,4570,1599500,11580584,16.03
9850762,9996890,5745,2010750,12007640,20.11
9850763,9970549,3508,1227800,11198349,12.31
9850764,9991709,4566,1598100,11589809,15.99
9850765,9997983,2898,1014300,11012283,10.15
9850766,9984716,1530,535500,10520216,5.36
9850767,9986173,1408,492800,10478973,4.93
9850768,9988864,4952,1733200,11722064,17.35
9850769,9996676,4067,1423450,11420126,14.24
9850771,9580760,4125,1443750,11024510,15.07
9850772,9997123,5449,1907150,11904273,19.08
9850773,9982905,7633,2671550,12654455,26.76
9850774,9986270,3781,1323350,11309620,13.25
9850775,9986965,4388,1535800,11522765,15.38
9850776,9987353,3354,1173900,11161253,11.75
9850777,9983442,3339,1168650,11152092,11.71
9850778,9974454,2106,737100,10711554,7.39
9850779,9983280,3984,1394400,11377680,13.97
9850780,9983308,3881,1358350,11341658,13.61
9850781,9981082,3443,1205050,11186132,12.07
9850782,9979124,4611,1613850,11592974,16.17
9850783,9982152,1412,494200,10476352,4.95
9850784,218663,114,39900,258563,18.25
9850785,9986868,2440,854000,10840868,8.55
9850786,9973317,4340,1519000,11492317,15.23
9850787,9977961,1794,627900,10605861,6.29
9850788,9997157,2253,788550,10785707,7.89
9850789,9997856,1395,488250,10486106,4.88
9850790,9989892,5883,2059050,12048942,20.61
9850791,9996853,1249,437150,10434003,4.37
9850792,9976957,3085,1079750,11056707,10.82
9850793,9980298,3294,1152900,11133198,11.55
9850794,9999777,3277,1146950,11146727,11.47
9850795,9993124,1260,441000,10434124,4.41
9850796,7131255,2203,771050,7902305,10.81
9850797,9983090,2978,1042300,11025390,10.44
9850798,9879429,1541,539350,10418779,5.46
9850799,9998528,2297,803950,10802478,8.04
9850800,9970459,1463,512050,10482509,5.14
9850801,9986500,3906,1367100,11353600,13.69
9850802,9980793,4865,1702750,11683543,17.06
9850803,9983515,4372,1530200,11513715,15.33
9850804,9972516,1015,355250,10327766,3.56
9850805,9976410,573,200550,10176960,2.01
9850806,9983571,788,275800,10259371,2.76
9850807,9980646,3535,1237250,11217896,12.40
9850808,9998710,2258,790300,10789010,7.90
9850809,5833922,1558,545300,6379222,9.35
9850810,9991804,4122,1442700,11434504,14.44
9850811,9990752,4907,1717450,11708202,17.19
9850812,8985228,3484,1219400,10204628,13.57
9850813,9963880,2535,887250,10851130,8.90
9850814,9970343,2433,851550,10821893,8.54
9850816,8719664,185,64750,8784414,0.74
9850817,9982175,3425,1198750,11180925,12.01
9850818,6554651,2582,903700,7458351,13.79
9850819,9983925,2866,1003100,10987025,10.05
9850820,9988137,519,181650,10169787,1.82
9850821,9994163,406,142100,10136263,1.42
9850822,9979798,987,345450,10325248,3.46
9850823,9382031,2810,983500,10365531,10.48
9850824,9990457,4194,1467900,11458357,14.69
9850825,1880092,726,254100,2134192,13.52
9850826,9962386,4541,1589350,11551736,15.95
9850827,9986431,3914,1369900,11356331,13.72
9850828,9984271,4632,1621200,11605471,16.24
9850830,9996229,3571,1249850,11246079,12.50
9850831,9986867,2039,713650,10700517,7.15
9850832,2336200,902,315700,2651900,13.51
9850833,9962811,3803,1331050,11293861,13.36
9850834,3019185,1089,381150,3400335,12.62
9850835,9957357,4404,1541400,11498757,15.48
9850836,9968276,5979,2092650,12060926,20.99
9850837,9969070,6579,2302650,12271720,23.10
9850838,9992604,5339,1868650,11861254,18.70
9850839,9904780,2681,938350,10843130,9.47
9850840,9988147,3409,1193150,11181297,11.95
9850841,4659502,1463,512050,5171552,10.99
9850842,9977892,4345,1520750,11498642,15.24
9850843,9968547,2812,984200,10952747,9.87
9850844,9982044,3464,1212400,11194444,12.15
9850845,9988348,1445,505750,10494098,5.06
9850846,8837142,1438,503300,9340442,5.70
9850847,5930707,1698,594300,6525007,10.02
9850848,9995760,5220,1827000,11822760,18.28
9850849,9988995,5342,1869700,11858695,18.72
9850850,9987381,3469,1214150,11201531,12.16
9850851,9976036,5244,1835400,11811436,18.40
9850852,9990962,3641,1274350,11265312,12.76
9850853,9985511,2315,810250,10795761,8.11
9850854,9990248,2864,1002400,10992648,10.03
9850855,9970923,3899,1364650,11335573,13.69
9850856,1995126,1712,599200,2594326,30.03
9850857,9983612,3077,1076950,11060562,10.79
9850858,9985435,3822,1337700,11323135,13.40
9850859,9988874,5251,1837850,11826724,18.40
9850860,9998097,2231,780850,10778947,7.81
9850861,9985631,3939,1378650,11364281,13.81
9850862,9941594,2810,983500,10925094,9.89
9850863,9970651,1283,449050,10419701,4.50
9850864,9964197,2526,884100,10848297,8.87
9850865,9973322,854,298900,10272222,3.00
9850866,2852296,1985,694750,3547046,24.36
9850867,9966361,4200,1470000,11436361,14.75
9850868,9984212,4657,1629950,11614162,16.33
9850869,9978560,2559,895650,10874210,8.98
9850870,9979629,2190,766500,10746129,7.68
9850871,9998841,874,305900,10304741,3.06
9850872,9995990,3985,1394750,11390740,13.95
9850873,9984961,2493,872550,10857511,8.74
9850874,9970400,2434,851900,10822300,8.54
9850875,9979550,2098,734300,10713850,7.36
9850876,9969694,4172,1460200,11429894,14.65
9850877,9960749,1936,677600,10638349,6.80
9850878,9967785,4871,1704850,11672635,17.10
9850879,2424113,919,321650,2745763,13.27
9850880,9973444,4000,1400000,11373444,14.04
9850881,9982005,2521,882350,10864355,8.84
9850882,9971126,3552,1243200,11214326,12.47
9850883,9991803,1985,694750,10686553,6.95
9850884,8097566,3676,1286600,9384166,15.89
9850885,484896,231,80850,565746,16.67
9850886,2331719,1198,419300,2751019,17.98
9850887,9846541,2679,937650,10784191,9.52
9850888,7950799,1856,649600,8600399,8.17
9850889,9966026,3285,1149750,11115776,11.54
9850890,9955090,3374,1180900,11135990,11.86
9850891,2027242,705,246750,2273992,12.17
9850892,9924045,2958,1035300,10959345,10.43
9850893,3169402,1416,495600,3665002,15.64
9850894,9926198,1624,568400,10494598,5.73
9850895,9919979,4255,1489250,11409229,15.01
9850896,522744,112,39200,561944,7.50
9850897,9909335,299,104650,10013985,1.06
9850898,9894023,2659,930650,10824673,9.41
9850899,9897632,3983,1394050,11291682,14.08
9850900,9917941,3124,1093400,11011341,11.02
9850901,9904106,2173,760550,10664656,7.68
9850902,9912881,2570,899500,10812381,9.07
9850903,9915166,4563,1597050,11512216,16.11
9850904,9903326,3227,1129450,11032776,11.40
9850905,9929688,4034,1411900,11341588,14.22
9850906,9905377,4859,1700650,11606027,17.17
9850907,500797,139,48650,549447,9.71
9850908,9923830,4732,1656200,11580030,16.69
9850909,9921036,3604,1261400,11182436,12.71
9850910,107835,149,52150,159985,48.36
9850911,9899440,5702,1995700,11895140,20.16
9850912,9898447,2783,974050,10872497,9.84
9850913,9918934,2861,1001350,10920284,10.10
9850914,9906432,5199,1819650,11726082,18.37
9850915,9913572,3947,1381450,11295022,13.93
9850916,9927890,4922,1722700,11650590,17.35
9850917,1551574,577,201950,1753524,13.02
9850918,9944984,3451,1207850,11152834,12.15
9850919,9953941,1303,456050,10409991,4.58
9850920,9942951,1403,491050,10434001,4.94
9850921,9970205,1999,699650,10669855,7.02
9850922,3506984,1163,407050,3914034,11.61
9850923,9682756,2727,954450,10637206,9.86
9850924,9960579,3974,1390900,11351479,13.96
9850925,542098,287,100450,642548,18.53
9850926,9951129,4891,1711850,11662979,17.20
9850927,8683169,2669,934150,9617319,10.76
9850928,9968188,2842,994700,10962888,9.98
9850929,9986595,3026,1059100,11045695,10.61
9850930,9976091,2257,789950,10766041,7.92
9850931,9982515,6919,2421650,12404165,24.26
9850932,147906,83,29050,176956,19.64
9850933,9968095,2728,954800,10922895,9.58
9850934,9989864,5111,1788850,11778714,17.91
9850935,9965010,5881,2058350,12023360,20.66
9850936,9970361,2957,1034950,11005311,10.38
9850937,9976310,4341,1519350,11495660,15.23
9850938,9373142,4491,1571850,10944992,16.77
9850939,9959771,3081,1078350,11038121,10.83
9850940,9971569,4314,1509900,11481469,15.14
9850941,9984172,4696,1643600,11627772,16.46
9850942,9962044,3769,1319150,11281194,13.24
9850943,9989794,4127,1444450,11434244,14.46
9850944,9987067,2966,1038100,11025167,10.39
9850945,9973647,4761,1666350,11639997,16.71
9850946,941991,409,143150,1085141,15.20
9850947,9963750,3835,1342250,11306000,13.47
9850948,9939473,2773,970550,10910023,9.76
9850949,9946781,3649,1277150,11223931,12.84
9850950,9947233,2321,812350,10759583,8.17
9850951,9941477,3672,1285200,11226677,12.93
9850952,9954593,2648,926800,10881393,9.31
9850953,9973986,4214,1474900,11448886,14.79
9850954,9988172,2288,800800,10788972,8.02
9850955,9994593,2865,1002750,10997343,10.03
9850956,9973018,4175,1461250,11434268,14.65
9850957,4517982,1956,684600,5202582,15.15
9850958,9995652,4378,1532300,11527952,15.33
9850959,9974938,1780,623000,10597938,6.25
9850960,9989311,4627,1619450,11608761,16.21
9850961,9999617,2876,1006600,11006217,10.07
9850962,9973953,3687,1290450,11264403,12.94
9850963,3777380,1098,384300,4161680,10.17
9850964,9955965,1847,646450,10602415,6.49
9850965,9966523,2004,701400,10667923,7.04
9850966,1576374,321,112350,1688724,7.13
9850967,9957506,5085,1779750,11737256,17.87
9850968,1740373,752,263200,2003573,15.12
9850969,9986000,4947,1731450,11717450,17.34
9850970,8981148,3366,1178100,10159248,13.12
9850971,9979038,3812,1334200,11313238,13.37
9850972,9999559,3387,1185450,11185009,11.86
9850973,9981805,2470,864500,10846305,8.66
9850974,1108189,614,214900,1323089,19.39
9850975,1442931,621,217350,1660281,15.06
9850976,9976350,2188,765800,10742150,7.68
9850977,9956088,3986,1395100,11351188,14.01
9850978,9944679,4199,1469650,11414329,14.78
9850979,9964851,2580,903000,10867851,9.06
9850980,5065093,2833,991550,6056643,19.58
9850981,9940112,2930,1025500,10965612,10.32
9850982,9950398,4642,1624700,11575098,16.33
9850983,9951469,2881,1008350,10959819,10.13
9850984,2055468,1256,439600,2495068,21.39
9850985,9972241,2766,968100,10940341,9.71
9850986,9985480,2208,772800,10758280,7.74
9850987,9977343,942,329700,10307043,3.30
9850988,9983111,4022,1407700,11390811,14.10
9850989,9971087,2775,971250,10942337,9.74
9850990,9956552,3959,1385650,11342202,13.92
9850991,227970,147,51450,279420,22.57
9850992,9958006,2582,903700,10861706,9.08
9850993,9870312,5696,1993600,11863912,20.20
9850994,9935369,2392,837200,10772569,8.43
9850995,8944580,3648,1276800,10221380,14.27
9850996,1505231,284,99400,1604631,6.60
9850997,9962371,3051,1067850,11030221,10.72
9850998,9977336,2085,729750,10707086,7.31
9850999,9971980,3570,1249500,11221480,12.53
9851000,608881,98,34300,643181,5.63
9851002,9965733,3519,1231650,11197383,12.36
9851003,2863377,657,229950,3093327,8.03
9851004,9954642,4123,1443050,11397692,14.50
9851005,9970317,2286,800100,10770417,8.02
9851006,3288029,1422,497700,3785729,15.14
9851007,9961902,2376,831600,10793502,8.35
9851008,98810,63,22050,120860,22.32
9851009,9961688,3970,1389500,11351188,13.95
9851010,9963065,3483,1219050,11182115,12.24
9851011,9985659,4723,1653050,11638709,16.55
9851013,9150615,4062,1421700,10572315,15.54
9851014,9158505,2550,892500,10051005,9.75
9851015,3909967,724,253400,4163367,6.48
9851017,3666408,2552,893200,4559608,24.36
9851018,9994384,3554,1243900,11238284,12.45
9851019,9984684,4472,1565200,11549884,15.68
9851020,2159442,184,64400,2223842,2.98
9851021,8989608,3539,1238650,10228258,13.78
9851022,9971627,4574,1600900,11572527,16.05
9851023,9957426,2134,746900,10704326,7.50
9851024,3736499,902,315700,4052199,8.45
9851025,9874423,5104,1786400,11660823,18.09
9851026,9947664,2144,750400,10698064,7.54
9851027,9967430,3424,1198400,11165830,12.02
9851028,9939518,2296,803600,10743118,8.08
9851029,9961601,4908,1717800,11679401,17.24
9851030,2548213,1392,487200,3035413,19.12
9851031,105987,103,36050,142037,34.01
9851032,1771527,482,168700,1940227,9.52
9851033,9969904,3866,1353100,11323004,13.57
9851034,561924,187,65450,627374,11.65
9851035,1008718,138,48300,1057018,4.79
9851036,9964686,4996,1748600,11713286,17.55
9851037,9965991,197,68950,10034941,0.69
9851038,9982320,3010,1053500,11035820,10.55
9851039,9978814,2782,973700,10952514,9.76
9851040,9980314,3000,1050000,11030314,10.52
9851041,9992498,4085,1429750,11422248,14.31
9851042,9983977,1488,520800,10504777,5.22
9851043,9992677,5193,1817550,11810227,18.19
9851044,9987891,2857,999950,10987841,10.01
9851045,9997954,3092,1082200,11080154,10.82
9851046,9971340,2092,732200,10703540,7.34
9851047,9979446,2635,922250,10901696,9.24
9851048,9983711,3499,1224650,11208361,12.27
9851049,9982514,4056,1419600,11402114,14.22
9851050,9997968,3097,1083950,11081918,10.84
9851051,9984750,2949,1032150,11016900,10.34
9851052,9215368,291,101850,9317218,1.11
9851053,9987505,4367,1528450,11515955,15.30
9851054,7169866,2869,1004150,8174016,14.01
9851055,693253,138,48300,741553,6.97
9851056,9950249,4843,1695050,11645299,17.04
9851057,9960803,4257,1489950,11450753,14.96
9851058,9958567,5390,1886500,11845067,18.94
9851059,9976409,2968,1038800,11015209,10.41
9851060,9961588,5767,2018450,11980038,20.26
9851061,9975511,3973,1390550,11366061,13.94
9851062,9961018,5576,1951600,11912618,19.59
9851063,9983738,3547,1241450,11225188,12.43
9851064,9875472,3287,1150450,11025922,11.65
9851065,9989704,198,69300,10059004,0.69
9851066,2418592,1568,548800,2967392,22.69
9851067,9953279,5169,1809150,11762429,18.18
9851068,9952727,4290,1501500,11454227,15.09
9851069,9949626,5617,1965950,11915576,19.76
9851070,9971951,2952,1033200,11005151,10.36
9851071,9868586,116,40600,9909186,0.41
9851072,9579831,2775,971250,10551081,10.14
9851073,9986321,3225,1128750,11115071,11.30
9851074,9990183,3497,1223950,11214133,12.25
9851075,9978852,5583,1954050,11932902,19.58
9851076,5095852,1576,551600,5647452,10.82
9851077,9962425,4312,1509200,11471625,15.15
9851078,2079604,776,271600,2351204,13.06
9851079,9964978,3400,1190000,11154978,11.94
9851080,9882380,3109,1088150,10970530,11.01
9851081,9870926,2537,887950,10758876,9.00
9851082,9988559,4578,1602300,11590859,16.04
9851083,9997790,4018,1406300,11404090,14.07
9851084,8990221,3016,1055600,10045821,11.74
9851085,9978214,4465,1562750,11540964,15.66
9851086,9991175,3998,1399300,11390475,14.01
9851087,9862418,4361,1526350,11388768,15.48
9851088,9993573,3707,1297450,11291023,12.98
9851089,9994343,3876,1356600,11350943,13.57
9851090,2198571,1389,486150,2684721,22.11
9851091,1242807,1161,406350,1649157,32.70
9851092,9955643,5952,2083200,12038843,20.92
9851093,9971668,2890,1011500,10983168,10.14
9851094,255943,151,52850,308793,20.65
9851095,9958168,2189,766150,10724318,7.69
9851096,9971153,3112,1089200,11060353,10.92
9851097,9969814,4265,1492750,11462564,14.97
9851098,9967797,3397,1188950,11156747,11.93
9851099,9979558,4261,1491350,11470908,14.94
9851100,9795139,3407,1192450,10987589,12.17
9851101,1975117,775,271250,2246367,13.73
9851102,9975367,2604,911400,10886767,9.14
9851103,9970876,3070,1074500,11045376,10.78
9851104,9978805,163,57050,10035855,0.57
9851105,9975960,3211,1123850,11099810,11.27
9851106,9981055,3562,1246700,11227755,12.49
9851107,1636101,660,231000,1867101,14.12
9851108,776835,238,83300,860135,10.72
9851109,9983012,3426,1199100,11182112,12.01
9851110,9971620,3008,1052800,11024420,10.56
9851111,1414840,269,94150,1508990,6.65
9851112,9984492,3604,1261400,11245892,12.63
9851113,9989452,2240,784000,10773452,7.85
9851115,9974056,2771,969850,10943906,9.72
9851116,9975311,3448,1206800,11182111,12.10
9851117,9988887,5084,1779400,11768287,17.81
9851118,9988091,4489,1571150,11559241,15.73
9851119,9987859,6304,2206400,12194259,22.09
9851120,9993556,5015,1755250,11748806,17.56
9851121,9999933,4657,1629950,11629883,16.30
9851122,9986286,4265,1492750,11479036,14.95
9851123,9977589,2838,993300,10970889,9.96
9851124,9545452,3730,1305500,10850952,13.68
9851125,1550243,1027,359450,1909693,23.19
9851126,9962495,3122,1092700,11055195,10.97
9851128,9949101,4414,1544900,11494001,15.53
9851130,9944995,2643,925050,10870045,9.30
9851131,9959724,5045,1765750,11725474,17.73
9851132,2482739,984,344400,2827139,13.87
9851133,9934440,4512,1579200,11513640,15.90
9851134,1378544,1263,442050,1820594,32.07
9851135,1973123,790,276500,2249623,14.01
9851136,7871919,7223,2528050,10399969,32.11
9851137,9947674,3515,1230250,11177924,12.37
9851138,9957063,4433,1551550,11508613,15.58
9851139,6469378,2618,916300,7385678,14.16
9851140,9927860,2065,722750,10650610,7.28
9851141,1187193,510,178500,1365693,15.04
9851142,1558889,633,221550,1780439,14.21
9851143,9918002,3466,1213100,11131102,12.23
9851144,9907381,2259,790650,10698031,7.98
9851145,9923379,4237,1482950,11406329,14.94
9851146,9919006,3660,1281000,11200006,12.91
9851147,9931881,2745,960750,10892631,9.67
9851148,9911431,3136,1097600,11009031,11.07
9851149,1813925,821,287350,2101275,15.84
9851150,9898787,5960,2086000,11984787,21.07
9851151,9596524,2350,822500,10419024,8.57
9851152,9893058,2724,953400,10846458,9.64
9851153,9913477,1461,511350,10424827,5.16
9851154,9902788,4222,1477700,11380488,14.92
9851155,9895183,118,41300,9936483,0.42
9851156,1368574,494,172900,1541474,12.63
9851157,9910730,2693,942550,10853280,9.51
9851159,1601373,481,168350,1769723,10.51
9851160,9885897,3440,1204000,11089897,12.18
9851161,9909067,2522,882700,10791767,8.91
9851162,9406625,2359,825650,10232275,8.78
9851164,7860059,4729,1655150,9515209,21.06
9851165,9902763,5413,1894550,11797313,19.13
9851166,9884845,3539,1238650,11123495,12.53
9851167,9884472,3794,1327900,11212372,13.43
9851168,9873312,2761,966350,10839662,9.79
9851170,9865537,2592,907200,10772737,9.20
9851171,9851385,4039,1413650,11265035,14.35
9851172,4050650,1634,571900,4622550,14.12
9851173,9857086,2589,906150,10763236,9.19
9851174,9870405,3313,1159550,11029955,11.75
9851175,9858711,2692,942200,10800911,9.56
9851176,9850410,1889,661150,10511560,6.71
9851177,9853604,2792,977200,10830804,9.92
9851178,8870804,3414,1194900,10065704,13.47
9851179,9873984,4607,1612450,11486434,16.33
9851180,9596073,5352,1873200,11469273,19.52
9851181,9893350,1846,646100,10539450,6.53
9851182,9907156,4318,1511300,11418456,15.25
9851183,9897782,3954,1383900,11281682,13.98
9851184,1266246,506,177100,1443346,13.99
9851185,9881640,3847,1346450,11228090,13.63
9851186,9890397,6199,2169650,12060047,21.94
9851187,9896232,3178,1112300,11008532,11.24
9851188,8666169,3626,1269100,9935269,14.64
9851189,4127001,1930,675500,4802501,16.37
9851190,9913190,4514,1579900,11493090,15.94
9851191,9904965,1944,680400,10585365,6.87
9851193,9908150,2963,1037050,10945200,10.47
9851194,9903976,3561,1246350,11150326,12.58
9851195,9780646,2380,833000,10613646,8.52
9851196,9915747,4568,1598800,11514547,16.12
9851197,9930583,3661,1281350,11211933,12.90
9851198,9929329,2154,753900,10683229,7.59
9851199,5331193,3676,1286600,6617793,24.13
9851200,9932628,4713,1649550,11582178,16.61
9851201,9910256,3164,1107400,11017656,11.17
9851202,9929142,5277,1846950,11776092,18.60
9851203,9923822,5024,1758400,11682222,17.72
9851204,9914385,2763,967050,10881435,9.75
9851205,3240714,2232,781200,4021914,24.11
9851206,9937786,2356,824600,10762386,8.30
9851207,4742480,1851,647850,5390330,13.66
9851208,6209488,3202,1120700,7330188,18.05
9851209,9933487,4146,1451100,11384587,14.61
9851210,954630,253,88550,1043180,9.28
9851211,3673424,720,252000,3925424,6.86
9851212,6310568,2723,953050,7263618,15.10
9851213,9917024,3552,1243200,11160224,12.54
9851214,9911027,2222,777700,10688727,7.85
9851215,9923796,2698,944300,10868096,9.52
9851216,9929455,3354,1173900,11103355,11.82
9851217,9940715,4200,1470000,11410715,14.79
9851218,1350146,991,346850,1696996,25.69
9851219,9927009,2981,1043350,10970359,10.51
9851220,9930610,3111,1088850,11019460,10.96
9851222,9928265,4513,1579550,11507815,15.91
9851223,9926493,2950,1032500,10958993,10.40
9851224,9926966,3261,1141350,11068316,11.50
9851225,9939336,2249,787150,10726486,7.92
9851226,9931018,3174,1110900,11041918,11.19
9851227,9936886,2589,906150,10843036,9.12
9851228,9956700,5072,1775200,11731900,17.83
9851229,7457047,2254,788900,8245947,10.58
9851230,9977598,2648,926800,10904398,9.29
9851231,5052176,1265,442750,5494926,8.76
9851232,9968277,2506,877100,10845377,8.80
9851233,9985936,3814,1334900,11320836,13.37
9851234,9997905,3895,1363250,11361155,13.64
9851235,9988951,3157,1104950,11093901,11.06
9851236,9991274,4463,1562050,11553324,15.63
9851237,3271132,769,269150,3540282,8.23
9851238,9976272,4844,1695400,11671672,16.99
9851239,9982235,1784,624400,10606635,6.26
9851240,4809077,939,328650,5137727,6.83
9851241,9979235,4531,1585850,11565085,15.89
9851242,9977774,3782,1323700,11301474,13.27
9851243,9974528,5704,1996400,11970928,20.01
9851244,2219895,691,241850,2461745,10.89
9851245,4549501,1009,353150,4902651,7.76
9851246,9959762,2955,1034250,10994012,10.38
9851247,9951407,4156,1454600,11406007,14.62
9851248,9978685,2115,740250,10718935,7.42
9851249,9982920,3162,1106700,11089620,11.09
9851250,9990076,3857,1349950,11340026,13.51
9851251,9962906,2667,933450,10896356,9.37
9851252,9983003,5290,1851500,11834503,18.55
9851253,9982079,3803,1331050,11313129,13.33
9851254,1432032,1465,512750,1944782,35.81
9851255,9982189,3361,1176350,11158539,11.78
9851256,729131,112,39200,768331,5.38
9851257,9969688,3998,1399300,11368988,14.04
9851258,9973642,3771,1319850,11293492,13.23
9851259,9970585,2998,1049300,11019885,10.52
9851260,9982574,3065,1072750,11055324,10.75
9851261,9994407,4717,1650950,11645357,16.52
9851262,9987351,4216,1475600,11462951,14.77
9851263,9985506,2776,971600,10957106,9.73
9851265,9972024,3198,1119300,11091324,11.22
9851266,114627,42,14700,129327,12.82
9851267,9982584,2945,1030750,11013334,10.33
9851268,916828,622,217700,1134528,23.74
9851269,9979886,3178,1112300,11092186,11.15
9851270,9995596,4308,1507800,11503396,15.08
9851271,9981944,2541,889350,10871294,8.91
9851272,9993963,1406,492100,10486063,4.92
9851273,9968538,1736,607600,10576138,6.10
9851274,9980375,3914,1369900,11350275,13.73
9851275,9989701,2924,1023400,11013101,10.24
9851276,9980998,719,251650,10232648,2.52
9851277,1458863,1501,525350,1984213,36.01
9851278,9994291,1636,572600,10566891,5.73
9851279,9972178,500,175000,10147178,1.75
9851280,9978093,692,242200,10220293,2.43
9851281,9997401,270,94500,10091901,0.95
9851282,9994257,1002,350700,10344957,3.51
9851283,9992595,1591,556850,10549445,5.57
9851284,9986075,1382,483700,10469775,4.84
9851285,9986385,3408,1192800,11179185,11.94
9851286,9981782,2231,780850,10762632,7.82
9851287,9984155,2698,944300,10928455,9.46
9851288,9995229,4060,1421000,11416229,14.22
9851289,9971398,4187,1465450,11436848,14.70
9851290,9980430,7741,2709350,12689780,27.15
9851291,9985500,2731,955850,10941350,9.57
9851292,9979894,2463,862050,10841944,8.64
9851293,9985368,3973,1390550,11375918,13.93
9851294,1296622,1096,383600,1680222,29.58
9851295,9962795,4582,1603700,11566495,16.10
9851296,9978185,4659,1630650,11608835,16.34
9851297,9989812,3358,1175300,11165112,11.76
9851298,9989141,4063,1422050,11411191,14.24
9851299,9998455,3619,1266650,11265105,12.67
9851300,707305,144,50400,757705,7.13
9851301,9968600,4171,1459850,11428450,14.64
9851302,1488168,621,217350,1705518,14.61
9851303,9962203,2907,1017450,10979653,10.21
9851304,9969945,7641,2674350,12644295,26.82
9851305,9958804,3159,1105650,11064454,11.10
9851306,992489,213,74550,1067039,7.51
9851307,1535247,1215,425250,1960497,27.70
9851308,770989,322,112700,883689,14.62
9851309,9967348,5549,1942150,11909498,19.49
9851310,9969409,4275,1496250,11465659,15.01
9851311,9956356,3911,1368850,11325206,13.75
9851312,5176598,2041,714350,5890948,13.80
9851313,8768562,1955,684250,9452812,7.80
9851314,9860654,1536,537600,10398254,5.45
9851315,9149948,1865,652750,9802698,7.13
9851316,7925594,2084,729400,8654994,9.20
9851317,4312034,2364,827400,5139434,19.19
9851318,871109,336,117600,988709,13.50
9851319,9347474,3873,1355550,10703024,14.50
9851321,8461253,2559,895650,9356903,10.59
9851322,9990683,261,91350,10082033,0.91
9851323,6077552,2315,810250,6887802,13.33
9851324,9988483,3285,1149750,11138233,11.51
9851325,8987724,3869,1354150,10341874,15.07
9851326,9958464,1812,634200,10592664,6.37
9851327,9969090,3053,1068550,11037640,10.72
9851328,9978066,6025,2108750,12086816,21.13
9851329,9966552,2308,807800,10774352,8.11
9851330,9975846,4985,1744750,11720596,17.49
9851331,9975088,3179,1112650,11087738,11.15
9851332,2160499,1189,416150,2576649,19.26
9851333,9961109,4128,1444800,11405909,14.50
9851334,9953124,3036,1062600,11015724,10.68
9851335,9972568,4659,1630650,11603218,16.35
9851336,9811452,915,320250,10131702,3.26
9851337,9963138,1618,566300,10529438,5.68
9851338,9974903,1749,612150,10587053,6.14
9851339,9966585,821,287350,10253935,2.88
9851340,9946917,3248,1136800,11083717,11.43
9851341,9972612,1244,435400,10408012,4.37
9851342,1235648,475,166250,1401898,13.45
9851343,9976633,2362,826700,10803333,8.29
9851344,9990918,4097,1433950,11424868,14.35
9851345,1935151,876,306600,2241751,15.84
9851346,4733982,2224,778400,5512382,16.44
9851347,8413365,1120,392000,8805365,4.66
9851348,9968366,2590,906500,10874866,9.09
9851349,9662516,3598,1259300,10921816,13.03
9851350,9959019,5195,1818250,11777269,18.26
9851351,9961642,4295,1503250,11464892,15.09
9851352,9058673,2904,1016400,10075073,11.22
9851353,7972904,2496,873600,8846504,10.96
9851355,9836960,2846,996100,10833060,10.13
9851356,9956518,3074,1075900,11032418,10.81
9851357,9997056,3870,1354500,11351556,13.55
9851358,819284,922,322700,1141984,39.39
9851359,9892882,3586,1255100,11147982,12.69
9851360,8877338,2769,969150,9846488,10.92
9851361,9556238,2833,991550,10547788,10.38
9851362,9972488,3541,1239350,11211838,12.43
9851363,3573136,1010,353500,3926636,9.89
9851365,9562370,3735,1307250,10869620,13.67
9851366,9953070,5778,2022300,11975370,20.32
9851367,9899649,3637,1272950,11172599,12.86
9851368,7939335,2710,948500,8887835,11.95
9851369,9611025,5587,1955450,11566475,20.35
9851370,9977973,4908,1717800,11695773,17.22
9851371,9990160,3897,1363950,11354110,13.65
9851372,9989003,1493,522550,10511553,5.23
9851373,9484787,3864,1352400,10837187,14.26
9851374,9963391,2653,928550,10891941,9.32
9851375,9936847,2378,832300,10769147,8.38
9851376,9979503,4104,1436400,11415903,14.39
9851377,9988687,3809,1333150,11321837,13.35
9851378,9984492,1106,387100,10371592,3.88
9851379,9958576,2232,781200,10739776,7.84
9851380,9990777,3067,1073450,11064227,10.74
9851381,9976036,868,303800,10279836,3.05
9851382,2483956,872,305200,2789156,12.29
9851383,9965494,1936,677600,10643094,6.80
9851384,9974393,5023,1758050,11732443,17.63
9851385,9971851,3242,1134700,11106551,11.38
9851386,2293991,52,18200,2312191,0.79
9851387,9975352,5715,2000250,11975602,20.05
9851388,3659112,2103,736050,4395162,20.12
9851389,9987980,4206,1472100,11460080,14.74
9851390,9969294,5598,1959300,11928594,19.65
9851391,9982118,3337,1167950,11150068,11.70
9851392,9998106,6310,2208500,12206606,22.09
9851393,2411788,866,303100,2714888,12.57
9851394,6466128,2642,924700,7390828,14.30
9851395,9967145,4271,1494850,11461995,15.00
9851396,9980310,3485,1219750,11200060,12.22
9851397,9974935,2884,1009400,10984335,10.12
9851398,9977281,3401,1190350,11167631,11.93
9851399,2926332,995,348250,3274582,11.90
9851400,9913033,2579,902650,10815683,9.11
9851401,9986919,2635,922250,10909169,9.23
9851402,7718049,2119,741650,8459699,9.61
9851403,9986840,3051,1067850,11054690,10.69
9851404,9992598,3960,1386000,11378598,13.87
9851405,9983972,3393,1187550,11171522,11.89
9851408,9961038,3332,1166200,11127238,11.71
9851409,9943035,3024,1058400,11001435,10.64
9851410,9951021,1840,644000,10595021,6.47
9851411,3927888,885,309750,4237638,7.89
9851412,9978735,2839,993650,10972385,9.96
9851413,9983732,4018,1406300,11390032,14.09
9851414,9969211,4217,1475950,11445161,14.81
9851415,9981639,2590,906500,10888139,9.08
9851416,4929587,2725,953750,5883337,19.35
9851417,7056229,4155,1454250,8510479,20.61
9851418,9977050,4113,1439550,11416600,14.43
9851419,9995255,3179,1112650,11107905,11.13
9851420,9586862,4478,1567300,11154162,16.35
9851421,9988648,2380,833000,10821648,8.34
9851422,9981668,6864,2402400,12384068,24.07
9851423,9989059,3518,1231300,11220359,12.33
9851424,9977263,3425,1198750,11176013,12.01
9851425,9986639,4352,1523200,11509839,15.25
9851426,8989375,2502,875700,9865075,9.74
9851427,9910193,5568,1948800,11858993,19.66
9851428,9476383,4029,1410150,10886533,14.88
9851429,7944393,3723,1303050,9247443,16.40
9851430,4959202,1551,542850,5502052,10.95
9851431,9979973,4124,1443400,11423373,14.46
9851432,9984367,3296,1153600,11137967,11.55
9851433,9979948,6333,2216550,12196498,22.21
9851434,9971043,3740,1309000,11280043,13.13
9851435,9950771,7280,2548000,12498771,25.61
9851436,9961042,3850,1347500,11308542,13.53
9851437,1714569,610,213500,1928069,12.45
9851438,9976324,3835,1342250,11318574,13.45
9851439,9987194,5386,1885100,11872294,18.88
9851440,9967628,2437,852950,10820578,8.56
9851441,9974595,3256,1139600,11114195,11.43
9851442,3375308,1850,647500,4022808,19.18
9851443,9971302,3422,1197700,11169002,12.01
9851444,9988951,3835,1342250,11331201,13.44
9851445,9979224,4231,1480850,11460074,14.84
9851446,9988095,2845,995750,10983845,9.97
9851447,9986768,4768,1668800,11655568,16.71
9851448,9988865,2853,998550,10987415,10.00
9851449,723337,358,125300,848637,17.32
9851451,9970655,2883,1009050,10979705,10.12
9851452,1256766,981,343350,1600116,27.32
9851453,9330684,2650,927500,10258184,9.94
9851454,9986731,5491,1921850,11908581,19.24
9851455,9987740,3637,1272950,11260690,12.75
9851456,9987239,4715,1650250,11637489,16.52
9851457,9974308,4051,1417850,11392158,14.22
9851458,9940278,5316,1860600,11800878,18.72
9851460,9614507,4620,1617000,11231507,16.82
9851461,9983468,4902,1715700,11699168,17.19
9851462,9971723,2977,1041950,11013673,10.45
9851463,9973427,2396,838600,10812027,8.41
9851464,9997746,2525,883750,10881496,8.84
9851465,8976426,2095,733250,9709676,8.17
9851466,9993440,4338,1518300,11511740,15.19
9851467,9979648,2256,789600,10769248,7.91
9851468,9988199,2854,998900,10987099,10.00
9851469,9985309,2707,947450,10932759,9.49
9851470,9999069,3388,1185800,11184869,11.86
9851471,9918808,3819,1336650,11255458,13.48
9851472,9987352,5149,1802150,11789502,18.04
9851473,9964476,3947,1381450,11345926,13.86
9851474,9985731,6255,2189250,12174981,21.92
9851475,9995536,3630,1270500,11266036,12.71
9851476,9869537,5655,1979250,11848787,20.05
9851477,9963769,3304,1156400,11120169,11.61
9851478,9973587,5174,1810900,11784487,18.16
9851479,9992571,5155,1804250,11796821,18.06
9851480,8147690,2859,1000650,9148340,12.28
9851481,9985527,4028,1409800,11395327,14.12
9851482,9992173,4194,1467900,11460073,14.69
9851483,9976374,3866,1353100,11329474,13.56
9851484,9996193,2056,719600,10715793,7.20
9851485,9985002,3043,1065050,11050052,10.67
9851486,9980657,3890,1361500,11342157,13.64
9851487,9997954,3950,1382500,11380454,13.83
9851488,9979041,5932,2076200,12055241,20.81
9851489,9985556,4743,1660050,11645606,16.62
9851490,9998086,5073,1775550,11773636,17.76
9851491,9984351,4497,1573950,11558301,15.76
9851492,9998424,3763,1317050,11315474,13.17
9851493,9998450,4917,1720950,11719400,17.21
9851494,1742925,1231,430850,2173775,24.72
9851495,9928315,4522,1582700,11511015,15.94
9851496,7527305,2677,936950,8464255,12.45
9851497,4683504,2344,820400,5503904,17.52
9851498,3530021,1685,589750,4119771,16.71
9851499,9901329,2649,927150,10828479,9.36
9851500,9956057,3714,1299900,11255957,13.06
9851501,9966844,2886,1010100,10976944,10.13
9851502,9988735,1203,421050,10409785,4.22
9851503,9995885,987,345450,10341335,3.46
9851504,9974116,4560,1596000,11570116,16.00
9851505,9986306,5046,1766100,11752406,17.69
9851506,9885381,4877,1706950,11592331,17.27
9851507,1585181,267,93450,1678631,5.90
9851508,9989734,1757,614950,10604684,6.16
9851509,491311,165,57750,549061,11.75
9851510,9977629,4782,1673700,11651329,16.77
9851511,5147229,2700,945000,6092229,18.36
9851512,9979177,4020,1407000,11386177,14.10
9851513,9971395,3189,1116150,11087545,11.19
9851514,9990291,5007,1752450,11742741,17.54
9851515,9993333,4854,1698900,11692233,17.00
9851516,9966416,3095,1083250,11049666,10.87
9851517,9977139,3321,1162350,11139489,11.65
9851518,3409917,1272,445200,3855117,13.06
9851519,9964925,3258,1140300,11105225,11.44
9851520,9969895,675,236250,10206145,2.37
9851521,2070506,711,248850,2319356,12.02
9851522,9960419,3093,1082550,11042969,10.87
9851523,9972884,3169,1109150,11082034,11.12
9851524,9972167,4910,1718500,11690667,17.23
9851525,9984512,1785,624750,10609262,6.26
9851526,9979842,3701,1295350,11275192,12.98
9851527,1442623,719,251650,1694273,17.44
9851528,4887254,1840,644000,5531254,13.18
9851529,9959206,5241,1834350,11793556,18.42
9851531,6704385,3135,1097250,7801635,16.37
9851532,9989275,4039,1413650,11402925,14.15
9851533,2491643,1586,555100,3046743,22.28
9851534,3213260,1639,573650,3786910,17.85
9851535,1475479,234,81900,1557379,5.55
9851536,9989977,5195,1818250,11808227,18.20
9851537,9359649,1566,548100,9907749,5.86
9851538,9981543,2962,1036700,11018243,10.39
9851539,9986710,2334,816900,10803610,8.18
9851540,7999664,3049,1067150,9066814,13.34
9851541,7970935,6462,2261700,10232635,28.37
9851542,9977094,3149,1102150,11079244,11.05
9851543,9987142,4748,1661800,11648942,16.64
9851544,9988224,4897,1713950,11702174,17.16
9851545,3972667,2444,855400,4828067,21.53
9851546,9993248,3157,1104950,11098198,11.06
9851547,9971928,2481,868350,10840278,8.71
9851548,9982564,4572,1600200,11582764,16.03
9851549,2745165,822,287700,3032865,10.48
9851551,9989103,3182,1113700,11102803,11.15
9851552,9913232,3851,1347850,11261082,13.60
9851553,2658607,774,270900,2929507,10.19
9851554,9983669,3487,1220450,11204119,12.22
9851555,9884871,3962,1386700,11271571,14.03
9851556,9975391,3131,1095850,11071241,10.99
9851557,9988684,4850,1697500,11686184,16.99
9851558,9976066,3815,1335250,11311316,13.38
9851559,7063753,3423,1198050,8261803,16.96
9851560,9997263,5521,1932350,11929613,19.33
9851561,9996959,2713,949550,10946509,9.50
9851562,9989847,3658,1280300,11270147,12.82
9851563,3633482,2045,715750,4349232,19.70
9851564,9980723,3308,1157800,11138523,11.60
9851565,4204475,1211,423850,4628325,10.08
9851566,9968844,5284,1849400,11818244,18.55
9851567,9969181,2588,905800,10874981,9.09
9851568,9978990,4038,1413300,11392290,14.16
9851569,9979225,3829,1340150,11319375,13.43
9851570,9970770,3723,1303050,11273820,13.07
9851571,9982072,331,115850,10097922,1.16
9851572,9980516,2904,1016400,10996916,10.18
9851573,276790,165,57750,334540,20.86
9851574,9999748,5313,1859550,11859298,18.60
9851575,9980254,4295,1503250,11483504,15.06
9851576,9985358,5818,2036300,12021658,20.39
9851577,9992095,1623,568050,10560145,5.68
9851578,9977962,863,302050,10280012,3.03
9851579,9941079,3946,1381100,11322179,13.89
9851580,403464,282,98700,502164,24.46
9851581,4283585,1334,466900,4750485,10.90
9851582,9980055,3323,1163050,11143105,11.65
9851583,9994034,1438,503300,10497334,5.04
9851584,9993455,3702,1295700,11289155,12.97
9851585,9983818,2867,1003450,10987268,10.05
9851586,9979002,3144,1100400,11079402,11.03
9851587,9929933,2538,888300,10818233,8.95
9851588,9967245,4025,1408750,11375995,14.13
9851589,9980685,3761,1316350,11297035,13.19
9851590,9696483,4918,1721300,11417783,17.75
9851591,9988716,4172,1460200,11448916,14.62
9851592,9983636,3949,1382150,11365786,13.84
9851593,2030051,546,191100,2221151,9.41
9851594,9988071,5204,1821400,11809471,18.24
9851595,9976540,1764,617400,10593940,6.19
9851596,3816823,995,348250,4165073,9.12
9851597,9982261,3417,1195950,11178211,11.98
9851598,9980362,5090,1781500,11761862,17.85
9851599,9998037,4859,1700650,11698687,17.01
9851600,9961677,4895,1713250,11674927,17.20
9851601,9951330,5042,1764700,11716030,17.73
9851602,9982513,3536,1237600,11220113,12.40
9851603,9980835,3980,1393000,11373835,13.96
9851604,9981580,6059,2120650,12102230,21.25
9851605,9989179,2765,967750,10956929,9.69
9851606,9999313,3226,1129100,11128413,11.29
9851607,9989088,2700,945000,10934088,9.46
9851608,9994887,1831,640850,10635737,6.41
9851609,6649610,2508,877800,7527410,13.20
9851610,9963652,3308,1157800,11121452,11.62
9851611,9907392,5635,1972250,11879642,19.91
9851612,9964151,3000,1050000,11014151,10.54
9851613,9889162,3861,1351350,11240512,13.66
9851614,9979167,3333,1166550,11145717,11.69
9851615,9990865,4388,1535800,11526665,15.37
9851616,9981528,3842,1344700,11326228,13.47
9851618,8770779,3000,1050000,9820779,11.97
9851619,9934148,4321,1512350,11446498,15.22
9851620,9964322,4341,1519350,11483672,15.25
9851621,9984141,3059,1070650,11054791,10.72
9851622,9976491,4451,1557850,11534341,15.62
9851623,9975524,4771,1669850,11645374,16.74
9851624,9419851,3033,1061550,10481401,11.27
9851625,9973425,3409,1193150,11166575,11.96
9851626,9981567,5213,1824550,11806117,18.28
9851627,9976622,3890,1361500,11338122,13.65
9851628,5522085,790,276500,5798585,5.01
9851629,9980477,4257,1489950,11470427,14.93
9851630,9991973,3755,1314250,11306223,13.15
9851631,9911034,523,183050,10094084,1.85
9851632,6714822,3045,1065750,7780572,15.87
9851633,9991858,4590,1606500,11598358,16.08
9851634,9978933,3720,1302000,11280933,13.05
9851635,9969852,1707,597450,10567302,5.99
9851636,9890251,939,328650,10218901,3.32
9851637,9980936,4559,1595650,11576586,15.99
9851638,7431193,2427,849450,8280643,11.43
9851639,9944048,5268,1843800,11787848,18.54
9851640,9977649,4105,1436750,11414399,14.40
9851641,9996058,4531,1585850,11581908,15.86
9851642,1752832,680,238000,1990832,13.58
9851643,9978656,4428,1549800,11528456,15.53
9851644,9971169,4370,1529500,11500669,15.34
9851645,9983716,5133,1796550,11780266,17.99
9851646,9983753,3124,1093400,11077153,10.95
9851647,9981001,4153,1453550,11434551,14.56
9851648,9987242,3950,1382500,11369742,13.84
9851649,9990352,4589,1606150,11596502,16.08
9851650,9996324,2019,706650,10702974,7.07
9851651,9988094,4138,1448300,11436394,14.50
9851652,9990851,2049,717150,10708001,7.18
9851653,8988117,3006,1052100,10040217,11.71
9851654,9996384,4366,1528100,11524484,15.29
9851655,9986530,5364,1877400,11863930,18.80
9851656,9986095,3820,1337000,11323095,13.39
9851657,9926403,4259,1490650,11417053,15.02
9851658,9963249,4909,1718150,11681399,17.24
9851659,8965952,2426,849100,9815052,9.47
9851660,9974882,5780,2023000,11997882,20.28
9851661,9907321,3512,1229200,11136521,12.41
9851662,8992611,5139,1798650,10791261,20.00
9851663,9997065,3447,1206450,11203515,12.07
9851664,9990859,5236,1832600,11823459,18.34
9851665,9989912,4940,1729000,11718912,17.31
9851666,9987829,4779,1672650,11660479,16.75
9851667,9980654,4200,1470000,11450654,14.73
9851668,9978222,1296,453600,10431822,4.55
9851669,1343179,571,199850,1543029,14.88
9851670,2046297,1004,351400,2397697,17.17
9851671,9980660,3925,1373750,11354410,13.76
9851672,9978922,1393,487550,10466472,4.89
9851673,9983196,4058,1420300,11403496,14.23
9851674,9983563,4312,1509200,11492763,15.12
9851675,9985802,4221,1477350,11463152,14.79
9851676,9983420,2747,961450,10944870,9.63
9851677,9999946,2429,850150,10850096,8.50
9851678,9991182,4047,1416450,11407632,14.18
9851679,9895106,3501,1225350,11120456,12.38
9851680,9984035,3485,1219750,11203785,12.22
9851681,9998232,2308,807800,10806032,8.08
9851683,9975516,5248,1836800,11812316,18.41
9851684,9962147,4540,1589000,11551147,15.95
9851685,9957248,3108,1087800,11045048,10.92
9851686,9950930,2767,968450,10919380,9.73
9851687,9965718,3125,1093750,11059468,10.98
9851688,3037225,959,335650,3372875,11.05
9851689,9948687,3387,1185450,11134137,11.92
9851690,9881666,2928,1024800,10906466,10.37
9851691,9956786,3489,1221150,11177936,12.26
9851692,9950430,2365,827750,10778180,8.32
9851693,9948760,4140,1449000,11397760,14.56
9851694,9952983,3794,1327900,11280883,13.34
9851695,9926527,2727,954450,10880977,9.62
9851696,9942828,3283,1149050,11091878,11.56
9851697,9953456,1829,640150,10593606,6.43
9851698,9944391,5692,1992200,11936591,20.03
9851699,9953325,5387,1885450,11838775,18.94
9851700,9929556,4374,1530900,11460456,15.42
9851701,9973643,2349,822150,10795793,8.24
9851703,9966863,506,177100,10143963,1.78
9851704,9967835,2601,910350,10878185,9.13
9851706,9971026,4322,1512700,11483726,15.17
9851708,9977742,4841,1694350,11672092,16.98
9851709,5452551,1180,413000,5865551,7.57
9851710,9922114,2826,989100,10911214,9.97
9851711,9994168,3519,1231650,11225818,12.32
9851712,9969748,1751,612850,10582598,6.15
9851713,9207794,4104,1436400,10644194,15.60
9851714,9979976,3388,1185800,11165776,11.88
9851715,9973704,5616,1965600,11939304,19.71
9851716,9892209,440,154000,10046209,1.56
9851717,9985959,2965,1037750,11023709,10.39
9851718,9989983,5674,1985900,11975883,19.88
9851719,9990193,1844,645400,10635593,6.46
9851720,9997460,2376,831600,10829060,8.32
9851721,9962572,1648,576800,10539372,5.79
9851722,9970736,974,340900,10311636,3.42
9851723,9990056,3545,1240750,11230806,12.42
9851724,9917246,3538,1238300,11155546,12.49
9851725,9948830,3194,1117900,11066730,11.24
9851726,9912033,3590,1256500,11168533,12.68
9851728,9990175,4777,1671950,11662125,16.74
9851729,1761510,651,227850,1989360,12.93
9851730,9972984,3816,1335600,11308584,13.39
9851731,9986876,3943,1380050,11366926,13.82
9851732,9971303,4216,1475600,11446903,14.80
9851733,9952311,2660,931000,10883311,9.35
9851734,9944320,5253,1838550,11782870,18.49
9851735,9928193,2428,849800,10777993,8.56
9851736,9931183,3041,1064350,10995533,10.72
9851737,9943054,2637,922950,10866004,9.28
9851738,9945630,3571,1249850,11195480,12.57
9851739,9956508,2344,820400,10776908,8.24
9851740,9956993,1836,642600,10599593,6.45
9851741,9950063,2442,854700,10804763,8.59
9851742,9965950,3165,1107750,11073700,11.12
9851744,9980680,4085,1429750,11410430,14.33
9851745,9982567,3122,1092700,11075267,10.95
9851746,9975206,4536,1587600,11562806,15.92
9851747,9984042,3168,1108800,11092842,11.11
9851748,9998887,2914,1019900,11018787,10.20
9851749,9984989,3479,1217650,11202639,12.19
9851750,974403,194,67900,1042303,6.97
9851751,1622098,472,165200,1787298,10.18
9851752,3648828,2015,705250,4354078,19.33
9851753,9969209,2600,910000,10879209,9.13
9851754,9971871,4997,1748950,11720821,17.54
9851755,9984088,3656,1279600,11263688,12.82
9851756,860881,916,320600,1181481,37.24
9851757,9955855,3269,1144150,11100005,11.49
9851758,9980886,2220,777000,10757886,7.78
9851759,9984414,1807,632450,10616864,6.33
9851760,9984504,3978,1392300,11376804,13.94
9851761,9928387,3585,1254750,11183137,12.64
9851762,3134609,1213,424550,3559159,13.54
9851763,9900522,3073,1075550,10976072,10.86
9851764,6742570,1980,693000,7435570,10.28
9851765,9971286,1706,597100,10568386,5.99
9851766,9988678,3757,1314950,11303628,13.16
9851767,9965031,4273,1495550,11460581,15.01
9851768,9961738,2357,824950,10786688,8.28
9851769,9980716,3292,1152200,11132916,11.54
9851770,9993932,2252,788200,10782132,7.89
9851771,2809955,1226,429100,3239055,15.27
9851772,9994096,3791,1326850,11320946,13.28
9851773,9984947,3273,1145550,11130497,11.47
9851774,9989928,3583,1254050,11243978,12.55
9851775,9989161,2729,955150,10944311,9.56
9851776,9994888,2006,702100,10696988,7.02
9851777,5717023,3841,1344350,7061373,23.51
9851778,9998530,3350,1172500,11171030,11.73
9851779,9841801,3704,1296400,11138201,13.17
9851780,9995775,2986,1045100,11040875,10.46
9851781,200092,155,54250,254342,27.11
9851783,9969246,4818,1686300,11655546,16.92
9851784,9951492,4893,1712550,11664042,17.21
9851785,9927557,3409,1193150,11120707,12.02
9851786,8113213,5450,1907500,10020713,23.51
9851787,7043341,2042,714700,7758041,10.15
9851788,9961706,1948,681800,10643506,6.84
9851789,9971480,4692,1642200,11613680,16.47
9851790,9982993,3297,1153950,11136943,11.56
9851791,3536023,2573,900550,4436573,25.47
9851792,9985747,4916,1720600,11706347,17.23
9851793,967081,415,145250,1112331,15.02
9851794,9975593,3697,1293950,11269543,12.97
9851795,1866794,914,319900,2186694,17.14
9851796,9982891,3664,1282400,11265291,12.85
9851797,9981258,1794,627900,10609158,6.29
9851798,9990545,3403,1191050,11181595,11.92
9851799,9827733,3146,1101100,10928833,11.20
9851800,9972451,5189,1816150,11788601,18.21
9851801,7459538,1968,688800,8148338,9.23
9851802,9964499,4117,1440950,11405449,14.46
9851803,9965154,3586,1255100,11220254,12.59
9851804,9974838,2071,724850,10699688,7.27
9851805,9976770,4010,1403500,11380270,14.07
9851806,9978986,3316,1160600,11139586,11.63
9851807,9986590,4286,1500100,11486690,15.02
9851808,9979302,3111,1088850,11068152,10.91
9851809,9972470,2264,792400,10764870,7.95
9851810,9984040,4555,1594250,11578290,15.97
9851811,9977756,3318,1161300,11139056,11.64
9851812,9976047,1341,469350,10445397,4.70
9851813,9975942,628,219800,10195742,2.20
9851814,9974818,1638,573300,10548118,5.75
9851815,9991643,2823,988050,10979693,9.89
9851816,9970794,4932,1726200,11696994,17.31
9851817,9991911,2793,977550,10969461,9.78
9851818,7483462,1540,539000,8022462,7.20
9851819,2732056,1701,595350,3327406,21.79
9851820,9980669,2144,750400,10731069,7.52
9851821,9981282,2894,1012900,10994182,10.15
9851822,9960098,5549,1942150,11902248,19.50
9851823,9972793,4972,1740200,11712993,17.45
9851824,2320027,841,294350,2614377,12.69
9851825,9989974,1695,593250,10583224,5.94
9851826,9993741,1819,636650,10630391,6.37
9851827,9993782,4335,1517250,11511032,15.18
9851828,4655324,1935,677250,5332574,14.55
9851829,9960201,3205,1121750,11081951,11.26
9851830,9985109,1899,664650,10649759,6.66
9851831,9960216,4787,1675450,11635666,16.82
9851832,9954080,3099,1084650,11038730,10.90
9851833,9968073,5248,1836800,11804873,18.43
9851834,9984056,2950,1032500,11016556,10.34
9851835,9910415,6455,2259250,12169665,22.80
9851836,2270859,1374,480900,2751759,21.18
9851837,9963281,3951,1382850,11346131,13.88
9851838,9987457,3573,1250550,11238007,12.52
9851839,9987873,4563,1597050,11584923,15.99
9851840,4574419,519,181650,4756069,3.97
9851841,5852683,1951,682850,6535533,11.67
9851842,9520449,4174,1460900,10981349,15.34
9851843,9989743,6114,2139900,12129643,21.42
9851844,9999285,4707,1647450,11646735,16.48
9851845,9999593,3046,1066100,11065693,10.66
9851846,9970146,5575,1951250,11921396,19.57
9851847,9988044,3922,1372700,11360744,13.74
9851848,9950512,3507,1227450,11177962,12.34
9851849,9989264,3968,1388800,11378064,13.90
9851850,9971956,3993,1397550,11369506,14.01
9851851,9975344,3397,1188950,11164294,11.92
9851852,7639619,3428,1199800,8839419,15.70
9851854,9975507,3144,1100400,11075907,11.03
9851855,9970109,3372,1180200,11150309,11.84
9851856,9975156,2729,955150,10930306,9.58
9851857,9963014,3084,1079400,11042414,10.83
9851858,2098693,1255,439250,2537943,20.93
9851859,9943788,4998,1749300,11693088,17.59
9851860,9970055,3251,1137850,11107905,11.41
9851861,9975612,3938,1378300,11353912,13.82
9851862,9962929,3319,1161650,11124579,11.66
9851863,9974834,5707,1997450,11972284,20.02
9851864,9980876,3845,1345750,11326626,13.48
9851865,1545735,764,267400,1813135,17.30
9851866,9987799,3873,1355550,11343349,13.57
9851867,9971635,3827,1339450,11311085,13.43
9851868,9971063,1049,367150,10338213,3.68
9851869,9993477,2486,870100,10863577,8.71
9851870,9988167,2681,938350,10926517,9.39
9851871,783307,62,21700,805007,2.77
9851872,9997824,5353,1873550,11871374,18.74
9851873,1410166,142,49700,1459866,3.52
9851874,9961233,3887,1360450,11321683,13.66
9851875,9965687,4496,1573600,11539287,15.79
9851876,9960563,2573,900550,10861113,9.04
9851877,9973424,2276,796600,10770024,7.99
9851878,9980889,4369,1529150,11510039,15.32
9851879,9994520,4202,1470700,11465220,14.72
9851880,9979472,4588,1605800,11585272,16.09
9851881,9994058,3703,1296050,11290108,12.97
9851882,9998127,4477,1566950,11565077,15.67
9851883,2703877,2052,718200,3422077,26.56
9851884,9984424,3293,1152550,11136974,11.54
9851885,9980816,4623,1618050,11598866,16.21
9851886,9976855,2775,971250,10948105,9.74
9851887,9999596,4682,1638700,11638296,16.39
9851888,1341084,448,156800,1497884,11.69
9851889,3735720,2215,775250,4510970,20.75
9851890,9985074,7543,2640050,12625124,26.44
9851891,9988143,4068,1423800,11411943,14.25
9851892,1225062,546,191100,1416162,15.60
9851893,9963037,7833,2741550,12704587,27.52
9851894,9982494,5239,1833650,11816144,18.37
9851895,9984203,3402,1190700,11174903,11.93
9851896,9983092,3825,1338750,11321842,13.41
9851897,9984112,4584,1604400,11588512,16.07
9851899,9940635,2348,821800,10762435,8.27
9851900,9989328,566,198100,10187428,1.98
9851901,9971404,1327,464450,10435854,4.66
9851902,9977968,3511,1228850,11206818,12.32
9851903,9993375,6367,2228450,12221825,22.30
9851904,9983652,1783,624050,10607702,6.25
9851905,6853907,4174,1460900,8314807,21.31
9851906,9989102,5102,1785700,11774802,17.88
9851907,2565613,1904,666400,3232013,25.97
9851908,9967175,5984,2094400,12061575,21.01
9851909,1648809,1672,585200,2234009,35.49
9851910,9933957,5555,1944250,11878207,19.57
9851911,9952455,3668,1283800,11236255,12.90
9851912,9929437,5343,1870050,11799487,18.83
9851913,9949249,3596,1258600,11207849,12.65
9851914,9949130,3494,1222900,11172030,12.29
9851915,3844185,1733,606550,4450735,15.78
9851916,9921877,3824,1338400,11260277,13.49
9851917,9937366,3617,1265950,11203316,12.74
9851918,9953857,3437,1202950,11156807,12.09
9851919,9947613,3806,1332100,11279713,13.39
9851920,4651311,4022,1407700,6059011,30.26
9851921,9934591,3924,1373400,11307991,13.82
9851922,9951347,4317,1510950,11462297,15.18
9851923,9943476,2667,933450,10876926,9.39
9851924,9945364,2947,1031450,10976814,10.37
9851926,9940150,5216,1825600,11765750,18.37
9851928,9934997,1776,621600,10556597,6.26
9851929,1183318,503,176050,1359368,14.88
9851930,9932355,2164,757400,10689755,7.63
9851931,9933887,3372,1180200,11114087,11.88
9851932,9921664,5495,1923250,11844914,19.38
9851933,9914644,953,333550,10248194,3.36
9851934,9148868,3165,1107750,10256618,12.11
9851935,9910813,5180,1813000,11723813,18.29
9851936,9930336,6064,2122400,12052736,21.37
9851937,9929549,3261,1141350,11070899,11.49
9851938,9931337,3553,1243550,11174887,12.52
9851939,9618271,5603,1961050,11579321,20.39
9851940,8953802,3000,1050000,10003802,11.73
9851941,9964443,5491,1921850,11886293,19.29
9851942,9975965,4975,1741250,11717215,17.45
9851943,9976036,4832,1691200,11667236,16.95
9851944,9977444,6107,2137450,12114894,21.42
9851945,9978439,4023,1408050,11386489,14.11
9851946,4706043,4019,1406650,6112693,29.89
9851947,9823361,3054,1068900,10892261,10.88
9851948,9975970,5566,1948100,11924070,19.53
9851949,6432707,482,168700,6601407,2.62
9851950,639231,251,87850,727081,13.74
9851951,9945369,4223,1478050,11423419,14.86
9851952,9952477,2680,938000,10890477,9.42
9851953,9973798,3025,1058750,11032548,10.62
9851954,9969100,5202,1820700,11789800,18.26
9851955,9949135,3419,1196650,11145785,12.03
9851956,9965950,6278,2197300,12163250,22.05
9851957,9971881,3151,1102850,11074731,11.06
9851958,9965371,2522,882700,10848071,8.86
9851959,9540552,4705,1646750,11187302,17.26
9851960,9754258,3160,1106000,10860258,11.34
9851961,196579,79,27650,224229,14.07
9851962,9962674,3709,1298150,11260824,13.03
9851963,9950917,2207,772450,10723367,7.76
9851964,9727471,2388,835800,10563271,8.59
9851965,9930214,5030,1760500,11690714,17.73
9851966,9944884,926,324100,10268984,3.26
9851967,9705377,3564,1247400,10952777,12.85
9851968,9954413,2476,866600,10821013,8.71
9851969,8931706,1563,547050,9478756,6.12
9851970,9970639,4982,1743700,11714339,17.49
9851971,6648867,3583,1254050,7902917,18.86
9851972,9075682,5767,2018450,11094132,22.24
9851973,9973334,1276,446600,10419934,4.48
9851974,607174,434,151900,759074,25.02
9851975,9959050,4127,1444450,11403500,14.50
9851977,9976932,4296,1503600,11480532,15.07
9851978,9972342,2230,780500,10752842,7.83
9851979,6675991,3053,1068550,7744541,16.01
9851980,9952989,733,256550,10209539,2.58
9851981,9938036,1484,519400,10457436,5.23
9851982,9972274,3630,1270500,11242774,12.74
9851983,7651125,2617,915950,8567075,11.97
9851984,9954617,1639,573650,10528267,5.76
9851985,9944269,374,130900,10075169,1.32
9851986,8884929,3150,1102500,9987429,12.41
9851988,9961837,2649,927150,10888987,9.31
9851989,9964677,2436,852600,10817277,8.56
9851990,9964499,3392,1187200,11151699,11.91
9851991,6246973,3069,1074150,7321123,17.19
9851992,9963959,5382,1883700,11847659,18.91
9851994,9948822,4075,1426250,11375072,14.34
9851995,9938794,4223,1478050,11416844,14.87
9851996,9966464,3682,1288700,11255164,12.93
9851997,9978224,7016,2455600,12433824,24.61
9851998,9974561,1841,644350,10618911,6.46
9851999,9991071,1028,359800,10350871,3.60
9852000,2432458,1571,549850,2982308,22.60
9852001,9964011,6561,2296350,12260361,23.05
9852002,8127747,1647,576450,8704197,7.09
9852003,9960435,2010,703500,10663935,7.06
9852004,9962575,856,299600,10262175,3.01
9852005,9983776,933,326550,10310326,3.27
9852006,9987106,664,232400,10219506,2.33
9852007,9963277,1901,665350,10628627,6.68
9852008,9972009,3392,1187200,11159209,11.91
9852009,9982982,3923,1373050,11356032,13.75
9852010,2331927,491,171850,2503777,7.37
9852011,2575635,1183,414050,2989685,16.08
9852012,2329956,2583,904050,3234006,38.80
9852013,9971059,3280,1148000,11119059,11.51
9852014,9976596,3498,1224300,11200896,12.27
9852015,8938679,1842,644700,9583379,7.21
9852017,2174639,1418,496300,2670939,22.82
9852018,9935008,2875,1006250,10941258,10.13
9852019,9955942,2638,923300,10879242,9.27
9852020,9928830,3019,1056650,10985480,10.64
9852021,2128966,429,150150,2279116,7.05
9852023,9924663,4484,1569400,11494063,15.81
9852024,9932702,3804,1331400,11264102,13.40
9852025,9955751,5274,1845900,11801651,18.54
9852026,9917656,2278,797300,10714956,8.04
9852027,9927870,5019,1756650,11684520,17.69
9852028,9925988,1094,382900,10308888,3.86
9852029,9937117,6094,2132900,12070017,21.46
9852030,9940778,1796,628600,10569378,6.32
9852031,9939502,3449,1207150,11146652,12.14
9852033,8703544,1687,590450,9293994,6.78
9852034,9917745,4795,1678250,11595995,16.92
9852035,9937278,4314,1509900,11447178,15.19
9852036,9934495,3114,1089900,11024395,10.97
9852037,9942061,2786,975100,10917161,9.81
9852038,9966033,4242,1484700,11450733,14.90
9852039,9948763,2466,863100,10811863,8.68
9852040,9902690,4929,1725150,11627840,17.42
9852041,7971191,5491,1921850,9893041,24.11
9852042,9948172,2780,973000,10921172,9.78
9852043,9943892,5344,1870400,11814292,18.81
9852044,9953234,1031,360850,10314084,3.63
9852045,9054619,5480,1918000,10972619,21.18
9852046,8769881,4189,1466150,10236031,16.72
9852047,9964509,4428,1549800,11514309,15.55
9852048,9948560,5915,2070250,12018810,20.81
9852050,1876970,1712,599200,2476170,31.92
9852052,9953305,5402,1890700,11844005,19.00
9852053,9957816,3979,1392650,11350466,13.99
9852054,9963660,7322,2562700,12526360,25.72
9852055,9977024,2367,828450,10805474,8.30
9852056,6336242,1601,560350,6896592,8.84
9852057,9966335,6655,2329250,12295585,23.37
9852058,9959429,4094,1432900,11392329,14.39
9852059,9971030,3534,1236900,11207930,12.40
9852060,9974944,4556,1594600,11569544,15.99
9852061,9970406,3847,1346450,11316856,13.50
9852062,9966460,325,113750,10080210,1.14
9852063,9949933,5875,2056250,12006183,20.67
9852064,9984114,3268,1143800,11127914,11.46
9852065,9988250,5714,1999900,11988150,20.02
9852066,9995782,4878,1707300,11703082,17.08
9852067,541383,100,35000,576383,6.46
9852068,9952682,5352,1873200,11825882,18.82
9852069,9987218,2603,911050,10898268,9.12
9852070,9989390,3547,1241450,11230840,12.43
9852071,487736,285,99750,587486,20.45
9852072,9898269,3260,1141000,11039269,11.53
9852073,194267,166,58100,252367,29.91
9852074,9957838,4355,1524250,11482088,15.31
9852075,9941664,3832,1341200,11282864,13.49
9852076,9937535,6517,2280950,12218485,22.95
9852077,9936191,3921,1372350,11308541,13.81
9852078,1028547,113,39550,1068097,3.85
9852079,9958343,2145,750750,10709093,7.54
9852080,9962540,3351,1172850,11135390,11.77
9852081,9959047,935,327250,10286297,3.29
9852082,9961906,1690,591500,10553406,5.94
9852083,9960379,4789,1676150,11636529,16.83
9852084,9965167,2764,967400,10932567,9.71
9852085,9960302,1405,491750,10452052,4.94
9852086,9957827,2871,1004850,10962677,10.09
9852087,9969025,1011,353850,10322875,3.55
9852088,9972373,1286,450100,10422473,4.51
9852089,9096490,2489,871150,9967640,9.58
9852090,8997319,2297,803950,9801269,8.94
9852091,8970612,3009,1053150,10023762,11.74
9852092,9980595,4586,1605100,11585695,16.08
9852093,9997855,3980,1393000,11390855,13.93
9852094,9991668,3994,1397900,11389568,13.99
9852095,9995118,4427,1549450,11544568,15.50
9852096,9972702,5258,1840300,11813002,18.45
9852097,9981662,1827,639450,10621112,6.41
9852098,9988092,901,315350,10303442,3.16
9852099,9983461,1030,360500,10343961,3.61
9852100,9736509,1537,537950,10274459,5.53
9852101,9982399,644,225400,10207799,2.26
9852102,9986588,1172,410200,10396788,4.11
9852103,9978935,2532,886200,10865135,8.88
9852104,9764140,3970,1389500,11153640,14.23
9852105,9936605,4066,1423100,11359705,14.32
9852106,9979311,3847,1346450,11325761,13.49
9852107,9981353,3599,1259650,11241003,12.62
9852108,9982926,2216,775600,10758526,7.77
9852109,9959918,6713,2349550,12309468,23.59
9852110,2094516,742,259700,2354216,12.40
9852111,9983002,5512,1929200,11912202,19.32
9852112,5701821,3130,1095500,6797321,19.21
9852113,9899330,3300,1155000,11054330,11.67
9852114,9983841,3232,1131200,11115041,11.33
9852115,9987446,2401,840350,10827796,8.41
9852116,3227655,720,252000,3479655,7.81
9852117,3073687,806,282100,3355787,9.18
9852118,9986600,1385,484750,10471350,4.85
9852119,9991206,2284,799400,10790606,8.00
9852120,9979921,5702,1995700,11975621,20.00
9852121,9971632,6274,2195900,12167532,22.02
9852122,2057279,1084,379400,2436679,18.44
9852123,9986981,3187,1115450,11102431,11.17
9852124,9992230,2514,879900,10872130,8.81
9852125,758559,205,71750,830309,9.46
9852126,9980648,3093,1082550,11063198,10.85
9852127,9902315,5630,1970500,11872815,19.90
9852128,9128146,3342,1169700,10297846,12.81
9852129,9860917,3836,1342600,11203517,13.62
9852130,9874133,4794,1677900,11552033,16.99
9852131,9872105,2593,907550,10779655,9.19
9852132,9994928,4344,1520400,11515328,15.21
9852133,9980213,3580,1253000,11233213,12.55
9852136,9968619,4586,1605100,11573719,16.10
9852137,1713748,621,217350,1931098,12.68
9852138,615821,267,93450,709271,15.17
9852139,9982348,3515,1230250,11212598,12.32
9852140,9988496,3106,1087100,11075596,10.88
9852141,9988862,6017,2105950,12094812,21.08
9852142,9983100,2837,992950,10976050,9.95
9852143,1946382,1053,368550,2314932,18.94
9852144,9991306,2776,971600,10962906,9.72
9852145,9989951,5780,2023000,12012951,20.25
9852146,8982652,3421,1197350,10180002,13.33
9852147,9981845,7153,2503550,12485395,25.08
9852148,8841279,3224,1128400,9969679,12.76
9852149,9993553,3415,1195250,11188803,11.96
9852150,9968464,5676,1986600,11955064,19.93
9852151,9990416,6341,2219350,12209766,22.21
9852152,9976150,3120,1092000,11068150,10.95
9852153,9992714,5762,2016700,12009414,20.18
9852154,5717130,1906,667100,6384230,11.67
9852155,9978761,3887,1360450,11339211,13.63
9852156,9984888,5900,2065000,12049888,20.68
9852157,9970095,4676,1636600,11606695,16.42
9852158,2917834,1779,622650,3540484,21.34
9852159,9966940,2388,835800,10802740,8.39
9852160,9972310,6313,2209550,12181860,22.16
9852161,9892642,5075,1776250,11668892,17.96
9852162,9977900,4202,1470700,11448600,14.74
9852163,9971142,4357,1524950,11496092,15.29
9852164,9954082,4477,1566950,11521032,15.74
9852165,9968208,2964,1037400,11005608,10.41
9852166,936756,590,206500,1143256,22.04
9852167,9950902,6119,2141650,12092552,21.52
9852168,8945579,4745,1660750,10606329,18.57
9852169,9934640,3290,1151500,11086140,11.59
9852170,9954570,3498,1224300,11178870,12.30
9852171,9955304,2387,835450,10790754,8.39
9852172,9948988,5255,1839250,11788238,18.49
9852173,3700523,1700,595000,4295523,16.08
9852174,6910532,5372,1880200,8790732,27.21
9852175,9961949,2767,968450,10930399,9.72
9852176,9972540,1949,682150,10654690,6.84
9852178,9998517,1993,697550,10696067,6.98
9852179,9988048,3864,1352400,11340448,13.54
9852180,9986496,4823,1688050,11674546,16.90
9852181,9971860,4767,1668450,11640310,16.73
9852182,9986432,3402,1190700,11177132,11.92
9852183,9995806,2367,828450,10824256,8.29
9852184,9979997,3180,1113000,11092997,11.15
9852185,9970720,5254,1838900,11809620,18.44
9852186,9977838,5454,1908900,11886738,19.13
9852187,9961241,6125,2143750,12104991,21.52
9852188,9955495,3105,1086750,11042245,10.92
9852189,1803913,1305,456750,2260663,25.32
9852190,9951864,4715,1650250,11602114,16.58
9852191,9930799,3973,1390550,11321349,14.00
9852192,9953311,3729,1305150,11258461,13.11
9852193,9947924,4749,1662150,11610074,16.71
9852195,9954692,4434,1551900,11506592,15.59
9852196,9940107,8030,2810500,12750607,28.27
9852197,9860998,4821,1687350,11548348,17.11
9852198,9948732,1078,377300,10326032,3.79
9852199,9947804,3171,1109850,11057654,11.16
9852200,9949721,6592,2307200,12256921,23.19
9852201,9964496,3667,1283450,11247946,12.88
9852202,9976476,1873,655550,10632026,6.57
9852203,9974961,3680,1288000,11262961,12.91
9852205,9960959,2936,1027600,10988559,10.32
9852206,9938558,3759,1315650,11254208,13.24
9852207,9983442,4205,1471750,11455192,14.74
9852208,9984387,3353,1173550,11157937,11.75
9852209,9990800,3949,1382150,11372950,13.83
9852210,2113601,377,131950,2245551,6.24
9852211,9969388,5013,1754550,11723938,17.60
9852212,9987166,4621,1617350,11604516,16.19
9852213,1298998,491,171850,1470848,13.23
9852214,2591132,851,297850,2888982,11.49
9852215,3233239,210,73500,3306739,2.27
9852216,9958762,4457,1559950,11518712,15.66
9852217,9993006,2948,1031800,11024806,10.33
9852218,1469579,636,222600,1692179,15.15
9852219,9964250,3045,1065750,11030000,10.70
9852220,9956562,3722,1302700,11259262,13.08
9852221,9955641,3902,1365700,11321341,13.72
9852222,9949084,2571,899850,10848934,9.04
9852223,4296350,1220,427000,4723350,9.94
9852224,9945874,3586,1255100,11200974,12.62
9852225,9951900,5096,1783600,11735500,17.92
9852226,9938815,3868,1353800,11292615,13.62
9852227,9709673,3483,1219050,10928723,12.56
9852228,9655954,5204,1821400,11477354,18.86
9852229,1063703,674,235900,1299603,22.18
9852230,9870890,4396,1538600,11409490,15.59
9852231,9968210,3544,1240400,11208610,12.44
9852232,9969540,4900,1715000,11684540,17.20
9852233,9965353,3455,1209250,11174603,12.13
9852234,9975224,4396,1538600,11513824,15.42
9852235,9980772,4469,1564150,11544922,15.67
9852236,9967667,1770,619500,10587167,6.22
9852237,521881,240,84000,605881,16.10
9852238,9944460,2719,951650,10896110,9.57
9852239,9955686,5738,2008300,11963986,20.17
9852241,9972887,5980,2093000,12065887,20.99
9852242,9942369,4665,1632750,11575119,16.42
9852243,9993917,5043,1765050,11758967,17.66
9852244,8246671,655,229250,8475921,2.78
9852245,9993633,5757,2014950,12008583,20.16
9852246,9998486,2072,725200,10723686,7.25
9852247,3315053,240,84000,3399053,2.53
9852248,5313973,3045,1065750,6379723,20.06
9852249,6424756,1676,586600,7011356,9.13
9852250,9961162,6822,2387700,12348862,23.97
9852251,9968396,4965,1737750,11706146,17.43
9852252,8989395,3060,1071000,10060395,11.91
9852253,9987767,4333,1516550,11504317,15.18
9852254,9983067,4779,1672650,11655717,16.75
9852255,9966608,2606,912100,10878708,9.15
9852256,8975105,2933,1026550,10001655,11.44
9852257,9981521,3416,1195600,11177121,11.98
9852258,9884620,4280,1498000,11382620,15.15
9852259,3541526,625,218750,3760276,6.18
9852260,9960954,6655,2329250,12290204,23.38
9852261,9478921,6841,2394350,11873271,25.26
9852262,9966307,7516,2630600,12596907,26.39
9852263,3177639,454,158900,3336539,5.00
9852264,9979084,3465,1212750,11191834,12.15
9852265,9987100,4833,1691550,11678650,16.94
9852266,9980367,4002,1400700,11381067,14.03
9852267,9981963,4218,1476300,11458263,14.79
9852268,9979972,4116,1440600,11420572,14.43
9852269,9990578,3646,1276100,11266678,12.77
9852270,9971106,1631,570850,10541956,5.73
9852271,3798825,362,126700,3925525,3.34
9852272,9986848,4162,1456700,11443548,14.59
9852273,2261011,2159,755650,3016661,33.42
9852274,9968930,4659,1630650,11599580,16.36
9852277,9968384,4492,1572200,11540584,15.77
9852278,391801,130,45500,437301,11.61
9852279,9968423,6542,2289700,12258123,22.97
9852280,9984378,3960,1386000,11370378,13.88
9852281,2517417,859,300650,2818067,11.94
9852282,9969809,5646,1976100,11945909,19.82
9852283,9965911,4021,1407350,11373261,14.12
9852284,9952629,4852,1698200,11650829,17.06
9852285,9953305,3284,1149400,11102705,11.55
9852286,9956920,3193,1117550,11074470,11.22
9852287,9959112,4051,1417850,11376962,14.24
9852288,9967897,3929,1375150,11343047,13.80
9852289,9971489,4878,1707300,11678789,17.12
9852290,9979390,2030,710500,10689890,7.12
9852291,1131408,404,141400,1272808,12.50
9852292,2247266,1795,628250,2875516,27.96
9852293,9970143,3146,1101100,11071243,11.04
9852294,9979659,5404,1891400,11871059,18.95
9852295,9978189,4095,1433250,11411439,14.36
9852297,9983745,2940,1029000,11012745,10.31
9852298,9984445,5088,1780800,11765245,17.84
9852299,1022306,531,185850,1208156,18.18
9852300,9936893,3521,1232350,11169243,12.40
9852301,9972192,4173,1460550,11432742,14.65
9852302,9978847,2243,785050,10763897,7.87
9852303,9985508,3567,1248450,11233958,12.50
9852304,9984486,3349,1172150,11156636,11.74
9852305,9979952,2852,998200,10978152,10.00
9852306,602293,289,101150,703443,16.79
9852307,8510657,2327,814450,9325107,9.57
9852308,9989723,6196,2168600,12158323,21.71
9852309,9917402,1749,612150,10529552,6.17
9852310,4766290,1106,387100,5153390,8.12
9852311,9966692,5088,1780800,11747492,17.87
9852312,9989581,2747,961450,10951031,9.62
9852313,9979737,2985,1044750,11024487,10.47
9852314,9983396,1538,538300,10521696,5.39
9852315,9974979,2453,858550,10833529,8.61
9852316,5420380,3427,1199450,6619830,22.13
9852317,9957328,4012,1404200,11361528,14.10
9852318,9943309,4193,1467550,11410859,14.76
9852319,9947046,1449,507150,10454196,5.10
9852320,9950520,3832,1341200,11291720,13.48
9852321,9944829,7932,2776200,12721029,27.92
9852322,9951457,4289,1501150,11452607,15.08
9852323,9965656,3831,1340850,11306506,13.45
9852324,9966810,5525,1933750,11900560,19.40
9852325,9959728,4341,1519350,11479078,15.25
9852326,5515399,3462,1211700,6727099,21.97
9852327,9966963,2708,947800,10914763,9.51
9852329,9963375,3942,1379700,11343075,13.85
9852330,1308103,387,135450,1443553,10.35
9852331,4341059,544,190400,4531459,4.39
9852332,9963857,4090,1431500,11395357,14.37
9852333,9988217,3044,1065400,11053617,10.67
9852334,782834,328,114800,897634,14.66
9852335,9951325,3735,1307250,11258575,13.14
9852336,9961910,4787,1675450,11637360,16.82
9852337,9947462,3723,1303050,11250512,13.10
9852339,9305044,2454,858900,10163944,9.23
9852340,9948445,3661,1281350,11229795,12.88
9852341,9927852,2324,813400,10741252,8.19
9852342,9946763,3857,1349950,11296713,13.57
9852344,9935801,3261,1141350,11077151,11.49
9852345,9939034,1641,574350,10513384,5.78
9852346,9952399,4923,1723050,11675449,17.31
9852347,9950795,2926,1024100,10974895,10.29
9852349,1573757,317,110950,1684707,7.05
9852350,9980705,5477,1916950,11897655,19.21
9852351,9975197,3896,1363600,11338797,13.67
9852353,9979679,2728,954800,10934479,9.57
9852354,9972575,1669,584150,10556725,5.86
9852355,9963735,4170,1459500,11423235,14.65
9852356,9967333,4337,1517950,11485283,15.23
9852358,3420858,1805,631750,4052608,18.47
9852359,9968187,4085,1429750,11397937,14.34
9852360,9951001,3675,1286250,11237251,12.93
9852361,9979679,1408,492800,10472479,4.94
9852362,9993084,2180,763000,10756084,7.64
9852363,1306213,1778,622300,1928513,47.64
9852365,9968559,3955,1384250,11352809,13.89
9852366,9976064,1272,445200,10421264,4.46
9852367,9948857,3877,1356950,11305807,13.64
9852368,9962388,2657,929950,10892338,9.33
9852369,9954121,1859,650650,10604771,6.54
9852370,9959312,1469,514150,10473462,5.16
9852371,9941943,1440,504000,10445943,5.07
9852372,8673122,2429,850150,9523272,9.80
9852373,9941749,3650,1277500,11219249,12.85
9852374,9898948,3236,1132600,11031548,11.44
9852375,3557655,2130,745500,4303155,20.95
9852376,9935727,4841,1694350,11630077,17.05
9852377,9945923,2254,788900,10734823,7.93
9852378,647884,458,160300,808184,24.74
9852379,9951668,4889,1711150,11662818,17.19
9852380,2662083,194,67900,2729983,2.55
9852381,9941926,1625,568750,10510676,5.72
9852382,9949601,3632,1271200,11220801,12.78
9852383,5199051,1948,681800,5880851,13.11
9852384,9924580,2709,948150,10872730,9.55
9852385,1482390,477,166950,1649340,11.26
9852386,9912049,3906,1367100,11279149,13.79
9852387,9913144,2207,772450,10685594,7.79
9852388,147590,68,23800,171390,16.13
9852389,9943491,936,327600,10271091,3.29
9852390,9952601,382,133700,10086301,1.34
9852391,9926661,4568,1598800,11525461,16.11
9852393,9953911,1581,553350,10507261,5.56
9852394,9964327,4310,1508500,11472827,15.14
9852395,9961033,1467,513450,10474483,5.15
9852396,9967302,199,69650,10036952,0.70
9852397,9948648,2807,982450,10931098,9.88
9852398,9953672,5474,1915900,11869572,19.25
9852399,9961443,5002,1750700,11712143,17.57
9852400,9931706,2750,962500,10894206,9.69
9852401,9971755,171,59850,10031605,0.60
9852402,9991289,1270,444500,10435789,4.45
9852403,8981840,3843,1345050,10326890,14.98
9852404,9974409,2452,858200,10832609,8.60
9852405,9984891,1767,618450,10603341,6.19
9852406,3079551,2202,770700,3850251,25.03
9852407,9968883,4242,1484700,11453583,14.89
9852408,9984026,2738,958300,10942326,9.60
9852409,3157483,3095,1083250,4240733,34.31
9852410,9977280,4419,1546650,11523930,15.50
9852411,9998717,5559,1945650,11944367,19.46
9852412,9988699,2998,1049300,11037999,10.50
9852413,2861247,251,87850,2949097,3.07
9852414,9861872,6465,2262750,12124622,22.94
9852415,9838618,2894,1012900,10851518,10.30
9852416,9793086,4021,1407350,11200436,14.37
9852417,1578142,1734,606900,2185042,38.46
9852418,9979430,3524,1233400,11212830,12.36
9852419,1477505,1107,387450,1864955,26.22
9852420,2839344,1276,446600,3285944,15.73
9852421,9973289,3250,1137500,11110789,11.41
9852422,9958245,2814,984900,10943145,9.89
9852423,9971872,1836,642600,10614472,6.44
9852424,9893851,1794,627900,10521751,6.35
9852426,9945634,2919,1021650,10967284,10.27
9852427,9930855,5164,1807400,11738255,18.20
9852428,9967960,3154,1103900,11071860,11.07
9852429,9985820,276,96600,10082420,0.97
9852430,7374684,1117,390950,7765634,5.30
9852431,3859972,2359,825650,4685622,21.39
9852432,9942346,2352,823200,10765546,8.28
9852433,9947926,3284,1149400,11097326,11.55
9852434,9942867,787,275450,10218317,2.77
9852435,9964995,1971,689850,10654845,6.92
9852436,9943292,1409,493150,10436442,4.96
9852437,9909770,1096,383600,10293370,3.87
9852438,9934967,246,86100,10021067,0.87
9852439,9934557,3670,1284500,11219057,12.93
9852440,542684,148,51800,594484,9.55
9852441,9922750,4216,1475600,11398350,14.87
9852442,9943207,3047,1066450,11009657,10.73
9852443,9949483,3480,1218000,11167483,12.24
9852444,9927833,2705,946750,10874583,9.54
9852445,9937131,4949,1732150,11669281,17.43
9852446,9923795,2001,700350,10624145,7.06
9852447,762746,179,62650,825396,8.21
9852448,9918030,615,215250,10133280,2.17
9852449,2889861,2079,727650,3617511,25.18
9852450,9924422,3458,1210300,11134722,12.20
9852451,9924643,3016,1055600,10980243,10.64
9852452,9926984,2910,1018500,10945484,10.26
9852453,9937863,1522,532700,10470563,5.36
9852454,847912,310,108500,956412,12.80
9852455,9954501,4404,1541400,11495901,15.48
9852456,9953633,5941,2079350,12032983,20.89
9852457,9970039,3835,1342250,11312289,13.46
9852458,9960547,2873,1005550,10966097,10.10
9852459,9957142,3841,1344350,11301492,13.50
9852460,9968278,4888,1710800,11679078,17.16
9852461,9988461,2399,839650,10828111,8.41
9852462,9991119,2052,718200,10709319,7.19
9852463,9970135,4263,1492050,11462185,14.97
9852464,9980827,2040,714000,10694827,7.15
9852465,9991209,3075,1076250,11067459,10.77
9852466,9987706,1357,474950,10462656,4.76
9852467,571216,343,120050,691266,21.02
9852468,9971762,2658,930300,10902062,9.33
9852469,9968445,4291,1501850,11470295,15.07
9852470,5914272,1697,593950,6508222,10.04
9852471,9983607,4569,1599150,11582757,16.02
9852472,2530777,1061,371350,2902127,14.67
9852473,9971701,4257,1489950,11461651,14.94
9852474,9968765,2329,815150,10783915,8.18
9852475,9989757,2905,1016750,11006507,10.18
9852476,9980509,5890,2061500,12042009,20.66
9852477,9980354,760,266000,10246354,2.67
9852478,367806,371,129850,497656,35.30
9852479,9961350,3929,1375150,11336500,13.80
9852480,9957122,3065,1072750,11029872,10.77
9852481,9953839,3632,1271200,11225039,12.77
9852483,9977549,2554,893900,10871449,8.96
9852484,9977033,2498,874300,10851333,8.76
9852486,9951141,4608,1612800,11563941,16.21
9852487,9988129,2717,950950,10939079,9.52
9852488,9996007,697,243950,10239957,2.44
9852489,1534983,804,281400,1816383,18.33
9852490,9478086,2948,1031800,10509886,10.89
9852491,9996509,2319,811650,10808159,8.12
9852492,6981232,3781,1323350,8304582,18.96
9852493,9989398,4528,1584800,11574198,15.86
9852495,9983350,5117,1790950,11774300,17.94
9852496,9980105,3432,1201200,11181305,12.04
9852497,9975256,5591,1956850,11932106,19.62
9852498,9999097,4915,1720250,11719347,17.20
9852500,9965590,4845,1695750,11661340,17.02
9852501,9988975,3355,1174250,11163225,11.76
9852502,9990807,2855,999250,10990057,10.00
9852503,404613,245,85750,490363,21.19
9852504,9986009,8058,2820300,12806309,28.24
9852505,9986001,6988,2445800,12431801,24.49
9852506,9962326,678,237300,10199626,2.38
9852507,9998537,3202,1120700,11119237,11.21
9852508,9985799,577,201950,10187749,2.02
9852509,6461927,1956,684600,7146527,10.59
9852510,6489208,3769,1319150,7808358,20.33
9852511,9047863,2636,922600,9970463,10.20
9852512,9990683,5645,1975750,11966433,19.78
9852513,9986358,2977,1041950,11028308,10.43
9852514,1236841,646,226100,1462941,18.28
9852515,9989238,3277,1146950,11136188,11.48
9852516,9962287,2742,959700,10921987,9.63
9852517,9960128,315,110250,10070378,1.11
9852518,1977755,517,180950,2158705,9.15
9852519,9997816,5451,1907850,11905666,19.08
9852520,9968859,1331,465850,10434709,4.67
9852521,3826495,600,210000,4036495,5.49
9852522,1732288,1495,523250,2255538,30.21
9852523,9974772,4003,1401050,11375822,14.05
9852524,1599604,712,249200,1848804,15.58
9852525,9961229,5146,1801100,11762329,18.08
9852526,9985917,2081,728350,10714267,7.29
9852527,9959033,3794,1327900,11286933,13.33
9852528,9936070,2477,866950,10803020,8.73
9852529,9971668,1138,398300,10369968,3.99
9852530,9986094,4807,1682450,11668544,16.85
9852531,243023,83,29050,272073,11.95
9852532,9952536,1277,446950,10399486,4.49
9852533,9956557,3631,1270850,11227407,12.76
9852534,9967574,4267,1493450,11461024,14.98
9852536,9977907,292,102200,10080107,1.02
9852537,9980482,4078,1427300,11407782,14.30
9852538,1363785,484,169400,1533185,12.42
9852539,9987068,5863,2052050,12039118,20.55
9852540,1034777,638,223300,1258077,21.58
9852541,1292354,755,264250,1556604,20.45
9852542,9972502,3378,1182300,11154802,11.86
9852543,9966544,4098,1434300,11400844,14.39
9852544,9985037,6511,2278850,12263887,22.82
9852545,9972721,2133,746550,10719271,7.49
9852546,8980774,2459,860650,9841424,9.58
9852547,9994045,6536,2287600,12281645,22.89
9852548,9980076,2113,739550,10719626,7.41
9852549,9994493,243,85050,10079543,0.85
9852550,9996420,8313,2909550,12905970,29.11
9852551,9989005,1550,542500,10531505,5.43
9852552,9995330,3452,1208200,11203530,12.09
9852553,9990903,637,222950,10213853,2.23
9852554,9970816,6404,2241400,12212216,22.48
9852555,6243209,2064,722400,6965609,11.57
9852556,9961430,3247,1136450,11097880,11.41
9852557,1072968,386,135100,1208068,12.59
9852560,592294,220,77000,669294,13.00
9852561,83197,42,14700,97897,17.67
9852562,9975874,3805,1331750,11307624,13.35
9852563,9980428,1690,591500,10571928,5.93
9852564,9968883,4576,1601600,11570483,16.07
9852565,9981959,4440,1554000,11535959,15.57
9852566,9986190,5086,1780100,11766290,17.83
9852567,9980160,1228,429800,10409960,4.31
9852568,9944581,1344,470400,10414981,4.73
9852569,9980469,2824,988400,10968869,9.90
9852570,9983148,3792,1327200,11310348,13.29
9852571,9989606,1992,697200,10686806,6.98
9852572,9959746,66,23100,9982846,0.23
9852573,9975929,5645,1975750,11951679,19.81
9852574,9985023,1177,411950,10396973,4.13
9852575,140462,123,43050,183512,30.65
9852577,9941134,3656,1279600,11220734,12.87
9852578,9956701,660,231000,10187701,2.32
9852579,9969018,2420,847000,10816018,8.50
9852580,9851270,2271,794850,10646120,8.07
9852581,427983,174,60900,488883,14.23
9852582,9981514,5619,1966650,11948164,19.70
9852583,9979374,3451,1207850,11187224,12.10
9852584,9989861,3006,1052100,11041961,10.53
9852585,9989646,3023,1058050,11047696,10.59
9852586,2486240,1618,566300,3052540,22.78
9852587,9969064,1378,482300,10451364,4.84
9852588,9950988,2738,958300,10909288,9.63
9852589,9978003,4252,1488200,11466203,14.91
9852590,866541,148,51800,918341,5.98
9852591,9963712,3802,1330700,11294412,13.36
9852592,9971736,1065,372750,10344486,3.74
9852593,9963262,1537,537950,10501212,5.40
9852594,9969493,3636,1272600,11242093,12.76
9852595,9964558,4208,1472800,11437358,14.78
9852596,9961697,968,338800,10300497,3.40
9852597,9972521,489,171150,10143671,1.72
9852598,1049185,750,262500,1311685,25.02
9852599,9957254,4343,1520050,11477304,15.27
9852600,9945873,2530,885500,10831373,8.90
9852601,9939521,1210,423500,10363021,4.26
9852602,9935995,414,144900,10080895,1.46
9852603,9715430,4191,1466850,11182280,15.10
9852604,9965117,1178,412300,10377417,4.14
9852605,9963108,1014,354900,10318008,3.56
9852606,9948074,5103,1786050,11734124,17.95
9852607,8967738,2410,843500,9811238,9.41
9852608,9936688,4785,1674750,11611438,16.85
9852609,9977532,4351,1522850,11500382,15.26
9852610,2190810,623,218050,2408860,9.95
9852611,9952990,2474,865900,10818890,8.70
9852612,1505139,720,252000,1757139,16.74
9852613,6727752,2982,1043700,7771452,15.51
9852614,9952101,6349,2222150,12174251,22.33
9852615,9964147,2366,828100,10792247,8.31
9852616,9963332,4257,1489950,11453282,14.95
9852617,1319682,662,231700,1551382,17.56
9852618,9971433,5543,1940050,11911483,19.46
9852619,3130378,1274,445900,3576278,14.24
9852620,9968546,4715,1650250,11618796,16.55
9852622,9957667,1887,660450,10618117,6.63
9852623,9981218,3814,1334900,11316118,13.37
9852624,9852635,2106,737100,10589735,7.48
9852625,9968245,5149,1802150,11770395,18.08
9852626,9980936,763,267050,10247986,2.68
9852627,9983301,3900,1365000,11348301,13.67
9852628,9994724,2971,1039850,11034574,10.40
9852629,9973349,862,301700,10275049,3.03
9852630,9990198,1478,517300,10507498,5.18
9852631,9979986,3187,1115450,11095436,11.18
9852632,9994572,3282,1148700,11143272,11.49
9852633,1031637,249,87150,1118787,8.45
9852634,104067,104,36400,140467,34.98
9852635,9989741,3598,1259300,11249041,12.61
9852636,9987824,1433,501550,10489374,5.02
9852637,9979037,3133,1096550,11075587,10.99
9852638,9986596,1351,472850,10459446,4.73
9852639,303146,225,78750,381896,25.98
9852640,9951146,3361,1176350,11127496,11.82
9852641,9951299,3200,1120000,11071299,11.25
9852642,2049251,516,180600,2229851,8.81
9852643,9956125,2869,1004150,10960275,10.09
9852644,9949207,1537,537950,10487157,5.41
9852645,9972754,3048,1066800,11039554,10.70
9852646,9957818,1214,424900,10382718,4.27
9852647,9955543,4980,1743000,11698543,17.51
9852649,9964219,3095,1083250,11047469,10.87
9852650,9969055,2478,867300,10836355,8.70
9852651,9977613,3483,1219050,11196663,12.22
9852652,9976276,1306,457100,10433376,4.58
9852653,9991770,3374,1180900,11172670,11.82
9852654,9992550,4068,1423800,11416350,14.25
9852655,8979502,4030,1410500,10390002,15.71
9852656,9984767,6143,2150050,12134817,21.53
9852657,9995859,1638,573300,10569159,5.74
9852658,9995082,5948,2081800,12076882,20.83
9852659,9996107,6223,2178050,12174157,21.79
9852660,9988056,3354,1173900,11161956,11.75
9852661,8987608,4992,1747200,10734808,19.44
9852662,9984047,3916,1370600,11354647,13.73
9852663,9983764,5941,2079350,12063114,20.83
9852664,9974517,4060,1421000,11395517,14.25
9852665,3253153,1726,604100,3857253,18.57
9852666,9985219,4292,1502200,11487419,15.04
9852667,9963877,4024,1408400,11372277,14.14
9852668,9999109,1190,416500,10415609,4.17
9852669,9825225,283,99050,9924275,1.01
9852670,9989415,3860,1351000,11340415,13.52
9852672,9988573,2084,729400,10717973,7.30
9852673,8982898,5808,2032800,11015698,22.63
9852674,9996770,6114,2139900,12136670,21.41
9852675,9896455,1362,476700,10373155,4.82
9852676,9987551,2990,1046500,11034051,10.48
9852677,9978725,232,81200,10059925,0.81
9852678,1842247,876,306600,2148847,16.64
9852679,9971591,4261,1491350,11462941,14.96
9852680,1640097,853,298550,1938647,18.20
9852682,9968174,2005,701750,10669924,7.04
9852683,9961282,2092,732200,10693482,7.35
9852684,9983793,2650,927500,10911293,9.29
9852685,9995168,3444,1205400,11200568,12.06
9852686,1539085,62,21700,1560785,1.41
9852687,9981502,1603,561050,10542552,5.62
9852688,9963643,1321,462350,10425993,4.64
9852689,9976224,1013,354550,10330774,3.55
9852690,9985206,942,329700,10314906,3.30
9852691,9991653,3548,1241800,11233453,12.43
9852692,9993231,516,180600,10173831,1.81
9852693,9995966,2196,768600,10764566,7.69
9852694,9985596,3560,1246000,11231596,12.48
9852695,9969370,3833,1341550,11310920,13.46
9852696,9991384,3125,1093750,11085134,10.95
9852697,3467109,1843,645050,4112159,18.60
9852698,9974660,4615,1615250,11589910,16.19
9852699,9973097,4601,1610350,11583447,16.15
9852700,728905,348,121800,850705,16.71
9852701,9976535,3967,1388450,11364985,13.92
9852702,9982255,5252,1838200,11820455,18.41
9852703,9960647,4838,1693300,11653947,17.00
9852704,658377,224,78400,736777,11.91
9852705,9969474,5456,1909600,11879074,19.15
9852706,9982490,3783,1324050,11306540,13.26
9852707,9990315,4054,1418900,11409215,14.20
9852708,9993217,5168,1808800,11802017,18.10
9852709,9999378,4123,1443050,11442428,14.43
9852710,452950,252,88200,541150,19.47
9852711,9982120,6238,2183300,12165420,21.87
9852712,9977650,5780,2023000,12000650,20.28
9852713,9950401,2471,864850,10815251,8.69
9852715,9988972,3084,1079400,11068372,10.81
9852716,9996880,1030,360500,10357380,3.61
9852717,9729908,5337,1867950,11597858,19.20
9852718,9982564,4886,1710100,11692664,17.13
9852719,9986608,2377,831950,10818558,8.33
9852720,9978041,3054,1068900,11046941,10.71
9852721,400748,235,82250,482998,20.52
9852722,9969643,4727,1654450,11624093,16.59
9852724,9949222,2500,875000,10824222,8.79
9852725,9952871,2300,805000,10757871,8.09
9852726,9934573,5191,1816850,11751423,18.29
9852727,9943773,6599,2309650,12253423,23.23
9852728,9958269,4605,1611750,11570019,16.19
9852729,7608068,3850,1347500,8955568,17.71
9852730,9936199,3212,1124200,11060399,11.31
9852731,9924637,2784,974400,10899037,9.82
9852732,9916469,5601,1960350,11876819,19.77
9852733,9907517,486,170100,10077617,1.72
9852734,9923246,1567,548450,10471696,5.53
9852735,9941941,2742,959700,10901641,9.65
9852736,9933106,2127,744450,10677556,7.49
9852737,9940101,5041,1764350,11704451,17.75
9852738,9909824,2573,900550,10810374,9.09
9852739,9967429,1265,442750,10410179,4.44
9852740,9961774,4342,1519700,11481474,15.26
9852741,9958957,3713,1299550,11258507,13.05
9852742,9973880,4034,1411900,11385780,14.16
9852743,9968229,4621,1617350,11585579,16.23
9852744,9501568,4871,1704850,11206418,17.94
9852745,9975061,3437,1202950,11178011,12.06
9852746,455996,131,45850,501846,10.05
9852747,9989644,6230,2180500,12170144,21.83
9852748,9953141,3918,1371300,11324441,13.78
9852749,4234753,3415,1195250,5430003,28.22
9852751,297475,131,45850,343325,15.41
9852752,8984836,4109,1438150,10422986,16.01
9852753,807890,954,333900,1141790,41.33
9852754,9989431,6353,2223550,12212981,22.26
9852755,9925578,4916,1720600,11646178,17.34
9852756,9998264,6160,2156000,12154264,21.56
9852757,9979972,4223,1478050,11458022,14.81
9852758,9990191,5334,1866900,11857091,18.69
9852759,9942578,3789,1326150,11268728,13.34
9852760,9967710,3945,1380750,11348460,13.85
9852761,9698411,4550,1592500,11290911,16.42
9852762,9990330,2102,735700,10726030,7.36
9852763,9983319,3292,1152200,11135519,11.54
9852764,9995175,1856,649600,10644775,6.50
9852765,358977,127,44450,403427,12.38
9852766,9987339,4177,1461950,11449289,14.64
9852767,9998520,2946,1031100,11029620,10.31
9852768,9987201,6349,2222150,12209351,22.25
9852769,9990140,5960,2086000,12076140,20.88
9852770,9986451,4875,1706250,11692701,17.09
9852771,9959245,2088,730800,10690045,7.34
9852772,9977999,6912,2419200,12397199,24.25
9852773,9973973,5939,2078650,12052623,20.84
9852774,9996158,5018,1756300,11752458,17.57
9852775,9986555,5663,1982050,11968605,19.85
9852776,9986022,5122,1792700,11778722,17.95
9852777,9983802,3927,1374450,11358252,13.77
9852778,9990631,4532,1586200,11576831,15.88
9852779,9998249,5828,2039800,12038049,20.40
9852780,9999339,2332,816200,10815539,8.16
9852781,9964349,2482,868700,10833049,8.72
9852782,9980256,2418,846300,10826556,8.48
9852783,1421685,469,164150,1585835,11.55
9852784,9950662,4985,1744750,11695412,17.53
9852786,9975895,2109,738150,10714045,7.40
9852787,9957708,2117,740950,10698658,7.44
9852788,9962999,6203,2171050,12134049,21.79
9852789,9960720,845,295750,10256470,2.97
9852790,9977962,3345,1170750,11148712,11.73
9852791,9964249,506,177100,10141349,1.78
9852792,9967062,1489,521150,10488212,5.23
9852793,9966731,3515,1230250,11196981,12.34
9852794,9974944,2398,839300,10814244,8.41
9852795,9974655,1692,592200,10566855,5.94
9852796,9978852,1457,509950,10488802,5.11
9852797,9982206,2075,726250,10708456,7.28
9852798,9945471,5434,1901900,11847371,19.12
9852799,2006874,1470,514500,2521374,25.64
9852800,9977249,4139,1448650,11425899,14.52
9852801,9978931,3461,1211350,11190281,12.14
9852802,2408878,1012,354200,2763078,14.70
9852803,9954997,1803,631050,10586047,6.34
9852804,9970621,709,248150,10218771,2.49
9852805,9970178,1244,435400,10405578,4.37
9852807,9976762,1177,411950,10388712,4.13
9852808,9992675,3547,1241450,11234125,12.42
9852809,9995581,3034,1061900,11057481,10.62
9852810,9985330,4167,1458450,11443780,14.61
9852811,9975993,895,313250,10289243,3.14
9852812,9970472,2812,984200,10954672,9.87
9852813,1877861,1759,615650,2493511,32.78
9852814,9959125,2561,896350,10855475,9.00
9852815,9951938,1375,481250,10433188,4.84
9852816,2865950,1781,623350,3489300,21.75
9852817,9962397,2531,885850,10848247,8.89
9852818,9911943,948,331800,10243743,3.35
9852819,9930205,1078,377300,10307505,3.80
9852820,9930061,3310,1158500,11088561,11.67
9852821,9669333,3517,1230950,10900283,12.73
9852822,9925994,3941,1379350,11305344,13.90
9852823,9937648,5448,1906800,11844448,19.19
9852824,2569445,420,147000,2716445,5.72
9852825,9435494,4019,1406650,10842144,14.91
9852826,9925187,4494,1572900,11498087,15.85
9852827,9928634,2380,833000,10761634,8.39
9852828,8935658,1749,612150,9547808,6.85
9852829,9940410,2301,805350,10745760,8.10
9852830,9941401,2306,807100,10748501,8.12
9852831,4225280,1471,514850,4740130,12.18
9852832,9956016,4240,1484000,11440016,14.91
9852834,9933489,7019,2456650,12390139,24.73
9852835,9924972,4452,1558200,11483172,15.70
9852836,477547,226,79100,556647,16.56
9852837,9925376,4060,1421000,11346376,14.32
9852838,9926822,4356,1524600,11451422,15.36
9852839,9628811,497,173950,9802761,1.81
9852840,9937032,629,220150,10157182,2.22
9852841,9928432,1648,576800,10505232,5.81
9852842,9945692,5310,1858500,11804192,18.69
9852844,9943059,660,231000,10174059,2.32
9852845,9951808,4027,1409450,11361258,14.16
9852846,9959310,4736,1657600,11616910,16.64
9852847,9934144,4275,1496250,11430394,15.06
9852848,9962313,991,346850,10309163,3.48
9852849,1189304,460,161000,1350304,13.54
9852850,9953140,4118,1441300,11394440,14.48
9852851,9955962,4395,1538250,11494212,15.45
9852852,9966282,3339,1168650,11134932,11.73
9852853,9963479,2719,951650,10915129,9.55
9852854,9974713,3446,1206100,11180813,12.09
9852855,121976,60,21000,142976,17.22
9852857,256743,244,85400,342143,33.26
9852858,9957210,2573,900550,10857760,9.04
9852859,9971383,3140,1099000,11070383,11.02
9852860,827933,405,141750,969683,17.12
9852861,9968305,1890,661500,10629805,6.64
9852862,1774196,1339,468650,2242846,26.41
9852863,9957391,4768,1668800,11626191,16.76
9852864,9971264,3399,1189650,11160914,11.93
9852865,9967515,2731,955850,10923365,9.59
9852866,9979503,2929,1025150,11004653,10.27
9852867,9975572,1061,371350,10346922,3.72
9852868,9974690,2109,738150,10712840,7.40
9852869,9969821,5814,2034900,12004721,20.41
9852870,595087,346,121100,716187,20.35
9852871,9947747,1683,589050,10536797,5.92
9852872,9964446,2293,802550,10766996,8.05
9852873,1384073,698,244300,1628373,17.65
9852874,98491,70,24500,122991,24.88
9852875,9959001,1879,657650,10616651,6.60
9852876,9952755,3406,1192100,11144855,11.98
9852877,331220,205,71750,402970,21.66
9852878,9960808,3741,1309350,11270158,13.15
9852879,9968236,4169,1459150,11427386,14.64
9852880,9958021,2099,734650,10692671,7.38
9852881,9970614,2278,797300,10767914,8.00
9852882,9994578,3993,1397550,11392128,13.98
9852883,9982217,668,233800,10216017,2.34
9852885,1362909,1347,471450,1834359,34.59
9852887,9942627,3249,1137150,11079777,11.44
9852888,9955014,819,286650,10241664,2.88
9852889,9956257,383,134050,10090307,1.35
9852890,9979165,3962,1386700,11365865,13.90
9852891,9957284,1585,554750,10512034,5.57
9852892,9984095,950,332500,10316595,3.33
9852893,9997420,3937,1377950,11375370,13.78
9852894,9919573,1050,367500,10287073,3.70
9852895,9992505,3372,1180200,11172705,11.81
9852896,9993835,3908,1367800,11361635,13.69
9852897,9977978,2983,1044050,11022028,10.46
9852898,9972636,1700,595000,10567636,5.97
9852899,9994484,2281,798350,10792834,7.99
9852900,9988915,5742,2009700,11998615,20.12
9852901,9969837,3668,1283800,11253637,12.88
9852902,9988690,3927,1374450,11363140,13.76
9852903,792752,333,116550,909302,14.70
9852904,5251403,4034,1411900,6663303,26.89
9852905,9969915,947,331450,10301365,3.32
9852906,198761,47,16450,215211,8.28
9852907,2415861,1295,453250,2869111,18.76
9852908,9970705,1602,560700,10531405,5.62
9852909,9976580,653,228550,10205130,2.29
9852910,9970737,1686,590100,10560837,5.92
9852911,9948587,1318,461300,10409887,4.64
9852912,806289,487,170450,976739,21.14
9852913,1624441,666,233100,1857541,14.35
9852914,9952918,4752,1663200,11616118,16.71
9852915,9970032,1171,409850,10379882,4.11
9852916,9982326,575,201250,10183576,2.02
9852917,9987694,2590,906500,10894194,9.08
9852918,9968795,833,291550,10260345,2.92
9852919,8976649,3737,1307950,10284599,14.57
9852920,125067,306,107100,232167,85.63
9852921,9955813,3615,1265250,11221063,12.71
9852922,9959879,1084,379400,10339279,3.81
9852923,68209,42,14700,82909,21.55
9852924,9976431,1236,432600,10409031,4.34
9852925,9974456,4753,1663550,11638006,16.68
9852926,413551,177,61950,475501,14.98
9852927,4834604,3505,1226750,6061354,25.37
9852928,9984904,3917,1370950,11355854,13.73
9852929,518977,328,114800,633777,22.12
9852930,9970510,3351,1172850,11143360,11.76
9852931,9972143,4250,1487500,11459643,14.92
9852932,9545076,4042,1414700,10959776,14.82
9852933,9736416,3502,1225700,10962116,12.59
9852934,9734183,938,328300,10062483,3.37
9852935,9960373,2223,778050,10738423,7.81
9852936,9985780,2080,728000,10713780,7.29
9852937,2613395,768,268800,2882195,10.29
9852938,9981789,2969,1039150,11020939,10.41
9852939,522242,46,16100,538342,3.08
9852940,483287,322,112700,595987,23.32
9852941,650369,264,92400,742769,14.21
9852942,9987692,5513,1929550,11917242,19.32
9852943,9712751,1146,401100,10113851,4.13
9852944,9987006,3547,1241450,11228456,12.43
9852945,9992545,5406,1892100,11884645,18.94
9852946,181760,150,52500,234260,28.88
9852947,9974566,4945,1730750,11705316,17.35
9852948,9960248,1876,656600,10616848,6.59
9852949,52032,87,30450,82482,58.52
9852950,348210,651,227850,576060,65.43
9852951,4555753,623,218050,4773803,4.79
9852952,9293794,4368,1528800,10822594,16.45
9852953,9966972,3376,1181600,11148572,11.86
9852954,9961575,2746,961100,10922675,9.65
9852955,583860,432,151200,735060,25.90
9852956,9964833,6225,2178750,12143583,21.86
9852957,9960401,5831,2040850,12001251,20.49
9852958,9953105,7816,2735600,12688705,27.48
9852959,9975578,5098,1784300,11759878,17.89
9852960,9985509,2886,1010100,10995609,10.12
9852962,9991785,3524,1233400,11225185,12.34
9852963,9998362,3114,1089900,11088262,10.90
9852964,9891199,2380,833000,10724199,8.42
9852965,9970584,4261,1491350,11461934,14.96
9852966,9990948,1938,678300,10669248,6.79
9852967,9988733,3360,1176000,11164733,11.77
9852969,9988366,3406,1192100,11180466,11.93
9852970,9973705,4777,1671950,11645655,16.76
9852971,8982132,1412,494200,9476332,5.50
9852972,9993003,4337,1517950,11510953,15.19
9852973,9984561,1910,668500,10653061,6.70
9852974,9990882,3778,1322300,11313182,13.24
9852975,343284,197,68950,412234,20.09
9852976,9997090,3678,1287300,11284390,12.88
9852977,9997982,1903,666050,10664032,6.66
9852978,697210,1240,434000,1131210,62.25
9852979,9655593,2396,838600,10494193,8.69
9852980,9993924,3646,1276100,11270024,12.77
9852981,9964458,3253,1138550,11103008,11.43
9852982,4927382,994,347900,5275282,7.06
9852983,9972077,3815,1335250,11307327,13.39
9852984,9968502,1305,456750,10425252,4.58
9852985,9977724,2934,1026900,11004624,10.29
9852986,9970053,4767,1668450,11638503,16.73
9852987,9987342,3760,1316000,11303342,13.18
9852988,9986910,1830,640500,10627410,6.41
9852989,9973891,2288,800800,10774691,8.03
9852990,141947,101,35350,177297,24.90
9852991,2266875,777,271950,2538825,12.00
9852992,2753318,1107,387450,3140768,14.07
9852993,650881,340,119000,769881,18.28
9852994,9968633,3395,1188250,11156883,11.92
9852996,9943511,2588,905800,10849311,9.11
9852997,340381,315,110250,450631,32.39
9852998,9957629,2374,830900,10788529,8.34
9852999,9985638,2175,761250,10746888,7.62
9853000,9010502,2635,922250,9932752,10.24
9853001,9964834,2801,980350,10945184,9.84
9853003,8635544,3650,1277500,9913044,14.79
9853004,9955833,3375,1181250,11137083,11.86
9853005,9950218,2178,762300,10712518,7.66
9853006,3344881,1886,660100,4004981,19.73
9853007,9694732,5353,1873550,11568282,19.33
9853008,9943199,1422,497700,10440899,5.01
9853009,37677,29,10150,47827,26.94
9853010,5640467,944,330400,5970867,5.86
9853011,9894882,2519,881650,10776532,8.91
9853012,9897754,1977,691950,10589704,6.99
9853013,9907420,1770,619500,10526920,6.25
9853014,9894245,2842,994700,10888945,10.05
9853015,9914542,4550,1592500,11507042,16.06
9853016,9911230,2968,1038800,10950030,10.48
9853017,9687624,5263,1842050,11529674,19.01
9853018,1304387,629,220150,1524537,16.88
9853020,9556751,3229,1130150,10686901,11.83
9853021,9909687,2510,878500,10788187,8.87
9853022,9922906,4720,1652000,11574906,16.65
9853023,9938062,2921,1022350,10960412,10.29
9853024,9949005,5662,1981700,11930705,19.92
9853025,9933416,4690,1641500,11574916,16.53
9853026,9944980,3726,1304100,11249080,13.11
9853027,9948187,6180,2163000,12111187,21.74
9853028,9964302,4723,1653050,11617352,16.59
9853029,9969287,7349,2572150,12541437,25.80
9853030,9957346,3337,1167950,11125296,11.73
9853031,9974021,5259,1840650,11814671,18.45
9853032,9965396,8768,3068800,13034196,30.79
9853033,9975126,3775,1321250,11296376,13.25
9853034,5882321,4601,1610350,7492671,27.38
9853035,2943994,2848,996800,3940794,33.86
9853036,26209,42,14700,40909,56.09
9853037,3681859,3217,1125950,4807809,30.58
9853038,1221828,287,100450,1322278,8.22
9853039,9948518,3274,1145900,11094418,11.52
9853040,9942382,6984,2444400,12386782,24.59
9853041,5225984,1820,637000,5862984,12.19
9853042,9952001,5140,1799000,11751001,18.08
9853043,9959917,5192,1817200,11777117,18.25
9853044,4478620,4063,1422050,5900670,31.75
9853045,1394400,1025,358750,1753150,25.73
9853046,9949619,2021,707350,10656969,7.11
9853047,9942853,4156,1454600,11397453,14.63
9853048,1388114,1511,528850,1916964,38.10
9853049,9955560,6743,2360050,12315610,23.71
9853050,9951936,5225,1828750,11780686,18.38
9853051,921337,407,142450,1063787,15.46
9853052,9933859,6510,2278500,12212359,22.94
9853053,9140151,3318,1161300,10301451,12.71
9853054,9934643,5907,2067450,12002093,20.81
9853055,9927733,3732,1306200,11233933,13.16
9853056,9941387,5114,1789900,11731287,18.00
9853057,9946996,2869,1004150,10951146,10.10
9853058,1550186,1151,402850,1953036,25.99
9853059,9926602,6621,2317350,12243952,23.34
9853060,9953116,6907,2417450,12370566,24.29
9853061,9954769,8437,2952950,12907719,29.66
9853062,9962705,4984,1744400,11707105,17.51
9853063,9970009,6963,2437050,12407059,24.44
9853064,9959560,1118,391300,10350860,3.93
9853065,9962201,792,277200,10239401,2.78
9853066,9952985,5356,1874600,11827585,18.83
9853067,1107645,1034,361900,1469545,32.67
9853068,1296682,981,343350,1640032,26.48
9853069,9950322,5101,1785350,11735672,17.94
9853070,9937861,5130,1795500,11733361,18.07
9853071,9949468,3866,1353100,11302568,13.60
9853072,917131,522,182700,1099831,19.92
9853073,9960867,3432,1201200,11162067,12.06
9853074,9979464,5259,1840650,11820114,18.44
9853075,9972544,5195,1818250,11790794,18.23
9853076,9909146,5053,1768550,11677696,17.85
9853077,9975534,5111,1788850,11764384,17.93
9853078,9977582,4471,1564850,11542432,15.68
9853079,9994894,3657,1279950,11274844,12.81
9853080,9988179,5705,1996750,11984929,19.99
9853081,9391599,4655,1629250,11020849,17.35
9853082,9952458,5815,2035250,11987708,20.45
9853084,9979423,4374,1530900,11510323,15.34
9853085,1526554,267,93450,1620004,6.12
9853086,9960081,5389,1886150,11846231,18.94
9853088,3340220,821,287350,3627570,8.60
9853089,9704100,4037,1412950,11117050,14.56
9853090,186759,80,28000,214759,14.99
9853091,9984263,5839,2043650,12027913,20.47
9853092,9731644,5317,1860950,11592594,19.12
9853093,9905266,3714,1299900,11205166,13.12
9853094,9971144,5065,1772750,11743894,17.78
9853095,9985786,2319,811650,10797436,8.13
9853097,9981649,3039,1063650,11045299,10.66
9853098,9989769,4239,1483650,11473419,14.85
9853099,9984556,5586,1955100,11939656,19.58
9853100,9981629,2517,880950,10862579,8.83
9853101,4150566,2108,737800,4888366,17.78
9853102,9995364,2784,974400,10969764,9.75
9853103,9992913,2450,857500,10850413,8.58
9853104,9977632,569,199150,10176782,2.00
9853105,9892895,4663,1632050,11524945,16.50
9853106,9999589,4375,1531250,11530839,15.31
9853107,9714614,2169,759150,10473764,7.81
9853108,9982240,3896,1363600,11345840,13.66
9853109,9983820,5353,1873550,11857370,18.77
9853110,9980015,4302,1505700,11485715,15.09
9853111,1415779,1134,396900,1812679,28.03
9853112,9962571,4748,1661800,11624371,16.68
9853113,9968649,1481,518350,10486999,5.20
9853114,3431422,1807,632450,4063872,18.43
9853115,9921351,2970,1039500,10960851,10.48
9853116,9952843,2927,1024450,10977293,10.29
9853117,9935763,4565,1597750,11533513,16.08
9853118,9941668,6365,2227750,12169418,22.41
9853119,9953037,5671,1984850,11937887,19.94
9853120,5965687,1491,521850,6487537,8.75
9853121,9958932,1972,690200,10649132,6.93
9853122,9964165,4486,1570100,11534265,15.76
9853123,9946669,3951,1382850,11329519,13.90
9853124,8404841,3073,1075550,9480391,12.80
9853125,9945411,3525,1233750,11179161,12.41
9853126,9939124,7533,2636550,12575674,26.53
9853127,9949517,4596,1608600,11558117,16.17
9853128,9952253,3809,1333150,11285403,13.40
9853129,9933677,4851,1697850,11631527,17.09
9853130,6567409,3588,1255800,7823209,19.12
9853131,9945474,4121,1442350,11387824,14.50
9853132,1291301,322,112700,1404001,8.73
9853133,9938199,7365,2577750,12515949,25.94
9853134,710630,200,70000,780630,9.85
9853135,9955843,5711,1998850,11954693,20.08
9853136,9961218,4946,1731100,11692318,17.38
9853137,3073803,1567,548450,3622253,17.84
9853138,9951733,3619,1266650,11218383,12.73
9853139,9937741,2234,781900,10719641,7.87
9853141,9969702,4356,1524600,11494302,15.29
9853142,3450933,1732,606200,4057133,17.57
9853143,9967668,1651,577850,10545518,5.80
9853144,9970796,2655,929250,10900046,9.32
9853145,9964779,3760,1316000,11280779,13.21
9853146,9953430,3878,1357300,11310730,13.64
9853147,9974630,2945,1030750,11005380,10.33
9853148,9635212,3901,1365350,11000562,14.17
9853149,9384879,4033,1411550,10796429,15.04
9853150,9957204,5018,1756300,11713504,17.64
9853151,9975884,3671,1284850,11260734,12.88
9853152,9986943,4161,1456350,11443293,14.58
9853153,9980032,3998,1399300,11379332,14.02
9853154,8988618,4415,1545250,10533868,17.19
9853155,9982497,3797,1328950,11311447,13.31
9853156,9960644,2537,887950,10848594,8.91
9853157,564020,227,79450,643470,14.09
9853159,9955664,3314,1159900,11115564,11.65
9853160,1075606,565,197750,1273356,18.38
9853161,4378190,3174,1110900,5489090,25.37
9853162,9950479,4222,1477700,11428179,14.85
9853163,9959525,5626,1969100,11928625,19.77
9853164,9951870,6793,2377550,12329420,23.89
9853165,9958216,4400,1540000,11498216,15.46
9853166,9962704,1339,468650,10431354,4.70
9853167,130811,138,48300,179111,36.92
9853168,9944413,5830,2040500,11984913,20.52
9853169,9869567,4696,1643600,11513167,16.65
9853170,9932985,2925,1023750,10956735,10.31
9853171,9941777,5441,1904350,11846127,19.16
9853172,9940833,4447,1556450,11497283,15.66
9853173,9920190,4149,1452150,11372340,14.64
9853174,9903774,5600,1960000,11863774,19.79
9853175,9946088,4495,1573250,11519338,15.82
9853176,74915,48,16800,91715,22.43
9853177,3849624,1312,459200,4308824,11.93
9853178,9901500,3993,1397550,11299050,14.11
9853179,9910808,6010,2103500,12014308,21.22
9853180,491356,227,79450,570806,16.17
9853181,9667164,3467,1213450,10880614,12.55
9853183,7509440,2606,912100,8421540,12.15
9853184,9724784,5608,1962800,11687584,20.18
9853185,9906347,2714,949900,10856247,9.59
9853186,1370258,1042,364700,1734958,26.62
9853187,9918329,3833,1341550,11259879,13.53
9853188,9864751,4808,1682800,11547551,17.06
9853189,9917765,4918,1721300,11639065,17.36
9853190,9759917,3567,1248450,11008367,12.79
9853191,9921149,3792,1327200,11248349,13.38
9853192,9915235,4154,1453900,11369135,14.66
9853193,9868561,4075,1426250,11294811,14.45
9853194,9909812,5074,1775900,11685712,17.92
9853195,91215,89,31150,122365,34.15
9853196,1277935,650,227500,1505435,17.80
9853197,9903873,2665,932750,10836623,9.42
9853198,9675118,5941,2079350,11754468,21.49
9853200,2464530,615,215250,2679780,8.73
9853201,1323619,166,58100,1381719,4.39
9853202,9921300,5984,2094400,12015700,21.11
9853203,9932322,5773,2020550,11952872,20.34
9853204,4732394,4096,1433600,6165994,30.29
9853205,9909400,8202,2870700,12780100,28.97
9853206,340139,118,41300,381439,12.14
9853208,9898726,3424,1198400,11097126,12.11
9853209,9888355,6521,2282350,12170705,23.08
9853210,1137360,483,169050,1306410,14.86
9853211,9886169,6592,2307200,12193369,23.34
9853212,9891667,6441,2254350,12146017,22.79
9853213,9887764,1447,506450,10394214,5.12
9853214,9884554,3396,1188600,11073154,12.02
9853215,9896442,1215,425250,10321692,4.30
9853216,9918270,2196,768600,10686870,7.75
9853217,5685845,1863,652050,6337895,11.47
9853218,9915612,3571,1249850,11165462,12.60
9853219,9933894,5743,2010050,11943944,20.23
9853220,9947746,5242,1834700,11782446,18.44
9853221,9951564,5381,1883350,11834914,18.93
9853222,9937850,6241,2184350,12122200,21.98
9853223,9839058,7221,2527350,12366408,25.69
9853224,9956406,2884,1009400,10965806,10.14
9853225,9952778,3201,1120350,11073128,11.26
9853226,716886,487,170450,887336,23.78
9853227,9972516,859,300650,10273166,3.01
9853228,9158745,4387,1535450,10694195,16.76
9853229,1752307,696,243600,1995907,13.90
9853230,9941891,5779,2022650,11964541,20.34
9853231,8961635,5583,1954050,10915685,21.80
9853232,9964652,5717,2000950,11965602,20.08
9853233,9940154,3320,1162000,11102154,11.69
9853234,9956466,3820,1337000,11293466,13.43
9853235,9968708,2214,774900,10743608,7.77
9853236,9891263,4129,1445150,11336413,14.61
9853237,9981274,670,234500,10215774,2.35
9853238,9984638,4795,1678250,11662888,16.81
9853239,9965788,2134,746900,10712688,7.49
9853240,965288,138,48300,1013588,5.00
9853242,9876932,2537,887950,10764882,8.99
9853243,9978967,1526,534100,10513067,5.35
9853244,2995094,3035,1062250,4057344,35.47
9853245,9929949,1960,686000,10615949,6.91
9853246,9975986,4139,1448650,11424636,14.52
9853247,8021915,4139,1448650,9470565,18.06
9853248,9965866,1107,387450,10353316,3.89
9853249,475712,166,58100,533812,12.21
9853250,570672,589,206150,776822,36.12
9853251,9937493,2177,761950,10699443,7.67
9853252,9956570,6166,2158100,12114670,21.68
9853253,139686,125,43750,183436,31.32
9853254,9602411,3344,1170400,10772811,12.19
9853255,9945113,2509,878150,10823263,8.83
9853256,9953090,2206,772100,10725190,7.76
9853257,9943150,1584,554400,10497550,5.58
9853258,9949382,5167,1808450,11757832,18.18
9853259,9913331,3434,1201900,11115231,12.12
9853260,9942265,7104,2486400,12428665,25.01
9853261,9970478,3857,1349950,11320428,13.54
9853262,9965319,2618,916300,10881619,9.19
9853263,9982342,2444,855400,10837742,8.57
9853264,89172,67,23450,112622,26.30
9853265,9647476,3254,1138900,10786376,11.81
9853266,9943093,3170,1109500,11052593,11.16
9853267,9957637,5126,1794100,11751737,18.02
9853268,9990283,1614,564900,10555183,5.65
9853269,475546,320,112000,587546,23.55
9853271,746533,782,273700,1020233,36.66
9853272,9951067,2283,799050,10750117,8.03
9853273,9698878,4291,1501850,11200728,15.48
9853274,9957013,1155,404250,10361263,4.06
9853275,9958448,6159,2155650,12114098,21.65
9853276,9965433,2779,972650,10938083,9.76
9853277,9942306,3779,1322650,11264956,13.30
9853278,9840112,1294,452900,10293012,4.60
9853279,163521,172,60200,223721,36.81
9853280,9965618,2028,709800,10675418,7.12
9853281,9966971,2694,942900,10909871,9.46
9853282,288489,224,78400,366889,27.18
9853283,9951132,2902,1015700,10966832,10.21
9853284,6921938,2276,796600,7718538,11.51
9853285,9932409,4263,1492050,11424459,15.02
9853286,9936125,6080,2128000,12064125,21.42
9853287,9953009,4552,1593200,11546209,16.01
9853288,9936897,349,122150,10059047,1.23
9853289,9974020,2047,716450,10690470,7.18
9853290,83030,43,15050,98080,18.13
9853291,9987970,4279,1497650,11485620,14.99
9853292,9979071,1546,541100,10520171,5.42
9853294,9987583,3076,1076600,11064183,10.78
9853295,9991580,2314,809900,10801480,8.11
9853296,9990640,1362,476700,10467340,4.77
9853297,9976692,4115,1440250,11416942,14.44
9853298,9978892,4967,1738450,11717342,17.42
9853299,9996924,1851,647850,10644774,6.48
9853300,556478,354,123900,680378,22.27
9853301,1713345,641,224350,1937695,13.09
9853302,328530,266,93100,421630,28.34
9853303,2230794,2247,786450,3017244,35.25
9853304,9987466,4091,1431850,11419316,14.34
9853305,461436,373,130550,591986,28.29
9853306,9955790,5033,1761550,11717340,17.69
9853307,9948200,3247,1136450,11084650,11.42
9853308,9965248,4563,1597050,11562298,16.03
9853309,625067,368,128800,753867,20.61
9853310,9722156,4564,1597400,11319556,16.43
9853311,9841944,5330,1865500,11707444,18.95
9853312,9944627,1956,684600,10629227,6.88
9853313,9968677,1332,466200,10434877,4.68
9853314,9957795,3214,1124900,11082695,11.30
9853315,9986237,2936,1027600,11013837,10.29
9853316,584000,655,229250,813250,39.26
9853317,9957307,4088,1430800,11388107,14.37
9853318,2924953,737,257950,3182903,8.82
9853319,2744774,1357,474950,3219724,17.30
9853320,9950336,5139,1798650,11748986,18.08
9853321,9944248,4093,1432550,11376798,14.41
9853322,9973827,1407,492450,10466277,4.94
9853323,9706995,1632,571200,10278195,5.88
9853324,9949458,2735,957250,10906708,9.62
9853325,9980778,1713,599550,10580328,6.01
9853326,1385396,1270,444500,1829896,32.08
9853327,9970754,3597,1258950,11229704,12.63
9853328,9980181,2215,775250,10755431,7.77
9853329,9987601,1183,414050,10401651,4.15
9853330,609488,255,89250,698738,14.64
9853331,9953429,3335,1167250,11120679,11.73
9853332,9948902,2759,965650,10914552,9.71
9853333,9954924,5842,2044700,11999624,20.54
9853334,973411,378,132300,1105711,13.59
9853335,9983884,2874,1005900,10989784,10.08
9853336,9977496,5154,1803900,11781396,18.08
9853337,9973061,5941,2079350,12052411,20.85
9853339,9964792,1800,630000,10594792,6.32
9853340,9955369,2197,768950,10724319,7.72
9853341,9983474,532,186200,10169674,1.87
9853342,9959089,3577,1251950,11211039,12.57
9853343,278187,197,68950,347137,24.79
9853344,9975951,3042,1064700,11040651,10.67
9853345,9950040,964,337400,10287440,3.39
9853346,9719574,709,248150,9967724,2.55
9853347,9975550,3296,1153600,11129150,11.56
9853349,9961932,455,159250,10121182,1.60
9853350,9955540,3594,1257900,11213440,12.64
9853351,9945340,3561,1246350,11191690,12.53
9853352,9958214,539,188650,10146864,1.89
9853353,9968909,3036,1062600,11031509,10.66
9853354,9966909,1261,441350,10408259,4.43
9853355,9965077,420,147000,10112077,1.48
9853356,9969281,4101,1435350,11404631,14.40
9853357,9735727,1161,406350,10142077,4.17
9853358,9971531,3919,1371650,11343181,13.76
9853359,9977212,1090,381500,10358712,3.82
9853360,9993080,3865,1352750,11345830,13.54
9853361,9978149,4144,1450400,11428549,14.54
9853362,9968589,5140,1799000,11767589,18.05
9853363,9964573,7916,2770600,12735173,27.80
9853364,9990046,7236,2532600,12522646,25.35
9853365,9881939,4136,1447600,11329539,14.65
9853366,937680,192,67200,1004880,7.17
9853367,2418981,1836,642600,3061581,26.56
9853368,9975247,3167,1108450,11083697,11.11
9853369,9969368,557,194950,10164318,1.96
9853370,9940805,2718,951300,10892105,9.57
9853371,9977196,5693,1992550,11969746,19.97
9853372,124481,69,24150,148631,19.40
9853373,9971328,266,93100,10064428,0.93
9853374,9959782,1135,397250,10357032,3.99
9853375,3226767,2169,759150,3985917,23.53
9853376,9932711,6817,2385950,12318661,24.02
9853377,9938552,4739,1658650,11597202,16.69
9853378,9965417,1002,350700,10316117,3.52
9853379,9943383,922,322700,10266083,3.25
9853380,4513020,1475,516250,5029270,11.44
9853381,9938499,1630,570500,10508999,5.74
9853382,2191061,209,73150,2264211,3.34
9853383,9961299,6234,2181900,12143199,21.90
9853384,9957934,4743,1660050,11617984,16.67
9853385,9948213,3482,1218700,11166913,12.25
9853386,6668066,3647,1276450,7944516,19.14
9853387,9872966,5362,1876700,11749666,19.01
9853388,9942257,7107,2487450,12429707,25.02
9853389,9961209,2135,747250,10708459,7.50
9853390,9936737,3697,1293950,11230687,13.02
9853391,9952112,1346,471100,10423212,4.73
9853392,1650744,873,305550,1956294,18.51
9853393,9946358,4844,1695400,11641758,17.05
9853394,9975256,5054,1768900,11744156,17.73
9853395,9981912,3307,1157450,11139362,11.60
9853396,9976548,6365,2227750,12204298,22.33
9853398,3899773,2298,804300,4704073,20.62
9853399,9963476,4367,1528450,11491926,15.34
9853400,9673150,3260,1141000,10814150,11.80
9853401,6288159,2940,1029000,7317159,16.36
9853402,9976046,5693,1992550,11968596,19.97
9853403,9971214,2559,895650,10866864,8.98
9853404,9979487,3567,1248450,11227937,12.51
9853405,9980354,5061,1771350,11751704,17.75
9853406,5397950,845,295750,5693700,5.48
9853407,9972795,4277,1496950,11469745,15.01
9853408,9976471,1996,698600,10675071,7.00
9853409,9985236,4353,1523550,11508786,15.26
9853410,9989860,2210,773500,10763360,7.74
9853411,9956475,1332,466200,10422675,4.68
9853412,9994417,1753,613550,10607967,6.14
9853414,9994651,2517,880950,10875601,8.81
9853415,9961033,3874,1355900,11316933,13.61
9853416,9998181,1409,493150,10491331,4.93
9853417,9997088,3573,1250550,11247638,12.51
9853418,9988489,1220,427000,10415489,4.27
9853419,9989635,2120,742000,10731635,7.43
9853420,177004,168,58800,235804,33.22
9853421,9978044,3682,1288700,11266744,12.92
9853422,9962470,1179,412650,10375120,4.14
9853423,219894,133,46550,266444,21.17
9853424,9977199,2655,929250,10906449,9.31
9853425,1336190,627,219450,1555640,16.42
9853426,9971226,3679,1287650,11258876,12.91
9853427,170293,163,57050,227343,33.50
9853428,9979960,2653,928550,10908510,9.30
9853429,9979496,3276,1146600,11126096,11.49
9853430,235099,184,64400,299499,27.39
9853431,9978332,2325,813750,10792082,8.16
9853432,9980408,834,291900,10272308,2.92
9853433,9966729,2366,828100,10794829,8.31
9853434,9955342,5271,1844850,11800192,18.53
9853435,9984530,5577,1951950,11936480,19.55
9853436,9988505,3562,1246700,11235205,12.48
9853437,9989198,2268,793800,10782998,7.95
9853438,9991387,3854,1348900,11340287,13.50
9853439,9991897,998,349300,10341197,3.50
9853440,9983605,487,170450,10154055,1.71
9853442,9999700,5025,1758750,11758450,17.59
9853443,9991542,924,323400,10314942,3.24
9853444,9950099,999,349650,10299749,3.51
9853445,9966351,456,159600,10125951,1.60
9853446,9996364,1079,377650,10374014,3.78
9853447,125136,96,33600,158736,26.85
9853448,9964412,2539,888650,10853062,8.92
9853449,9928895,2339,818650,10747545,8.25
9853450,3151569,1301,455350,3606919,14.45
9853451,9976742,4641,1624350,11601092,16.28
9853452,9985970,4407,1542450,11528420,15.45
9853453,9984345,6502,2275700,12260045,22.79
9853454,9979310,3727,1304450,11283760,13.07
9853455,9982362,940,329000,10311362,3.30
9853456,9986543,1850,647500,10634043,6.48
9853457,9991238,1556,544600,10535838,5.45
9853458,9982114,4497,1573950,11556064,15.77
9853459,9941756,806,282100,10223856,2.84
9853460,9990134,3640,1274000,11264134,12.75
9853461,193189,103,36050,229239,18.66
9853462,9727629,1287,450450,10178079,4.63
9853463,9876222,5135,1797250,11673472,18.20
9853464,9969987,3062,1071700,11041687,10.75
9853465,9987109,4685,1639750,11626859,16.42
9853466,9631672,3835,1342250,10973922,13.94
9853467,9983761,2861,1001350,10985111,10.03
9853468,2395845,685,239750,2635595,10.01
9853469,9990771,5091,1781850,11772621,17.83
9853470,9994057,3087,1080450,11074507,10.81
9853471,9985181,4707,1647450,11632631,16.50
9853472,9985184,7260,2541000,12526184,25.45
9853473,9982130,5599,1959650,11941780,19.63
9853474,9971468,5638,1973300,11944768,19.79
9853475,9976816,1320,462000,10438816,4.63
9853476,3008627,2129,745150,3753777,24.77
9853477,9967913,4544,1590400,11558313,15.96
9853478,9964504,6007,2102450,12066954,21.10
9853480,9934981,2377,831950,10766931,8.37
9853481,9952599,2768,968800,10921399,9.73
9853482,9935275,785,274750,10210025,2.77
9853483,9950965,1213,424550,10375515,4.27
9853484,9948102,3164,1107400,11055502,11.13
9853485,9949525,5409,1893150,11842675,19.03
9853486,9962238,1308,457800,10420038,4.60
9853487,9945931,4764,1667400,11613331,16.76
9853488,9969247,3161,1106350,11075597,11.10
9853489,9944662,2432,851200,10795862,8.56
9853490,4502417,1517,530950,5033367,11.79
9853491,9946488,3386,1185100,11131588,11.91
9853492,9931406,1507,527450,10458856,5.31
9853493,9926729,2637,922950,10849679,9.30
9853494,9933263,3232,1131200,11064463,11.39
9853495,2454545,1469,514150,2968695,20.95
9853496,9916235,2871,1004850,10921085,10.13
9853497,9910045,4289,1501150,11411195,15.15
9853498,9958676,3682,1288700,11247376,12.94
9853499,9948784,315,110250,10059034,1.11
9853500,9970882,1178,412300,10383182,4.14
9853501,9819132,6079,2127650,11946782,21.67
9853502,9951518,351,122850,10074368,1.23
9853503,9975832,2412,844200,10820032,8.46
9853504,9969948,299,104650,10074598,1.05
9853505,21589,21,7350,28939,34.05
9853506,9968156,1688,590800,10558956,5.93
9853507,9912201,6129,2145150,12057351,21.64
9853508,2820948,718,251300,3072248,8.91
9853509,9963879,1571,549850,10513729,5.52
9853510,9956085,2108,737800,10693885,7.41
9853511,2704646,1020,357000,3061646,13.20
9853512,9955789,1909,668150,10623939,6.71
9853513,9946908,3713,1299550,11246458,13.06
9853514,519537,137,47950,567487,9.23
9853515,1735832,1580,553000,2288832,31.86
9853517,9966991,5240,1834000,11800991,18.40
9853518,9934393,6657,2329950,12264343,23.45
9853519,9962592,4258,1490300,11452892,14.96
9853520,9979108,1913,669550,10648658,6.71
9853521,9855504,707,247450,10102954,2.51
9853522,9972368,1422,497700,10470068,4.99
9853523,750326,511,178850,929176,23.84
9853524,9956628,6508,2277800,12234428,22.88
9853525,9975781,3142,1099700,11075481,11.02
9853526,92933,64,22400,115333,24.10
9853527,9915300,4428,1549800,11465100,15.63
9853528,9936405,5876,2056600,11993005,20.70
9853529,4252988,2802,980700,5233688,23.06
9853530,6238762,3299,1154650,7393412,18.51
9853531,9930451,5479,1917650,11848101,19.31
9853532,9917758,3799,1329650,11247408,13.41
9853533,9931691,4488,1570800,11502491,15.82
9853534,9823805,2870,1004500,10828305,10.23
9853535,9934983,2789,976150,10911133,9.83
9853536,9928860,5405,1891750,11820610,19.05
9853537,9932126,2288,800800,10732926,8.06
9853538,9929443,2649,927150,10856593,9.34
9853540,9921402,2321,812350,10733752,8.19
9853541,9938221,3154,1103900,11042121,11.11
9853542,9944887,3139,1098650,11043537,11.05
9853543,9952917,2964,1037400,10990317,10.42
9853544,9957261,4599,1609650,11566911,16.17
9853545,9961720,6408,2242800,12204520,22.51
9853546,9942605,3155,1104250,11046855,11.11
9853547,9942364,4793,1677550,11619914,16.87
9853548,9946494,4624,1618400,11564894,16.27
9853549,9939592,1705,596750,10536342,6.00
9853550,9852666,3058,1070300,10922966,10.86
9853551,1056005,680,238000,1294005,22.54
9853552,9905633,4396,1538600,11444233,15.53
9853553,7893120,3410,1193500,9086620,15.12
9853554,423601,268,93800,517401,22.14
9853556,9932409,5778,2022300,11954709,20.36
9853557,9928474,6058,2120300,12048774,21.36
9853558,8909042,4029,1410150,10319192,15.83
9853559,9948806,949,332150,10280956,3.34
9853560,2494434,1395,488250,2982684,19.57
9853561,5182916,3518,1231300,6414216,23.76
9853562,9952847,6031,2110850,12063697,21.21
9853563,9953362,5236,1832600,11785962,18.41
9853564,9950834,6959,2435650,12386484,24.48
9853565,9962909,4332,1516200,11479109,15.22
9853566,9965244,3726,1304100,11269344,13.09
9853567,9830673,698,244300,10074973,2.49
9853568,9970916,4858,1700300,11671216,17.05
9853570,9968604,3851,1347850,11316454,13.52
9853571,2360576,1740,609000,2969576,25.80
9853572,9967484,5278,1847300,11814784,18.53
9853573,3415075,1747,611450,4026525,17.90
9853574,9959295,3753,1313550,11272845,13.19
9853575,9966022,5150,1802500,11768522,18.09
9853576,9959883,640,224000,10183883,2.25
9853577,9977837,7065,2472750,12450587,24.78
9853578,9991716,4773,1670550,11662266,16.72
9853579,9829714,3825,1338750,11168464,13.62
9853580,9984659,4239,1483650,11468309,14.86
9853581,364959,252,88200,453159,24.17
9853582,1890069,1689,591150,2481219,31.28
9853583,9979304,3538,1238300,11217604,12.41
9853584,9971153,3691,1291850,11263003,12.96
9853585,9989322,3750,1312500,11301822,13.14
9853586,4647929,2708,947800,5595729,20.39
9853587,9983124,3413,1194550,11177674,11.97
9853588,9985174,1795,628250,10613424,6.29
9853589,9989596,4360,1526000,11515596,15.28
9853590,9963173,5410,1893500,11856673,19.00
9853591,214187,190,66500,280687,31.05
9853593,9967499,4961,1736350,11703849,17.42
9853594,9971797,3878,1357300,11329097,13.61
9853595,9970220,1348,471800,10442020,4.73
9853596,2069960,2029,710150,2780110,34.31
9853597,9957327,1301,455350,10412677,4.57
9853598,9979014,2626,919100,10898114,9.21
9853599,9991205,1081,378350,10369555,3.79
9853600,9987620,3683,1289050,11276670,12.91
9853601,9986979,4135,1447250,11434229,14.49
9853602,9948685,2361,826350,10775035,8.31
9853603,9884982,3514,1229900,11114882,12.44
9853605,9994650,1097,383950,10378600,3.84
9853606,9939747,4945,1730750,11670497,17.41
9853607,1334513,755,264250,1598763,19.80
9853609,9962462,1949,682150,10644612,6.85
9853610,2452730,731,255850,2708580,10.43
9853611,5735534,3373,1180550,6916084,20.58
9853612,9941950,3291,1151850,11093800,11.59
9853613,1329169,760,266000,1595169,20.01
9853614,9990792,2477,866950,10857742,8.68
9853615,9994461,4350,1522500,11516961,15.23
9853616,1082712,904,316400,1399112,29.22
9853617,120644,62,21700,142344,17.99
9853618,9966005,2639,923650,10889655,9.27
9853619,9885774,6090,2131500,12017274,21.56
9853620,9962451,4032,1411200,11373651,14.17
9853621,9977653,6276,2196600,12174253,22.02
9853622,9986208,3196,1118600,11104808,11.20
9853623,9982502,1361,476350,10458852,4.77
9853624,9998048,2073,725550,10723598,7.26
9853625,9991883,5158,1805300,11797183,18.07
9853626,9986816,3832,1341200,11328016,13.43
9853627,9993382,4598,1609300,11602682,16.10
9853628,9967538,4913,1719550,11687088,17.25
9853629,9969695,1265,442750,10412445,4.44
9853630,307492,288,100800,408292,32.78
9853631,9984883,2657,929950,10914833,9.31
9853632,9973455,555,194250,10167705,1.95
9853633,9879782,4302,1505700,11385482,15.24
9853634,9962603,151,52850,10015453,0.53
9853635,9981833,5045,1765750,11747583,17.69
9853636,9975233,993,347550,10322783,3.48
9853637,9984835,2823,988050,10972885,9.90
9853638,9975491,4506,1577100,11552591,15.81
9853639,9988526,3366,1178100,11166626,11.79
9853640,9983061,4687,1640450,11623511,16.43
9853641,9976842,6309,2208150,12184992,22.13
9853642,9983574,3316,1160600,11144174,11.63
9853643,9987230,1334,466900,10454130,4.67
9853644,9968990,730,255500,10224490,2.56
9853645,9966464,2845,995750,10962214,9.99
9853646,9992819,910,318500,10311319,3.19
9853647,1770658,674,235900,2006558,13.32
9853648,9963137,2548,891800,10854937,8.95
9853649,9965517,747,261450,10226967,2.62
9853650,9967928,1072,375200,10343128,3.76
9853651,9975980,3494,1222900,11198880,12.26
9853652,9966907,3729,1305150,11272057,13.09
9853653,3519003,1030,360500,3879503,10.24
9853654,9251975,4716,1650600,10902575,17.84
9853655,9987107,2444,855400,10842507,8.57
9853656,817917,404,141400,959317,17.29
9853657,9970069,5449,1907150,11877219,19.13
9853659,9963747,3836,1342600,11306347,13.47
9853660,126545,71,24850,151395,19.64
9853661,9942085,4550,1592500,11534585,16.02
9853662,9962170,1836,642600,10604770,6.45
9853663,9960789,4169,1459150,11419939,14.65
9853664,9962775,4025,1408750,11371525,14.14
9853665,9971184,606,212100,10183284,2.13
9853666,3035835,600,210000,3245835,6.92
9853667,9973643,2070,724500,10698143,7.26
9853668,9975111,3952,1383200,11358311,13.87
9853669,9989758,1742,609700,10599458,6.10
9853670,9980956,3359,1175650,11156606,11.78
9853671,194570,265,92750,287320,47.67
9853673,9960862,2223,778050,10738912,7.81
9853674,9973223,3913,1369550,11342773,13.73
9853675,9956717,724,253400,10210117,2.55
9853676,9974082,652,228200,10202282,2.29
9853677,9948967,2807,982450,10931417,9.87
9853678,9977555,1575,551250,10528805,5.52
9853679,9958188,5667,1983450,11941638,19.92
9853680,9991311,1855,649250,10640561,6.50
9853681,9996145,492,172200,10168345,1.72
9853682,9929783,924,323400,10253183,3.26
9853683,2720666,915,320250,3040916,11.77
9853684,9976109,4891,1711850,11687959,17.16
9853685,9920429,2994,1047900,10968329,10.56
9853686,9979817,2848,996800,10976617,9.99
9853687,9979447,4122,1442700,11422147,14.46
9853688,9916262,292,102200,10018462,1.03
9853689,9985283,4156,1454600,11439883,14.57
9853690,9720277,81,28350,9748627,0.29
9853691,9989712,3862,1351700,11341412,13.53
9853692,9975727,2484,869400,10845127,8.72
9853693,9897883,3416,1195600,11093483,12.08
9853694,9966876,3939,1378650,11345526,13.83
9853695,9987540,6558,2295300,12282840,22.98
9853696,9944134,2120,742000,10686134,7.46
9853698,9978871,909,318150,10297021,3.19
9853699,9953328,443,155050,10108378,1.56
9853700,9972002,5474,1915900,11887902,19.21
9853701,9890081,5358,1875300,11765381,18.96
9853702,9970993,3835,1342250,11313243,13.46
9853703,9956016,1156,404600,10360616,4.06
9853704,9992439,3215,1125250,11117689,11.26
9853705,9976996,3630,1270500,11247496,12.73
9853706,9988612,3907,1367450,11356062,13.69
9853707,9968521,1033,361550,10330071,3.63
9853708,9958559,3574,1250900,11209459,12.56
9853710,9974693,471,164850,10139543,1.65
9853711,9930660,4758,1665300,11595960,16.77
9853712,9917706,4549,1592150,11509856,16.05
9853713,9928517,4881,1708350,11636867,17.21
9853714,9939288,8899,3114650,13053938,31.34
9853715,9974725,3378,1182300,11157025,11.85
9853716,9968819,3314,1159900,11128719,11.64
9853717,9968935,244,85400,10054335,0.86
9853718,107362,71,24850,132212,23.15
9853719,2582896,1150,402500,2985396,15.58
9853720,9956259,4522,1582700,11538959,15.90
9853721,331422,280,98000,429422,29.57
9853722,9940015,4559,1595650,11535665,16.05
9853724,9955002,4026,1409100,11364102,14.15
9853725,9965462,2069,724150,10689612,7.27
9853726,9977566,2680,938000,10915566,9.40
9853727,9996847,621,217350,10214197,2.17
9853728,348140,180,63000,411140,18.10
9853730,9968559,1597,558950,10527509,5.61
9853731,9694983,1740,609000,10303983,6.28
9853732,9959234,927,324450,10283684,3.26
9853733,9955164,5848,2046800,12001964,20.56
9853734,9944055,4692,1642200,11586255,16.51
9853735,9976240,2193,767550,10743790,7.69
9853736,1107067,133,46550,1153617,4.20
9853737,1977524,1161,406350,2383874,20.55
9853738,733991,617,215950,949941,29.42
9853739,9973565,875,306250,10279815,3.07
9853740,9479853,4230,1480500,10960353,15.62
9853741,776891,300,105000,881891,13.52
9853742,206072,189,66150,272222,32.10
9853743,9971094,4124,1443400,11414494,14.48
9853744,9975969,5130,1795500,11771469,18.00
9853745,9989719,5465,1912750,11902469,19.15
9853746,9989482,5237,1832950,11822432,18.35
9853747,9993207,3874,1355900,11349107,13.57
9853748,9983159,4639,1623650,11606809,16.26
9853749,9984708,4142,1449700,11434408,14.52
9853750,2300597,2278,797300,3097897,34.66
9853751,9851464,1549,542150,10393614,5.50
9853752,9971450,967,338450,10309900,3.39
9853753,9964214,612,214200,10178414,2.15
9853754,9967016,3530,1235500,11202516,12.40
9853755,9967939,5338,1868300,11836239,18.74
9853756,9977801,3894,1362900,11340701,13.66
9853757,9973817,1880,658000,10631817,6.60
9853758,9960287,2062,721700,10681987,7.25
9853759,9981681,1051,367850,10349531,3.69
9853760,9984979,1689,591150,10576129,5.92
9853761,9995531,2304,806400,10801931,8.07
9853762,9967946,658,230300,10198246,2.31
9853763,119841,42,14700,134541,12.27
9853764,9938872,2984,1044400,10983272,10.51
9853765,9977381,2335,817250,10794631,8.19
9853766,9963564,676,236600,10200164,2.37
9853767,9960767,754,263900,10224667,2.65
9853768,5823745,3972,1390200,7213945,23.87
9853769,9962479,722,252700,10215179,2.54
9853770,9967353,3929,1375150,11342503,13.80
9853771,9989054,4009,1403150,11392204,14.05
9853772,9941049,1219,426650,10367699,4.29
9853773,9986496,535,187250,10173746,1.88
9853774,9999368,2542,889700,10889068,8.90
9853775,9980573,651,227850,10208423,2.28
9853776,9964175,2405,841750,10805925,8.45
9853777,9992966,2739,958650,10951616,9.59
9853778,9983944,1549,542150,10526094,5.43
9853780,9957616,3271,1144850,11102466,11.50
9853781,9984789,2964,1037400,11022189,10.39
9853782,9974950,2365,827750,10802700,8.30
9853783,9985529,3186,1115100,11100629,11.17
9853784,1329357,1287,450450,1779807,33.88
9853785,9953412,2303,806050,10759462,8.10
9853786,9980999,929,325150,10306149,3.26
9853787,9985458,583,204050,10189508,2.04
9853788,4247103,1219,426650,4673753,10.05
9853789,9726338,1981,693350,10419688,7.13
9853791,9970536,3684,1289400,11259936,12.93
9853792,9960894,1560,546000,10506894,5.48
9853793,9928908,748,261800,10190708,2.64
9853794,9946101,1175,411250,10357351,4.13
9853795,9953039,2493,872550,10825589,8.77
9853797,9959026,3083,1079050,11038076,10.83
9853798,9943581,1667,583450,10527031,5.87
9853799,9948467,5179,1812650,11761117,18.22
9853800,9948464,3532,1236200,11184664,12.43
9853801,9950084,4213,1474550,11424634,14.82
9853802,9957500,2924,1023400,10980900,10.28
9853803,6268250,2500,875000,7143250,13.96
9853804,9963847,2195,768250,10732097,7.71
9853806,9944450,1690,591500,10535950,5.95
9853807,9962534,3744,1310400,11272934,13.15
9853808,9658388,601,210350,9868738,2.18
9853809,9960070,2535,887250,10847320,8.91
9853810,9953563,2587,905450,10859013,9.10
9853811,9977233,2064,722400,10699633,7.24
9853812,9982456,946,331100,10313556,3.32
9853813,9987547,2180,763000,10750547,7.64
9853814,586531,149,52150,638681,8.89
9853815,5076401,1942,679700,5756101,13.39
9853816,9977879,3641,1274350,11252229,12.77
9853818,159989,54,18900,178889,11.81
9853819,498986,188,65800,564786,13.19
9853820,9931862,3365,1177750,11109612,11.86
9853821,9970064,3892,1362200,11332264,13.66
9853822,257303,168,58800,316103,22.85
9853823,9961321,2219,776650,10737971,7.80
9853824,9929380,784,274400,10203780,2.76
9853825,4805019,2174,760900,5565919,15.84
9853826,78533,77,26950,105483,34.32
9853827,9948419,737,257950,10206369,2.59
9853828,9962063,2179,762650,10724713,7.66
9853829,3569438,1745,610750,4180188,17.11
9853830,9964154,3471,1214850,11179004,12.19
9853831,9947544,4400,1540000,11487544,15.48
9853832,9615911,2204,771400,10387311,8.02
9853833,9990021,2110,738500,10728521,7.39
9853835,9998851,1443,505050,10503901,5.05
9853836,9952069,1302,455700,10407769,4.58
9853837,9967912,4103,1436050,11403962,14.41
9853838,9950625,1797,628950,10579575,6.32
9853839,342283,751,262850,605133,76.79
9853840,9977373,4199,1469650,11447023,14.73
9853841,9973692,921,322350,10296042,3.23
9853842,9993717,1839,643650,10637367,6.44
9853843,9967852,2480,868000,10835852,8.71
9853844,9995592,639,223650,10219242,2.24
9853845,9634235,405,141750,9775985,1.47
9853846,9972197,806,282100,10254297,2.83
9853847,9980733,4558,1595300,11576033,15.98
9853848,9984024,5195,1818250,11802274,18.21
9853849,9968167,3216,1125600,11093767,11.29
9853850,237464,170,59500,296964,25.06
9853852,9963152,1793,627550,10590702,6.30
9853853,9970175,1487,520450,10490625,5.22
9853854,9998999,1051,367850,10366849,3.68
9853855,9740435,1888,660800,10401235,6.78
9853856,9981524,5521,1932350,11913874,19.36
9853857,9980686,5176,1811600,11792286,18.15
9853858,9998993,2497,873950,10872943,8.74
9853859,5552121,5077,1776950,7329071,32.00
9853860,9982906,4810,1683500,11666406,16.86
9853861,9983017,4870,1704500,11687517,17.07
9853862,9979758,738,258300,10238058,2.59
9853863,9958318,2380,833000,10791318,8.36
9853864,9987863,3192,1117200,11105063,11.19
9853865,9985614,3769,1319150,11304764,13.21
9853866,9980875,4176,1461600,11442475,14.64
9853867,269825,476,166600,436425,61.74
9853869,9949963,6064,2122400,12072363,21.33
9853870,9938596,2750,962500,10901096,9.68
9853871,1542469,712,249200,1791669,16.16
9853872,9921894,3244,1135400,11057294,11.44
9853873,9929040,1044,365400,10294440,3.68
9853874,9947390,6496,2273600,12220990,22.86
9853875,9957024,2925,1023750,10980774,10.28
9853876,9957619,2075,726250,10683869,7.29
9853877,9911343,4461,1561350,11472693,15.75
9853878,9944943,3507,1227450,11172393,12.34
9853879,9943224,2814,984900,10928124,9.91
9853880,9940915,1292,452200,10393115,4.55
9853881,9959841,2213,774550,10734391,7.78
9853882,8979824,4607,1612450,10592274,17.96
9853883,9985222,4819,1686650,11671872,16.89
9853884,778803,294,102900,881703,13.21
9853885,8958591,5563,1947050,10905641,21.73
9853886,9965595,3949,1382150,11347745,13.87
9853887,9971263,6000,2100000,12071263,21.06
9853888,9977430,2150,752500,10729930,7.54
9853889,9965274,820,287000,10252274,2.88
9853890,9948747,1536,537600,10486347,5.40
9853891,9978244,3631,1270850,11249094,12.74
9853893,9969576,594,207900,10177476,2.09
9853894,9973901,1667,583450,10557351,5.85
9853895,146209,42,14700,160909,10.05
9853897,9950997,4376,1531600,11482597,15.39
9853898,9967066,5677,1986950,11954016,19.94
9853899,9939812,5021,1757350,11697162,17.68
9853900,9983112,393,137550,10120662,1.38
9853901,1174799,757,264950,1439749,22.55
9853902,9982416,2731,955850,10938266,9.58
9853903,9983151,2611,913850,10897001,9.15
9853904,9996763,1154,403900,10400663,4.04
9853905,100520,24,8400,108920,8.36
9853906,9964367,1286,450100,10414467,4.52
9853907,9974330,1646,576100,10550430,5.78
9853908,173043,88,30800,203843,17.80
9853909,9980620,2286,800100,10780720,8.02
9853910,9981226,4653,1628550,11609776,16.32
9853911,9995481,727,254450,10249931,2.55
9853912,9997814,1846,646100,10643914,6.46
9853913,9958360,2398,839300,10797660,8.43
9853915,835977,410,143500,979477,17.17
9853916,9963831,2997,1048950,11012781,10.53
9853917,9969430,827,289450,10258880,2.90
9853918,9981382,1439,503650,10485032,5.05
9853919,9975190,1462,511700,10486890,5.13
9853920,102502,108,37800,140302,36.88
9853921,9963972,3082,1078700,11042672,10.83
9853922,1745477,534,186900,1932377,10.71
9853923,9963381,5842,2044700,12008081,20.52
9853924,9953369,1821,637350,10590719,6.40
9853925,67696,46,16100,83796,23.78
9853926,9943183,1543,540050,10483233,5.43
9853927,2074991,1015,355250,2430241,17.12
9853928,8756937,226,79100,8836037,0.90
9853929,9944452,553,193550,10138002,1.95
9853930,9963052,704,246400,10209452,2.47
9853931,9961255,288,100800,10062055,1.01
9853932,9957382,1361,476350,10433732,4.78
9853933,9960099,375,131250,10091349,1.32
9853934,9976496,745,260750,10237246,2.61
9853935,6692038,3386,1185100,7877138,17.71
9853936,9962969,1146,401100,10364069,4.03
9853937,9977224,2647,926450,10903674,9.29
9853938,9982467,4720,1652000,11634467,16.55
9853939,9993531,3254,1138900,11132431,11.40
9853940,9982666,4450,1557500,11540166,15.60
9853941,9992622,4067,1423450,11416072,14.25
9853942,9985856,4622,1617700,11603556,16.20
9853943,9982280,4256,1489600,11471880,14.92
9853944,9987197,2373,830550,10817747,8.32
9853945,9690213,1208,422800,10113013,4.36
9853946,9986057,3888,1360800,11346857,13.63
9853947,2844267,1528,534800,3379067,18.80
9853948,4445719,2084,729400,5175119,16.41
9853949,9957433,1196,418600,10376033,4.20
9853950,9974253,2781,973350,10947603,9.76
9853951,2402456,1230,430500,2832956,17.92
9853952,9952961,2839,993650,10946611,9.98
9853953,233986,290,101500,335486,43.38
9853954,9933579,4905,1716750,11650329,17.28
9853955,9933422,2355,824250,10757672,8.30
9853956,9806419,3411,1193850,11000269,12.17
9853958,9953113,5571,1949850,11902963,19.59
9853959,9943670,3109,1088150,11031820,10.94
9853960,9943204,1711,598850,10542054,6.02
9853961,4297282,3424,1198400,5495682,27.89
9853962,1797055,1188,415800,2212855,23.14
9853963,157015,59,20650,177665,13.15
9853964,9891980,3913,1369550,11261530,13.85
9853965,9803039,4311,1508850,11311889,15.39
9853966,887118,405,141750,1028868,15.98
9853967,9902298,6360,2226000,12128298,22.48
9853968,9919815,5742,2009700,11929515,20.26
9853969,654327,140,49000,703327,7.49
9853970,9899149,4724,1653400,11552549,16.70
9853971,5753157,1950,682500,6435657,11.86
9853972,8033317,1206,422100,8455417,5.25
9853973,9893232,3339,1168650,11061882,11.81
9853974,9905537,2964,1037400,10942937,10.47
9853975,9878171,5067,1773450,11651621,17.95
9853976,9894588,3808,1332800,11227388,13.47
9853977,9906691,2137,747950,10654641,7.55
9853978,9916851,86,30100,9946951,0.30
9853979,9921389,2436,852600,10773989,8.59
9853980,9932453,285,99750,10032203,1.00
9853981,3158935,1929,675150,3834085,21.37
9853982,9950370,5403,1891050,11841420,19.00
9853983,9963895,3460,1211000,11174895,12.15
9853984,9966393,1223,428050,10394443,4.29
9853985,466369,177,61950,528319,13.28
9853986,9954302,4125,1443750,11398052,14.50
9853987,1017271,1045,365750,1383021,35.95
9853988,5194996,2530,885500,6080496,17.05
9853990,9960385,4498,1574300,11534685,15.81
9853991,9958969,6079,2127650,12086619,21.36
9853992,9984847,5647,1976450,11961297,19.79
9853993,216491,136,47600,264091,21.99
9853994,9962079,4864,1702400,11664479,17.09
9853995,437862,453,158550,596412,36.21
9853996,9938466,1272,445200,10383666,4.48
9853997,9953722,5320,1862000,11815722,18.71
9853998,9707913,4775,1671250,11379163,17.22
9853999,9957999,3445,1205750,11163749,12.11
9854000,9984671,4182,1463700,11448371,14.66
9854001,9981486,1799,629650,10611136,6.31
9854002,9977799,2370,829500,10807299,8.31
9854003,9726616,1018,356300,10082916,3.66
9854004,9989479,3339,1168650,11158129,11.70
9854005,9985897,432,151200,10137097,1.51
9854006,183215,97,33950,217165,18.53
9854007,9994174,3923,1373050,11367224,13.74
9854008,9995625,3141,1099350,11094975,11.00
9854009,9775847,2036,712600,10488447,7.29
9854010,9987266,3165,1107750,11095016,11.09
9854011,9978119,1335,467250,10445369,4.68
9854012,9983939,1473,515550,10499489,5.16
9854013,2517327,573,200550,2717877,7.97
9854014,9966003,3356,1174600,11140603,11.79
9854015,9974167,2550,892500,10866667,8.95
9854016,9977071,2969,1039150,11016221,10.42
9854017,9971522,2769,969150,10940672,9.72
9854018,9976744,3905,1366750,11343494,13.70
9854019,824695,608,212800,1037495,25.80
9854020,100713,64,22400,123113,22.24
9854023,3283310,1948,681800,3965110,20.77
9854024,9978403,2785,974750,10953153,9.77
9854025,9964503,2049,717150,10681653,7.20
9854026,3212910,1684,589400,3802310,18.34
9854027,6625187,2345,820750,7445937,12.39
9854028,9921807,891,311850,10233657,3.14
9854029,9981226,2569,899150,10880376,9.01
9854030,9970839,1042,364700,10335539,3.66
9854031,968515,46,16100,984615,1.66
9854032,1918292,1061,371350,2289642,19.36
9854033,9958789,2965,1037750,10996539,10.42
9854034,9975645,626,219100,10194745,2.20
9854035,9974708,1922,672700,10647408,6.74
9854036,9956738,429,150150,10106888,1.51
9854037,9984709,833,291550,10276259,2.92
9854038,9965955,3927,1374450,11340405,13.79
9854039,9980466,970,339500,10319966,3.40
9854041,9978312,3578,1252300,11230612,12.55
9854042,9990058,1573,550550,10540608,5.51
9854043,9987355,1654,578900,10566255,5.80
9854044,9988267,1470,514500,10502767,5.15
9854045,9976587,3823,1338050,11314637,13.41
9854046,502073,209,73150,575223,14.57
9854047,9710724,1522,532700,10243424,5.49
9854048,9946740,1291,451850,10398590,4.54
9854049,9956800,3855,1349250,11306050,13.55
9854050,9971331,1380,483000,10454331,4.84
9854051,9941976,2471,864850,10806826,8.70
9854052,9956899,1657,579950,10536849,5.82
9854053,9974479,3462,1211700,11186179,12.15
9854054,9956037,3956,1384600,11340637,13.91
9854055,9663936,4465,1562750,11226686,16.17
9854056,9960754,2052,718200,10678954,7.21
9854057,9965826,5610,1963500,11929326,19.70
9854058,9958822,3404,1191400,11150222,11.96
9854059,9974412,3465,1212750,11187162,12.16
9854060,9977282,3761,1316350,11293632,13.19
9854061,9979273,3923,1373050,11352323,13.76
9854062,9988879,3218,1126300,11115179,11.28
9854063,9979796,2489,871150,10850946,8.73
9854064,9984855,4018,1406300,11391155,14.08
9854065,9993442,1312,459200,10452642,4.60
9854066,9975927,3233,1131550,11107477,11.34
9854067,9977663,3116,1090600,11068263,10.93
9854068,9993738,3279,1147650,11141388,11.48
9854069,1894521,1184,414400,2308921,21.87
9854070,9978238,5042,1764700,11742938,17.69
9854071,9962844,5324,1863400,11826244,18.70
9854072,9979755,4374,1530900,11510655,15.34
9854073,9984927,2579,902650,10887577,9.04
9854074,9965247,1320,462000,10427247,4.64
9854075,9999178,5395,1888250,11887428,18.88
9854076,9970339,1684,589400,10559739,5.91
9854077,9992779,1319,461650,10454429,4.62
9854078,9997837,1868,653800,10651637,6.54
9854079,9984635,931,325850,10310485,3.26
9854080,9965487,656,229600,10195087,2.30
9854081,9923561,662,231700,10155261,2.33
9854082,9960577,1284,449400,10409977,4.51
9854083,9974069,1947,681450,10655519,6.83
9854085,9967500,2219,776650,10744150,7.79
9854086,9964987,4415,1545250,11510237,15.51
9854087,9959996,3767,1318450,11278446,13.24
9854088,9965217,3758,1315300,11280517,13.20
9854089,9981933,2292,802200,10784133,8.04
9854090,9964903,4095,1433250,11398153,14.38
9854092,9872203,3143,1100050,10972253,11.14
9854093,9983162,4744,1660400,11643562,16.63
9854094,6008403,2195,768250,6776653,12.79
9854095,9975929,5196,1818600,11794529,18.23
9854096,9975836,3582,1253700,11229536,12.57
9854097,9808200,3947,1381450,11189650,14.08
9854098,9982904,5477,1916950,11899854,19.20
9854099,9994857,3737,1307950,11302807,13.09
9854100,9983801,4664,1632400,11616201,16.35
9854101,7958590,2657,929950,8888540,11.68
9854102,9991777,5715,2000250,11992027,20.02
9854103,9986249,6993,2447550,12433799,24.51
9854104,9982965,3021,1057350,11040315,10.59
9854105,9945278,1259,440650,10385928,4.43
9854106,9985000,3670,1284500,11269500,12.86
9854107,9971193,2574,900900,10872093,9.04
9854108,9992074,4539,1588650,11580724,15.90
9854109,9981467,3363,1177050,11158517,11.79
9854110,9986756,5403,1891050,11877806,18.94
9854111,759955,1001,350350,1110305,46.10
9854112,9984746,5962,2086700,12071446,20.90
9854113,9986625,5832,2041200,12027825,20.44
9854114,9979342,2528,884800,10864142,8.87
9854115,9970902,3745,1310750,11281652,13.15
9854116,9978388,4030,1410500,11388888,14.14
9854117,9946916,5096,1783600,11730516,17.93
9854118,9777724,6101,2135350,11913074,21.84
9854120,2645758,1401,490350,3136108,18.53
9854121,9988689,3112,1089200,11077889,10.90
9854122,2523509,1207,422450,2945959,16.74
9854123,9974422,1879,657650,10632072,6.59
9854124,9976256,3495,1223250,11199506,12.26
9854125,9685801,3786,1325100,11010901,13.68
9854126,4455694,1662,581700,5037394,13.06
9854127,9994180,4978,1742300,11736480,17.43
9854128,9948265,4169,1459150,11407415,14.67
9854129,9988490,5907,2067450,12055940,20.70
9854130,9973060,3799,1329650,11302710,13.33
9854131,9971766,2483,869050,10840816,8.72
9854132,2812899,1878,657300,3470199,23.37
9854133,9871941,910,318500,10190441,3.23
9854134,9973292,1740,609000,10582292,6.11
9854135,9960762,5867,2053450,12014212,20.62
9854136,9977203,3851,1347850,11325053,13.51
9854137,9939314,2187,765450,10704764,7.70
9854138,9970338,1372,480200,10450538,4.82
9854139,9957657,7042,2464700,12422357,24.75
9854140,9950362,4634,1621900,11572262,16.30
9854141,9953449,4990,1746500,11699949,17.55
9854142,9933241,1291,451850,10385091,4.55
9854143,9963895,2049,717150,10681045,7.20
9854144,9956736,1558,545300,10502036,5.48
9854145,9985727,1506,527100,10512827,5.28
9854146,9963897,3462,1211700,11175597,12.16
9854147,9967183,5707,1997450,11964633,20.04
9854148,9962898,3028,1059800,11022698,10.64
9854149,9992828,387,135450,10128278,1.36
9854150,9754014,3004,1051400,10805414,10.78
9854151,660193,453,158550,818743,24.02
9854152,9621490,741,259350,9880840,2.70
9854153,9976360,2277,796950,10773310,7.99
9854154,9974432,949,332150,10306582,3.33
9854155,9957678,2889,1011150,10968828,10.15
9854156,9982891,2222,777700,10760591,7.79
9854157,9715487,709,248150,9963637,2.55
9854158,9977418,4719,1651650,11629068,16.55
9854159,9973887,4332,1516200,11490087,15.20
9854160,9786144,2896,1013600,10799744,10.36
9854161,2961788,1821,637350,3599138,21.52
9854162,9976555,5049,1767150,11743705,17.71
9854163,9965863,3735,1307250,11273113,13.12
9854164,9777230,3952,1383200,11160430,14.15
9854165,9977065,1834,641900,10618965,6.43
9854166,9992840,3553,1243550,11236390,12.44
9854167,9976763,3110,1088500,11065263,10.91
9854168,9710013,1472,515200,10225213,5.31
9854170,9977228,1282,448700,10425928,4.50
9854171,4217279,1572,550200,4767479,13.05
9854172,9992571,5614,1964900,11957471,19.66
9854173,9965854,3816,1335600,11301454,13.40
9854174,5163416,1746,611100,5774516,11.84
9854175,9961898,4939,1728650,11690548,17.35
9854176,2549649,1750,612500,3162149,24.02
9854177,9916773,4347,1521450,11438223,15.34
9854178,9951461,4533,1586550,11538011,15.94
9854179,9944187,3287,1150450,11094637,11.57
9854180,9938439,2539,888650,10827089,8.94
9854181,1253093,729,255150,1508243,20.36
9854182,9933097,4366,1528100,11461197,15.38
9854183,9942328,2803,981050,10923378,9.87
9854184,9955280,5318,1861300,11816580,18.70
9854185,1800435,841,294350,2094785,16.35
9854187,9398374,6269,2194150,11592524,23.35
9854188,1882249,1055,369250,2251499,19.62
9854189,7040619,3785,1324750,8365369,18.82
9854190,9860792,4770,1669500,11530292,16.93
9854191,9951294,4879,1707650,11658944,17.16
9854192,9962127,3887,1360450,11322577,13.66
9854194,9972621,2792,977200,10949821,9.80
9854195,9971676,3809,1333150,11304826,13.37
9854196,9979996,3372,1180200,11160196,11.83
9854197,9994646,4761,1666350,11660996,16.67
9854198,9975006,2105,736750,10711756,7.39
9854199,9954900,5585,1954750,11909650,19.64
9854200,1185475,686,240100,1425575,20.25
9854201,9780534,6193,2167550,11948084,22.16
9854202,9950782,2710,948500,10899282,9.53
9854203,9925463,2177,761950,10687413,7.68
9854204,2224750,1061,371350,2596100,16.69
9854205,9793548,4596,1608600,11402148,16.43
9854206,9943981,4529,1585150,11529131,15.94
9854207,9958047,3392,1187200,11145247,11.92
9854208,9959966,3424,1198400,11158366,12.03
9854209,9976349,7782,2723700,12700049,27.30
9854210,9970959,2984,1044400,11015359,10.47
9854211,9977215,1803,631050,10608265,6.32
9854212,9672279,2261,791350,10463629,8.18
9854213,9335024,4536,1587600,10922624,17.01
9854214,9998633,2045,715750,10714383,7.16
9854215,9970592,3791,1326850,11297442,13.31
9854216,8277276,1969,689150,8966426,8.33
9854217,4273421,2239,783650,5057071,18.34
9854218,9981405,3130,1095500,11076905,10.98
9854219,9974172,2860,1001000,10975172,10.04
9854220,9985913,2330,815500,10801413,8.17
9854221,9993023,2877,1006950,10999973,10.08
9854222,2565339,897,313950,2879289,12.24
9854223,9971703,3301,1155350,11127053,11.59
9854224,9976026,4200,1470000,11446026,14.74
9854225,165967,91,31850,197817,19.19
9854226,9981397,2969,1039150,11020547,10.41
9854227,9995853,2009,703150,10699003,7.03
9854228,9427528,3896,1363600,10791128,14.46
9854229,9977032,1922,672700,10649732,6.74
9854230,6544262,4197,1468950,8013212,22.45
9854231,9952437,2537,887950,10840387,8.92
9854232,9966707,2180,763000,10729707,7.66
9854233,1033745,444,155400,1189145,15.03
9854234,9940471,3083,1079050,11019521,10.86
9854235,9942205,2958,1035300,10977505,10.41
9854236,9956527,3865,1352750,11309277,13.59
9854237,9949441,4720,1652000,11601441,16.60
9854238,57923,28,9800,67723,16.92
9854239,9939583,5254,1838900,11778483,18.50
9854240,314043,166,58100,372143,18.50
9854241,9922102,4187,1465450,11387552,14.77
9854242,9935347,3510,1228500,11163847,12.36
9854243,9932375,2203,771050,10703425,7.76
9854244,9931790,5084,1779400,11711190,17.92
9854245,9932500,4904,1716400,11648900,17.28
9854246,9945612,1719,601650,10547262,6.05
9854247,9948004,2869,1004150,10952154,10.09
9854248,4021130,1454,508900,4530030,12.66
9854249,9949931,3715,1300250,11250181,13.07
9854250,9926068,3037,1062950,10989018,10.71
9854251,4532213,1557,544950,5077163,12.02
9854252,7960570,2418,846300,8806870,10.63
9854253,9928812,5432,1901200,11830012,19.15
9854254,7003757,3580,1253000,8256757,17.89
9854255,9943650,4471,1564850,11508500,15.74
9854257,9949945,4537,1587950,11537895,15.96
9854258,9945919,3896,1363600,11309519,13.71
9854259,9930608,2537,887950,10818558,8.94
9854260,9948761,1430,500500,10449261,5.03
9854261,2450578,674,235900,2686478,9.63
9854262,9924675,1788,625800,10550475,6.31
9854263,9912777,4165,1457750,11370527,14.71
9854264,9936303,3128,1094800,11031103,11.02
9854265,9933284,3630,1270500,11203784,12.79
9854266,9906867,3046,1066100,10972967,10.76
9854267,9936461,1287,450450,10386911,4.53
9854268,9912753,2447,856450,10769203,8.64
9854269,398410,331,115850,514260,29.08
9854270,2714212,1119,391650,3105862,14.43
9854271,9935442,5605,1961750,11897192,19.74
9854272,3991897,1040,364000,4355897,9.12
9854273,9951349,3428,1199800,11151149,12.06
9854274,9955655,2282,798700,10754355,8.02
9854275,9610695,1500,525000,10135695,5.46
9854276,9959478,2170,759500,10718978,7.63
9854277,9710035,2130,745500,10455535,7.68
9854278,9986014,2472,865200,10851214,8.66
9854279,9990689,2586,905100,10895789,9.06
9854280,9982792,2338,818300,10801092,8.20
9854281,9955709,5898,2064300,12020009,20.73
9854282,9451591,4015,1405250,10856841,14.87
9854283,9976182,3690,1291500,11267682,12.95
9854284,9974584,1531,535850,10510434,5.37
9854285,808863,197,68950,877813,8.52
9854286,93745,12,4200,97945,4.48
9854287,9997489,3100,1085000,11082489,10.85
9854288,9979443,4155,1454250,11433693,14.57
9854289,9741448,2778,972300,10713748,9.98
9854290,9970574,3429,1200150,11170724,12.04
9854291,9973151,2742,959700,10932851,9.62
9854292,3014676,1128,394800,3409476,13.10
9854293,9969453,3069,1074150,11043603,10.77
9854294,9887867,5575,1951250,11839117,19.73
9854295,9965693,4724,1653400,11619093,16.59
9854296,9978033,1927,674450,10652483,6.76
9854298,9982069,3037,1062950,11045019,10.65
9854299,9946427,4155,1454250,11400677,14.62
9854300,999628,385,134750,1134378,13.48
9854301,9723710,2881,1008350,10732060,10.37
9854302,9972422,3590,1256500,11228922,12.60
9854303,9979536,2652,928200,10907736,9.30
9854304,4944314,1677,586950,5531264,11.87
9854305,1546322,433,151550,1697872,9.80
9854306,9988254,5343,1870050,11858304,18.72
9854307,9597404,3962,1386700,10984104,14.45
9854308,9982883,3432,1201200,11184083,12.03
9854309,9990902,2313,809550,10800452,8.10
9854310,9993648,4101,1435350,11428998,14.36
9854311,9983034,1759,615650,10598684,6.17
9854312,9980677,3969,1389150,11369827,13.92
9854313,9985122,2004,701400,10686522,7.02
9854314,9971355,1909,668150,10639505,6.70
9854315,1513284,2029,710150,2223434,46.93
9854316,5053550,2709,948150,6001700,18.76
9854317,1018543,446,156100,1174643,15.33
9854318,3660757,630,220500,3881257,6.02
9854319,9976757,3477,1216950,11193707,12.20
9854320,495990,180,63000,558990,12.70
9854321,9976496,3620,1267000,11243496,12.70
9854322,9990835,2775,971250,10962085,9.72
9854323,9970765,4306,1507100,11477865,15.12
9854324,9973762,2522,882700,10856462,8.85
9854325,9976258,1584,554400,10530658,5.56
9854326,9994323,1966,688100,10682423,6.88
9854327,301756,102,35700,337456,11.83
9854328,9979655,1454,508900,10488555,5.10
9854329,9976009,4236,1482600,11458609,14.86
9854330,9902802,3028,1059800,10962602,10.70
9854331,9902864,2775,971250,10874114,9.81
9854332,9965185,2242,784700,10749885,7.87
9854333,9979501,3942,1379700,11359201,13.83
9854334,9947814,2984,1044400,10992214,10.50
9854335,9974489,1579,552650,10527139,5.54
9854336,9952110,1512,529200,10481310,5.32
9854337,2617799,1053,368550,2986349,14.08
9854338,2542181,836,292600,2834781,11.51
9854339,9980252,4944,1730400,11710652,17.34
9854340,9975944,4845,1695750,11671694,17.00
9854341,109841,101,35350,145191,32.18
9854342,9964565,5182,1813700,11778265,18.20
9854343,1758384,445,155750,1914134,8.86
9854344,9961908,2262,791700,10753608,7.95
9854345,9961045,5276,1846600,11807645,18.54
9854346,9970394,3680,1288000,11258394,12.92
9854347,9985350,2966,1038100,11023450,10.40
9854348,9981583,2638,923300,10904883,9.25
9854349,4418187,1786,625100,5043287,14.15
9854350,9962562,3191,1116850,11079412,11.21
9854351,9501743,3993,1397550,10899293,14.71
9854352,9974657,3078,1077300,11051957,10.80
9854353,9963495,3913,1369550,11333045,13.75
9854354,9952900,2036,712600,10665500,7.16
9854355,9979369,4122,1442700,11422069,14.46
9854356,9964963,4548,1591800,11556763,15.97
9854357,9990299,3293,1152550,11142849,11.54
9854358,1914776,1087,380450,2295226,19.87
9854359,2687694,1020,357000,3044694,13.28
9854360,9957363,3662,1281700,11239063,12.87
9854361,9958081,2629,920150,10878231,9.24
9854362,9942633,4605,1611750,11554383,16.21
9854363,9938925,2530,885500,10824425,8.91
9854364,9946675,2942,1029700,10976375,10.35
9854365,9947490,2921,1022350,10969840,10.28
9854366,9932538,2235,782250,10714788,7.88
9854367,1502929,973,340550,1843479,22.66
9854368,9405251,5243,1835050,11240301,19.51
9854369,9962754,4458,1560300,11523054,15.66
9854370,9948304,4533,1586550,11534854,15.95
9854371,9970915,5429,1900150,11871065,19.06
9854372,9980798,3397,1188950,11169748,11.91
9854373,9977350,3189,1116150,11093500,11.19
9854374,9984224,1948,681800,10666024,6.83
9854375,9980592,3493,1222550,11203142,12.25
9854376,1603171,613,214550,1817721,13.38
9854377,9969953,4150,1452500,11422453,14.57
9854378,9984700,2338,818300,10803000,8.20
9854379,4213750,1604,561400,4775150,13.32
9854380,9698778,4091,1431850,11130628,14.76
9854381,9978514,4977,1741950,11720464,17.46
9854382,9980170,5419,1896650,11876820,19.00
9854383,9987444,4253,1488550,11475994,14.90
9854384,9992773,2138,748300,10741073,7.49
9854385,9715216,2238,783300,10498516,8.06
9854386,1909040,1027,359450,2268490,18.83
9854387,9959826,3273,1145550,11105376,11.50
9854388,9976587,5228,1829800,11806387,18.34
9854389,9974594,5969,2089150,12063744,20.94
9854390,9970072,2001,700350,10670422,7.02
9854391,9973358,1650,577500,10550858,5.79
9854392,9979772,1983,694050,10673822,6.95
9854393,9965450,4043,1415050,11380500,14.20
9854394,9975106,4237,1482950,11458056,14.87
9854395,9978903,2403,841050,10819953,8.43
9854396,9984041,4467,1563450,11547491,15.66
9854397,9947324,2381,833350,10780674,8.38
9854398,9999493,5117,1790950,11790443,17.91
9854399,9978618,2419,846650,10825268,8.48
9854400,9979814,2480,868000,10847814,8.70
9854401,1709078,1002,350700,2059778,20.52
9854402,9977967,1742,609700,10587667,6.11
9854403,9980193,1469,514150,10494343,5.15
9854404,9985280,2215,775250,10760530,7.76
9854405,202155,100,35000,237155,17.31
9854406,9970088,4153,1453550,11423638,14.58
9854409,9960233,3346,1171100,11131333,11.76
9854410,9971404,3740,1309000,11280404,13.13
9854411,9460503,3214,1124900,10585403,11.89
9854412,9986015,1454,508900,10494915,5.10
9854413,214710,86,30100,244810,14.02
9854414,9947117,4943,1730050,11677167,17.39
9854415,9961921,2782,973700,10935621,9.77
9854416,9964245,1409,493150,10457395,4.95
9854417,9968477,2847,996450,10964927,10.00
9854418,9966827,3254,1138900,11105727,11.43
9854419,9991148,4189,1466150,11457298,14.67
9854420,735915,329,115150,851065,15.65
9854421,9973088,5473,1915550,11888638,19.21
9854422,3949097,814,284900,4233997,7.21
9854423,8599863,3538,1238300,9838163,14.40
9854424,9984780,4428,1549800,11534580,15.52
9854425,9977958,3280,1148000,11125958,11.51
9854426,1051292,435,152250,1203542,14.48
9854427,9986258,3433,1201550,11187808,12.03
9854428,9982447,2889,1011150,10993597,10.13
9854429,9987235,3389,1186150,11173385,11.88
9854430,9977355,2601,910350,10887705,9.12
9854431,589401,310,108500,697901,18.41
9854432,8534792,3190,1116500,9651292,13.08
9854433,2077307,2664,932400,3009707,44.89
9854434,9934898,6001,2100350,12035248,21.14
9854435,4027548,1833,641550,4669098,15.93
9854436,9952976,1960,686000,10638976,6.89
9854437,5336030,1799,629650,5965680,11.80
9854438,9962675,3997,1398950,11361625,14.04
9854439,9972458,2876,1006600,10979058,10.09
9854440,9973894,3155,1104250,11078144,11.07
9854441,9992274,4216,1475600,11467874,14.77
9854442,9986581,4881,1708350,11694931,17.11
9854443,9984651,2871,1004850,10989501,10.06
9854444,9980386,4418,1546300,11526686,15.49
9854445,236232,332,116200,352432,49.19
9854446,1400884,1197,418950,1819834,29.91
9854447,236518,214,74900,311418,31.67
9854448,9950815,4268,1493800,11444615,15.01
9854449,9934306,4718,1651300,11585606,16.62
9854450,9949903,2925,1023750,10973653,10.29
9854451,6896365,1032,361200,7257565,5.24
9854452,1852742,1022,357700,2210442,19.31
9854453,9911595,4139,1448650,11360245,14.62
9854454,9908524,3783,1324050,11232574,13.36
9854455,9926590,3567,1248450,11175040,12.58
9854456,9933047,4457,1559950,11492997,15.70
9854457,9945571,1752,613200,10558771,6.17
9854458,9960706,4881,1708350,11669056,17.15
9854459,9950106,2579,902650,10852756,9.07
9854460,9969552,3127,1094450,11064002,10.98
9854461,9969038,1643,575050,10544088,5.77
9854462,9964875,2935,1027250,10992125,10.31
9854463,7964099,3418,1196300,9160399,15.02
9854464,2836301,1222,427700,3264001,15.08
9854465,9957864,2051,717850,10675714,7.21
9854467,3823174,1745,610750,4433924,15.97
9854468,9948486,2085,729750,10678236,7.34
9854469,9952999,3543,1240050,11193049,12.46
9854470,9948511,3950,1382500,11331011,13.90
9854471,9973529,1520,532000,10505529,5.33
9854472,62209,42,14700,76909,23.63
9854473,9995804,3066,1073100,11068904,10.74
9854474,9989744,4753,1663550,11653294,16.65
9854475,935239,814,284900,1220139,30.46
9854476,9963145,2465,862750,10825895,8.66
9854477,9052286,2924,1023400,10075686,11.31
9854478,6031547,1476,516600,6548147,8.56
9854479,9948951,4105,1436750,11385701,14.44
9854480,465795,250,87500,553295,18.79
9854481,9956056,2982,1043700,10999756,10.48
9854482,9961636,1777,621950,10583586,6.24
9854483,9960575,4922,1722700,11683275,17.30
9854484,9965024,2606,912100,10877124,9.15
9854485,9968435,3368,1178800,11147235,11.83
9854486,1673197,977,341950,2015147,20.44
9854487,9984093,4134,1446900,11430993,14.49
9854488,9977623,2453,858550,10836173,8.60
9854489,9982343,4649,1627150,11609493,16.30
9854490,9983432,2907,1017450,11000882,10.19
9854491,9962050,4359,1525650,11487700,15.31
9854492,9840090,1122,392700,10232790,3.99
9854493,9991521,2895,1013250,11004771,10.14
9854494,9969779,1969,689150,10658929,6.91
9854495,7176846,2438,853300,8030146,11.89
9854496,9984123,2474,865900,10850023,8.67
9854497,9972328,3215,1125250,11097578,11.28
9854498,9954990,5442,1904700,11859690,19.13
9854499,9976993,3422,1197700,11174693,12.00
9854500,2170268,1623,568050,2738318,26.17
9854501,9973595,3293,1152550,11126145,11.56
9854502,9989349,3317,1160950,11150299,11.62
9854503,6958735,2613,914550,7873285,13.14
9854505,9979853,3742,1309700,11289553,13.12
9854506,9991030,1149,402150,10393180,4.03
9854507,9994197,4163,1457050,11451247,14.58
9854508,9976833,3001,1050350,11027183,10.53
9854509,435162,422,147700,582862,33.94
9854510,223900,156,54600,278500,24.39
9854511,9978180,4149,1452150,11430330,14.55
9854512,9969512,1925,673750,10643262,6.76
9854513,9547135,2766,968100,10515235,10.14
9854514,9973098,3428,1199800,11172898,12.03
9854515,46097,16,5600,51697,12.15
9854516,9960270,3222,1127700,11087970,11.32
9854517,9969163,4382,1533700,11502863,15.38
9854518,9987741,988,345800,10333541,3.46
9854519,8113347,3101,1085350,9198697,13.38
9854520,9995805,4758,1665300,11661105,16.66
9854521,9982575,3442,1204700,11187275,12.07
9854522,9979330,2134,746900,10726230,7.48
9854523,9990077,2141,749350,10739427,7.50
9854524,496199,283,99050,595249,19.96
9854525,9958386,1976,691600,10649986,6.94
9854526,9960123,2380,833000,10793123,8.36
9854527,9941635,1751,612850,10554485,6.16
9854528,4259518,1291,451850,4711368,10.61
9854529,9929322,2355,824250,10753572,8.30
9854530,3478087,602,210700,3688787,6.06
9854531,9934828,4434,1551900,11486728,15.62
9854532,1271296,444,155400,1426696,12.22
9854533,9931627,3392,1187200,11118827,11.95
9854534,670638,1126,394100,1064738,58.76
9854535,9884662,2820,987000,10871662,9.99
9854536,9646668,3372,1180200,10826868,12.23
9854537,4050013,2227,779450,4829463,19.25
9854538,9884420,3743,1310050,11194470,13.25
9854539,639037,100,35000,674037,5.48
9854540,9816850,2186,765100,10581950,7.79
9854541,9889870,1733,606550,10496420,6.13
9854542,9898525,2940,1029000,10927525,10.40
9854543,9899791,3625,1268750,11168541,12.82
9854544,9899501,2259,790650,10690151,7.99
9854545,9920998,3384,1184400,11105398,11.94
9854546,9908059,2592,907200,10815259,9.16
9854547,9910999,1209,423150,10334149,4.27
9854548,9900519,3529,1235150,11135669,12.48
9854549,460534,383,134050,594584,29.11
9854550,9917336,3734,1306900,11224236,13.18
9854551,9908734,4581,1603350,11512084,16.18
9854552,9340972,4389,1536150,10877122,16.45
9854553,9905182,3955,1384250,11289432,13.98
9854554,9905263,2206,772100,10677363,7.79
9854555,1748087,1274,445900,2193987,25.51
9854556,9921647,4710,1648500,11570147,16.62
9854557,4075975,1517,530950,4606925,13.03
9854558,9930676,5709,1998150,11928826,20.12
9854559,775013,291,101850,876863,13.14
9854560,9923140,3991,1396850,11319990,14.08
9854561,9911748,2812,984200,10895948,9.93
9854562,9938661,2544,890400,10829061,8.96
9854564,9955528,1521,532350,10487878,5.35
9854565,9952713,2236,782600,10735313,7.86
9854566,9937004,4739,1658650,11595654,16.69
9854567,9931189,5249,1837150,11768339,18.50
9854568,9911964,4435,1552250,11464214,15.66
9854569,2400007,711,248850,2648857,10.37
9854570,9963885,2938,1028300,10992185,10.32
9854571,216552,115,40250,256802,18.59
9854572,9932861,4950,1732500,11665361,17.44
9854573,462077,138,48300,510377,10.45
9854574,9937336,4502,1575700,11513036,15.86
9854575,2825634,940,329000,3154634,11.64
9854576,9931741,2606,912100,10843841,9.18
9854577,9949042,4299,1504650,11453692,15.12
9854578,718943,226,79100,798043,11.00
9854579,2103764,780,273000,2376764,12.98
9854580,6571742,2401,840350,7412092,12.79
9854581,9941475,3334,1166900,11108375,11.74
9854582,9947892,4026,1409100,11356992,14.16
9854583,9950312,3802,1330700,11281012,13.37
9854584,9944562,4878,1707300,11651862,17.17
9854585,9962743,4934,1726900,11689643,17.33
9854586,9923713,3558,1245300,11169013,12.55
9854587,9965026,4001,1400350,11365376,14.05
9854588,7170137,2526,884100,8054237,12.33
9854589,9981353,2061,721350,10702703,7.23
9854590,9966794,4019,1406650,11373444,14.11
9854591,9970230,3335,1167250,11137480,11.71
9854592,9980254,3066,1073100,11053354,10.75
9854593,9948701,3108,1087800,11036501,10.93
9854595,9966578,4186,1465100,11431678,14.70
9854596,9956106,6066,2123100,12079206,21.32
9854597,5154730,3033,1061550,6216280,20.59
9854599,9949595,3228,1129800,11079395,11.36
9854600,1798484,482,168700,1967184,9.38
9854601,9890968,2965,1037750,10928718,10.49
9854602,9941704,3208,1122800,11064504,11.29
9854603,358004,126,44100,402104,12.32
9854604,9956969,2440,854000,10810969,8.58
9854605,9952138,2620,917000,10869138,9.21
9854606,9910525,3885,1359750,11270275,13.72
9854607,9968749,3070,1074500,11043249,10.78
9854608,9960957,4692,1642200,11603157,16.49
9854609,737124,434,151900,889024,20.61
9854610,9958274,3779,1322650,11280924,13.28
9854611,9955497,2735,957250,10912747,9.62
9854612,5016622,1694,592900,5609522,11.82
9854613,9939163,3454,1208900,11148063,12.16
9854614,7533978,3680,1288000,8821978,17.10
9854615,9964041,3020,1057000,11021041,10.61
9854616,9805407,4030,1410500,11215907,14.38
9854617,2034048,719,251650,2285698,12.37
9854619,9943525,3318,1161300,11104825,11.68
9854620,9947029,2923,1023050,10970079,10.28
9854621,2940637,4487,1570450,4511087,53.41
9854622,9953857,1896,663600,10617457,6.67
9854623,3950978,2122,742700,4693678,18.80
9854624,9970861,1551,542850,10513711,5.44
9854625,9965390,3382,1183700,11149090,11.88
9854626,9907473,1969,689150,10596623,6.96
9854627,9973809,1723,603050,10576859,6.05
9854628,1620050,812,284200,1904250,17.54
9854629,9972827,4068,1423800,11396627,14.28
9854630,9981478,2612,914200,10895678,9.16
9854631,9981271,3156,1104600,11085871,11.07
9854632,9989012,3625,1268750,11257762,12.70
9854633,9952247,3181,1113350,11065597,11.19
9854634,801824,409,143150,944974,17.85
9854635,9975929,1532,536200,10512129,5.37
9854636,9990358,4235,1482250,11472608,14.84
9854638,9979347,3597,1258950,11238297,12.62
9854639,512207,161,56350,568557,11.00
9854640,9992937,4111,1438850,11431787,14.40
9854641,1941054,1061,371350,2312404,19.13
9854642,9965621,2652,928200,10893821,9.31
9854643,9986264,3880,1358000,11344264,13.60
9854644,9919752,4411,1543850,11463602,15.56
9854646,2350638,813,284550,2635188,12.11
9854647,9981527,2993,1047550,11029077,10.49
9854648,8997596,5291,1851850,10849446,20.58
9854649,5351225,2474,865900,6217125,16.18
9854650,9993690,5682,1988700,11982390,19.90
9854651,9976281,4423,1548050,11524331,15.52
9854652,9984331,3180,1113000,11097331,11.15
9854653,9567795,3270,1144500,10712295,11.96
9854654,9964077,4520,1582000,11546077,15.88
9854655,3525745,1236,432600,3958345,12.27
9854656,9972256,354,123900,10096156,1.24
9854657,9980517,3545,1240750,11221267,12.43
9854658,9943687,5269,1844150,11787837,18.55
9854659,9990023,5455,1909250,11899273,19.11
9854660,9980129,2692,942200,10922329,9.44
9854661,9983545,2695,943250,10926795,9.45
9854662,9982457,2119,741650,10724107,7.43
9854663,2701392,1715,600250,3301642,22.22
9854664,9972412,3193,1117550,11089962,11.21
9854665,4495657,2480,868000,5363657,19.31
9854666,3484977,1733,606550,4091527,17.40
9854667,9973952,6685,2339750,12313702,23.46
9854669,9941249,5201,1820350,11761599,18.31
9854670,9951473,2578,902300,10853773,9.07
9854671,9955725,4465,1562750,11518475,15.70
9854672,9980253,2154,753900,10734153,7.55
9854673,9972966,3417,1195950,11168916,11.99
9854674,9996891,3676,1286600,11283491,12.87
9854675,9991753,1352,473200,10464953,4.74
9854676,9993095,2142,749700,10742795,7.50
9854677,9983344,1739,608650,10591994,6.10
9854678,9983149,4022,1407700,11390849,14.10
9854679,9939585,2818,986300,10925885,9.92
9854680,9979673,4008,1402800,11382473,14.06
9854681,9957543,3327,1164450,11121993,11.69
9854682,4023507,815,285250,4308757,7.09
9854683,9959507,3531,1235850,11195357,12.41
9854684,9986140,2005,701750,10687890,7.03
9854685,230743,108,37800,268543,16.38
9854686,9975416,2789,976150,10951566,9.79
9854687,9961099,4289,1501150,11462249,15.07
9854688,9961126,5502,1925700,11886826,19.33
9854689,473094,240,84000,557094,17.76
9854690,9956578,2029,710150,10666728,7.13
9854691,9952138,3938,1378300,11330438,13.85
9854692,9467918,2192,767200,10235118,8.10
9854693,9952029,1267,443450,10395479,4.46
9854694,9948756,2586,905100,10853856,9.10
9854695,8951669,2041,714350,9666019,7.98
9854696,9963220,3826,1339100,11302320,13.44
9854697,9676970,1335,467250,10144220,4.83
9854698,9984042,2677,936950,10920992,9.38
9854699,9988607,2392,837200,10825807,8.38
9854700,9968925,5477,1916950,11885875,19.23
9854701,9966652,2229,780150,10746802,7.83
9854702,9975263,211,73850,10049113,0.74
9854703,9970683,3913,1369550,11340233,13.74
9854704,8967702,2190,766500,9734202,8.55
9854705,9978565,2284,799400,10777965,8.01
9854706,9976024,1988,695800,10671824,6.97
9854707,9740818,4396,1538600,11279418,15.80
9854708,9981928,3814,1334900,11316828,13.37
9854709,9985850,1473,515550,10501400,5.16
9854710,1416211,395,138250,1554461,9.76
9854711,7085913,2708,947800,8033713,13.38
9854712,1960282,641,224350,2184632,11.44
9854713,9952034,4484,1569400,11521434,15.77
9854714,9941223,3014,1054900,10996123,10.61
9854715,9937388,1878,657300,10594688,6.61
9854716,2408544,2033,711550,3120094,29.54
9854717,9951268,4107,1437450,11388718,14.44
9854718,9964471,3373,1180550,11145021,11.85
9854719,9964484,3903,1366050,11330534,13.71
9854720,3815801,1702,595700,4411501,15.61
9854721,9918299,3318,1161300,11079599,11.71
9854722,9969171,4007,1402450,11371621,14.07
9854723,9957286,5206,1822100,11779386,18.30
9854724,9975565,2268,793800,10769365,7.96
9854725,9976785,2081,728350,10705135,7.30
9854726,9970480,8037,2812950,12783430,28.21
9854727,9985618,2393,837550,10823168,8.39
9854728,9987180,1596,558600,10545780,5.59
9854729,4568462,2223,778050,5346512,17.03
9854730,9967493,4096,1433600,11401093,14.38
9854731,9982662,1021,357350,10340012,3.58
9854732,1296255,362,126700,1422955,9.77
9854733,9945388,5476,1916600,11861988,19.27
9854734,9748737,2164,757400,10506137,7.77
9854735,201721,148,51800,253521,25.68
9854736,3079191,1585,554750,3633941,18.02
9854737,1696361,639,223650,1920011,13.18
9854738,1637330,586,205100,1842430,12.53
9854739,9988889,3775,1321250,11310139,13.23
9854740,9991691,2816,985600,10977291,9.86
9854741,9973223,5410,1893500,11866723,18.99
9854742,2316186,495,173250,2489436,7.48
9854743,2078245,780,273000,2351245,13.14
9854744,6522372,1300,455000,6977372,6.98
9854745,9972392,4067,1423450,11395842,14.27
9854746,9969527,4525,1583750,11553277,15.89
9854747,9979560,4183,1464050,11443610,14.67
9854748,9995364,3317,1160950,11156314,11.61
9854750,4638839,1590,556500,5195339,12.00
9854751,2097130,1580,553000,2650130,26.37
9854752,9964460,4988,1745800,11710260,17.52
9854753,9973470,3494,1222900,11196370,12.26
9854754,9977397,2158,755300,10732697,7.57
9854755,9986722,3376,1181600,11168322,11.83
9854756,9989005,4127,1444450,11433455,14.46
9854757,9986401,2816,985600,10972001,9.87
9854758,9741079,3039,1063650,10804729,10.92
9854759,9989502,4496,1573600,11563102,15.75
9854760,1087058,344,120400,1207458,11.08
9854761,5113056,1879,657650,5770706,12.86
9854762,9445384,3626,1269100,10714484,13.44
9854764,1363916,855,299250,1663166,21.94
9854765,4057060,1118,391300,4448360,9.64
9854766,712246,342,119700,831946,16.81
9854767,9963911,5169,1809150,11773061,18.16
9854768,9979917,3355,1174250,11154167,11.77
9854769,9971505,3561,1246350,11217855,12.50
9854770,9975257,1202,420700,10395957,4.22
9854771,9981883,958,335300,10317183,3.36
9854772,9951449,3980,1393000,11344449,14.00
9854773,9983207,3826,1339100,11322307,13.41
9854774,9983390,3299,1154650,11138040,11.57
9854775,8620872,3136,1097600,9718472,12.73
9854776,9974091,3286,1150100,11124191,11.53
9854777,9997398,2763,967050,10964448,9.67
9854778,2163196,1243,435050,2598246,20.11
9854779,9970005,4097,1433950,11403955,14.38
9854780,1298562,592,207200,1505762,15.96
9854781,9962404,3484,1219400,11181804,12.24
9854782,9954462,4982,1743700,11698162,17.52
9854783,9943350,3811,1333850,11277200,13.41
9854784,9958423,1599,559650,10518073,5.62
9854785,9964547,2657,929950,10894497,9.33
9854786,9949711,2489,871150,10820861,8.76
9854787,1508146,839,293650,1801796,19.47
9854788,9969438,3036,1062600,11032038,10.66
9854789,2160509,825,288750,2449259,13.36
9854791,982549,139,48650,1031199,4.95
9854792,7203682,2622,917700,8121382,12.74
9854793,9712720,3048,1066800,10779520,10.98
9854794,2564077,930,325500,2889577,12.69
9854795,3618325,1089,381150,3999475,10.53
9854796,9985587,3260,1141000,11126587,11.43
9854797,9956618,1687,590450,10547068,5.93
9854798,9983044,3810,1333500,11316544,13.36
9854799,9992584,2062,721700,10714284,7.22
9854800,9991897,4010,1403500,11395397,14.05
9854801,9983788,3296,1153600,11137388,11.55
9854802,9986845,4749,1662150,11648995,16.64
9854803,9984212,3043,1065050,11049262,10.67
9854804,965167,283,99050,1064217,10.26
9854805,8248781,2713,949550,9198331,11.51
9854806,9990359,3843,1345050,11335409,13.46
9854807,9981144,4231,1480850,11461994,14.84
9854808,9996591,2108,737800,10734391,7.38
9854809,251824,42,14700,266524,5.84
9854810,9972182,4048,1416800,11388982,14.21
9854811,5480091,3079,1077650,6557741,19.66
9854812,9972554,3280,1148000,11120554,11.51
9854813,9972545,4454,1558900,11531445,15.63
9854814,6655081,1196,418600,7073681,6.29
9854815,9981399,3738,1308300,11289699,13.11
9854816,9989934,5912,2069200,12059134,20.71
9854817,1599707,592,207200,1806907,12.95
9854818,6069113,2317,810950,6880063,13.36
9854819,1987647,546,191100,2178747,9.61
9854820,9887381,5791,2026850,11914231,20.50
9854821,604911,224,78400,683311,12.96
9854822,9965158,2428,849800,10814958,8.53
9854823,555044,244,85400,640444,15.39
9854824,9964333,2128,744800,10709133,7.47
9854826,9966869,3355,1174250,11141119,11.78
9854827,9968915,5281,1848350,11817265,18.54
9854828,543077,217,75950,619027,13.99
9854829,9955476,1932,676200,10631676,6.79
9854830,6069808,2586,905100,6974908,14.91
9854831,9529086,4412,1544200,11073286,16.21
9854832,9971995,2933,1026550,10998545,10.29
9854833,9971483,2799,979650,10951133,9.82
9854834,9982481,44,15400,9997881,0.15
9854835,9993177,3387,1185450,11178627,11.86
9854836,587066,466,163100,750166,27.78
9854837,9969391,3762,1316700,11286091,13.21
9854838,9977651,74,25900,10003551,0.26
9854839,9964051,2524,883400,10847451,8.87
9854840,9974711,3433,1201550,11176261,12.05
9854841,9981369,4863,1702050,11683419,17.05
9854842,2284965,826,289100,2574065,12.65
9854843,9989461,2667,933450,10922911,9.34
9854844,9994009,2999,1049650,11043659,10.50
9854845,9908026,52,18200,9926226,0.18
9854846,9993821,3529,1235150,11228971,12.36
9854847,9991774,2382,833700,10825474,8.34
9854848,9979015,5151,1802850,11781865,18.07
9854849,9983945,2509,878150,10862095,8.80
9854850,1631701,458,160300,1792001,9.82
9854851,9983555,2741,959350,10942905,9.61
9854852,9999111,4746,1661100,11660211,16.61
9854853,9982817,3998,1399300,11382117,14.02
9854854,9997755,2385,834750,10832505,8.35
9854855,9991219,3183,1114050,11105269,11.15
9854856,9980770,5090,1781500,11762270,17.85
9854857,9972735,3078,1077300,11050035,10.80
9854858,9970361,3281,1148350,11118711,11.52
9854859,9983588,72,25200,10008788,0.25
9854860,9962899,2773,970550,10933449,9.74
9854861,3639723,70,24500,3664223,0.67
9854862,9978909,3211,1123850,11102759,11.26
9854863,9985044,4123,1443050,11428094,14.45
9854864,9982236,3001,1050350,11032586,10.52
9854865,9971891,3761,1316350,11288241,13.20
9854866,9977747,5344,1870400,11848147,18.75
9854867,9996757,1331,465850,10462607,4.66
9854868,9997352,2987,1045450,11042802,10.46
9854869,541007,311,108850,649857,20.12
9854870,9964731,2718,951300,10916031,9.55
9854871,9972104,3427,1199450,11171554,12.03
9854872,9993793,3140,1099000,11092793,11.00
9854873,9989397,2827,989450,10978847,9.91
9854874,2731662,654,228900,2960562,8.38
9854875,9982213,2065,722750,10704963,7.24
9854876,9985180,2627,919450,10904630,9.21
9854877,9971573,2734,956900,10928473,9.60
9854878,9982435,1876,656600,10639035,6.58
9854879,9955119,2121,742350,10697469,7.46
9854880,9982650,3888,1360800,11343450,13.63
9854881,9985796,2944,1030400,11016196,10.32
9854882,9984530,3352,1173200,11157730,11.75
9854883,9980044,3446,1206100,11186144,12.09
9854884,9967818,2853,998550,10966368,10.02
9854885,9971657,4252,1488200,11459857,14.92
9854886,9969793,1500,525000,10494793,5.27
9854887,9975030,2854,998900,10973930,10.01
9854888,9979480,3180,1113000,11092480,11.15
9854889,9982401,3356,1174600,11157001,11.77
9854890,9994427,2597,908950,10903377,9.09
9854891,9992596,3167,1108450,11101046,11.09
9854892,9986116,2950,1032500,11018616,10.34
9854893,9959638,1788,625800,10585438,6.28
9854894,9964435,3369,1179150,11143585,11.83
9854895,9928364,4119,1441650,11370014,14.52
9854896,9982927,3358,1175300,11158227,11.77
9854897,9986987,3269,1144150,11131137,11.46
9854898,9975407,2967,1038450,11013857,10.41
9854899,9973431,193,67550,10040981,0.68
9854900,2472029,894,312900,2784929,12.66
9854901,9961598,2216,775600,10737198,7.79
9854902,9959558,3355,1174250,11133808,11.79
9854903,9961233,3395,1188250,11149483,11.93
9854904,9962017,3116,1090600,11052617,10.95
9854905,9964867,4316,1510600,11475467,15.16
9854906,9979171,2689,941150,10920321,9.43
9854908,1012543,424,148400,1160943,14.66
9854909,9967772,4046,1416100,11383872,14.21
9854910,9978475,1512,529200,10507675,5.30
9854911,9978366,3639,1273650,11252016,12.76
9854912,9977022,3320,1162000,11139022,11.65
9854913,9944105,2295,803250,10747355,8.08
9854915,827881,349,122150,950031,14.75
9854916,9901676,3424,1198400,11100076,12.10
9854917,5011920,427,149450,5161370,2.98
9854918,9947926,1715,600250,10548176,6.03
9854919,9950959,1774,620900,10571859,6.24
9854920,9979137,928,324800,10303937,3.25
9854921,9965080,1547,541450,10506530,5.43
9854922,9971035,2692,942200,10913235,9.45
9854923,9974433,4176,1461600,11436033,14.65
9854924,9981928,4574,1600900,11582828,16.04
9854925,9982820,1218,426300,10409120,4.27
9854926,109406,42,14700,124106,13.44
9854927,9969209,3501,1225350,11194559,12.29
9854928,9954538,4406,1542100,11496638,15.49
9854929,9975524,3867,1353450,11328974,13.57
9854930,9975271,3047,1066450,11041721,10.69
9854931,9961698,5807,2032450,11994148,20.40
9854933,9975646,4397,1538950,11514596,15.43
9854934,9983007,4525,1583750,11566757,15.86
9854935,9989079,3791,1326850,11315929,13.28
9854936,9987787,1719,601650,10589437,6.02
9854937,9984254,2459,860650,10844904,8.62
9854938,9981458,3329,1165150,11146608,11.67
9854939,9974508,2124,743400,10717908,7.45
9854940,210631,139,48650,259281,23.10
9854941,9984830,3180,1113000,11097830,11.15
9854942,209958,98,34300,244258,16.34
9854943,9968166,2195,768250,10736416,7.71
9854944,9941440,3911,1368850,11310290,13.77
9854945,9950593,4473,1565550,11516143,15.73
9854946,9965568,3563,1247050,11212618,12.51
9854947,9956576,4547,1591450,11548026,15.98
9854948,9945887,3739,1308650,11254537,13.16
9854949,9913431,3958,1385300,11298731,13.97
9854950,9957684,4168,1458800,11416484,14.65
9854951,9944690,1336,467600,10412290,4.70
9854952,9943500,3778,1322300,11265800,13.30
9854953,9960619,2054,718900,10679519,7.22
9854954,2461735,1830,640500,3102235,26.02
9854955,9958073,2939,1028650,10986723,10.33
9854956,9963500,2224,778400,10741900,7.81
9854957,9977581,3903,1366050,11343631,13.69
9854958,9984022,3837,1342950,11326972,13.45
9854959,9978482,3268,1143800,11122282,11.46
9854960,9839580,3385,1184750,11024330,12.04
9854961,1844498,356,124600,1969098,6.76
9854962,9981517,3565,1247750,11229267,12.50
9854963,9996641,2904,1016400,11013041,10.17
9854964,9998738,1666,583100,10581838,5.83
9854965,9977485,2609,913150,10890635,9.15
9854966,9999182,2321,812350,10811532,8.12
9854967,9972561,2366,828100,10800661,8.30
9854968,9991330,3131,1095850,11087180,10.97
9854969,9993401,2261,791350,10784751,7.92
9854970,9978914,4537,1587950,11566864,15.91
9854971,9991714,2975,1041250,11032964,10.42
9854972,9974703,3390,1186500,11161203,11.90
9854973,9990039,3550,1242500,11232539,12.44
9854974,9191659,2248,786800,9978459,8.56
9854975,4963299,3038,1063300,6026599,21.42
9854976,9960355,3481,1218350,11178705,12.23
9854978,9910035,5346,1871100,11781135,18.88
9854979,9933735,3963,1387050,11320785,13.96
9854980,9951526,3165,1107750,11059276,11.13
9854981,490780,123,43050,533830,8.77
9854982,9944869,4811,1683850,11628719,16.93
9854984,9953600,3006,1052100,11005700,10.57
9854985,9955727,2881,1008350,10964077,10.13
9854986,9965656,3776,1321600,11287256,13.26
9854987,9980116,2188,765800,10745916,7.67
9854988,2043584,864,302400,2345984,14.80
9854989,316261,40,14000,330261,4.43
9854990,9986492,4730,1655500,11641992,16.58
9854991,9976912,3648,1276800,11253712,12.80
9854992,9978309,4347,1521450,11499759,15.25
9854993,9989973,4756,1664600,11654573,16.66
9854994,9985452,3275,1146250,11131702,11.48
9854995,9967985,4047,1416450,11384435,14.21
9854996,9744138,4355,1524250,11268388,15.64
9854997,9982990,3392,1187200,11170190,11.89
9854998,9985393,5162,1806700,11792093,18.09
9854999,9989601,7199,2519650,12509251,25.22
9855000,9962096,3256,1139600,11101696,11.44
9855001,9966993,3954,1383900,11350893,13.88
9855002,9974821,4762,1666700,11641521,16.71
9855003,9486774,2992,1047200,10533974,11.04
9855005,9973338,4540,1589000,11562338,15.93
9855006,9966745,4089,1431150,11397895,14.36
9855007,9945537,2260,791000,10736537,7.95
9855008,4491998,2656,929600,5421598,20.69
9855009,9998678,4431,1550850,11549528,15.51
9855010,9954543,2124,743400,10697943,7.47
9855011,9752065,3151,1102850,10854915,11.31
9855012,9971926,1752,613200,10585126,6.15
9855013,860318,261,91350,951668,10.62
9855014,9968826,3220,1127000,11095826,11.31
9855015,2751595,1503,526050,3277645,19.12
9855016,9978225,3294,1152900,11131125,11.55
9855017,9988991,2476,866600,10855591,8.68
9855018,9979522,2051,717850,10697372,7.19
9855019,710713,310,108500,819213,15.27
9855020,9978038,1773,620550,10598588,6.22
9855021,9983396,3176,1111600,11094996,11.13
9855022,9954432,3528,1234800,11189232,12.40
9855023,753978,209,73150,827128,9.70
9855024,9987146,3611,1263850,11250996,12.65
9855025,5489628,1589,556150,6045778,10.13
9855026,6596169,1710,598500,7194669,9.07
9855027,9918967,3206,1122100,11041067,11.31
9855028,9915186,3978,1392300,11307486,14.04
9855029,9968442,4068,1423800,11392242,14.28
9855031,9961167,3361,1176350,11137517,11.81
9855032,9980937,2948,1031800,11012737,10.34
9855033,9779551,1476,516600,10296151,5.28
9855034,9960637,1588,555800,10516437,5.58
9855035,1080344,565,197750,1278094,18.30
9855036,9948101,3888,1360800,11308901,13.68
9855037,9938042,2462,861700,10799742,8.67
9855038,242045,42,14700,256745,6.07
9855039,1318047,150,52500,1370547,3.98
9855040,9937581,4811,1683850,11621431,16.94
9855041,9949846,4293,1502550,11452396,15.10
9855042,9671129,3516,1230600,10901729,12.72
9855043,9941992,5071,1774850,11716842,17.85
9855044,9958532,3364,1177400,11135932,11.82
9855045,9980159,2305,806750,10786909,8.08
9855046,9988009,3848,1346800,11334809,13.48
9855047,653440,91,31850,685290,4.87
9855048,9969589,4865,1702750,11672339,17.08
9855049,9964673,2740,959000,10923673,9.62
9855050,9962103,3232,1131200,11093303,11.36
9855051,9977734,3859,1350650,11328384,13.54
9855052,9994050,1182,413700,10407750,4.14
9855053,9968219,2519,881650,10849869,8.84
9855054,9901086,3633,1271550,11172636,12.84
9855055,9979720,4086,1430100,11409820,14.33
9855056,9970622,2734,956900,10927522,9.60
9855057,9965941,3809,1333150,11299091,13.38
9855059,9946423,3550,1242500,11188923,12.49
9855060,9956930,2476,866600,10823530,8.70
9855061,9932273,2200,770000,10702273,7.75
9855062,9953038,4564,1597400,11550438,16.05
9855063,9967712,4208,1472800,11440512,14.78
9855064,9958121,3648,1276800,11234921,12.82
9855065,9950507,1766,618100,10568607,6.21
9855066,9970038,6253,2188550,12158588,21.95
9855067,3622235,1467,513450,4135685,14.17
9855068,7789008,1806,632100,8421108,8.12
9855069,9931526,3681,1288350,11219876,12.97
9855070,9993430,2742,959700,10953130,9.60
9855071,9976530,2209,773150,10749680,7.75
9855072,9970149,2465,862750,10832899,8.65
9855073,9966780,3521,1232350,11199130,12.36
9855074,9974758,2244,785400,10760158,7.87
9855075,9989734,4261,1491350,11481084,14.93
9855076,2018727,680,238000,2256727,11.79
9855077,9990367,2766,968100,10958467,9.69
9855078,9486807,1997,698950,10185757,7.37
9855079,9989102,4930,1725500,11714602,17.27
9855080,9980368,1946,681100,10661468,6.82
9855081,9714005,4040,1414000,11128005,14.56
9855082,9891520,1454,508900,10400420,5.14
9855083,9940469,5762,2016700,11957169,20.29
9855085,9971102,2789,976150,10947252,9.79
9855086,9950875,2562,896700,10847575,9.01
9855087,3081443,2415,845250,3926693,27.43
9855088,9967708,4276,1496600,11464308,15.01
9855089,9975580,5696,1993600,11969180,19.98
9855090,9976425,3702,1295700,11272125,12.99
9855091,9974582,6305,2206750,12181332,22.12
9855092,9977153,4459,1560650,11537803,15.64
9855093,9990884,4216,1475600,11466484,14.77
9855094,1091695,498,174300,1265995,15.97
9855095,2910393,1057,369950,3280343,12.71
9855096,9959962,3712,1299200,11259162,13.04
9855097,9963025,4098,1434300,11397325,14.40
9855098,9946629,2756,964600,10911229,9.70
9855099,9953489,2333,816550,10770039,8.20
9855100,476456,411,143850,620306,30.19
9855101,359950,60,21000,380950,5.83
9855102,9720320,3240,1134000,10854320,11.67
9855103,9468808,3462,1211700,10680508,12.80
9855104,1261499,523,183050,1444549,14.51
9855105,9994145,2943,1030050,11024195,10.31
9855106,9989784,3087,1080450,11070234,10.82
9855107,9986667,3640,1274000,11260667,12.76
9855108,552690,225,78750,631440,14.25
9855109,9963855,2031,710850,10674705,7.13
9855110,9977863,2817,985950,10963813,9.88
9855111,9704361,3602,1260700,10965061,12.99
9855112,1365898,598,209300,1575198,15.32
9855113,9962801,1050,367500,10330301,3.69
9855114,310520,280,98000,408520,31.56
9855115,9948427,3488,1220800,11169227,12.27
9855116,9941518,3731,1305850,11247368,13.14
9855117,9946878,2627,919450,10866328,9.24
9855118,9936915,2414,844900,10781815,8.50
9855119,9956930,4065,1422750,11379680,14.29
9855120,9921473,5927,2074450,11995923,20.91
9855121,9947790,2526,884100,10831890,8.89
9855122,9702041,3058,1070300,10772341,11.03
9855123,83209,42,14700,97909,17.67
9855124,9961987,3207,1122450,11084437,11.27
9855125,9961575,3029,1060150,11021725,10.64
9855126,9959277,1108,387800,10347077,3.89
9855127,9965674,2444,855400,10821074,8.58
9855128,9949454,1808,632800,10582254,6.36
9855130,9926791,3189,1116150,11042941,11.24
9855131,9957072,2673,935550,10892622,9.40
9855132,9943079,3773,1320550,11263629,13.28
9855133,9961613,807,282450,10244063,2.84
9855134,3902840,268,93800,3996640,2.40
9855135,9957238,1778,622300,10579538,6.25
9855136,9967842,3542,1239700,11207542,12.44
9855137,9973824,2741,959350,10933174,9.62
9855138,9979015,4879,1707650,11686665,17.11
9855139,3113845,1272,445200,3559045,14.30
9855140,9984688,2897,1013950,10998638,10.16
9855141,779324,579,202650,981974,26.00
9855142,9989752,3817,1335950,11325702,13.37
9855143,3194379,1526,534100,3728479,16.72
9855144,9994886,5548,1941800,11936686,19.43
9855145,653323,819,286650,939973,43.88
9855146,9976149,2228,779800,10755949,7.82
9855147,2734288,406,142100,2876388,5.20
9855148,9738218,2879,1007650,10745868,10.35
9855149,9986359,3112,1089200,11075559,10.91
9855150,9988191,3709,1298150,11286341,13.00
9855151,360506,118,41300,401806,11.46
9855152,9977968,3506,1227100,11205068,12.30
9855153,9967122,4120,1442000,11409122,14.47
9855154,9987481,2893,1012550,11000031,10.14
9855155,9992514,2386,835100,10827614,8.36
9855157,9987400,4330,1515500,11502900,15.17
9855158,9995538,3872,1355200,11350738,13.56
9855159,9975829,3415,1195250,11171079,11.98
9855160,9992993,3321,1162350,11155343,11.63
9855161,9997915,2875,1006250,11004165,10.06
9855163,9970468,3890,1361500,11331968,13.66
9855164,5255336,2127,744450,5999786,14.17
9855165,9972153,4892,1712200,11684353,17.17
9855166,9984709,3342,1169700,11154409,11.71
9855167,1594249,691,241850,1836099,15.17
9855168,9984235,2016,705600,10689835,7.07
9855169,9976655,5509,1928150,11904805,19.33
9855170,9989444,2518,881300,10870744,8.82
9855171,9995913,247,86450,10082363,0.86
9855172,9997292,3445,1205750,11203042,12.06
9855173,9989246,2339,818650,10807896,8.20
9855174,306019,310,108500,414519,35.46
9855175,9967119,3748,1311800,11278919,13.16
9855176,9999520,2249,787150,10786670,7.87
9855177,9986023,4031,1410850,11396873,14.13
9855178,9729219,3425,1198750,10927969,12.32
9855179,9974952,2929,1025150,11000102,10.28
9855180,9980286,1612,564200,10544486,5.65
9855181,1022922,515,180250,1203172,17.62
9855182,9969566,1306,457100,10426666,4.58
9855183,9933806,6176,2161600,12095406,21.76
9855184,9978705,4343,1520050,11498755,15.23
9855185,9982422,1839,643650,10626072,6.45
9855186,9991205,2110,738500,10729705,7.39
9855187,869417,187,65450,934867,7.53
9855188,2641334,1176,411600,3052934,15.58
9855189,890298,291,101850,992148,11.44
9855190,9976310,2511,878850,10855160,8.81
9855191,9970061,2805,981750,10951811,9.85
9855192,9975122,6200,2170000,12145122,21.75
9855193,9742594,3602,1260700,11003294,12.94
9855194,9975354,1947,681450,10656804,6.83
9855195,9972024,4035,1412250,11384274,14.16
9855196,9969761,2544,890400,10860161,8.93
9855197,9994761,7755,2714250,12709011,27.16
9855198,9981550,3060,1071000,11052550,10.73
9855199,9979911,3452,1208200,11188111,12.11
9855200,9982314,4479,1567650,11549964,15.70
9855201,9987563,3349,1172150,11159713,11.74
9855202,9986626,4581,1603350,11589976,16.05
9855203,9983948,2154,753900,10737848,7.55
9855204,9991872,3551,1242850,11234722,12.44
9855205,93361,75,26250,119611,28.12
9855206,9972692,3730,1305500,11278192,13.09
9855207,9983539,3224,1128400,11111939,11.30
9855208,9967551,2321,812350,10779901,8.15
9855209,9961139,4366,1528100,11489239,15.34
9855210,1548062,392,137200,1685262,8.86
9855211,2209020,491,171850,2380870,7.78
9855212,224785,110,38500,263285,17.13
9855213,5710521,1810,633500,6344021,11.09
9855214,9962069,1817,635950,10598019,6.38
9855215,9962868,3444,1205400,11168268,12.10
9855216,5703226,2556,894600,6597826,15.69
9855217,9976714,5462,1911700,11888414,19.16
9855218,9971968,1779,622650,10594618,6.24
9855219,9980599,3837,1342950,11323549,13.46
9855220,9993968,4076,1426600,11420568,14.27
9855221,4049979,355,124250,4174229,3.07
9855222,4693889,682,238700,4932589,5.09
9855223,3831112,1679,587650,4418762,15.34
9855224,9974449,3510,1228500,11202949,12.32
9855225,1319820,468,163800,1483620,12.41
9855226,1652668,583,204050,1856718,12.35
9855227,9976763,2915,1020250,10997013,10.23
9855228,9978686,4392,1537200,11515886,15.40
9855229,9980337,3187,1115450,11095787,11.18
9855230,9978661,4665,1632750,11611411,16.36
9855231,9969590,3073,1075550,11045140,10.79
9855232,9950947,7164,2507400,12458347,25.20
9855233,1574747,573,200550,1775297,12.74
9855234,4570142,1973,690550,5260692,15.11
9855235,1066905,513,179550,1246455,16.83
9855236,9966326,3260,1141000,11107326,11.45
9855237,9976633,2591,906850,10883483,9.09
9855238,9970613,4593,1607550,11578163,16.12
9855239,9493667,2424,848400,10342067,8.94
9855240,9949380,3698,1294300,11243680,13.01
9855242,9968404,3406,1192100,11160504,11.96
9855243,9983496,3666,1283100,11266596,12.85
9855244,9992276,2452,858200,10850476,8.59
9855245,633621,217,75950,709571,11.99
9855246,2823167,903,316050,3139217,11.19
9855247,281644,83,29050,310694,10.31
9855249,9989491,3345,1170750,11160241,11.72
9855250,6673493,2091,731850,7405343,10.97
9855251,9972506,2955,1034250,11006756,10.37
9855252,9980283,4308,1507800,11488083,15.11
9855253,9996484,2901,1015350,11011834,10.16
9855254,9989841,3082,1078700,11068541,10.80
9855255,9989405,5367,1878450,11867855,18.80
9855256,9996775,3798,1329300,11326075,13.30
9855257,9991840,4458,1560300,11552140,15.62
9855258,9989816,2552,893200,10883016,8.94
9855259,9987808,1101,385350,10373158,3.86
9855260,9994245,1358,475300,10469545,4.76
9855261,507367,99,34650,542017,6.83
9855262,9962376,3685,1289750,11252126,12.95
9855263,1517375,402,140700,1658075,9.27
9855264,9986922,5092,1782200,11769122,17.85
9855265,673845,700,245000,918845,36.36
9855266,9968156,4093,1432550,11400706,14.37
9855267,9967169,2661,931350,10898519,9.34
9855268,9692980,3007,1052450,10745430,10.86
9855269,9957525,4968,1738800,11696325,17.46
9855270,9963999,3143,1100050,11064049,11.04
9855271,9963343,3360,1176000,11139343,11.80
9855272,9976373,5745,2010750,11987123,20.16
9855273,9957502,2421,847350,10804852,8.51
9855274,9973368,4301,1505350,11478718,15.09
9855275,9968739,3617,1265950,11234689,12.70
9855276,9955751,3538,1238300,11194051,12.44
9855277,9952601,5453,1908550,11861151,19.18
9855278,9966684,3583,1254050,11220734,12.58
9855279,9979197,3156,1104600,11083797,11.07
9855280,8961017,1781,623350,9584367,6.96
9855281,9974460,7035,2462250,12436710,24.69
9855282,9973823,3048,1066800,11040623,10.70
9855283,9964579,1260,441000,10405579,4.43
9855284,70488,54,18900,89388,26.81
9855286,9961248,4161,1456350,11417598,14.62
9855287,265374,280,98000,363374,36.93
9855288,1679733,383,134050,1813783,7.98
9855289,9972994,2068,723800,10696794,7.26
9855290,9972585,2641,924350,10896935,9.27
9855291,9971027,2288,800800,10771827,8.03
9855292,9982527,1495,523250,10505777,5.24
9855293,340883,91,31850,372733,9.34
9855294,9965413,3781,1323350,11288763,13.28
9855295,4653881,2137,747950,5401831,16.07
9855297,9953475,3212,1124200,11077675,11.29
9855298,2865072,349,122150,2987222,4.26
9855300,9932947,2498,874300,10807247,8.80
9855301,9721019,3431,1200850,10921869,12.35
9855302,9952508,4411,1543850,11496358,15.51
9855303,9970156,3253,1138550,11108706,11.42
9855304,9959559,2679,937650,10897209,9.41
9855305,903040,550,192500,1095540,21.32
9855306,8593988,837,292950,8886938,3.41
9855307,9978703,3339,1168650,11147353,11.71
9855308,9961716,4556,1594600,11556316,16.01
9855309,9974326,3715,1300250,11274576,13.04
9855311,1183828,400,140000,1323828,11.83
9855312,9967113,3502,1225700,11192813,12.30
9855313,9948189,2789,976150,10924339,9.81
9855314,9945721,3059,1070650,11016371,10.76
9855315,9950559,3549,1242150,11192709,12.48
9855316,9946718,3709,1298150,11244868,13.05
9855317,9969059,2440,854000,10823059,8.57
9855318,9948406,4570,1599500,11547906,16.08
9855319,9935794,3775,1321250,11257044,13.30
9855320,9944432,4148,1451800,11396232,14.60
9855321,9960805,4214,1474900,11435705,14.81
9855322,9949529,3413,1194550,11144079,12.01
9855323,5273543,2282,798700,6072243,15.15
9855324,9980148,3646,1276100,11256248,12.79
9855325,9973844,4165,1457750,11431594,14.62
9855326,9982296,2182,763700,10745996,7.65
9855327,9982135,4371,1529850,11511985,15.33
9855328,9976727,3222,1127700,11104427,11.30
9855329,9994028,1976,691600,10685628,6.92
9855330,9985337,3146,1101100,11086437,11.03
9855331,9984092,2538,888300,10872392,8.90
9855332,9718441,4201,1470350,11188791,15.13
9855333,4284625,2383,834050,5118675,19.47
9855334,9983413,3227,1129450,11112863,11.31
9855335,9977905,3458,1210300,11188205,12.13
9855336,9741974,3447,1206450,10948424,12.38
9855337,416731,293,102550,519281,24.61
9855338,3598153,317,110950,3709103,3.08
9855339,9970128,2712,949200,10919328,9.52
9855340,9970685,2243,785050,10755735,7.87
9855341,5744025,1124,393400,6137425,6.85
9855342,1303371,383,134050,1437421,10.28
9855343,9940690,2014,704900,10645590,7.09
9855344,9931454,5202,1820700,11752154,18.33
9855345,9915025,1056,369600,10284625,3.73
9855346,9944764,1463,512050,10456814,5.15
9855347,9941473,3385,1184750,11126223,11.92
9855348,3755035,1845,645750,4400785,17.20
9855349,9956753,5518,1931300,11888053,19.40
9855350,9947760,3647,1276450,11224210,12.83
9855351,9944557,2402,840700,10785257,8.45
9855352,9950934,3640,1274000,11224934,12.80
9855353,9948973,2612,914200,10863173,9.19
9855354,9972876,1149,402150,10375026,4.03
9855355,9976560,628,219800,10196360,2.20
9855356,9984275,2231,780850,10765125,7.82
9855357,9975470,1407,492450,10467920,4.94
9855359,9978324,3014,1054900,11033224,10.57
9855360,9983133,3156,1104600,11087733,11.06
9855361,9964429,2893,1012550,10976979,10.16
9855362,9968754,2874,1005900,10974654,10.09
9855363,9986248,4708,1647800,11634048,16.50
9855364,9971342,4793,1677550,11648892,16.82
9855365,9958660,4773,1670550,11629210,16.77
9855366,1928794,1519,531650,2460444,27.56
9855367,9962211,3361,1176350,11138561,11.81
9855368,9943560,3594,1257900,11201460,12.65
9855369,9945174,1648,576800,10521974,5.80
9855370,9960980,2881,1008350,10969330,10.12
9855371,706525,180,63000,769525,8.92
9855372,9960264,1989,696150,10656414,6.99
9855373,9929102,4011,1403850,11332952,14.14
9855374,9958466,4597,1608950,11567416,16.16
9855375,9976124,2179,762650,10738774,7.64
9855377,9970013,1898,664300,10634313,6.66
9855378,9954890,2354,823900,10778790,8.28
9855379,9997871,4342,1519700,11517571,15.20
9855380,9969658,1686,590100,10559758,5.92
9855381,9971296,3619,1266650,11237946,12.70
9855382,9967026,4828,1689800,11656826,16.95
9855383,9989150,6115,2140250,12129400,21.43
9855384,9738947,3944,1380400,11119347,14.17
9855385,9979292,2308,807800,10787092,8.09
9855386,1926110,2053,718550,2644660,37.31
9855387,1533313,934,326900,1860213,21.32
9855388,9989708,4310,1508500,11498208,15.10
9855389,1708931,977,341950,2050881,20.01
9855390,9965515,5116,1790600,11756115,17.97
9855391,9936713,5651,1977850,11914563,19.90
9855392,9980553,3526,1234100,11214653,12.37
9855393,9983247,4798,1679300,11662547,16.82
9855394,9982303,5810,2033500,12015803,20.37
9855395,1211630,1638,573300,1784930,47.32
9855396,9969755,1654,578900,10548655,5.81
9855397,5779570,3313,1159550,6939120,20.06
9855398,9975108,1895,663250,10638358,6.65
9855399,9985646,2996,1048600,11034246,10.50
9855400,9974042,1851,647850,10621892,6.50
9855401,9976886,4628,1619800,11596686,16.24
9855402,9963273,2755,964250,10927523,9.68
9855403,9959299,3943,1380050,11339349,13.86
9855404,9965088,3056,1069600,11034688,10.73
9855405,9946794,3119,1091650,11038444,10.97
9855406,9981785,6365,2227750,12209535,22.32
9855407,9986394,1976,691600,10677994,6.93
9855408,9970026,2714,949900,10919926,9.53
9855409,9979076,4519,1581650,11560726,15.85
9855410,9984264,3569,1249150,11233414,12.51
9855411,9981806,3804,1331400,11313206,13.34
9855412,9986938,2349,822150,10809088,8.23
9855413,9984358,3161,1106350,11090708,11.08
9855414,9978823,2291,801850,10780673,8.04
9855415,9986991,2621,917350,10904341,9.19
9855416,1954304,693,242550,2196854,12.41
9855417,1654334,528,184800,1839134,11.17
9855418,1879634,101,35350,1914984,1.88
9855419,9967757,5474,1915900,11883657,19.22
9855420,9972134,3012,1054200,11026334,10.57
9855421,9964055,2997,1048950,11013005,10.53
9855422,9970338,3222,1127700,11098038,11.31
9855423,9971531,2596,908600,10880131,9.11
9855424,9999903,4167,1458450,11458353,14.58
9855425,9997122,3956,1384600,11381722,13.85
9855426,9980851,3543,1240050,11220901,12.42
9855427,9978394,4345,1520750,11499144,15.24
9855428,9993221,1729,605150,10598371,6.06
9855429,1204535,384,134400,1338935,11.16
9855430,8802493,4261,1491350,10293843,16.94
9855431,1068149,282,98700,1166849,9.24
9855432,5403902,2151,752850,6156752,13.93
9855433,9970268,3656,1279600,11249868,12.83
9855434,9964532,3830,1340500,11305032,13.45
9855435,2496064,602,210700,2706764,8.44
9855437,9948361,3210,1123500,11071861,11.29
9855438,9946938,2644,925400,10872338,9.30
9855439,9950530,2365,827750,10778280,8.32
9855440,9942418,3224,1128400,11070818,11.35
9855441,9951595,3755,1314250,11265845,13.21
9855442,9962495,4421,1547350,11509845,15.53
9855443,9982323,2518,881300,10863623,8.83
9855444,540342,484,169400,709742,31.35
9855445,9962337,4558,1595300,11557637,16.01
9855446,9955595,4088,1430800,11386395,14.37
9855447,9953096,4909,1718150,11671246,17.26
9855449,9936562,1857,649950,10586512,6.54
9855450,9931618,2500,875000,10806618,8.81
9855451,7117704,1381,483350,7601054,6.79
9855452,5302702,2419,846650,6149352,15.97
9855453,9941136,4098,1434300,11375436,14.43
9855454,9943991,2996,1048600,10992591,10.55
9855456,9498617,4334,1516900,11015517,15.97
9855457,9942010,3267,1143450,11085460,11.50
9855458,9940213,3472,1215200,11155413,12.23
9855459,9909606,5484,1919400,11829006,19.37
9855460,9920933,4758,1665300,11586233,16.79
9855461,6089159,3282,1148700,7237859,18.86
9855462,9930675,4764,1667400,11598075,16.79
9855463,447911,170,59500,507411,13.28
9855464,4107259,3488,1220800,5328059,29.72
9855465,9907862,4218,1476300,11384162,14.90
9855466,9918226,5560,1946000,11864226,19.62
9855467,9911709,1337,467950,10379659,4.72
9855468,4921225,2150,752500,5673725,15.29
9855469,9908924,4272,1495200,11404124,15.09
9855470,9880172,1885,659750,10539922,6.68
9855471,613404,992,347200,960604,56.60
9855473,4200033,971,339850,4539883,8.09
9855474,9745977,4984,1744400,11490377,17.90
9855475,9912672,2041,714350,10627022,7.21
9855476,9933777,1450,507500,10441277,5.11
9855477,9946052,4214,1474900,11420952,14.83
9855478,9956389,1860,651000,10607389,6.54
9855479,9828685,2367,828450,10657135,8.43
9855480,9940777,1481,518350,10459127,5.21
9855481,2249438,1417,495950,2745388,22.05
9855482,9917680,3777,1321950,11239630,13.33
9855483,9933137,2268,793800,10726937,7.99
9855484,3222517,801,280350,3502867,8.70
9855485,9950272,2932,1026200,10976472,10.31
9855486,9943335,3827,1339450,11282785,13.47
9855487,9970983,3591,1256850,11227833,12.61
9855488,9980171,1618,566300,10546471,5.67
9855489,9987832,1948,681800,10669632,6.83
9855490,9842971,2738,958300,10801271,9.74
9855491,9981781,1825,638750,10620531,6.40
9855492,9983677,868,303800,10287477,3.04
9855493,9917975,2489,871150,10789125,8.78
9855494,9966805,4171,1459850,11426655,14.65
9855495,6838132,2809,983150,7821282,14.38
9855496,9992087,1858,650300,10642387,6.51
9855497,9974562,2547,891450,10866012,8.94
9855498,1514087,162,56700,1570787,3.74
9855499,9990249,3753,1313550,11303799,13.15
9855500,9993852,2012,704200,10698052,7.05
9855501,9967502,2846,996100,10963602,9.99
9855502,9968954,2563,897050,10866004,9.00
9855503,9992602,2030,710500,10703102,7.11
9855504,9983243,2844,995400,10978643,9.97
9855505,924485,189,66150,990635,7.16
9855506,9974646,1131,395850,10370496,3.97
9855507,9938204,2259,790650,10728854,7.96
9855508,9982489,3022,1057700,11040189,10.60
9855509,9969607,4408,1542800,11512407,15.48
9855510,9990394,1361,476350,10466744,4.77
9855511,9980259,1514,529900,10510159,5.31
9855512,9954022,942,329700,10283722,3.31
9855513,9984318,1234,431900,10416218,4.33
9855514,9972195,2078,727300,10699495,7.29
9855515,9981773,3513,1229550,11211323,12.32
9855516,9997968,3068,1073800,11071768,10.74
9855517,9721106,1244,435400,10156506,4.48
9855519,9952201,2349,822150,10774351,8.26
9855520,9974858,2460,861000,10835858,8.63
9855521,2852549,1859,650650,3503199,22.81
9855522,1394387,597,208950,1603337,14.99
9855523,9968090,3300,1155000,11123090,11.59
9855524,9999907,1372,480200,10480107,4.80
9855526,9696518,2945,1030750,10727268,10.63
9855527,9962402,1389,486150,10448552,4.88
9855528,9965813,4173,1460550,11426363,14.66
9855529,9968606,3080,1078000,11046606,10.81
9855530,9975620,4050,1417500,11393120,14.21
9855531,4624734,1328,464800,5089534,10.05
9855532,1211574,583,204050,1415624,16.84
9855533,9969856,2314,809900,10779756,8.12
9855534,3263963,924,323400,3587363,9.91
9855535,2327760,1574,550900,2878660,23.67
9855537,9925578,5894,2062900,11988478,20.78
9855538,9930660,1351,472850,10403510,4.76
9855539,9952926,1480,518000,10470926,5.20
9855541,3260546,1232,431200,3691746,13.22
9855542,6436411,2594,907900,7344311,14.11
9855543,9692585,4025,1408750,11101335,14.53
9855544,1178029,991,346850,1524879,29.44
9855545,5328106,1860,651000,5979106,12.22
9855546,9866172,3488,1220800,11086972,12.37
9855547,9817923,3200,1120000,10937923,11.41
9855548,9912169,1713,599550,10511719,6.05
9855549,9919064,2454,858900,10777964,8.66
9855550,9910861,1450,507500,10418361,5.12
9855551,1558066,1021,357350,1915416,22.94
9855552,9907952,2170,759500,10667452,7.67
9855553,9906713,1910,668500,10575213,6.75
9855554,9910025,2167,758450,10668475,7.65
9855555,9914310,1923,673050,10587360,6.79
9855556,9896254,4979,1742650,11638904,17.61
9855557,9912142,2148,751800,10663942,7.58
9855558,344874,121,42350,387224,12.28
9855559,9899972,1596,558600,10458572,5.64
9855560,9922411,2829,990150,10912561,9.98
9855561,9914135,2616,915600,10829735,9.24
9855562,442154,64,22400,464554,5.07
9855564,9899449,3322,1162700,11062149,11.75
9855565,8890575,3603,1261050,10151625,14.18
9855567,9842361,4985,1744750,11587111,17.73
9855568,9899946,1905,666750,10566696,6.73
9855569,9908555,975,341250,10249805,3.44
9855570,1379147,327,114450,1493597,8.30
9855571,8937463,3511,1228850,10166313,13.75
9855572,9928845,2565,897750,10826595,9.04
9855573,1482328,373,130550,1612878,8.81
9855574,9927991,4008,1402800,11330791,14.13
9855575,9947303,1231,430850,10378153,4.33
9855576,2228416,882,308700,2537116,13.85
9855577,1325814,502,175700,1501514,13.25
9855578,9937368,3912,1369200,11306568,13.78
9855579,9940843,4107,1437450,11378293,14.46
9855580,9964793,2320,812000,10776793,8.15
9855581,9967522,5522,1932700,11900222,19.39
9855582,9957038,1234,431900,10388938,4.34
9855583,9965987,288,100800,10066787,1.01
9855584,88418,42,14700,103118,16.63
9855585,9820874,1218,426300,10247174,4.34
9855586,9709701,4641,1624350,11334051,16.73
9855587,9632830,1615,565250,10198080,5.87
9855588,9974003,323,113050,10087053,1.13
9855589,9972635,3534,1236900,11209535,12.40
9855590,9991939,3236,1132600,11124539,11.34
9855591,9998407,3896,1363600,11362007,13.64
9855592,9996939,406,142100,10139039,1.42
9855593,9986679,2425,848750,10835429,8.50
9855595,9991139,3629,1270150,11261289,12.71
9855596,1986667,782,273700,2260367,13.78
9855597,9966334,3255,1139250,11105584,11.43
9855598,9959967,2729,955150,10915117,9.59
9855599,9973831,3108,1087800,11061631,10.91
9855600,1471305,654,228900,1700205,15.56
9855601,9990278,5052,1768200,11758478,17.70
9855602,541135,162,56700,597835,10.48
9855603,9983080,2482,868700,10851780,8.70
9855604,9989061,3203,1121050,11110111,11.22
9855605,9986310,2915,1020250,11006560,10.22
9855606,9972473,2869,1004150,10976623,10.07
9855607,9987373,2642,924700,10912073,9.26
9855608,9978069,3858,1350300,11328369,13.53
9855609,9972393,3696,1293600,11265993,12.97
9855610,1137259,417,145950,1283209,12.83
9855611,9928084,3366,1178100,11106184,11.87
9855613,9607458,2290,801500,10408958,8.34
9855614,9966795,2402,840700,10807495,8.44
9855615,9936493,3072,1075200,11011693,10.82
9855616,1380316,605,211750,1592066,15.34
9855617,2356506,1082,378700,2735206,16.07
9855618,691362,194,67900,759262,9.82
9855619,9957312,2436,852600,10809912,8.56
9855620,3771049,956,334600,4105649,8.87
9855621,9933332,4665,1632750,11566082,16.44
9855622,9923683,5037,1762950,11686633,17.77
9855623,9916196,2262,791700,10707896,7.98
9855624,484231,64,22400,506631,4.63
9855625,9900186,2084,729400,10629586,7.37
9855626,9912579,2599,909650,10822229,9.18
9855627,9898476,2153,753550,10652026,7.61
9855628,9908803,2417,845950,10754753,8.54
9855629,9917626,3296,1153600,11071226,11.63
9855630,9893905,4826,1689100,11583005,17.07
9855631,1885105,792,277200,2162305,14.70
9855632,9904738,4408,1542800,11447538,15.58
9855633,9901102,2820,987000,10888102,9.97
9855634,9904024,2065,722750,10626774,7.30
9855635,9900770,3819,1336650,11237420,13.50
9855636,304111,127,44450,348561,14.62
9855638,2993684,893,312550,3306234,10.44
9855639,9816201,3079,1077650,10893851,10.98
9855640,8918088,4530,1585500,10503588,17.78
9855641,9918165,3357,1174950,11093115,11.85
9855642,215191,156,54600,269791,25.37
9855643,9905273,3785,1324750,11230023,13.37
9855644,9672688,1156,404600,10077288,4.18
9855645,9881204,3422,1197700,11078904,12.12
9855646,6329970,413,144550,6474520,2.28
9855647,9943172,4479,1567650,11510822,15.77
9855648,9943066,3355,1174250,11117316,11.81
9855649,9957789,1562,546700,10504489,5.49
9855650,9956386,2767,968450,10924836,9.73
9855651,8965909,2429,850150,9816059,9.48
9855652,412996,207,72450,485446,17.54
9855653,9705048,1513,529550,10234598,5.46
9855654,9944558,5578,1952300,11896858,19.63
9855655,9985639,4141,1449350,11434989,14.51
9855656,204240,125,43750,247990,21.42
9855657,9986621,1870,654500,10641121,6.55
9855658,9982562,4538,1588300,11570862,15.91
9855659,9993706,1794,627900,10621606,6.28
9855660,9945542,3221,1127350,11072892,11.34
9855661,9989595,2340,819000,10808595,8.20
9855662,9984878,2757,964950,10949828,9.66
9855664,9982493,2742,959700,10942193,9.61
9855665,9943367,2308,807800,10751167,8.12
9855666,8409213,2945,1030750,9439963,12.26
9855667,9916611,2725,953750,10870361,9.62
9855668,9971365,2581,903350,10874715,9.06
9855669,412890,52,18200,431090,4.41
9855670,3066293,921,322350,3388643,10.51
9855671,9993533,3236,1132600,11126133,11.33
9855673,9984754,4636,1622600,11607354,16.25
9855674,9989582,3675,1286250,11275832,12.88
9855675,9988858,4085,1429750,11418608,14.31
9855676,9982467,4286,1500100,11482567,15.03
9855677,7779358,3955,1384250,9163608,17.79
9855678,9859963,3093,1082550,10942513,10.98
9855679,9984894,4240,1484000,11468894,14.86
9855680,9965238,2373,830550,10795788,8.33
9855681,9993072,3922,1372700,11365772,13.74
9855683,9988849,3671,1284850,11273699,12.86
9855684,9984264,3421,1197350,11181614,11.99
9855685,1060215,741,259350,1319565,24.46
9855686,9974301,4025,1408750,11383051,14.12
9855687,9696234,3022,1057700,10753934,10.91
9855688,9977330,2488,870800,10848130,8.73
9855689,9224617,2229,780150,10004767,8.46
9855690,4345409,818,286300,4631709,6.59
9855691,9969113,5893,2062550,12031663,20.69
9855692,9053687,3125,1093750,10147437,12.08
9855693,2277896,1726,604100,2881996,26.52
9855694,9957144,2950,1032500,10989644,10.37
9855695,2584472,1545,540750,3125222,20.92
9855696,9943485,2234,781900,10725385,7.86
9855698,9925913,1996,698600,10624513,7.04
9855699,9947275,2573,900550,10847825,9.05
9855700,9951269,2561,896350,10847619,9.01
9855701,9947578,1788,625800,10573378,6.29
9855702,9942228,3378,1182300,11124528,11.89
9855703,5125087,1465,512750,5637837,10.00
9855704,9209784,3294,1152900,10362684,12.52
9855705,9958810,4374,1530900,11489710,15.37
9855706,9968158,2815,985250,10953408,9.88
9855707,1981411,1237,432950,2414361,21.85
9855708,9943156,3561,1246350,11189506,12.53
9855709,9961017,3639,1273650,11234667,12.79
9855710,9974772,2614,914900,10889672,9.17
9855711,9972559,2195,768250,10740809,7.70
9855712,9984479,1566,548100,10532579,5.49
9855713,9995200,1975,691250,10686450,6.92
9855714,9960790,3611,1263850,11224640,12.69
9855715,9985897,3400,1190000,11175897,11.92
9855716,9970618,3906,1367100,11337718,13.71
9855717,9969496,3866,1353100,11322596,13.57
9855718,9956396,1008,352800,10309196,3.54
9855719,9961386,2546,891100,10852486,8.95
9855720,9980466,3534,1236900,11217366,12.39
9855721,9974288,4881,1708350,11682638,17.13
9855722,9969802,3352,1173200,11143002,11.77
9855723,1538460,787,275450,1813910,17.90
9855724,9965314,1558,545300,10510614,5.47
9855725,9993957,2062,721700,10715657,7.22
9855726,9964434,2295,803250,10767684,8.06
9855727,9981629,2951,1032850,11014479,10.35
9855728,2748103,1923,673050,3421153,24.49
9855729,9983874,7048,2466800,12450674,24.71
9855730,3542767,1337,467950,4010717,13.21
9855731,4419674,2473,865550,5285224,19.58
9855732,9974156,3152,1103200,11077356,11.06
9855733,9983690,2759,965650,10949340,9.67
9855735,9982936,7023,2458050,12440986,24.62
9855736,9990365,2240,784000,10774365,7.85
9855738,9971643,2928,1024800,10996443,10.28
9855739,9974742,3565,1247750,11222492,12.51
9855740,9976901,1245,435750,10412651,4.37
9855741,9969870,3571,1249850,11219720,12.54
9855742,9984045,3441,1204350,11188395,12.06
9855743,9984552,3472,1215200,11199752,12.17
9855744,4783213,3105,1086750,5869963,22.72
9855745,9986038,3220,1127000,11113038,11.29
9855746,9959166,3019,1056650,11015816,10.61
9855747,9989334,2905,1016750,11006084,10.18
9855748,9481221,4182,1463700,10944921,15.44
9855749,332665,74,25900,358565,7.79
9855750,9951568,4365,1527750,11479318,15.35
9855751,1185238,142,49700,1234938,4.19
9855752,9970468,5665,1982750,11953218,19.89
9855753,9956089,1741,609350,10565439,6.12
9855755,9954641,2239,783650,10738291,7.87
9855756,4963381,3244,1135400,6098781,22.88
9855757,9968415,3492,1222200,11190615,12.26
9855758,9967835,2781,973350,10941185,9.76
9855759,6447842,2490,871500,7319342,13.52
9855760,9971461,3148,1101800,11073261,11.05
9855761,9950480,2486,870100,10820580,8.74
9855762,9975205,4075,1426250,11401455,14.30
9855763,9971858,1462,511700,10483558,5.13
9855764,9972648,3125,1093750,11066398,10.97
9855765,9728062,4023,1408050,11136112,14.47
9855766,3100744,1218,426300,3527044,13.75
9855767,9960576,3376,1181600,11142176,11.86
9855768,9967150,2857,999950,10967100,10.03
9855769,7941799,2455,859250,8801049,10.82
9855770,9946727,4020,1407000,11353727,14.15
9855771,1684597,1039,363650,2048247,21.59
9855772,9952189,3906,1367100,11319289,13.74
9855773,9944959,3682,1288700,11233659,12.96
9855774,9956191,3404,1191400,11147591,11.97
9855775,9923204,1443,505050,10428254,5.09
9855776,9946138,3148,1101800,11047938,11.08
9855777,9946376,5111,1788850,11735226,17.98
9855778,9965925,4114,1439900,11405825,14.45
9855779,9979897,3924,1373400,11353297,13.76
9855780,9988877,4616,1615600,11604477,16.17
9855781,9991380,3466,1213100,11204480,12.14
9855782,9972068,2240,784000,10756068,7.86
9855783,310624,167,58450,369074,18.82
9855784,9970691,3553,1243550,11214241,12.47
9855785,9197745,2467,863450,10061195,9.39
9855786,9965995,3278,1147300,11113295,11.51
9855787,9970479,2679,937650,10908129,9.40
9855788,9974752,2676,936600,10911352,9.39
9855789,9947521,1897,663950,10611471,6.67
9855790,9978187,3644,1275400,11253587,12.78
9855791,778796,294,102900,881696,13.21
9855792,9992548,3956,1384600,11377148,13.86
9855793,9987284,3816,1335600,11322884,13.37
9855794,7299443,2043,715050,8014493,9.80
9855795,9967286,2709,948150,10915436,9.51
9855796,9969378,3144,1100400,11069778,11.04
9855797,9982602,3843,1345050,11327652,13.47
9855798,9963292,1244,435400,10398692,4.37
9855799,9974262,4606,1612100,11586362,16.16
9855800,9970371,3145,1100750,11071121,11.04
9855801,9984119,3241,1134350,11118469,11.36
9855802,775692,257,89950,865642,11.60
9855803,8999511,1409,493150,9492661,5.48
9855804,9995531,3860,1351000,11346531,13.52
9855805,9970997,2699,944650,10915647,9.47
9855806,429029,144,50400,479429,11.75
9855807,9960924,2748,961800,10922724,9.66
9855808,9941591,2019,706650,10648241,7.11
9855809,9951188,3423,1198050,11149238,12.04
9855810,9950229,2804,981400,10931629,9.86
9855811,9957534,2994,1047900,11005434,10.52
9855812,2044037,958,335300,2379337,16.40
9855813,9969470,3478,1217300,11186770,12.21
9855814,9989374,3476,1216600,11205974,12.18
9855815,3577318,1612,564200,4141518,15.77
9855816,9976920,3479,1217650,11194570,12.20
9855817,2624970,1403,491050,3116020,18.71
9855818,1478094,422,147700,1625794,9.99
9855819,9997878,3840,1344000,11341878,13.44
9855820,280038,217,75950,355988,27.12
9855821,1438686,1453,508550,1947236,35.35
9855822,9971218,3560,1246000,11217218,12.50
9855823,9942826,4285,1499750,11442576,15.08
9855824,2023666,493,172550,2196216,8.53
9855826,5765659,2044,715400,6481059,12.41
9855827,9925392,5042,1764700,11690092,17.78
9855828,9941442,3213,1124550,11065992,11.31
9855829,9934072,2403,841050,10775122,8.47
9855830,9935262,3849,1347150,11282412,13.56
9855831,9932380,1739,608650,10541030,6.13
9855832,9933731,1028,359800,10293531,3.62
9855833,2697398,1740,609000,3306398,22.58
9855834,9927807,4174,1460900,11388707,14.72
9855835,204267,87,30450,234717,14.91
9855836,9933890,3447,1206450,11140340,12.14
9855837,5289095,1784,624400,5913495,11.81
9855838,4734361,1277,446950,5181311,9.44
9855839,9929316,2917,1020950,10950266,10.28
9855840,9923504,2717,950950,10874454,9.58
9855841,9918831,2104,736400,10655231,7.42
9855842,1931256,591,206850,2138106,10.71
9855843,2434523,656,229600,2664123,9.43
9855844,9883387,2835,992250,10875637,10.04
9855845,9878556,2224,778400,10656956,7.88
9855846,9909754,2694,942900,10852654,9.51
9855847,742211,475,166250,908461,22.40
9855848,9898518,3403,1191050,11089568,12.03
9855849,9896227,3841,1344350,11240577,13.58
9855850,9801941,4550,1592500,11394441,16.25
9855851,9882212,4572,1600200,11482412,16.19
9855852,9738918,3659,1280650,11019568,13.15
9855853,9894268,3589,1256150,11150418,12.70
9855854,9920668,3630,1270500,11191168,12.81
9855855,9876794,4229,1480150,11356944,14.99
9855856,9264157,3108,1087800,10351957,11.74
9855857,9910180,3061,1071350,10981530,10.81
9855858,9877301,3548,1241800,11119101,12.57
9855859,9916528,3368,1178800,11095328,11.89
9855860,2715902,1156,404600,3120502,14.90
9855861,9888815,4648,1626800,11515615,16.45
9855862,9911225,4826,1689100,11600325,17.04
9855863,9903361,3066,1073100,10976461,10.84
9855864,9904740,3308,1157800,11062540,11.69
9855865,9919176,4180,1463000,11382176,14.75
9855866,1349865,553,193550,1543415,14.34
9855867,9769097,2004,701400,10470497,7.18
9855869,9908532,2503,876050,10784582,8.84
9855870,9661184,4296,1503600,11164784,15.56
9855871,9936727,2619,916650,10853377,9.22
9855872,9357334,4745,1660750,11018084,17.75
9855873,3909377,974,340900,4250277,8.72
9855874,9921173,4753,1663550,11584723,16.77
9855875,9921730,2552,893200,10814930,9.00
9855877,9946630,4954,1733900,11680530,17.43
9855878,9943140,4358,1525300,11468440,15.34
9855879,6758201,1691,591850,7350051,8.76
9855880,9959987,3361,1176350,11136337,11.81
9855881,589834,112,39200,629034,6.65
9855882,9967547,2588,905800,10873347,9.09
9855883,9960513,4645,1625750,11586263,16.32
9855884,9968221,2316,810600,10778821,8.13
9855885,9969239,2603,911050,10880289,9.14
9855886,9965841,4343,1520050,11485891,15.25
9855887,8991318,2567,898450,9889768,9.99
9855888,9882447,3087,1080450,10962897,10.93
9855889,9856448,3776,1321600,11178048,13.41
9855890,9984030,4031,1410850,11394880,14.13
9855891,362599,107,37450,400049,10.33
9855892,9989751,3032,1061200,11050951,10.62
9855893,7275100,1485,519750,7794850,7.14
9855895,9967842,4247,1486450,11454292,14.91
9855896,1155721,274,95900,1251621,8.30
9855897,9977680,3161,1106350,11084030,11.09
9855898,9982939,1081,378350,10361289,3.79
9855899,9988482,3662,1281700,11270182,12.83
9855900,9884406,3027,1059450,10943856,10.72
9855901,9993530,1909,668150,10661680,6.69
9855902,9977248,3074,1075900,11053148,10.78
9855903,9992103,3632,1271200,11263303,12.72
9855904,5003910,2017,705950,5709860,14.11
9855905,9988187,3650,1277500,11265687,12.79
9855906,9969989,4470,1564500,11534489,15.69
9855907,7974148,2570,899500,8873648,11.28
9855908,9718173,3987,1395450,11113623,14.36
9855909,9993262,2050,717500,10710762,7.18
9855910,9992543,3008,1052800,11045343,10.54
9855911,9978446,3363,1177050,11155496,11.80
9855912,2698486,766,268100,2966586,9.94
9855914,9984796,2951,1032850,11017646,10.34
9855915,9973792,3386,1185100,11158892,11.88
9855916,9978256,3984,1394400,11372656,13.97
9855917,9992256,3199,1119650,11111906,11.21
9855918,9993911,4250,1487500,11481411,14.88
9855919,9998713,4368,1528800,11527513,15.29
9855920,9981421,2491,871850,10853271,8.73
9855921,9998355,6158,2155300,12153655,21.56
9855922,9970424,2246,786100,10756524,7.88
9855923,9966639,4092,1432200,11398839,14.37
9855924,9990085,2214,774900,10764985,7.76
9855925,9970148,4553,1593550,11563698,15.98
9855926,9981578,5020,1757000,11738578,17.60
9855927,9997764,3494,1222900,11220664,12.23
9855928,9967106,4202,1470700,11437806,14.76
9855929,822709,109,38150,860859,4.64
9855930,9981226,3259,1140650,11121876,11.43
9855931,9965958,5378,1882300,11848258,18.89
9855932,9967082,2694,942900,10909982,9.46
9855933,9976903,4864,1702400,11679303,17.06
9855934,519850,490,171500,691350,32.99
9855935,9956002,3514,1229900,11185902,12.35
9855936,1340923,956,334600,1675523,24.95
9855937,9947361,1545,540750,10488111,5.44
9855938,9955935,5224,1828400,11784335,18.36
9855939,9969780,5243,1835050,11804830,18.41
9855940,9962318,4352,1523200,11485518,15.29
9855941,9962959,4907,1717450,11680409,17.24
9855942,9970032,5280,1848000,11818032,18.54
9855943,9976919,2716,950600,10927519,9.53
9855944,9957149,5399,1889650,11846799,18.98
9855945,9988156,4634,1621900,11610056,16.24
9855948,5350871,1896,663600,6014471,12.40
9855949,9986369,3197,1118950,11105319,11.20
9855950,1230972,381,133350,1364322,10.83
9855951,9851752,3612,1264200,11115952,12.83
9855952,9958257,4868,1703800,11662057,17.11
9855953,3603232,1335,467250,4070482,12.97
9855954,9972567,3984,1394400,11366967,13.98
9855955,9977976,3616,1265600,11243576,12.68
9855956,9472684,5015,1755250,11227934,18.53
9855957,2625003,1680,588000,3213003,22.40
9855958,9952140,5394,1887900,11840040,18.97
9855959,816765,71,24850,841615,3.04
9855960,9946816,3511,1228850,11175666,12.35
9855961,9948180,5169,1809150,11757330,18.19
9855962,7269304,3463,1212050,8481354,16.67
9855963,9866864,3105,1086750,10953614,11.01
9855964,9965329,2905,1016750,10982079,10.20
9855965,9966244,4896,1713600,11679844,17.19
9855966,9660690,3276,1146600,10807290,11.87
9855967,5704547,2255,789250,6493797,13.84
9855968,9962881,2520,882000,10844881,8.85
9855969,9971552,2196,768600,10740152,7.71
9855970,9971517,2432,851200,10822717,8.54
9855971,9986429,3965,1387750,11374179,13.90
9855972,9980953,3497,1223950,11204903,12.26
9855973,9971321,3922,1372700,11344021,13.77
9855974,9980686,2140,749000,10729686,7.50
9855975,9972249,3447,1206450,11178699,12.10
9855976,9977530,3932,1376200,11353730,13.79
9855977,9982222,3859,1350650,11332872,13.53
9855978,2491132,1893,662550,3153682,26.60
9855979,9972168,3986,1395100,11367268,13.99
9855980,9972992,3236,1132600,11105592,11.36
9855981,9960829,3329,1165150,11125979,11.70
9855982,2443199,396,138600,2581799,5.67
9855983,9953603,3584,1254400,11208003,12.60
9855984,9966841,4401,1540350,11507191,15.45
9855985,9975587,3314,1159900,11135487,11.63
9855986,9904779,2066,723100,10627879,7.30
9855987,963262,368,128800,1092062,13.37
9855988,9980657,4119,1441650,11422307,14.44
9855989,9983193,3947,1381450,11364643,13.84
9855990,2235774,1913,669550,2905324,29.95
9855991,9977262,4187,1465450,11442712,14.69
9855992,9948111,2889,1011150,10959261,10.16
9855993,9661342,4737,1657950,11319292,17.16
9855994,9994044,4459,1560650,11554694,15.62
9855995,9983627,2039,713650,10697277,7.15
9855996,9989744,3464,1212400,11202144,12.14
9855997,9973510,3859,1350650,11324160,13.54
9855998,2722232,623,218050,2940282,8.01
9855999,9969742,2177,761950,10731692,7.64
9856001,742408,315,110250,852658,14.85
9856002,9964040,2885,1009750,10973790,10.13
9856003,9974637,5603,1961050,11935687,19.66
9856004,9978520,2686,940100,10918620,9.42
9856005,5705175,3568,1248800,6953975,21.89
9856006,557859,344,120400,678259,21.58
9856007,7112647,2514,879900,7992547,12.37
9856008,9957810,2802,980700,10938510,9.85
9856009,9951702,2858,1000300,10952002,10.05
9856010,9921579,3047,1066450,10988029,10.75
9856011,9944139,2474,865900,10810039,8.71
9856012,9951793,1671,584850,10536643,5.88
9856013,9946787,1716,600600,10547387,6.04
9856014,9680273,4735,1657250,11337523,17.12
9856015,1032023,291,101850,1133873,9.87
9856016,9960629,3569,1249150,11209779,12.54
9856017,9901838,4186,1465100,11366938,14.80
9856020,9908125,4168,1458800,11366925,14.72
9856021,9914786,3451,1207850,11122636,12.18
9856022,9928974,1815,635250,10564224,6.40
9856023,9940345,2977,1041950,10982295,10.48
9856024,9927022,3649,1277150,11204172,12.87
9856025,9940057,4513,1579550,11519607,15.89
9856026,9946216,3142,1099700,11045916,11.06
9856027,9938387,3469,1214150,11152537,12.22
9856028,9944132,2119,741650,10685782,7.46
9856029,9950461,5610,1963500,11913961,19.73
9856030,9963927,2984,1044400,11008327,10.48
9856032,5729669,1250,437500,6167169,7.64
9856033,9974279,3031,1060850,11035129,10.64
9856034,9969768,3318,1161300,11131068,11.65
9856035,4474498,1233,431550,4906048,9.64
9856036,9610523,2976,1041600,10652123,10.84
9856037,9980487,2079,727650,10708137,7.29
9856038,9978713,2051,717850,10696563,7.19
9856039,9975932,2333,816550,10792482,8.19
9856040,9979906,2747,961450,10941356,9.63
9856041,9978189,2384,834400,10812589,8.36
9856042,9982890,2743,960050,10942940,9.62
9856043,9969004,2738,958300,10927304,9.61
9856044,8727353,2527,884450,9611803,10.13
9856045,4312483,1380,483000,4795483,11.20
9856046,105959,54,18900,124859,17.84
9856047,9971197,4134,1446900,11418097,14.51
9856048,9974766,2966,1038100,11012866,10.41
9856049,9976870,2854,998900,10975770,10.01
9856050,9989821,3137,1097950,11087771,10.99
9856051,4177242,1057,369950,4547192,8.86
9856052,9985026,3271,1144850,11129876,11.47
9856053,661201,493,172550,833751,26.10
9856054,9962736,3108,1087800,11050536,10.92
9856055,9943408,2253,788550,10731958,7.93
9856056,9973104,4024,1408400,11381504,14.12
9856057,641369,267,93450,734819,14.57
9856058,9945907,4701,1645350,11591257,16.54
9856059,9952531,2893,1012550,10965081,10.17
9856060,9947656,4341,1519350,11467006,15.27
9856061,9930338,2674,935900,10866238,9.42
9856062,9853137,2019,706650,10559787,7.17
9856063,757566,312,109200,866766,14.41
9856064,9955930,3522,1232700,11188630,12.38
9856065,9968750,5317,1860950,11829700,18.67
9856066,9962874,4093,1432550,11395424,14.38
9856067,9989970,2309,808150,10798120,8.09
9856068,9979824,3546,1241100,11220924,12.44
9856069,9965364,2600,910000,10875364,9.13
9856070,9968484,5758,2015300,11983784,20.22
9856071,9988162,1476,516600,10504762,5.17
9856072,9985152,1732,606200,10591352,6.07
9856073,9975898,2291,801850,10777748,8.04
9856074,9980637,2303,806050,10786687,8.08
9856075,9983713,2216,775600,10759313,7.77
9856076,9980241,2269,794150,10774391,7.96
9856077,4423392,758,265300,4688692,6.00
9856078,4927894,1723,603050,5530944,12.24
9856079,9979605,2360,826000,10805605,8.28
9856080,9986185,4803,1681050,11667235,16.83
9856082,5671214,1842,644700,6315914,11.37
9856083,9986476,2741,959350,10945826,9.61
9856084,9900316,4106,1437100,11337416,14.52
9856085,9980697,1694,592900,10573597,5.94
9856086,9993997,4681,1638350,11632347,16.39
9856087,5123751,1331,465850,5589601,9.09
9856088,9978706,3188,1115800,11094506,11.18
9856089,1550185,173,60550,1610735,3.91
9856091,9949421,2919,1021650,10971071,10.27
9856092,9972849,2577,901950,10874799,9.04
9856093,9949652,1308,457800,10407452,4.60
9856094,1220489,94,32900,1253389,2.70
9856095,9980597,4350,1522500,11503097,15.25
9856096,9992920,4773,1670550,11663470,16.72
9856097,3336811,637,222950,3559761,6.68
9856098,9987234,2652,928200,10915434,9.29
9856099,9983053,4678,1637300,11620353,16.40
9856100,4873381,1367,478450,5351831,9.82
9856101,9977961,4503,1576050,11554011,15.80
9856102,9983856,3325,1163750,11147606,11.66
9856103,9990926,5216,1825600,11816526,18.27
9856104,9965125,1736,607600,10572725,6.10
9856105,900594,236,82600,983194,9.17
9856106,6327394,2737,957950,7285344,15.14
9856107,9957008,4990,1746500,11703508,17.54
9856108,9956499,2686,940100,10896599,9.44
9856109,9958532,4064,1422400,11380932,14.28
9856110,2163450,434,151900,2315350,7.02
9856111,9968831,4038,1413300,11382131,14.18
9856113,9624952,4654,1628900,11253852,16.92
9856114,9984994,3231,1130850,11115844,11.33
9856115,9987270,3521,1232350,11219620,12.34
9856116,9891002,2536,887600,10778602,8.97
9856117,9981902,3989,1396150,11378052,13.99
9856118,9976272,3178,1112300,11088572,11.15
9856119,9994721,3652,1278200,11272921,12.79
9856120,247537,183,64050,311587,25.87
9856121,3907593,2087,730450,4638043,18.69
9856122,3791239,1148,401800,4193039,10.60
9856123,9960498,3320,1162000,11122498,11.67
9856124,9949906,3604,1261400,11211306,12.68
9856125,4319159,1609,563150,4882309,13.04
9856126,9956004,3398,1189300,11145304,11.95
9856127,9958694,2689,941150,10899844,9.45
9856128,9981384,4478,1567300,11548684,15.70
9856129,9977265,2680,938000,10915265,9.40
9856130,9968330,1656,579600,10547930,5.81
9856131,9963227,3687,1290450,11253677,12.95
9856132,618979,173,60550,679529,9.78
9856133,9916178,2868,1003800,10919978,10.12
9856134,9927124,2681,938350,10865474,9.45
9856135,9889151,2800,980000,10869151,9.91
9856137,9841480,2055,719250,10560730,7.31
9856138,1521027,461,161350,1682377,10.61
9856139,9931447,3457,1209950,11141397,12.18
9856140,9947419,2193,767550,10714969,7.72
9856141,9938031,3552,1243200,11181231,12.51
9856142,9939420,2442,854700,10794120,8.60
9856143,9946390,3346,1171100,11117490,11.77
9856144,9933863,3243,1135050,11068913,11.43
9856145,9936876,2638,923300,10860176,9.29
9856146,9919714,4104,1436400,11356114,14.48
9856147,9948438,3471,1214850,11163288,12.21
9856148,1762670,623,218050,1980720,12.37
9856149,9954840,3583,1254050,11208890,12.60
9856150,9942019,2116,740600,10682619,7.45
9856151,9949795,4147,1451450,11401245,14.59
9856152,9969724,2760,966000,10935724,9.69
9856154,9968745,4030,1410500,11379245,14.15
9856155,9974854,4433,1551550,11526404,15.55
9856156,9966353,2289,801150,10767503,8.04
9856158,9864671,3041,1064350,10929021,10.79
9856159,9902593,1368,478800,10381393,4.84
9856160,9931970,2377,831950,10763920,8.38
9856161,9949396,2753,963550,10912946,9.68
9856162,9950837,1893,662550,10613387,6.66
9856163,557024,166,58100,615124,10.43
9856164,9959546,3097,1083950,11043496,10.88
9856166,6373666,1994,697900,7071566,10.95
9856167,9942536,2162,756700,10699236,7.61
9856168,9951391,3704,1296400,11247791,13.03
9856169,9954183,2724,953400,10907583,9.58
9856170,9957403,2463,862050,10819453,8.66
9856172,9943839,265,92750,10036589,0.93
9856173,9949258,3542,1239700,11188958,12.46
9856174,9965194,3946,1381100,11346294,13.86
9856175,9946871,3654,1278900,11225771,12.86
9856176,2081047,577,201950,2282997,9.70
9856177,3378310,678,237300,3615610,7.02
9856178,9932087,3947,1381450,11313537,13.91
9856179,9952254,4423,1548050,11500304,15.55
9856180,9961853,2171,759850,10721703,7.63
9856181,9954553,3620,1267000,11221553,12.73
9856182,9964373,3698,1294300,11258673,12.99
9856183,9940877,4018,1406300,11347177,14.15
9856184,9972314,2607,912450,10884764,9.15
9856185,9549824,4044,1415400,10965224,14.82
9856186,9963559,3444,1205400,11168959,12.10
9856187,9969858,3654,1278900,11248758,12.83
9856188,9933555,2280,798000,10731555,8.03
9856189,406996,173,60550,467546,14.88
9856190,9963317,1797,628950,10592267,6.31
9856191,118418,42,14700,133118,12.41
9856192,9895638,3665,1282750,11178388,12.96
9856193,9991681,2102,735700,10727381,7.36
9856194,9983329,2786,975100,10958429,9.77
9856195,9976004,2910,1018500,10994504,10.21
9856196,9984106,3591,1256850,11240956,12.59
9856197,9999617,3446,1206100,11205717,12.06
9856198,2276267,547,191450,2467717,8.41
9856199,9970854,3185,1114750,11085604,11.18
9856200,9983144,2335,817250,10800394,8.19
9856201,9981242,3731,1305850,11287092,13.08
9856202,9993398,4865,1702750,11696148,17.04
9856203,9997960,2690,941500,10939460,9.42
9856204,9757319,2103,736050,10493369,7.54
9856205,8358988,2205,771750,9130738,9.23
9856206,2238118,997,348950,2587068,15.59
9856207,9867024,2984,1044400,10911424,10.58
9856208,2950639,839,293650,3244289,9.95
9856209,9972372,3444,1205400,11177772,12.09
9856210,9958563,1975,691250,10649813,6.94
9856212,989655,278,97300,1086955,9.83
9856213,9968999,4435,1552250,11521249,15.57
9856214,9962940,4834,1691900,11654840,16.98
9856215,9978630,2625,918750,10897380,9.21
9856216,1855174,703,246050,2101224,13.26
9856217,9993707,1741,609350,10603057,6.10
9856218,9989761,2430,850500,10840261,8.51
9856219,9741320,3108,1087800,10829120,11.17
9856220,9366024,2874,1005900,10371924,10.74
9856221,9966285,5057,1769950,11736235,17.76
9856222,9970556,4140,1449000,11419556,14.53
9856223,9991015,2459,860650,10851665,8.61
9856224,9991604,2876,1006600,10998204,10.07
9856225,9984428,3609,1263150,11247578,12.65
9856226,9974679,4045,1415750,11390429,14.19
9856227,2018953,411,143850,2162803,7.12
9856228,9952100,3585,1254750,11206850,12.61
9856229,9486906,2786,975100,10462006,10.28
9856230,9991300,3413,1194550,11185850,11.96
9856231,8983028,3332,1166200,10149228,12.98
9856232,9951663,3845,1345750,11297413,13.52
9856233,9942882,1845,645750,10588632,6.49
9856234,9479031,3095,1083250,10562281,11.43
9856235,1971379,464,162400,2133779,8.24
9856236,9699478,2658,930300,10629778,9.59
9856237,9970133,6231,2180850,12150983,21.87
9856238,6163265,2642,924700,7087965,15.00
9856239,9974798,3227,1129450,11104248,11.32
9856240,9983428,1748,611800,10595228,6.13
9856241,9962842,3084,1079400,11042242,10.83
9856242,9975863,441,154350,10130213,1.55
9856243,9986576,3600,1260000,11246576,12.62
9856244,9965978,3612,1264200,11230178,12.69
9856245,9963658,2217,775950,10739608,7.79
9856246,9963287,4240,1484000,11447287,14.89
9856247,9983454,2866,1003100,10986554,10.05
9856248,9999045,2476,866600,10865645,8.67
9856249,2188845,878,307300,2496145,14.04
9856250,1618064,551,192850,1810914,11.92
9856251,9988162,3873,1355550,11343712,13.57
9856252,9979840,2709,948150,10927990,9.50
9856253,9978286,4189,1466150,11444436,14.69
9856254,9988530,4535,1587250,11575780,15.89
9856255,1206302,335,117250,1323552,9.72
9856256,9987581,2457,859950,10847531,8.61
9856257,136112,18,6300,142412,4.63
9856258,9981664,3313,1159550,11141214,11.62
9856259,9986311,4080,1428000,11414311,14.30
9856260,4957143,1382,483700,5440843,9.76
9856261,9891001,3452,1208200,11099201,12.22
9856262,9978253,2836,992600,10970853,9.95
9856263,9994421,3968,1388800,11383221,13.90
9856264,1949434,1121,392350,2341784,20.13
9856265,9989365,2670,934500,10923865,9.35
9856266,9997163,3200,1120000,11117163,11.20
9856267,9990924,4046,1416100,11407024,14.17
9856268,9975231,3264,1142400,11117631,11.45
9856269,9991713,1692,592200,10583913,5.93
9856270,9976468,5958,2085300,12061768,20.90
9856271,1689466,1234,431900,2121366,25.56
9856272,9961022,2830,990500,10951522,9.94
9856273,9956047,2580,903000,10859047,9.07
9856274,9751790,2205,771750,10523540,7.91
9856275,9954356,3203,1121050,11075406,11.26
9856276,9977529,3561,1246350,11223879,12.49
9856277,9978956,3088,1080800,11059756,10.83
9856278,9947564,2772,970200,10917764,9.75
9856279,3262702,1484,519400,3782102,15.92
9856280,9987984,3218,1126300,11114284,11.28
9856281,9983391,1847,646450,10629841,6.48
9856282,2479139,1149,402150,2881289,16.22
9856283,9972762,2752,963200,10935962,9.66
9856284,9958746,2076,726600,10685346,7.30
9856285,9961593,3384,1184400,11145993,11.89
9856286,9960890,2775,971250,10932140,9.75
9856287,9963373,1562,546700,10510073,5.49
9856288,1927175,600,210000,2137175,10.90
9856289,9972769,1977,691950,10664719,6.94
9856290,4037963,1451,507850,4545813,12.58
9856291,9945271,2466,863100,10808371,8.68
9856292,4184304,1947,681450,4865754,16.29
9856293,9953924,3146,1101100,11055024,11.06
9856294,8863640,5240,1834000,10697640,20.69
9856295,9960677,3055,1069250,11029927,10.73
9856296,9943640,3353,1173550,11117190,11.80
9856297,9954012,2200,770000,10724012,7.74
9856298,9962752,4803,1681050,11643802,16.87
9856299,9932799,2594,907900,10840699,9.14
9856300,9960495,3575,1251250,11211745,12.56
9856301,9962972,3186,1115100,11078072,11.19
9856302,9973470,3446,1206100,11179570,12.09
9856303,9971040,3042,1064700,11035740,10.68
9856304,9989799,2954,1033900,11023699,10.35
9856305,9963573,4017,1405950,11369523,14.11
9856306,2554354,1526,534100,3088454,20.91
9856307,9979058,4587,1605450,11584508,16.09
9856308,2205647,607,212450,2418097,9.63
9856309,9966655,2566,898100,10864755,9.01
9856310,9971189,3678,1287300,11258489,12.91
9856311,9677408,3068,1073800,10751208,11.10
9856313,1952278,567,198450,2150728,10.17
9856314,9973186,2175,761250,10734436,7.63
9856316,9968428,3491,1221850,11190278,12.26
9856317,9972446,3112,1089200,11061646,10.92
9856318,571369,77,26950,598319,4.72
9856319,3417509,937,327950,3745459,9.60
9856320,9981462,4311,1508850,11490312,15.12
9856321,9983635,4591,1606850,11590485,16.09
9856322,9944001,2685,939750,10883751,9.45
9856323,9982480,1484,519400,10501880,5.20
9856324,9977517,4726,1654100,11631617,16.58
9856325,3004976,886,310100,3315076,10.32
9856326,9977584,4475,1566250,11543834,15.70
9856327,9981932,2384,834400,10816332,8.36
9856328,9978395,3176,1111600,11089995,11.14
9856329,9974276,2560,896000,10870276,8.98
9856330,9968471,6864,2402400,12370871,24.10
9856331,9982353,2376,831600,10813953,8.33
9856332,5047923,1829,640150,5688073,12.68
9856333,1579698,922,322700,1902398,20.43
9856334,9942658,2554,893900,10836558,8.99
9856335,9985200,5006,1752100,11737300,17.55
9856336,9973287,2989,1046150,11019437,10.49
9856337,9989799,3727,1304450,11294249,13.06
9856338,1599022,623,218050,1817072,13.64
9856339,9963788,3642,1274700,11238488,12.79
9856340,9961945,1380,483000,10444945,4.85
9856341,1251094,181,63350,1314444,5.06
9856342,9946175,1916,670600,10616775,6.74
9856343,9954756,1633,571550,10526306,5.74
9856344,9946497,3196,1118600,11065097,11.25
9856345,9854683,2328,814800,10669483,8.27
9856346,9930431,2348,821800,10752231,8.28
9856347,9939036,2863,1002050,10941086,10.08
9856348,964046,242,84700,1048746,8.79
9856349,9939532,2527,884450,10823982,8.90
9856350,9868040,1970,689500,10557540,6.99
9856351,9930066,1355,474250,10404316,4.78
9856352,9962787,3654,1278900,11241687,12.84
9856353,9982952,4909,1718150,11701102,17.21
9856354,9985108,4506,1577100,11562208,15.79
9856355,9996778,1600,560000,10556778,5.60
9856356,9961752,3239,1133650,11095402,11.38
9856357,1282773,390,136500,1419273,10.64
9856358,9956749,4126,1444100,11400849,14.50
9856359,1031028,317,110950,1141978,10.76
9856360,9931741,2846,996100,10927841,10.03
9856361,9952841,4142,1449700,11402541,14.57
9856362,9919762,1995,698250,10618012,7.04
9856363,9954627,2712,949200,10903827,9.54
9856364,7460893,1516,530600,7991493,7.11
9856365,2333236,910,318500,2651736,13.65
9856366,9952892,3245,1135750,11088642,11.41
9856367,1089255,263,92050,1181305,8.45
9856368,9925991,2879,1007650,10933641,10.15
9856369,9911829,2945,1030750,10942579,10.40
9856370,9932594,2226,779100,10711694,7.84
9856371,9938842,3213,1124550,11063392,11.31
9856372,9930433,3011,1053850,10984283,10.61
9856373,9943709,2971,1039850,10983559,10.46
9856374,9949543,1963,687050,10636593,6.91
9856375,9951834,2474,865900,10817734,8.70
9856376,9969475,2708,947800,10917275,9.51
9856377,3177088,221,77350,3254438,2.43
9856378,9969982,2838,993300,10963282,9.96
9856379,9959049,2609,913150,10872199,9.17
9856380,9973202,4106,1437100,11410302,14.41
9856381,9979545,2331,815850,10795395,8.18
9856382,9977098,2452,858200,10835298,8.60
9856383,9967204,3369,1179150,11146354,11.83
9856384,9972460,1240,434000,10406460,4.35
9856385,9940754,3385,1184750,11125504,11.92
9856386,9972541,2819,986650,10959191,9.89
9856387,9985524,1399,489650,10475174,4.90
9856388,9985205,2793,977550,10962755,9.79
9856389,9971531,3161,1106350,11077881,11.10
9856390,685762,306,107100,792862,15.62
9856391,9979719,1591,556850,10536569,5.58
9856392,8258549,2079,727650,8986199,8.81
9856393,3662214,1059,370650,4032864,10.12
9856394,9987254,3313,1159550,11146804,11.61
9856395,9973861,2292,802200,10776061,8.04
9856396,9977871,3099,1084650,11062521,10.87
9856397,9995567,3332,1166200,11161767,11.67
9856398,576401,166,58100,634501,10.08
9856399,9981615,2569,899150,10880765,9.01
9856400,1443941,295,103250,1547191,7.15
9856401,9985601,5165,1807750,11793351,18.10
9856402,8978679,1936,677600,9656279,7.55
9856403,9981883,5335,1867250,11849133,18.71
9856404,9933773,2431,850850,10784623,8.57
9856405,9976334,1636,572600,10548934,5.74
9856406,9964108,2520,882000,10846108,8.85
9856407,9403019,4986,1745100,11148119,18.56
9856408,3833882,1053,368550,4202432,9.61
9856409,9969841,4284,1499400,11469241,15.04
9856410,1129554,977,341950,1471504,30.27
9856411,9973284,3998,1399300,11372584,14.03
9856412,9964680,4019,1406650,11371330,14.12
9856413,4464079,2470,864500,5328579,19.37
9856414,4758617,3798,1329300,6087917,27.93
9856415,6299496,2232,781200,7080696,12.40
9856416,4077964,1249,437150,4515114,10.72
9856417,9846531,3461,1211350,11057881,12.30
9856418,9431387,3302,1155700,10587087,12.25
9856419,8969012,3335,1167250,10136262,13.01
9856420,9972025,3469,1214150,11186175,12.18
9856421,9967418,1667,583450,10550868,5.85
9856423,9959248,3344,1170400,11129648,11.75
9856424,9951560,2809,983150,10934710,9.88
9856425,9975996,3826,1339100,11315096,13.42
9856426,9968170,2707,947450,10915620,9.50
9856427,9947973,3392,1187200,11135173,11.93
9856428,9985231,2776,971600,10956831,9.73
9856429,9971352,3024,1058400,11029752,10.61
9856430,8700984,2917,1020950,9721934,11.73
9856431,9979277,2970,1039500,11018777,10.42
9856432,9984139,3984,1394400,11378539,13.97
9856433,9987838,4124,1443400,11431238,14.45
9856434,4215614,977,341950,4557564,8.11
9856435,9979901,2384,834400,10814301,8.36
9856436,9947920,1611,563850,10511770,5.67
9856437,9978284,3125,1093750,11072034,10.96
9856438,9944741,3350,1172500,11117241,11.79
9856439,9714989,4237,1482950,11197939,15.26
9856440,2768710,489,171150,2939860,6.18
9856441,9984342,3430,1200500,11184842,12.02
9856442,958775,287,100450,1059225,10.48
9856443,9809227,3174,1110900,10920127,11.33
9856444,9966124,3831,1340850,11306974,13.45
9856446,9944391,4624,1618400,11562791,16.27
9856447,4824525,1527,534450,5358975,11.08
9856448,9922267,2652,928200,10850467,9.35
9856449,9945221,2759,965650,10910871,9.71
9856450,9953810,1982,693700,10647510,6.97
9856451,9954161,2821,987350,10941511,9.92
9856452,6998774,2594,907900,7906674,12.97
9856453,504181,50,17500,521681,3.47
9856454,550138,281,98350,648488,17.88
9856455,9958319,3072,1075200,11033519,10.80
9856456,9950804,2662,931700,10882504,9.36
9856457,128347,68,23800,152147,18.54
9856458,9952780,2854,998900,10951680,10.04
9856459,3858046,2038,713300,4571346,18.49
9856460,1309023,520,182000,1491023,13.90
9856461,9949661,3393,1187550,11137211,11.94
9856462,9954387,4833,1691550,11645937,16.99
9856463,9968598,1973,690550,10659148,6.93
9856464,9970606,2780,973000,10943606,9.76
9856465,9967918,5927,2074450,12042368,20.81
9856466,9966793,2492,872200,10838993,8.75
9856467,3073444,724,253400,3326844,8.24
9856468,9959696,3369,1179150,11138846,11.84
9856469,9956992,3148,1101800,11058792,11.07
9856470,9974119,1312,459200,10433319,4.60
9856471,9986520,1802,630700,10617220,6.32
9856472,9986194,2849,997150,10983344,9.99
9856473,7778734,3073,1075550,8854284,13.83
9856474,9966396,2143,750050,10716446,7.53
9856475,2390416,703,246050,2636466,10.29
9856476,9943986,2075,726250,10670236,7.30
9856477,9921239,2974,1040900,10962139,10.49
9856478,9933123,3991,1396850,11329973,14.06
9856479,9933930,4229,1480150,11414080,14.90
9856480,1320845,369,129150,1449995,9.78
9856481,1356655,328,114800,1471455,8.46
9856482,9918916,3485,1219750,11138666,12.30
9856483,9924371,2717,950950,10875321,9.58
9856484,9927447,3111,1088850,11016297,10.97
9856486,9923324,3084,1079400,11002724,10.88
9856487,9923477,1161,406350,10329827,4.09
9856488,9945628,1561,546350,10491978,5.49
9856489,9874701,1685,589750,10464451,5.97
9856490,9932674,3154,1103900,11036574,11.11
9856491,9934208,2002,700700,10634908,7.05
9856492,9956769,2712,949200,10905969,9.53
9856493,9956353,3008,1052800,11009153,10.57
9856494,9945114,388,135800,10080914,1.37
9856495,9947178,4172,1460200,11407378,14.68
9856496,9919530,4852,1698200,11617730,17.12
9856497,9923917,3216,1125600,11049517,11.34
9856498,9935555,2497,873950,10809505,8.80
9856499,9944679,2654,928900,10873579,9.34
9856500,9940812,2057,719950,10660762,7.24
9856501,9937700,4068,1423800,11361500,14.33
9856502,9960425,3159,1105650,11066075,11.10
9856503,9953158,3890,1361500,11314658,13.68
9856504,6891554,3025,1058750,7950304,15.36
9856505,9953576,2173,760550,10714126,7.64
9856506,9920843,1081,378350,10299193,3.81
9856507,9960927,1535,537250,10498177,5.39
9856508,8957098,1123,393050,9350148,4.39
9856509,5732455,2577,901950,6634405,15.73
9856510,9952292,3075,1076250,11028542,10.81
9856511,9978360,3045,1065750,11044110,10.68
9856512,9985723,826,289100,10274823,2.90
9856513,9980750,1310,458500,10439250,4.59
9856514,9879456,3083,1079050,10958506,10.92
9856515,1255080,442,154700,1409780,12.33
9856516,3280653,1091,381850,3662503,11.64
9856517,3401642,1600,560000,3961642,16.46
9856518,2566687,1241,434350,3001037,16.92
9856519,9978607,3564,1247400,11226007,12.50
9856520,9987256,4848,1696800,11684056,16.99
9856521,9983334,3577,1251950,11235284,12.54
9856522,9992122,3514,1229900,11222022,12.31
9856523,9975628,4172,1460200,11435828,14.64
9856524,9979089,1357,474950,10454039,4.76
9856526,9948122,4868,1703800,11651922,17.13
9856527,9745852,2366,828100,10573952,8.50
9856528,9988249,3059,1070650,11058899,10.72
9856529,9986528,4599,1609650,11596178,16.12
9856530,9964091,1169,409150,10373241,4.11
9856531,9973848,3372,1180200,11154048,11.83
9856532,778830,390,136500,915330,17.53
9856533,9949374,1297,453950,10403324,4.56
9856534,9958920,3429,1200150,11159070,12.05
9856535,9973320,3130,1095500,11068820,10.98
9856536,9949127,1250,437500,10386627,4.40
9856537,657581,162,56700,714281,8.62
9856538,9938058,2531,885850,10823908,8.91
9856539,9914023,483,169050,10083073,1.71
9856540,9939282,610,213500,10152782,2.15
9856541,9911464,1708,597800,10509264,6.03
9856542,9943078,3877,1356950,11300028,13.65
9856543,1659114,560,196000,1855114,11.81
9856544,9936176,3330,1165500,11101676,11.73
9856545,2144656,833,291550,2436206,13.59
9856546,9936211,3743,1310050,11246261,13.18
9856547,9926547,3043,1065050,10991597,10.73
9856548,1874320,270,94500,1968820,5.04
9856549,9939858,2276,796600,10736458,8.01
9856550,9926608,3619,1266650,11193258,12.76
9856551,511853,243,85050,596903,16.62
9856552,9945803,4607,1612450,11558253,16.21
9856553,9953550,1914,669900,10623450,6.73
9856554,9967505,3405,1191750,11159255,11.96
9856555,9962403,605,211750,10174153,2.13
9856556,4691079,1293,452550,5143629,9.65
9856557,9940049,1727,604450,10544499,6.08
9856558,9960485,4072,1425200,11385685,14.31
9856559,313485,280,98000,411485,31.26
9856560,9945269,2452,858200,10803469,8.63
9856562,9944765,3593,1257550,11202315,12.65
9856563,286949,171,59850,346799,20.86
9856564,9974629,2989,1046150,11020779,10.49
9856565,9934690,3329,1165150,11099840,11.73
9856566,9953367,2123,743050,10696417,7.47
9856567,9932562,2614,914900,10847462,9.21
9856568,9951982,2257,789950,10741932,7.94
9856569,9952675,2742,959700,10912375,9.64
9856570,9950860,2788,975800,10926660,9.81
9856571,9951594,2225,778750,10730344,7.83
9856572,1082411,787,275450,1357861,25.45
9856573,9937455,3102,1085700,11023155,10.93
9856574,9942756,3279,1147650,11090406,11.54
9856575,9920922,2685,939750,10860672,9.47
9856577,9915313,2948,1031800,10947113,10.41
9856578,9932052,2663,932050,10864102,9.38
9856579,9946539,3593,1257550,11204089,12.64
9856580,5037766,1433,501550,5539316,9.96
9856581,9852942,1967,688450,10541392,6.99
9856582,1024790,472,165200,1189990,16.12
9856583,9909477,3055,1069250,10978727,10.79
9856584,9922729,2277,796950,10719679,8.03
9856585,9932030,3498,1224300,11156330,12.33
9856586,1447569,1028,359800,1807369,24.86
9856587,375375,104,36400,411775,9.70
9856588,9938807,3019,1056650,10995457,10.63
9856589,6597501,2182,763700,7361201,11.58
9856590,9983090,3549,1242150,11225240,12.44
9856591,9964182,5024,1758400,11722582,17.65
9856592,9972494,2811,983850,10956344,9.87
9856593,9973883,3871,1354850,11328733,13.58
9856594,9975163,2852,998200,10973363,10.01
9856595,9963316,2273,795550,10758866,7.98
9856598,2533310,863,302050,2835360,11.92
9856599,911951,119,41650,953601,4.57
9856600,9977110,3347,1171450,11148560,11.74
9856601,9980485,3394,1187900,11168385,11.90
9856602,9974174,2461,861350,10835524,8.64
9856603,9967636,3918,1371300,11338936,13.76
9856604,9981582,4979,1742650,11724232,17.46
9856605,9970319,3821,1337350,11307669,13.41
9856606,9971643,2691,941850,10913493,9.45
9856607,9962133,4325,1513750,11475883,15.20
9856608,6343749,1799,629650,6973399,9.93
9856609,1719205,1275,446250,2165455,25.96
9856610,9979295,4962,1736700,11715995,17.40
9856611,9987051,3251,1137850,11124901,11.39
9856612,9983476,3415,1195250,11178726,11.97
9856613,9987587,5282,1848700,11836287,18.51
9856614,2031687,387,135450,2167137,6.67
9856615,9973303,2854,998900,10972203,10.02
9856616,9985771,3015,1055250,11041021,10.57
9856617,9996754,1734,606900,10603654,6.07
9856618,9981122,2765,967750,10948872,9.70
9856619,9986033,2337,817950,10803983,8.19
9856620,9986387,1697,593950,10580337,5.95
9856621,9987737,4182,1463700,11451437,14.65
9856622,9974577,4572,1600200,11574777,16.04
9856623,9981483,1939,678650,10660133,6.80
9856624,9969008,1283,449050,10418058,4.50
9856625,9723225,2295,803250,10526475,8.26
9856627,9986333,2247,786450,10772783,7.88
9856628,9973052,3479,1217650,11190702,12.21
9856629,9960928,3208,1122800,11083728,11.27
9856630,9967557,3615,1265250,11232807,12.69
9856631,1395856,1117,390950,1786806,28.01
9856632,4399591,2083,729050,5128641,16.57
9856633,9950375,3567,1248450,11198825,12.55
9856634,3897651,2439,853650,4751301,21.90
9856635,913326,478,167300,1080626,18.32
9856636,9935019,2829,990150,10925169,9.97
9856637,9932088,4469,1564150,11496238,15.75
9856638,9945386,3615,1265250,11210636,12.72
9856639,2128953,1479,517650,2646603,24.31
9856640,811372,359,125650,937022,15.49
9856641,9910472,3269,1144150,11054622,11.54
9856642,9913317,4876,1706600,11619917,17.22
9856643,9918893,3684,1289400,11208293,13.00
9856644,9914237,4045,1415750,11329987,14.28
9856645,9684522,1339,468650,10153172,4.84
9856646,9934838,4316,1510600,11445438,15.21
9856647,9943595,3894,1362900,11306495,13.71
9856648,9941225,6502,2275700,12216925,22.89
9856649,877054,252,88200,965254,10.06
9856650,9934374,858,300300,10234674,3.02
9856651,9953112,4889,1711150,11664262,17.19
9856652,9952725,6149,2152150,12104875,21.62
9856653,9932603,5628,1969800,11902403,19.83
9856654,9923055,3241,1134350,11057405,11.43
9856655,9955268,2789,976150,10931418,9.81
9856656,9941910,3285,1149750,11091660,11.56
9856657,9961677,4988,1745800,11707477,17.53
9856658,9312599,5887,2060450,11373049,22.13
9856659,5736181,4142,1449700,7185881,25.27
9856660,9946381,4917,1720950,11667331,17.30
9856661,9959264,3730,1305500,11264764,13.11
9856662,2096809,2374,830900,2927709,39.63
9856663,9955745,4044,1415400,11371145,14.22
9856665,9964244,3805,1331750,11295994,13.37
9856666,9965351,4405,1541750,11507101,15.47
9856667,9977439,4478,1567300,11544739,15.71
9856668,9973752,3273,1145550,11119302,11.49
9856669,9993956,7237,2532950,12526906,25.34
9856670,9980764,3276,1146600,11127364,11.49
9856671,9984329,2219,776650,10760979,7.78
9856672,9980001,5634,1971900,11951901,19.76
9856673,9975928,2453,858550,10834478,8.61
9856674,9990666,3458,1210300,11200966,12.11
9856675,9986236,1208,422800,10409036,4.23
9856676,9992061,1072,375200,10367261,3.75
9856677,9997653,4264,1492400,11490053,14.93
9856678,9993555,3728,1304800,11298355,13.06
9856679,9990577,4026,1409100,11399677,14.10
9856680,606917,189,66150,673067,10.90
9856681,1826158,711,248850,2075008,13.63
9856682,5490980,3791,1326850,6817830,24.16
9856683,9950653,3943,1380050,11330703,13.87
9856684,9959827,2822,987700,10947527,9.92
9856685,9943629,3861,1351350,11294979,13.59
9856687,9932330,3688,1290800,11223130,13.00
9856688,9940374,4499,1574650,11515024,15.84
9856689,9952579,3572,1250200,11202779,12.56
9856690,9968649,1182,413700,10382349,4.15
9856691,9957473,2684,939400,10896873,9.43
9856692,9959747,3754,1313900,11273647,13.19
9856693,9983243,1509,528150,10511393,5.29
9856694,6587049,1502,525700,7112749,7.98
9856695,9957455,2057,719950,10677405,7.23
9856696,6762320,1728,604800,7367120,8.94
9856697,9961437,3452,1208200,11169637,12.13
9856698,9961464,4914,1719900,11681364,17.27
9856699,9961136,1671,584850,10545986,5.87
9856700,9971270,1806,632100,10603370,6.34
9856701,1562563,542,189700,1752263,12.14
9856702,9956349,4432,1551200,11507549,15.58
9856703,9966650,4650,1627500,11594150,16.33
9856704,9949332,1620,567000,10516332,5.70
9856705,9979387,5113,1789550,11768937,17.93
9856706,9987638,3406,1192100,11179738,11.94
9856707,1879162,410,143500,2022662,7.64
9856708,9982911,4369,1529150,11512061,15.32
9856709,9982692,4428,1549800,11532492,15.52
9856710,9972703,3518,1231300,11204003,12.35
9856711,9990408,3273,1145550,11135958,11.47
9856712,1854491,385,134750,1989241,7.27
9856713,9983491,3722,1302700,11286191,13.05
9856714,9987561,4568,1598800,11586361,16.01
9856715,9984717,1997,698950,10683667,7.00
9856716,9989573,3991,1396850,11386423,13.98
9856717,9928447,4202,1470700,11399147,14.81
9856718,9977313,3607,1262450,11239763,12.65
9856719,9973411,3020,1057000,11030411,10.60
9856720,1398952,540,189000,1587952,13.51
9856721,9851548,1183,414050,10265598,4.20
9856722,9984866,3334,1166900,11151766,11.69
9856723,9976437,3350,1172500,11148937,11.75
9856724,9995341,5130,1795500,11790841,17.96
9856725,9892446,5064,1772400,11664846,17.92
9856726,9964434,1878,657300,10621734,6.60
9856727,9955386,1111,388850,10344236,3.91
9856728,9976624,2575,901250,10877874,9.03
9856729,9975894,3593,1257550,11233444,12.61
9856730,9971910,4112,1439200,11411110,14.43
9856731,9972813,1013,354550,10327363,3.56
9856733,628039,65,22750,650789,3.62
9856734,9974341,3066,1073100,11047441,10.76
9856735,9990743,3726,1304100,11294843,13.05
9856736,9970917,1615,565250,10536167,5.67
9856737,9972281,3770,1319500,11291781,13.23
9856738,9966523,3442,1204700,11171223,12.09
9856739,9969977,3557,1244950,11214927,12.49
9856740,9975009,2089,731150,10706159,7.33
9856741,9968980,4039,1413650,11382630,14.18
9856742,9963140,4114,1439900,11403040,14.45
9856743,9952285,3351,1172850,11125135,11.78
9856744,9965069,3100,1085000,11050069,10.89
9856745,9959037,2444,855400,10814437,8.59
9856746,9955825,3662,1281700,11237525,12.87
9856747,9964824,2132,746200,10711024,7.49
9856748,9981423,2376,831600,10813023,8.33
9856749,3639171,705,246750,3885921,6.78
9856750,9966866,2997,1048950,11015816,10.52
9856751,9982707,4741,1659350,11642057,16.62
9856752,442908,137,47950,490858,10.83
9856753,9968569,3466,1213100,11181669,12.17
9856754,9976891,3629,1270150,11247041,12.73
9856755,9988864,3535,1237250,11226114,12.39
9856756,9992605,2530,885500,10878105,8.86
9856757,4641052,1500,525000,5166052,11.31
9856758,9973946,1967,688450,10662396,6.90
9856759,4685776,1527,534450,5220226,11.41
9856760,2726225,1111,388850,3115075,14.26
9856761,1094100,606,212100,1306200,19.39
9856762,558649,246,86100,644749,15.41
9856763,9988209,4474,1565900,11554109,15.68
9856764,9974801,3603,1261050,11235851,12.64
9856765,9383639,4577,1601950,10985589,17.07
9856766,9960770,2557,894950,10855720,8.98
9856767,9997743,3755,1314250,11311993,13.15
9856768,2899471,1357,474950,3374421,16.38
9856769,9997543,3018,1056300,11053843,10.57
9856770,9981973,3753,1313550,11295523,13.16
9856771,939306,119,41650,980956,4.43
9856772,9991200,2552,893200,10884400,8.94
9856773,9952102,961,336350,10288452,3.38
9856774,9998691,2282,798700,10797391,7.99
9856775,9992571,958,335300,10327871,3.36
9856776,9985515,1997,698950,10684465,7.00
9856777,9990921,3174,1110900,11101821,11.12
9856778,9979323,3775,1321250,11300573,13.24
9856779,9962968,3448,1206800,11169768,12.11
9856780,9980543,4587,1605450,11585993,16.09
9856782,9968573,4787,1675450,11644023,16.81
9856784,9975592,3485,1219750,11195342,12.23
9856785,9980079,3684,1289400,11269479,12.92
9856786,1485510,1293,452550,1938060,30.46
9856787,9981292,2916,1020600,11001892,10.23
9856788,9948409,4003,1401050,11349459,14.08
9856789,9984373,5780,2023000,12007373,20.26
9856790,9984320,2322,812700,10797020,8.14
9856791,1185256,425,148750,1334006,12.55
9856792,9839298,1933,676550,10515848,6.88
9856793,9978094,1975,691250,10669344,6.93
9856794,805934,346,121100,927034,15.03
9856795,9966357,481,168350,10134707,1.69
9856796,9978851,3544,1240400,11219251,12.43
9856797,9983183,2091,731850,10715033,7.33
9856798,9980287,3841,1344350,11324637,13.47
9856799,9992008,3454,1208900,11200908,12.10
9856800,1617105,713,249550,1866655,15.43
9856801,9978957,4111,1438850,11417807,14.42
9856802,9984718,3683,1289050,11273768,12.91
9856803,9942861,3877,1356950,11299811,13.65
9856804,9974070,4272,1495200,11469270,14.99
9856805,9976635,2830,990500,10967135,9.93
9856806,562737,158,55300,618037,9.83
9856807,9994639,3236,1132600,11127239,11.33
9856808,9994427,5543,1940050,11934477,19.41
9856809,9981131,3966,1388100,11369231,13.91
9856810,9984187,1663,582050,10566237,5.83
9856811,9983300,2811,983850,10967150,9.85
9856812,9975069,2213,774550,10749619,7.76
9856813,9749079,3369,1179150,10928229,12.09
9856814,9986510,4673,1635550,11622060,16.38
9856815,9985399,4973,1740550,11725949,17.43
9856816,9982622,3770,1319500,11302122,13.22
9856817,9977966,3552,1243200,11221166,12.46
9856818,9924716,4594,1607900,11532616,16.20
9856819,9966387,3589,1256150,11222537,12.60
9856820,1700331,1112,389200,2089531,22.89
9856822,9938095,4133,1446550,11384645,14.56
9856823,2593852,823,288050,2881902,11.11
9856824,677353,304,106400,783753,15.71
9856825,9943890,2790,976500,10920390,9.82
9856827,9958077,3274,1145900,11103977,11.51
9856828,913833,231,80850,994683,8.85
9856830,4795407,2627,919450,5714857,19.17
9856831,473961,78,27300,501261,5.76
9856832,9958439,2580,903000,10861439,9.07
9856833,9975040,2554,893900,10868940,8.96
9856834,9964719,2644,925400,10890119,9.29
9856835,9980479,2047,716450,10696929,7.18
9856836,9956134,4895,1713250,11669384,17.21
9856837,9972974,3450,1207500,11180474,12.11
9856838,9967842,2001,700350,10668192,7.03
9856839,9983422,5830,2040500,12023922,20.44
9856840,9993261,2040,714000,10707261,7.14
9856841,662202,259,90650,752852,13.69
9856842,9967885,2056,719600,10687485,7.22
9856843,1195961,478,167300,1363261,13.99
9856844,9989141,2895,1013250,11002391,10.14
9856845,9981090,1676,586600,10567690,5.88
9856846,9987979,5069,1774150,11762129,17.76
9856847,9993396,3085,1079750,11073146,10.80
9856848,9980027,4115,1440250,11420277,14.43
9856849,8001976,2804,981400,8983376,12.26
9856850,9973094,4849,1697150,11670244,17.02
9856851,9978893,2085,729750,10708643,7.31
9856852,9984770,3351,1172850,11157620,11.75
9856853,9998462,1941,679350,10677812,6.79
9856854,9975950,4465,1562750,11538700,15.67
9856857,9971250,3870,1354500,11325750,13.58
9856858,1950860,860,301000,2251860,15.43
9856859,9048124,3801,1330350,10378474,14.70
9856860,9987876,2506,877100,10864976,8.78
9856861,9980782,2835,992250,10973032,9.94
9856862,9976594,4772,1670200,11646794,16.74
9856863,3391995,2092,732200,4124195,21.59
9856864,9984557,3758,1315300,11299857,13.17
9856865,9986544,3261,1141350,11127894,11.43
9856866,9988852,2056,719600,10708452,7.20
9856867,9975659,2933,1026550,11002209,10.29
9856868,9981561,2903,1016050,10997611,10.18
9856869,9981216,3933,1376550,11357766,13.79
9856870,9992212,6105,2136750,12128962,21.38
9856871,816010,374,130900,946910,16.04
9856872,9995452,3555,1244250,11239702,12.45
9856873,9982945,5023,1758050,11740995,17.61
9856874,4343464,1872,655200,4998664,15.08
9856875,9979223,1898,664300,10643523,6.66
9856876,9982939,4455,1559250,11542189,15.62
9856877,9983329,3760,1316000,11299329,13.18
9856878,9999869,2555,894250,10894119,8.94
9856879,9485667,3376,1181600,10667267,12.46
9856880,9981759,3381,1183350,11165109,11.86
9856881,9981520,3208,1122800,11104320,11.25
9856882,9978978,4822,1687700,11666678,16.91
9856883,2068925,871,304850,2373775,14.73
9856884,9972324,2373,830550,10802874,8.33
9856885,9976745,5076,1776600,11753345,17.81
9856886,9980501,5634,1971900,11952401,19.76
9856887,9981430,5296,1853600,11835030,18.57
9856888,9539208,1964,687400,10226608,7.21
9856889,9966737,3802,1330700,11297437,13.35
9856890,9967112,2894,1012900,10980012,10.16
9856891,9473385,3211,1123850,10597235,11.86
9856892,9977445,3040,1064000,11041445,10.66
9856894,9978501,2782,973700,10952201,9.76
9856896,1113311,708,247800,1361111,22.26
9856897,9969047,3841,1344350,11313397,13.49
9856898,645341,385,134750,780091,20.88
9856899,5029358,925,323750,5353108,6.44
9856900,9945895,1877,656950,10602845,6.61
9856901,9942597,1866,653100,10595697,6.57
9856902,9943793,1163,407050,10350843,4.09
9856903,9313616,2551,892850,10206466,9.59
9856904,1603202,565,197750,1800952,12.33
9856905,5919346,1521,532350,6451696,8.99
9856907,9948202,2398,839300,10787502,8.44
9856908,9937055,2839,993650,10930705,10.00
9856909,3577964,954,333900,3911864,9.33
9856910,9925213,2223,778050,10703263,7.84
9856911,1697883,539,188650,1886533,11.11
9856912,9912213,5546,1941100,11853313,19.58
9856913,9917729,3757,1314950,11232679,13.26
9856914,9925540,2294,802900,10728440,8.09
9856915,9932848,2929,1025150,10957998,10.32
9856916,9954028,3771,1319850,11273878,13.26
9856917,1885091,472,165200,2050291,8.76
9856918,9974358,3698,1294300,11268658,12.98
9856919,9980266,2736,957600,10937866,9.59
9856920,9979072,6780,2373000,12352072,23.78
9856921,9960905,6111,2138850,12099755,21.47
9856922,9951501,2532,886200,10837701,8.91
9856923,9974501,3872,1355200,11329701,13.59
9856924,9963899,2928,1024800,10988699,10.29
9856925,9952731,3216,1125600,11078331,11.31
9856926,9973151,6050,2117500,12090651,21.23
9856927,9997643,3027,1059450,11057093,10.60
9856928,9989121,2732,956200,10945321,9.57
9856929,9986515,2683,939050,10925565,9.40
9856930,5141561,764,267400,5408961,5.20
9856931,9976740,2872,1005200,10981940,10.08
9856932,9980144,6536,2287600,12267744,22.92
9856933,9970446,3785,1324750,11295196,13.29
9856934,9910107,1515,530250,10440357,5.35
9856935,3269489,1184,414400,3683889,12.67
9856936,9935692,2498,874300,10809992,8.80
9856937,9941017,3930,1375500,11316517,13.84
9856938,3561523,1217,425950,3987473,11.96
9856939,9947807,3177,1111950,11059757,11.18
9856941,9972625,1800,630000,10602625,6.32
9856942,9873505,3470,1214500,11088005,12.30
9856943,9964159,2673,935550,10899709,9.39
9856944,9960340,5023,1758050,11718390,17.65
9856945,9946289,1725,603750,10550039,6.07
9856946,9966746,1887,660450,10627196,6.63
9856947,441660,111,38850,480510,8.80
9856948,369704,104,36400,406104,9.85
9856949,9972660,3622,1267700,11240360,12.71
9856950,9990960,1728,604800,10595760,6.05
9856951,9967279,2797,978950,10946229,9.82
9856952,9992088,2376,831600,10823688,8.32
9856953,1996972,1087,380450,2377422,19.05
9856954,9974482,3124,1093400,11067882,10.96
9856955,4305157,1353,473550,4778707,11.00
9856956,9979079,2446,856100,10835179,8.58
9856957,9984280,3390,1186500,11170780,11.88
9856958,9955414,2670,934500,10889914,9.39
9856959,9978495,2884,1009400,10987895,10.12
9856960,9977545,2909,1018150,10995695,10.20
9856961,9976358,3233,1131550,11107908,11.34
9856962,9979963,1541,539350,10519313,5.40
9856963,9479602,2788,975800,10455402,10.29
9856964,2675269,365,127750,2803019,4.78
9856965,9987072,2915,1020250,11007322,10.22
9856966,9987673,3002,1050700,11038373,10.52
9856967,9973771,3389,1186150,11159921,11.89
9856968,2511697,1685,589750,3101447,23.48
9856969,9969295,3740,1309000,11278295,13.13
9856970,9947265,2869,1004150,10951415,10.09
9856971,9963640,5314,1859900,11823540,18.67
9856973,9947957,2707,947450,10895407,9.52
9856974,9950967,2464,862400,10813367,8.67
9856975,9950670,4072,1425200,11375870,14.32
9856976,1211178,366,128100,1339278,10.58
9856977,9942604,2799,979650,10922254,9.85
9856978,9724945,2248,786800,10511745,8.09
9856979,9941492,6026,2109100,12050592,21.22
9856980,9944127,1888,660800,10604927,6.65
9856981,9945615,5177,1811950,11757565,18.22
9856982,9968804,3664,1282400,11251204,12.86
9856983,1286980,630,220500,1507480,17.13
9856984,9960884,4878,1707300,11668184,17.14
9856985,9973451,4053,1418550,11392001,14.22
9856986,9970559,5055,1769250,11739809,17.74
9856987,4239851,1589,556150,4796001,13.12
9856988,9964405,2303,806050,10770455,8.09
9856989,9961983,4365,1527750,11489733,15.34
9856990,9951119,3649,1277150,11228269,12.83
9856991,9950943,2168,758800,10709743,7.63
9856992,9964905,3490,1221500,11186405,12.26
9856993,9976341,3470,1214500,11190841,12.17
9856995,9964284,4295,1503250,11467534,15.09
9856996,9983812,3243,1135050,11118862,11.37
9856997,9990066,2581,903350,10893416,9.04
9856998,9980694,3077,1076950,11057644,10.79
9856999,9969132,3678,1287300,11256432,12.91
9857000,9966300,3061,1071350,11037650,10.75
9857001,9971487,4387,1535450,11506937,15.40
9857002,602678,202,70700,673378,11.73
9857003,9955789,2762,966700,10922489,9.71
9857005,9958526,2054,718900,10677426,7.22
9857006,9956152,3390,1186500,11142652,11.92
9857007,9964497,2596,908600,10873097,9.12
9857008,9951632,2566,898100,10849732,9.02
9857009,9931761,4602,1610700,11542461,16.22
9857010,4494645,2234,781900,5276545,17.40
9857011,9944174,2082,728700,10672874,7.33
9857012,1337144,445,155750,1492894,11.65
9857013,9958450,4392,1537200,11495650,15.44
9857014,1867207,572,200200,2067407,10.72
9857015,9945115,2800,980000,10925115,9.85
9857016,9964906,2966,1038100,11003006,10.42
9857017,9980254,3221,1127350,11107604,11.30
9857018,9140352,1262,441700,9582052,4.83
9857019,9946167,2296,803600,10749767,8.08
9857020,9953478,3162,1106700,11060178,11.12
9857021,9961926,3138,1098300,11060226,11.02
9857022,9971242,4203,1471050,11442292,14.75
9857023,4608112,1846,646100,5254212,14.02
9857024,9965799,3557,1244950,11210749,12.49
9857025,9973501,2990,1046500,11020001,10.49
9857026,9993167,3347,1171450,11164617,11.72
9857027,9893834,3770,1319500,11213334,13.34
9857028,2629450,913,319550,2949000,12.15
9857029,9942949,3842,1344700,11287649,13.52
9857030,1667769,832,291200,1958969,17.46
9857031,9960438,2440,854000,10814438,8.57
9857032,9978509,2173,760550,10739059,7.62
9857033,9997384,3902,1365700,11363084,13.66
9857034,9982291,3655,1279250,11261541,12.82
9857035,9980435,3312,1159200,11139635,11.61
9857036,9980449,3057,1069950,11050399,10.72
9857037,543610,222,77700,621310,14.29
9857038,9988941,5112,1789200,11778141,17.91
9857039,9997678,4682,1638700,11636378,16.39
9857040,9169905,2385,834750,10004655,9.10
9857041,9691025,2937,1027950,10718975,10.61
9857042,9981851,2029,710150,10692001,7.11
9857043,9993093,4051,1417850,11410943,14.19
9857044,8986045,2712,949200,9935245,10.56
9857045,9963117,3587,1255450,11218567,12.60
9857046,9969569,5475,1916250,11885819,19.22
9857047,9994293,3573,1250550,11244843,12.51
9857048,9972652,2536,887600,10860252,8.90
9857049,478016,102,35700,513716,7.47
9857050,9978631,2472,865200,10843831,8.67
9857051,9969701,2197,768950,10738651,7.71
9857052,3702052,1742,609700,4311752,16.47
9857053,9971758,4565,1597750,11569508,16.02
9857054,9979459,2615,915250,10894709,9.17
9857055,9961515,2977,1041950,11003465,10.46
9857056,9773138,3174,1110900,10884038,11.37
9857057,9979166,3096,1083600,11062766,10.86
9857058,9973943,2072,725200,10699143,7.27
9857059,9948220,2689,941150,10889370,9.46
9857060,9962459,1851,647850,10610309,6.50
9857061,9966041,3536,1237600,11203641,12.42
9857062,9989992,3247,1136450,11126442,11.38
9857063,2791076,783,274050,3065126,9.82
9857065,2405902,686,240100,2646002,9.98
9857066,9991401,3017,1055950,11047351,10.57
9857067,372955,256,89600,462555,24.02
9857068,9972634,1505,526750,10499384,5.28
9857069,9975410,1813,634550,10609960,6.36
9857070,9969989,4471,1564850,11534839,15.70
9857071,9982880,1146,401100,10383980,4.02
9857072,9999240,3811,1333850,11333090,13.34
9857073,9999687,4250,1487500,11487187,14.88
9857074,3049656,747,261450,3311106,8.57
9857075,9998896,3164,1107400,11106296,11.08
9857077,9976477,3171,1109850,11086327,11.12
9857078,1400331,232,81200,1481531,5.80
9857079,9996859,2403,841050,10837909,8.41
9857080,9986855,2720,952000,10938855,9.53
9857081,9992483,1914,669900,10662383,6.70
9857082,592120,113,39550,631670,6.68
9857083,9986468,3053,1068550,11055018,10.70
9857084,9996263,2970,1039500,11035763,10.40
9857085,9988190,2616,915600,10903790,9.17
9857086,9988587,3588,1255800,11244387,12.57
9857087,9992212,1893,662550,10654762,6.63
9857088,9999272,2649,927150,10926422,9.27
9857089,9984030,2042,714700,10698730,7.16
9857090,9986639,2757,964950,10951589,9.66
9857091,135363,128,44800,180163,33.10
9857092,9990189,3097,1083950,11074139,10.85
9857093,9993962,3478,1217300,11211262,12.18
9857094,2634090,442,154700,2788790,5.87
9857095,3611176,1072,375200,3986376,10.39
9857096,2633757,707,247450,2881207,9.40
9857097,9984793,3676,1286600,11271393,12.89
9857098,9989062,2234,781900,10770962,7.83
9857099,9984965,4998,1749300,11734265,17.52
9857100,1401492,305,106750,1508242,7.62
9857102,9952762,2293,802550,10755312,8.06
9857103,9955293,2758,965300,10920593,9.70
9857104,9939801,2473,865550,10805351,8.71
9857105,9962923,2821,987350,10950273,9.91
9857106,9964850,2507,877450,10842300,8.81
9857107,2015028,1355,474250,2489278,23.54
9857108,9950191,1630,570500,10520691,5.73
9857109,9955545,3684,1289400,11244945,12.95
9857110,9917330,4925,1723750,11641080,17.38
9857111,9930900,4117,1440950,11371850,14.51
9857112,9957978,6792,2377200,12335178,23.87
9857113,9956097,5303,1856050,11812147,18.64
9857114,9963849,3473,1215550,11179399,12.20
9857115,9954934,4010,1403500,11358434,14.10
9857116,9959851,2219,776650,10736501,7.80
9857117,9978522,2491,871850,10850372,8.74
9857118,9968818,1928,674800,10643618,6.77
9857119,41197,42,14700,55897,35.68
9857120,9943974,4332,1516200,11460174,15.25
9857121,9934007,3638,1273300,11207307,12.82
9857122,1783080,849,297150,2080230,16.66
9857123,9915666,2366,828100,10743766,8.35
9857124,9933143,2790,976500,10909643,9.83
9857125,1461485,961,336350,1797835,23.01
9857126,1951325,803,281050,2232375,14.40
9857127,9910645,4405,1541750,11452395,15.56
9857128,9848660,5299,1854650,11703310,18.83
9857129,1753541,654,228900,1982441,13.05
9857130,9926674,2903,1016050,10942724,10.24
9857131,9921912,2754,963900,10885812,9.71
9857132,9423353,2982,1043700,10467053,11.08
9857133,9944501,2280,798000,10742501,8.02
9857134,9946443,1869,654150,10600593,6.58
9857135,9957149,3172,1110200,11067349,11.15
9857136,9960572,5225,1828750,11789322,18.36
9857137,1084316,787,275450,1359766,25.40
9857138,9957948,2773,970550,10928498,9.75
9857139,9957610,1967,688450,10646060,6.91
9857140,9972996,3790,1326500,11299496,13.30
9857141,9979755,3283,1149050,11128805,11.51
9857142,9990610,2486,870100,10860710,8.71
9857143,654718,130,45500,700218,6.95
9857144,9973106,1918,671300,10644406,6.73
9857145,9978677,3656,1279600,11258277,12.82
9857146,9990529,2228,779800,10770329,7.81
9857147,9969249,3962,1386700,11355949,13.91
9857148,9968410,2719,951650,10920060,9.55
9857149,9983081,5930,2075500,12058581,20.79
9857151,9967452,3361,1176350,11143802,11.80
9857152,9963421,3791,1326850,11290271,13.32
9857153,9972358,2468,863800,10836158,8.66
9857154,9981980,2156,754600,10736580,7.56
9857155,9967985,1639,573650,10541635,5.75
9857156,9949765,3050,1067500,11017265,10.73
9857157,9939065,3131,1095850,11034915,11.03
9857158,9944386,3435,1202250,11146636,12.09
9857159,9962571,1445,505750,10468321,5.08
9857160,3259222,1838,643300,3902522,19.74
9857161,9960463,4124,1443400,11403863,14.49
9857162,1177674,827,289450,1467124,24.58
9857163,9956737,3424,1198400,11155137,12.04
9857164,9973113,3933,1376550,11349663,13.80
9857165,3937314,3054,1068900,5006214,27.15
9857166,9636147,1876,656600,10292747,6.81
9857167,9401167,2458,860300,10261467,9.15
9857168,9957553,2839,993650,10951203,9.98
9857169,6494481,639,223650,6718131,3.44
9857170,9952349,4193,1467550,11419899,14.75
9857171,9957738,1951,682850,10640588,6.86
9857172,1120225,892,312200,1432425,27.87
9857173,9925933,5116,1790600,11716533,18.04
9857174,9948883,2694,942900,10891783,9.48
9857175,1260945,754,263900,1524845,20.93
9857176,364667,179,62650,427317,17.18
9857178,9931801,2066,723100,10654901,7.28
9857179,9971026,3799,1329650,11300676,13.34
9857180,9966214,6734,2356900,12323114,23.65
9857181,9958476,725,253750,10212226,2.55
9857182,8779065,1207,422450,9201515,4.81
9857183,5419170,1813,634550,6053720,11.71
9857184,9954346,3449,1207150,11161496,12.13
9857185,9982223,1156,404600,10386823,4.05
9857186,9983415,3974,1390900,11374315,13.93
9857187,9972467,2671,934850,10907317,9.37
9857188,9963015,2843,995050,10958065,9.99
9857189,9960213,1403,491050,10451263,4.93
9857190,9956439,2486,870100,10826539,8.74
9857191,9955871,3844,1345400,11301271,13.51
9857192,9951985,2046,716100,10668085,7.20
9857193,9972455,2990,1046500,11018955,10.49
9857195,9970670,2816,985600,10956270,9.88
9857196,9963265,1711,598850,10562115,6.01
9857197,9948220,3973,1390550,11338770,13.98
9857198,9960974,3141,1099350,11060324,11.04
9857199,9941284,2343,820050,10761334,8.25
9857200,9952167,3718,1301300,11253467,13.08
9857201,3830230,1555,544250,4374480,14.21
9857202,9948228,3127,1094450,11042678,11.00
9857203,9964261,3865,1352750,11317011,13.58
9857204,9969397,2760,966000,10935397,9.69
9857205,9956727,4242,1484700,11441427,14.91
9857206,1489554,765,267750,1757304,17.98
9857207,9961211,2807,982450,10943661,9.86
9857208,9962694,3012,1054200,11016894,10.58
9857209,9958449,3608,1262800,11221249,12.68
9857210,9968287,1979,692650,10660937,6.95
9857211,1306141,332,116200,1422341,8.90
9857212,3687173,1282,448700,4135873,12.17
9857213,9975773,4729,1655150,11630923,16.59
9857214,9975745,3436,1202600,11178345,12.06
9857215,3439422,1790,626500,4065922,18.22
9857216,9956566,1526,534100,10490666,5.36
9857217,9970899,2500,875000,10845899,8.78
9857218,9951144,2211,773850,10724994,7.78
9857219,9966293,2313,809550,10775843,8.12
9857220,9974884,1181,413350,10388234,4.14
9857221,2076080,701,245350,2321430,11.82
9857222,2979193,1609,563150,3542343,18.90
9857223,9993240,3311,1158850,11152090,11.60
9857224,9899069,3733,1306550,11205619,13.20
9857225,9986901,2515,880250,10867151,8.81
9857226,9973919,4497,1573950,11547869,15.78
9857227,9977075,4279,1497650,11474725,15.01
9857228,9981621,2783,974050,10955671,9.76
9857229,9988426,3869,1354150,11342576,13.56
9857231,1459834,1050,367500,1827334,25.17
9857232,9979595,5030,1760500,11740095,17.64
9857233,601271,262,91700,692971,15.25
9857234,9972343,2027,709450,10681793,7.11
9857235,8981018,2811,983850,9964868,10.95
9857236,9977767,3733,1306550,11284317,13.09
9857237,9979233,2355,824250,10803483,8.26
9857238,9967669,3003,1051050,11018719,10.54
9857239,330273,146,51100,381373,15.47
9857240,9979265,5120,1792000,11771265,17.96
9857241,9989959,3153,1103550,11093509,11.05
9857242,9954633,1844,645400,10600033,6.48
9857243,9991986,3441,1204350,11196336,12.05
9857244,9945753,3016,1055600,11001353,10.61
9857245,9978961,4348,1521800,11500761,15.25
9857246,9989378,3314,1159900,11149278,11.61
9857247,9978262,1773,620550,10598812,6.22
9857248,9984548,2191,766850,10751398,7.68
9857249,9981024,3587,1255450,11236474,12.58
9857250,9626220,2004,701400,10327620,7.29
9857251,9998833,3552,1243200,11242033,12.43
9857252,9983144,3372,1180200,11163344,11.82
9857253,3628026,1008,352800,3980826,9.72
9857254,9966729,4423,1548050,11514779,15.53
9857255,9967067,3730,1305500,11272567,13.10
9857256,9975686,3170,1109500,11085186,11.12
9857257,9982117,2764,967400,10949517,9.69
9857258,9990617,2214,774900,10765517,7.76
9857259,515743,137,47950,563693,9.30
9857260,9976980,2265,792750,10769730,7.95
9857261,1835361,612,214200,2049561,11.67
9857262,9968060,2999,1049650,11017710,10.53
9857263,9955878,900,315000,10270878,3.16
9857264,9976756,3982,1393700,11370456,13.97
9857265,387759,186,65100,452859,16.79
9857266,9947006,3366,1178100,11125106,11.84
9857268,9941613,3226,1129100,11070713,11.36
9857269,9967811,3921,1372350,11340161,13.77
9857270,9948452,3292,1152200,11100652,11.58
9857271,2853182,640,224000,3077182,7.85
9857272,9959253,3210,1123500,11082753,11.28
9857273,9969095,3304,1156400,11125495,11.60
9857274,9960875,2571,899850,10860725,9.03
9857275,9979139,3736,1307600,11286739,13.10
9857276,9954458,2386,835100,10789558,8.39
9857277,9964347,3510,1228500,11192847,12.33
9857278,1549844,1467,513450,2063294,33.13
9857279,9978501,3557,1244950,11223451,12.48
9857280,9981473,4089,1431150,11412623,14.34
9857281,7377581,4385,1534750,8912331,20.80
9857282,9981594,2941,1029350,11010944,10.31
9857283,9976144,3165,1107750,11083894,11.10
9857284,9996353,3231,1130850,11127203,11.31
9857285,9982662,4789,1676150,11658812,16.79
9857287,1497501,1421,497350,1994851,33.21
9857288,9942274,4838,1693300,11635574,17.03
9857289,9947005,3835,1342250,11289255,13.49
9857290,9152716,3114,1089900,10242616,11.91
9857291,9955968,4693,1642550,11598518,16.50
9857292,2269535,1355,474250,2743785,20.90
9857293,9929025,5473,1915550,11844575,19.29
9857294,1026705,164,57400,1084105,5.59
9857296,5303248,1925,673750,5976998,12.70
9857297,9932199,1911,668850,10601049,6.73
9857298,9917898,5160,1806000,11723898,18.21
9857299,3364025,380,133000,3497025,3.95
9857300,9924619,4801,1680350,11604969,16.93
9857301,9935639,3201,1120350,11055989,11.28
9857302,9940605,3887,1360450,11301055,13.69
9857303,9929087,4148,1451800,11380887,14.62
9857304,9916840,1908,667800,10584640,6.73
9857305,9904636,1391,486850,10391486,4.92
9857306,9933036,1353,473550,10406586,4.77
9857307,9938194,3232,1131200,11069394,11.38
9857308,530973,232,81200,612173,15.29
9857309,9936662,3404,1191400,11128062,11.99
9857310,9910443,4132,1446200,11356643,14.59
9857311,9918154,6104,2136400,12054554,21.54
9857312,9912810,1476,516600,10429410,5.21
9857313,9693595,1674,585900,10279495,6.04
9857314,9944947,3819,1336650,11281597,13.44
9857315,9947835,2642,924700,10872535,9.30
9857316,9945453,3180,1113000,11058453,11.19
9857317,9950417,4491,1571850,11522267,15.80
9857318,9177579,3077,1076950,10254529,11.73
9857319,9973532,3837,1342950,11316482,13.47
9857320,9968894,3742,1309700,11278594,13.14
9857321,9982318,3451,1207850,11190168,12.10
9857322,9997792,4651,1627850,11625642,16.28
9857323,6726416,2704,946400,7672816,14.07
9857324,9978971,3633,1271550,11250521,12.74
9857325,9960986,2667,933450,10894436,9.37
9857326,9971224,3560,1246000,11217224,12.50
9857327,3028310,904,316400,3344710,10.45
9857328,9951701,4874,1705900,11657601,17.14
9857329,9924184,2125,743750,10667934,7.49
9857330,9960406,2577,901950,10862356,9.06
9857331,9952687,5495,1923250,11875937,19.32
9857332,9964750,2398,839300,10804050,8.42
9857333,3258943,1134,396900,3655843,12.18
9857334,9956554,3344,1170400,11126954,11.76
9857335,3745596,705,246750,3992346,6.59
9857336,9994099,5760,2016000,12010099,20.17
9857337,9961510,3841,1344350,11305860,13.50
9857338,9979245,3845,1345750,11324995,13.49
9857339,9993966,1189,416150,10410116,4.16
9857340,9988195,3559,1245650,11233845,12.47
9857341,9967836,2620,917000,10884836,9.20
9857342,9971822,3441,1204350,11176172,12.08
9857343,9964383,3769,1319150,11283533,13.24
9857344,9975451,3426,1199100,11174551,12.02
9857345,9981066,1144,400400,10381466,4.01
9857346,9973448,3333,1166550,11139998,11.70
9857347,1008537,832,291200,1299737,28.87
9857348,5038637,1147,401450,5440087,7.97
9857349,9982456,3214,1124900,11107356,11.27
9857350,762324,425,148750,911074,19.51
9857351,9991708,5545,1940750,11932458,19.42
9857352,9979311,3996,1398600,11377911,14.01
9857353,3176158,1250,437500,3613658,13.77
9857354,9969819,2635,922250,10892069,9.25
9857355,5011689,2162,756700,5768389,15.10
9857356,9980297,5813,2034550,12014847,20.39
9857357,9997476,1126,394100,10391576,3.94
9857358,9982366,5257,1839950,11822316,18.43
9857359,9985706,3041,1064350,11050056,10.66
9857361,9995810,1994,697900,10693710,6.98
9857362,6234259,3702,1295700,7529959,20.78
9857363,9974881,4451,1557850,11532731,15.62
9857364,9976139,4677,1636950,11613089,16.41
9857365,9975437,4929,1725150,11700587,17.29
9857366,2064318,830,290500,2354818,14.07
9857367,3860186,2047,716450,4576636,18.56
9857368,9987635,5088,1780800,11768435,17.83
9857369,4980097,1662,581700,5561797,11.68
9857370,2908154,2926,1024100,3932254,35.21
9857371,9977452,4540,1589000,11566452,15.93
9857372,2785141,727,254450,3039591,9.14
9857373,9698734,2678,937300,10636034,9.66
9857374,9987588,3497,1223950,11211538,12.25
9857375,9983570,4072,1425200,11408770,14.28
9857376,9990894,3861,1351350,11342244,13.53
9857377,9989061,4708,1647800,11636861,16.50
9857378,9973418,5320,1862000,11835418,18.67
9857379,4836810,3062,1071700,5908510,22.16
9857380,630950,333,116550,747500,18.47
9857381,9981654,5526,1934100,11915754,19.38
9857382,2584348,943,330050,2914398,12.77
9857383,9993849,6834,2391900,12385749,23.93
9857384,9991970,2118,741300,10733270,7.42
9857385,1018904,267,93450,1112354,9.17
9857386,9981012,3102,1085700,11066712,10.88
9857387,9859383,3630,1270500,11129883,12.89
9857389,5177230,2773,970550,6147780,18.75
9857390,258841,114,39900,298741,15.41
9857391,9966119,6107,2137450,12103569,21.45
9857392,9968002,3150,1102500,11070502,11.06
9857393,9978821,2797,978950,10957771,9.81
9857394,9313621,2884,1009400,10323021,10.84
9857395,9975147,2390,836500,10811647,8.39
9857396,1476990,320,112000,1588990,7.58
9857397,9966167,3483,1219050,11185217,12.23
9857398,9975633,2654,928900,10904533,9.31
9857399,9958292,2561,896350,10854642,9.00
9857400,9946851,4380,1533000,11479851,15.41
9857401,9963153,2959,1035650,10998803,10.39
9857402,9898712,4044,1415400,11314112,14.30
9857403,9964541,3223,1128050,11092591,11.32
9857404,9963085,3872,1355200,11318285,13.60
9857405,9971759,3798,1329300,11301059,13.33
9857406,9958592,3782,1323700,11282292,13.29
9857407,9968536,3565,1247750,11216286,12.52
9857408,3592510,1270,444500,4037010,12.37
9857409,9958264,4146,1451100,11409364,14.57
9857410,9961574,2024,708400,10669974,7.11
9857411,494646,268,93800,588446,18.96
9857412,9961049,2665,932750,10893799,9.36
9857413,9615692,4402,1540700,11156392,16.02
9857414,9964747,4625,1618750,11583497,16.24
9857415,9968415,4241,1484350,11452765,14.89
9857416,9966765,3873,1355550,11322315,13.60
9857417,9990360,5861,2051350,12041710,20.53
9857418,503189,149,52150,555339,10.36
9857419,9982712,3693,1292550,11275262,12.95
9857420,9979615,3683,1289050,11268665,12.92
9857421,9977172,3672,1285200,11262372,12.88
9857422,3420766,1254,438900,3859666,12.83
9857423,9966372,2884,1009400,10975772,10.13
9857424,9984470,4985,1744750,11729220,17.47
9857426,9984045,4697,1643950,11627995,16.47
9857427,9994567,4275,1496250,11490817,14.97
9857428,9980386,3193,1117550,11097936,11.20
9857429,9984720,3377,1181950,11166670,11.84
9857430,9980777,4478,1567300,11548077,15.70
9857431,9988554,4489,1571150,11559704,15.73
9857433,9974540,4515,1580250,11554790,15.84
9857434,9972025,4127,1444450,11416475,14.49
9857435,4443329,939,328650,4771979,7.40
9857436,9970560,2901,1015350,10985910,10.18
9857437,9974390,3223,1128050,11102440,11.31
9857438,9994862,2255,789250,10784112,7.90
9857439,9999900,3335,1167250,11167150,11.67
9857440,9979727,4398,1539300,11519027,15.42
9857441,9989067,3459,1210650,11199717,12.12
9857442,625406,387,135450,760856,21.66
9857443,9962287,3650,1277500,11239787,12.82
9857444,9971201,4477,1566950,11538151,15.71
9857445,9984967,5650,1977500,11962467,19.80
9857446,9981926,3365,1177750,11159676,11.80
9857447,9995880,2504,876400,10872280,8.77
9857448,9956543,1743,610050,10566593,6.13
9857449,1347086,538,188300,1535386,13.98
9857450,9969499,3160,1106000,11075499,11.09
9857451,9959287,3245,1135750,11095037,11.40
9857452,9955765,3920,1372000,11327765,13.78
9857453,6585737,2124,743400,7329137,11.29
9857454,9973156,4220,1477000,11450156,14.81
9857456,9958989,4548,1591800,11550789,15.98
9857457,9955538,2524,883400,10838938,8.87
9857458,9972234,3183,1114050,11086284,11.17
9857459,9978165,2246,786100,10764265,7.88
9857460,9889571,2577,901950,10791521,9.12
9857461,9994140,3813,1334550,11328690,13.35
9857462,9973772,2968,1038800,11012572,10.42
9857463,9975570,2503,876050,10851620,8.78
9857464,9973452,3066,1073100,11046552,10.76
9857465,9977892,1738,608300,10586192,6.10
9857466,9974633,2707,947450,10922083,9.50
9857467,9958078,4796,1678600,11636678,16.86
9857468,9941166,3677,1286950,11228116,12.95
9857469,9949778,2568,898800,10848578,9.03
9857470,9953072,3108,1087800,11040872,10.93
9857471,9880260,3921,1372350,11252610,13.89
9857472,9959677,3146,1101100,11060777,11.06
9857473,9966962,3453,1208550,11175512,12.13
9857474,9981027,3998,1399300,11380327,14.02
9857475,4633346,1186,415100,5048446,8.96
9857476,9979246,3213,1124550,11103796,11.27
9857477,9999844,2804,981400,10981244,9.81
9857478,9986566,2915,1020250,11006816,10.22
9857479,1706930,1002,350700,2057630,20.55
9857480,9965800,3924,1373400,11339200,13.78
9857481,9975561,3531,1235850,11211411,12.39
9857482,6192967,2232,781200,6974167,12.61
9857483,4008701,1744,610400,4619101,15.23
9857484,3101211,1330,465500,3566711,15.01
9857485,9959799,4086,1430100,11389899,14.36
9857486,9961520,4457,1559950,11521470,15.66
9857487,9954477,4203,1471050,11425527,14.78
9857488,9949174,3692,1292200,11241374,12.99
9857489,9968297,4612,1614200,11582497,16.19
9857490,9956355,5693,1992550,11948905,20.01
9857491,9958288,3590,1256500,11214788,12.62
9857492,9963705,2025,708750,10672455,7.11
9857493,9979342,3218,1126300,11105642,11.29
9857495,9983694,4544,1590400,11574094,15.93
9857496,7034106,3341,1169350,8203456,16.62
9857497,9972784,4442,1554700,11527484,15.59
9857498,9954089,5430,1900500,11854589,19.09
9857499,9971109,4797,1678950,11650059,16.84
9857500,9949018,4831,1690850,11639868,17.00
9857501,8987555,3626,1269100,10256655,14.12
9857502,9965977,2410,843500,10809477,8.46
9857504,9967057,4454,1558900,11525957,15.64
9857505,9940665,5368,1878800,11819465,18.90
9857506,9958625,3977,1391950,11350575,13.98
9857507,9974056,7332,2566200,12540256,25.73
9857508,9929910,3186,1115100,11045010,11.23
9857509,9962666,3511,1228850,11191516,12.33
9857510,9976161,3896,1363600,11339761,13.67
9857511,3468952,1106,387100,3856052,11.16
9857512,9012637,3888,1360800,10373437,15.10
9857513,9963171,5982,2093700,12056871,21.01
9857514,9965325,6571,2299850,12265175,23.08
9857515,9965614,4843,1695050,11660664,17.01
9857516,9929377,3581,1253350,11182727,12.62
9857517,9970076,4003,1401050,11371126,14.05
9857518,9965467,4031,1410850,11376317,14.16
9857519,9973786,6928,2424800,12398586,24.31
9857520,2107373,758,265300,2372673,12.59
9857521,9956904,4273,1495550,11452454,15.02
9857522,9976480,6306,2207100,12183580,22.12
9857523,9968788,6133,2146550,12115338,21.53
9857524,9965507,2866,1003100,10968607,10.07
9857525,7957930,4750,1662500,9620430,20.89
9857526,9984230,6032,2111200,12095430,21.15
9857527,9965168,6386,2235100,12200268,22.43
9857528,9953568,6104,2136400,12089968,21.46
9857529,9956317,5452,1908200,11864517,19.17
9857530,9978257,1854,648900,10627157,6.50
9857531,9983562,4346,1521100,11504662,15.24
9857532,9986073,3996,1398600,11384673,14.01
9857533,9976639,3616,1265600,11242239,12.69
9857534,9975167,4915,1720250,11695417,17.25
9857535,9982431,4615,1615250,11597681,16.18
9857537,9998263,4648,1626800,11625063,16.27
9857538,8268863,908,317800,8586663,3.84
9857539,9990751,6807,2382450,12373201,23.85
9857540,9983895,2872,1005200,10989095,10.07
9857541,9974808,3890,1361500,11336308,13.65
9857542,9984317,4654,1628900,11613217,16.31
9857543,9987285,3879,1357650,11344935,13.59
9857544,5738785,1442,504700,6243485,8.79
9857545,8589088,5189,1816150,10405238,21.14
9857546,9972769,3651,1277850,11250619,12.81
9857547,9977745,2818,986300,10964045,9.88
9857548,1087223,199,69650,1156873,6.41
9857549,9960804,5374,1880900,11841704,18.88
9857550,9948180,4311,1508850,11457030,15.17
9857551,9957293,3377,1181950,11139243,11.87
9857552,9966305,4493,1572550,11538855,15.78
9857553,8515906,2392,837200,9353106,9.83
9857554,9976745,3086,1080100,11056845,10.83
9857555,9252505,5043,1765050,11017555,19.08
9857556,9993830,5824,2038400,12032230,20.40
9857557,9989123,3021,1057350,11046473,10.59
9857558,9966379,3563,1247050,11213429,12.51
9857559,9999988,6968,2438800,12438788,24.39
9857560,9971267,4542,1589700,11560967,15.94
9857561,9978966,4290,1501500,11480466,15.05
9857562,9982806,5238,1833300,11816106,18.36
9857563,9994036,2610,913500,10907536,9.14
9857565,9962013,5204,1821400,11783413,18.28
9857566,9974989,3458,1210300,11185289,12.13
9857567,9984155,4635,1622250,11606405,16.25
9857568,9994905,1590,556500,10551405,5.57
9857569,9967438,2934,1026900,10994338,10.30
9857570,9983259,4395,1538250,11521509,15.41
9857571,9997468,3036,1062600,11060068,10.63
9857572,9973394,3617,1265950,11239344,12.69
9857573,9980211,3163,1107050,11087261,11.09
9857574,9991096,2713,949550,10940646,9.50
9857575,9983602,5222,1827700,11811302,18.31
9857576,9983276,3004,1051400,11034676,10.53
9857577,9986592,1785,624750,10611342,6.26
9857578,9990583,4266,1493100,11483683,14.95
9857579,9985888,3506,1227100,11212988,12.29
9857580,9988739,4105,1436750,11425489,14.38
9857581,9976806,4183,1464050,11440856,14.67
9857582,4893572,2407,842450,5736022,17.22
9857583,9976218,4203,1471050,11447268,14.75
9857584,9969404,6362,2226700,12196104,22.34
9857585,9978966,4913,1719550,11698516,17.23
9857586,9976365,4854,1698900,11675265,17.03
9857587,9982672,3830,1340500,11323172,13.43
9857588,9982748,6102,2135700,12118448,21.39
9857589,3517141,1745,610750,4127891,17.36
9857590,9991228,3240,1134000,11125228,11.35
9857591,9974220,2212,774200,10748420,7.76
9857592,9989395,3244,1135400,11124795,11.37
9857593,9989123,995,348250,10337373,3.49
9857594,3205145,2060,721000,3926145,22.50
9857595,9897154,3996,1398600,11295754,14.13
9857596,9976090,4226,1479100,11455190,14.83
9857597,9977429,3685,1289750,11267179,12.93
9857598,9997175,4202,1470700,11467875,14.71
9857599,2233008,804,281400,2514408,12.60
9857600,2294624,495,173250,2467874,7.55
9857601,3758719,1416,495600,4254319,13.19
9857602,8229742,4264,1492400,9722142,18.13
9857603,9969323,3659,1280650,11249973,12.85
9857604,9975242,3720,1302000,11277242,13.05
9857605,9944482,2725,953750,10898232,9.59
9857606,9964810,3785,1324750,11289560,13.29
9857607,9931883,2797,978950,10910833,9.86
9857608,9988703,2741,959350,10948053,9.60
9857609,863906,438,153300,1017206,17.74
9857610,971184,380,133000,1104184,13.69
9857611,9979903,1084,379400,10359303,3.80
9857612,9993267,2070,724500,10717767,7.25
9857613,9103076,3170,1109500,10212576,12.19
9857614,9992866,4308,1507800,11500666,15.09
9857615,1386284,787,275450,1661734,19.87
9857616,9972187,5434,1901900,11874087,19.07
9857617,1238631,533,186550,1425181,15.06
9857618,9946006,3489,1221150,11167156,12.28
9857619,9950768,3798,1329300,11280068,13.36
9857620,9939021,3121,1092350,11031371,10.99
9857621,9961042,4037,1412950,11373992,14.18
9857622,483591,152,53200,536791,11.00
9857623,9948873,4491,1571850,11520723,15.80
9857624,9957508,3501,1225350,11182858,12.31
9857625,9956809,4303,1506050,11462859,15.13
9857626,9930748,3961,1386350,11317098,13.96
9857627,9955569,1204,421400,10376969,4.23
9857628,9975127,5515,1930250,11905377,19.35
9857629,3362161,1250,437500,3799661,13.01
9857630,9975456,2893,1012550,10988006,10.15
9857631,9988531,3731,1305850,11294381,13.07
9857632,9985344,2882,1008700,10994044,10.10
9857633,9988840,1875,656250,10645090,6.57
9857634,8918917,4179,1462650,10381567,16.40
9857635,9295892,3557,1244950,10540842,13.39
9857636,3075748,1411,493850,3569598,16.06
9857637,9962781,1907,667450,10630231,6.70
9857638,9972042,3946,1381100,11353142,13.85
9857639,9970429,4571,1599850,11570279,16.05
9857640,9971844,5180,1813000,11784844,18.18
9857641,5510199,3100,1085000,6595199,19.69
9857642,9968797,4151,1452850,11421647,14.57
9857643,9621436,3466,1213100,10834536,12.61
9857644,9968864,3474,1215900,11184764,12.20
9857645,9974370,2707,947450,10921820,9.50
9857647,9986331,3717,1300950,11287281,13.03
9857648,9972941,2868,1003800,10976741,10.07
9857649,9960382,2543,890050,10850432,8.94
9857650,9973359,4606,1612100,11585459,16.16
9857651,9963610,4461,1561350,11524960,15.67
9857652,9966239,1867,653450,10619689,6.56
9857653,9962120,3707,1297450,11259570,13.02
9857654,9983055,5939,2078650,12061705,20.82
9857655,4290576,2286,800100,5090676,18.65
9857656,9951171,1779,622650,10573821,6.26
9857657,9972290,5616,1965600,11937890,19.71
9857658,9984000,3896,1363600,11347600,13.66
9857659,9888663,5111,1788850,11677513,18.09
9857660,9953880,2234,781900,10735780,7.86
9857661,9956548,5300,1855000,11811548,18.63
9857662,9972341,3006,1052100,11024441,10.55
9857664,3035775,1467,513450,3549225,16.91
9857665,9344588,2589,906150,10250738,9.70
9857666,9988000,4183,1464050,11452050,14.66
9857667,9998350,7730,2705500,12703850,27.06
9857668,9973232,6898,2414300,12387532,24.21
9857669,2620662,405,141750,2762412,5.41
9857670,9987185,2799,979650,10966835,9.81
9857671,9984747,3692,1292200,11276947,12.94
9857672,6166493,1918,671300,6837793,10.89
9857673,6031447,1607,562450,6593897,9.33
9857674,9961820,3556,1244600,11206420,12.49
9857675,9900600,3835,1342250,11242850,13.56
9857676,9969833,4197,1468950,11438783,14.73
9857677,9958479,3603,1261050,11219529,12.66
9857678,9908233,3523,1233050,11141283,12.44
9857679,9976293,3521,1232350,11208643,12.35
9857680,9993068,3524,1233400,11226468,12.34
9857681,9987323,3608,1262800,11250123,12.64
9857682,9723149,3000,1050000,10773149,10.80
9857683,9977859,5323,1863050,11840909,18.67
9857684,1602537,1223,428050,2030587,26.71
9857685,9970058,2378,832300,10802358,8.35
9857686,9954638,4957,1734950,11689588,17.43
9857687,9946264,5882,2058700,12004964,20.70
9857688,9940198,5781,2023350,11963548,20.36
9857689,328329,248,86800,415129,26.44
9857690,6380810,1053,368550,6749360,5.78
9857691,9946399,6073,2125550,12071949,21.37
9857692,9875185,4498,1574300,11449485,15.94
9857693,9942042,4192,1467200,11409242,14.76
9857694,3519381,1677,586950,4106331,16.68
9857695,9929533,1358,475300,10404833,4.79
9857696,9938426,3590,1256500,11194926,12.64
9857697,9964156,5487,1920450,11884606,19.27
9857698,9970505,2391,836850,10807355,8.39
9857699,3665492,2067,723450,4388942,19.74
9857700,9977962,2806,982100,10960062,9.84
9857701,9983850,3987,1395450,11379300,13.98
9857702,9986878,2432,851200,10838078,8.52
9857703,9986200,3223,1128050,11114250,11.30
9857705,9981952,4749,1662150,11644102,16.65
9857706,9995554,1888,660800,10656354,6.61
9857707,9982180,2152,753200,10735380,7.55
9857708,9968268,2485,869750,10838018,8.73
9857709,9989935,6636,2322600,12312535,23.25
9857710,9982643,5187,1815450,11798093,18.19
9857711,4284193,902,315700,4599893,7.37
9857712,9556899,3387,1185450,10742349,12.40
9857713,9968609,4979,1742650,11711259,17.48
9857714,9985774,4372,1530200,11515974,15.32
9857715,9977211,6637,2322950,12300161,23.28
9857716,9969397,3237,1132950,11102347,11.36
9857717,9966211,4213,1474550,11440761,14.80
9857719,9967682,3324,1163400,11131082,11.67
9857720,3565781,929,325150,3890931,9.12
9857721,9965342,3948,1381800,11347142,13.87
9857722,6125073,1868,653800,6778873,10.67
9857723,6286213,3669,1284150,7570363,20.43
9857724,9954267,1988,695800,10650067,6.99
9857725,9956412,3493,1222550,11178962,12.28
9857726,9630991,3094,1082900,10713891,11.24
9857727,9951916,5878,2057300,12009216,20.67
9857728,9957749,4902,1715700,11673449,17.23
9857729,2833227,1047,366450,3199677,12.93
9857730,9958518,6268,2193800,12152318,22.03
9857731,9952958,4053,1418550,11371508,14.25
9857732,9981458,5403,1891050,11872508,18.95
9857733,9995665,4696,1643600,11639265,16.44
9857734,4880811,4450,1557500,6438311,31.91
9857735,9706094,3896,1363600,11069694,14.05
9857736,9986084,3476,1216600,11202684,12.18
9857737,9987784,3377,1181950,11169734,11.83
9857738,9998386,2085,729750,10728136,7.30
9857739,9986254,3035,1062250,11048504,10.64
9857740,9726358,3150,1102500,10828858,11.34
9857741,9987212,3422,1197700,11184912,11.99
9857742,9992006,3192,1117200,11109206,11.18
9857743,9970233,2847,996450,10966683,9.99
9857744,9994189,2355,824250,10818439,8.25
9857745,9995386,5436,1902600,11897986,19.03
9857746,9979144,5398,1889300,11868444,18.93
9857747,9999728,3443,1205050,11204778,12.05
9857748,9982809,4485,1569750,11552559,15.72
9857749,9981525,3158,1105300,11086825,11.07
9857750,9993012,2511,878850,10871862,8.79
9857751,2155242,414,144900,2300142,6.72
9857752,9967827,6292,2202200,12170027,22.09
9857753,1592713,471,164850,1757563,10.35
9857754,9967404,4166,1458100,11425504,14.63
9857755,2220992,1553,543550,2764542,24.47
9857756,9967417,4461,1561350,11528767,15.66
9857757,9980187,2878,1007300,10987487,10.09
9857758,9994314,3778,1322300,11316614,13.23
9857759,9980706,3383,1184050,11164756,11.86
9857760,9978900,3726,1304100,11283000,13.07
9857761,9986782,3849,1347150,11333932,13.49
9857762,9981726,2341,819350,10801076,8.21
9857763,9963881,3216,1125600,11089481,11.30
9857764,9982984,4749,1662150,11645134,16.65
9857765,9721181,5685,1989750,11710931,20.47
9857767,9970977,1835,642250,10613227,6.44
9857768,9983376,4046,1416100,11399476,14.18
9857769,9554731,7038,2463300,12018031,25.78
9857770,1745834,597,208950,1954784,11.97
9857772,9974196,4443,1555050,11529246,15.59
9857773,2199157,581,203350,2402507,9.25
9857774,505646,232,81200,586846,16.06
9857775,9986742,4239,1483650,11470392,14.86
9857776,9990908,1753,613550,10604458,6.14
9857777,9971383,2792,977200,10948583,9.80
9857778,9979621,3605,1261750,11241371,12.64
9857779,9988259,4571,1599850,11588109,16.02
9857780,9994931,1653,578550,10573481,5.79
9857781,9797938,2853,998550,10796488,10.19
9857782,9977737,3892,1362200,11339937,13.65
9857783,8914006,4757,1664950,10578956,18.68
9857784,9982187,4326,1514100,11496287,15.17
9857785,9989618,3116,1090600,11080218,10.92
9857786,9982948,1987,695450,10678398,6.97
9857787,1816385,896,313600,2129985,17.27
9857788,2835794,1569,549150,3384944,19.36
9857789,9998441,4965,1737750,11736191,17.38
9857790,9985692,2534,886900,10872592,8.88
9857791,9992652,3949,1382150,11374802,13.83
9857792,8497543,4156,1454600,9952143,17.12
9857793,9982625,3755,1314250,11296875,13.17
9857794,426293,390,136500,562793,32.02
9857795,9965116,1332,466200,10431316,4.68
9857796,9961675,997,348950,10310625,3.50
9857797,9983929,3112,1089200,11073129,10.91
9857798,9974067,1713,599550,10573617,6.01
9857799,9986469,3833,1341550,11328019,13.43
9857800,9998412,4053,1418550,11416962,14.19
9857801,9981731,5133,1796550,11778281,18.00
9857802,9974873,1423,498050,10472923,4.99
9857803,9995361,1638,573300,10568661,5.74
9857804,2513914,631,220850,2734764,8.79
9857805,9985027,2631,920850,10905877,9.22
9857806,9978670,5243,1835050,11813720,18.39
9857807,6462544,3718,1301300,7763844,20.14
9857808,9919340,5302,1855700,11775040,18.71
9857809,1972162,717,250950,2223112,12.72
9857810,9957309,5185,1814750,11772059,18.23
9857811,9968217,2659,930650,10898867,9.34
9857812,9971288,3201,1120350,11091638,11.24
9857813,9966491,3337,1167950,11134441,11.72
9857814,1902726,1020,357000,2259726,18.76
9857815,9906541,3302,1155700,11062241,11.67
9857816,9940459,2932,1026200,10966659,10.32
9857817,9979481,1900,665000,10644481,6.66
9857818,9998122,3972,1390200,11388322,13.90
9857819,9994731,5717,2000950,11995681,20.02
9857820,9987249,3850,1347500,11334749,13.49
9857821,9977562,4264,1492400,11469962,14.96
9857822,9976352,4848,1696800,11673152,17.01
9857823,9982099,3513,1229550,11211649,12.32
9857824,9977825,4490,1571500,11549325,15.75
9857825,9984732,4024,1408400,11393132,14.11
9857826,9970185,2014,704900,10675085,7.07
9857827,9975709,4270,1494500,11470209,14.98
9857828,9964935,3762,1316700,11281635,13.21
9857829,3795129,2850,997500,4792629,26.28
9857830,9973889,3461,1211350,11185239,12.15
9857831,9913768,2752,963200,10876968,9.72
9857832,9961489,5380,1883000,11844489,18.90
9857833,1172799,275,96250,1269049,8.21
9857834,9997928,2684,939400,10937328,9.40
9857835,2826884,704,246400,3073284,8.72
9857836,7569015,1774,620900,8189915,8.20
9857837,3930341,1165,407750,4338091,10.37
9857838,9895707,2298,804300,10700007,8.13
9857839,9976725,4254,1488900,11465625,14.92
9857840,9983841,2992,1047200,11031041,10.49
9857841,1631973,490,171500,1803473,10.51
9857842,6815539,1864,652400,7467939,9.57
9857844,1934601,816,285600,2220201,14.76
9857845,9981114,4020,1407000,11388114,14.10
9857846,9990560,5575,1951250,11941810,19.53
9857847,9985851,4356,1524600,11510451,15.27
9857848,9966851,2240,784000,10750851,7.87
9857849,9976780,3547,1241450,11218230,12.44
9857850,9995917,3083,1079050,11074967,10.79
9857851,9969979,2560,896000,10865979,8.99
9857852,9976555,4262,1491700,11468255,14.95
9857853,9986593,2470,864500,10851093,8.66
9857854,9994213,4066,1423100,11417313,14.24
9857855,9970229,4509,1578150,11548379,15.83
9857856,1146862,590,206500,1353362,18.01
9857857,9973238,4450,1557500,11530738,15.62
9857858,9995460,2274,795900,10791360,7.96
9857859,9693027,2974,1040900,10733927,10.74
9857860,9985584,3432,1201200,11186784,12.03
9857861,9965301,1529,535150,10500451,5.37
9857862,9970492,2255,789250,10759742,7.92
9857863,9963233,4840,1694000,11657233,17.00
9857864,9965835,4872,1705200,11671035,17.11
9857865,9952535,844,295400,10247935,2.97
9857866,9978558,2277,796950,10775508,7.99
9857867,9969780,3210,1123500,11093280,11.27
9857868,9983223,1106,387100,10370323,3.88
9857869,9989737,3588,1255800,11245537,12.57
9857870,109406,42,14700,124106,13.44
9857871,9964071,3794,1327900,11291971,13.33
9857872,7487457,2350,822500,8309957,10.99
9857873,9967806,4190,1466500,11434306,14.71
9857874,9980738,5856,2049600,12030338,20.54
9857875,9989404,2291,801850,10791254,8.03
9857876,9991323,2814,984900,10976223,9.86
9857877,9983156,803,281050,10264206,2.82
9857878,9989977,6905,2416750,12406727,24.19
9857879,9981668,528,184800,10166468,1.85
9857880,9988106,3552,1243200,11231306,12.45
9857881,9984115,4336,1517600,11501715,15.20
9857882,9962192,3784,1324400,11286592,13.29
9857883,1137617,397,138950,1276567,12.21
9857884,9979792,3668,1283800,11263592,12.86
9857885,9968190,3628,1269800,11237990,12.74
9857886,9962640,3556,1244600,11207240,12.49
9857887,9987979,4080,1428000,11415979,14.30
9857888,9973769,5324,1863400,11837169,18.68
9857889,9987833,3145,1100750,11088583,11.02
9857890,9991359,2368,828800,10820159,8.30
9857891,1024701,581,203350,1228051,19.84
9857892,9982957,1792,627200,10610157,6.28
9857893,9975101,3895,1363250,11338351,13.67
9857894,9962361,5159,1805650,11768011,18.12
9857895,9974290,4936,1727600,11701890,17.32
9857896,710854,570,199500,910354,28.06
9857897,9191114,3414,1194900,10386014,13.00
9857898,9960966,2905,1016750,10977716,10.21
9857899,9959707,2207,772450,10732157,7.76
9857900,9984026,2755,964250,10948276,9.66
9857901,9971079,3359,1175650,11146729,11.79
9857902,9979983,1578,552300,10532283,5.53
9857903,9967794,4290,1501500,11469294,15.06
9857904,9981276,5297,1853950,11835226,18.57
9857905,9990822,3982,1393700,11384522,13.95
9857906,9992005,3455,1209250,11201255,12.10
9857907,9986802,2479,867650,10854452,8.69
9857908,9986410,7300,2555000,12541410,25.58
9857909,9898929,3947,1381450,11280379,13.96
9857910,4551321,2289,801150,5352471,17.60
9857911,4827729,2150,752500,5580229,15.59
9857912,1134197,923,323050,1457247,28.48
9857913,8923174,3128,1094800,10017974,12.27
9857914,8909481,2171,759850,9669331,8.53
9857915,2567919,949,332150,2900069,12.93
9857916,9965013,3843,1345050,11310063,13.50
9857917,9951344,3850,1347500,11298844,13.54
9857918,9972350,5756,2014600,11986950,20.20
9857919,1249204,457,159950,1409154,12.80
9857920,9961167,2303,806050,10767217,8.09
9857921,9962066,5041,1764350,11726416,17.71
9857922,9972510,2482,868700,10841210,8.71
9857923,9984830,1606,562100,10546930,5.63
9857924,9978309,4228,1479800,11458109,14.83
9857925,9999125,2487,870450,10869575,8.71
9857926,9999711,5156,1804600,11804311,18.05
9857927,9972417,5688,1990800,11963217,19.96
9857928,9957197,1652,578200,10535397,5.81
9857929,9966092,2449,857150,10823242,8.60
9857930,9976047,5508,1927800,11903847,19.32
9857931,9991185,3778,1322300,11313485,13.23
9857932,9980685,2192,767200,10747885,7.69
9857933,9991068,1467,513450,10504518,5.14
9857935,9982365,2832,991200,10973565,9.93
9857936,1439731,389,136150,1575881,9.46
9857937,9980449,4030,1410500,11390949,14.13
9857938,9999354,5342,1869700,11869054,18.70
9857939,9972794,3933,1376550,11349344,13.80
9857940,8984379,4729,1655150,10639529,18.42
9857941,9968677,6613,2314550,12283227,23.22
9857943,2758382,1451,507850,3266232,18.41
9857944,2846012,828,289800,3135812,10.18
9857945,9982664,6010,2103500,12086164,21.07
9857946,9972561,3851,1347850,11320411,13.52
9857947,9999689,3363,1177050,11176739,11.77
9857948,9988554,3163,1107050,11095604,11.08
9857949,9979739,2815,985250,10964989,9.87
9857950,9993354,3617,1265950,11259304,12.67
9857951,9986819,4646,1626100,11612919,16.28
9857952,9984555,4685,1639750,11624305,16.42
9857953,9984432,3292,1152200,11136632,11.54
9857954,9967520,3505,1226750,11194270,12.31
9857955,9958869,2988,1045800,11004669,10.50
9857956,9945654,5320,1862000,11807654,18.72
9857957,9967280,3631,1270850,11238130,12.75
9857958,9971216,3824,1338400,11309616,13.42
9857959,9967594,3758,1315300,11282894,13.20
9857960,9963575,6691,2341850,12305425,23.50
9857961,9950627,3227,1129450,11080077,11.35
9857962,9968525,4324,1513400,11481925,15.18
9857963,9980279,4611,1613850,11594129,16.17
9857964,1174934,762,266700,1441634,22.70
9857965,9968772,3293,1152550,11121322,11.56
9857966,9972498,6171,2159850,12132348,21.66
9857967,9976078,5959,2085650,12061728,20.91
9857968,9986150,5215,1825250,11811400,18.28
9857969,9978979,4473,1565550,11544529,15.69
9857970,9961846,2321,812350,10774196,8.15
9857971,9970129,4326,1514100,11484229,15.19
9857972,9992636,4172,1460200,11452836,14.61
9857973,9991859,4298,1504300,11496159,15.06
9857974,9978786,5835,2042250,12021036,20.47
9857975,9982716,4012,1404200,11386916,14.07
9857976,9979325,6984,2444400,12423725,24.49
9857977,9985696,3363,1177050,11162746,11.79
9857978,1047941,608,212800,1260741,20.31
9857979,9972626,6673,2335550,12308176,23.42
9857980,9973992,3741,1309350,11283342,13.13
9857981,9969775,2901,1015350,10985125,10.18
9857982,9968389,2259,790650,10759039,7.93
9857983,2265234,1165,407750,2672984,18.00
9857984,9983143,2206,772100,10755243,7.73
9857985,5892555,2353,823550,6716105,13.98
9857986,5012908,2320,812000,5824908,16.20
9857988,9956191,4774,1670900,11627091,16.78
9857989,9968749,5174,1810900,11779649,18.17
9857990,9979207,3753,1313550,11292757,13.16
9857991,9964087,5212,1824200,11788287,18.31
9857992,9979342,6313,2209550,12188892,22.14
9857993,9994750,5037,1762950,11757700,17.64
9857994,9973183,5121,1792350,11765533,17.97
9857995,9989259,4033,1411550,11400809,14.13
9857996,9988401,4611,1613850,11602251,16.16
9857997,9978316,5255,1839250,11817566,18.43
9857998,9962849,4746,1661100,11623949,16.67
9857999,9975747,6552,2293200,12268947,22.99
9858000,9984306,5823,2038050,12022356,20.41
9858001,9985244,7393,2587550,12572794,25.91
9858002,9986427,4764,1667400,11653827,16.70
9858003,4959085,2803,981050,5940135,19.78
9858004,1099454,931,325850,1425304,29.64
9858005,9995424,7358,2575300,12570724,25.76
9858006,9994505,5776,2021600,12016105,20.23
9858007,2400721,852,298200,2698921,12.42
9858008,9983167,4618,1616300,11599467,16.19
9858009,9979122,3705,1296750,11275872,12.99
9858010,9962119,3280,1148000,11110119,11.52
9858011,9977549,5211,1823850,11801399,18.28
9858012,9984597,5378,1882300,11866897,18.85
9858013,2643191,925,323750,2966941,12.25
9858014,9986339,6014,2104900,12091239,21.08
9858015,9970839,5264,1842400,11813239,18.48
9858016,9991007,4418,1546300,11537307,15.48
9858017,9994585,4800,1680000,11674585,16.81
9858018,1026067,362,126700,1152767,12.35
9858019,9998592,3764,1317400,11315992,13.18
9858020,9980902,2554,893900,10874802,8.96
9858021,6044385,2127,744450,6788835,12.32
9858022,9991905,4367,1528450,11520355,15.30
9858023,9972342,4466,1563100,11535442,15.67
9858024,9971161,2350,822500,10793661,8.25
9858025,9980557,2908,1017800,10998357,10.20
9858026,3934116,2860,1001000,4935116,25.44
9858027,9963234,5544,1940400,11903634,19.48
9858028,9960102,1582,553700,10513802,5.56
9858030,9969129,5992,2097200,12066329,21.04
9858031,9969123,4528,1584800,11553923,15.90
9858032,9963773,3392,1187200,11150973,11.92
9858033,9983273,6508,2277800,12261073,22.82
9858034,9962613,2452,858200,10820813,8.61
9858035,9960414,1890,661500,10621914,6.64
9858036,9959787,2226,779100,10738887,7.82
9858037,9970165,2523,883050,10853215,8.86
9858039,9959551,2754,963900,10923451,9.68
9858040,9951727,2302,805700,10757427,8.10
9858041,9958561,4495,1573250,11531811,15.80
9858042,1015361,77,26950,1042311,2.65
9858043,9972105,3472,1215200,11187305,12.19
9858044,9977684,3830,1340500,11318184,13.43
9858045,9134651,3014,1054900,10189551,11.55
9858046,9991128,3291,1151850,11142978,11.53
9858047,9995072,3113,1089550,11084622,10.90
9858048,9979765,2971,1039850,11019615,10.42
9858049,460356,249,87150,547506,18.93
9858050,9969897,3845,1345750,11315647,13.50
9858051,9984435,4291,1501850,11486285,15.04
9858052,1097714,388,135800,1233514,12.37
9858053,8979621,1226,429100,9408721,4.78
9858054,8969030,3658,1280300,10249330,14.27
9858055,9975375,4804,1681400,11656775,16.86
9858056,9380350,4017,1405950,10786300,14.99
9858057,9577592,6066,2123100,11700692,22.17
9858058,9983743,5445,1905750,11889493,19.09
9858059,9964792,3921,1372350,11337142,13.77
9858060,9963260,1145,400750,10364010,4.02
9858061,9988003,5231,1830850,11818853,18.33
9858062,9985919,5167,1808450,11794369,18.11
9858063,9979003,2729,955150,10934153,9.57
9858064,9661672,3490,1221500,10883172,12.64
9858065,9991820,3558,1245300,11237120,12.46
9858066,9984636,5045,1765750,11750386,17.68
9858067,9957886,4008,1402800,11360686,14.09
9858069,9963101,2623,918050,10881151,9.21
9858070,9978331,6742,2359700,12338031,23.65
9858071,9993075,5548,1941800,11934875,19.43
9858072,9964559,4742,1659700,11624259,16.66
9858073,9741847,2329,815150,10556997,8.37
9858074,9741341,4766,1668100,11409441,17.12
9858075,9989854,4135,1447250,11437104,14.49
9858076,9982293,6692,2342200,12324493,23.46
9858077,9353650,5533,1936550,11290200,20.70
9858078,9975829,3441,1204350,11180179,12.07
9858079,9981814,6010,2103500,12085314,21.07
9858080,9978552,5995,2098250,12076802,21.03
9858081,1245201,594,207900,1453101,16.70
9858082,9781901,4176,1461600,11243501,14.94
9858084,9988309,6437,2252950,12241259,22.56
9858085,9985341,6459,2260650,12245991,22.64
9858086,9973042,4648,1626800,11599842,16.31
9858087,9981083,4496,1573600,11554683,15.77
9858088,9980274,1908,667800,10648074,6.69
9858089,9983774,4180,1463000,11446774,14.65
9858090,9962282,5791,2026850,11989132,20.35
9858091,9973030,4054,1418900,11391930,14.23
9858092,9976331,4476,1566600,11542931,15.70
9858093,9979822,4589,1606150,11585972,16.09
9858094,9999124,4302,1505700,11504824,15.06
9858095,9979949,3696,1293600,11273549,12.96
9858096,8333344,3251,1137850,9471194,13.65
9858097,9985542,2954,1033900,11019442,10.35
9858098,9978832,3459,1210650,11189482,12.13
9858099,9988565,4268,1493800,11482365,14.96
9858100,9991802,2845,995750,10987552,9.97
9858101,6895622,3013,1054550,7950172,15.29
9858102,9979571,4962,1736700,11716271,17.40
9858103,9928107,3838,1343300,11271407,13.53
9858104,9974955,2152,753200,10728155,7.55
9858107,7658137,2993,1047550,8705687,13.68
9858108,9981877,4224,1478400,11460277,14.81
9858109,9999440,4254,1488900,11488340,14.89
9858110,7531372,3783,1324050,8855422,17.58
9858111,9978974,5475,1916250,11895224,19.20
9858112,8971869,5094,1782900,10754769,19.87
9858113,6585330,2806,982100,7567430,14.91
9858114,9988143,3891,1361850,11349993,13.63
9858115,9979533,4491,1571850,11551383,15.75
9858116,9975009,4509,1578150,11553159,15.82
9858117,9982798,3524,1233400,11216198,12.36
9858118,2825644,1553,543550,3369194,19.24
9858119,1479485,376,131600,1611085,8.89
9858120,9947366,2486,870100,10817466,8.75
9858121,9967154,5063,1772050,11739204,17.78
9858122,9965354,4528,1584800,11550154,15.90
9858123,9978109,3721,1302350,11280459,13.05
9858124,9982041,4164,1457400,11439441,14.60
9858125,9970866,5481,1918350,11889216,19.24
9858126,9984966,2927,1024450,11009416,10.26
9858127,9997577,3594,1257900,11255477,12.58
9858128,7158318,2858,1000300,8158618,13.97
9858129,9984067,4946,1731100,11715167,17.34
9858130,9463306,4329,1515150,10978456,16.01
9858131,9978580,4777,1671950,11650530,16.76
9858132,9987763,4860,1701000,11688763,17.03
9858133,9982753,4897,1713950,11696703,17.17
9858134,9982152,2213,774550,10756702,7.76
9858135,9974689,3386,1185100,11159789,11.88
9858136,9983644,2125,743750,10727394,7.45
9858137,4859602,3356,1174600,6034202,24.17
9858139,9974135,4624,1618400,11592535,16.23
9858140,1852924,218,76300,1929224,4.12
9858141,9956189,5363,1877050,11833239,18.85
9858142,9982113,3726,1304100,11286213,13.06
9858143,9938923,5744,2010400,11949323,20.23
9858144,9995094,1796,628600,10623694,6.29
9858145,9981638,3732,1306200,11287838,13.09
9858146,9976345,4724,1653400,11629745,16.57
9858147,9975949,5493,1922550,11898499,19.27
9858148,8209100,3314,1159900,9369000,14.13
9858149,8523079,4118,1441300,9964379,16.91
9858150,9967635,6069,2124150,12091785,21.31
9858151,9978519,4390,1536500,11515019,15.40
9858152,9987434,5708,1997800,11985234,20.00
9858153,9984088,6319,2211650,12195738,22.15
9858154,2874760,1412,494200,3368960,17.19
9858155,9973657,3922,1372700,11346357,13.76
9858156,9990945,2614,914900,10905845,9.16
9858157,9997332,4511,1578850,11576182,15.79
9858158,9980359,6025,2108750,12089109,21.13
9858159,9981108,7166,2508100,12489208,25.13
9858160,9990857,5049,1767150,11758007,17.69
9858161,5712389,2248,786800,6499189,13.77
9858162,9973112,4101,1435350,11408462,14.39
9858163,7666418,3514,1229900,8896318,16.04
9858164,4645232,2207,772450,5417682,16.63
9858165,9942695,4684,1639400,11582095,16.49
9858167,9962877,2997,1048950,11011827,10.53
9858168,9969656,3496,1223600,11193256,12.27
9858169,9979020,4511,1578850,11557870,15.82
9858170,9980795,6277,2196950,12177745,22.01
9858171,9978944,4343,1520050,11498994,15.23
9858172,6379159,3485,1219750,7598909,19.12
9858173,9970976,2374,830900,10801876,8.33
9858174,9974395,4074,1425900,11400295,14.30
9858175,9938102,4061,1421350,11359452,14.30
9858176,9966755,3498,1224300,11191055,12.28
9858177,9942608,3528,1234800,11177408,12.42
9858178,9968689,6321,2212350,12181039,22.19
9858179,9972246,3647,1276450,11248696,12.80
9858180,9947607,2773,970550,10918157,9.76
9858181,9970409,6161,2156350,12126759,21.63
9858182,2051492,242,84700,2136192,4.13
9858183,9985209,3825,1338750,11323959,13.41
9858184,1462559,1031,360850,1823409,24.67
9858185,9952939,3086,1080100,11033039,10.85
9858186,9952101,2428,849800,10801901,8.54
9858187,9961489,4607,1612450,11573939,16.19
9858188,9966571,2409,843150,10809721,8.46
9858189,9933790,5439,1903650,11837440,19.16
9858190,9970028,5305,1856750,11826778,18.62
9858191,9983082,3642,1274700,11257782,12.77
9858192,5478924,3054,1068900,6547824,19.51
9858193,9985826,3847,1346450,11332276,13.48
9858194,2571614,1382,483700,3055314,18.81
9858195,9967316,3469,1214150,11181466,12.18
9858196,1993524,1230,430500,2424024,21.59
9858197,9948939,4907,1717450,11666389,17.26
9858198,9935951,4776,1671600,11607551,16.82
9858199,9924535,3995,1398250,11322785,14.09
9858200,3410948,1512,529200,3940148,15.51
9858201,9945834,4390,1536500,11482334,15.45
9858202,1218536,728,254800,1473336,20.91
9858203,9929138,4467,1563450,11492588,15.75
9858204,9943366,2540,889000,10832366,8.94
9858205,9940584,3054,1068900,11009484,10.75
9858206,9912668,3933,1376550,11289218,13.89
9858207,4391846,1693,592550,4984396,13.49
9858208,9051270,3960,1386000,10437270,15.31
9858209,9937748,5249,1837150,11774898,18.49
9858210,2182537,363,127050,2309587,5.82
9858211,9924892,5063,1772050,11696942,17.85
9858212,9920187,3972,1390200,11310387,14.01
9858213,9929843,2197,768950,10698793,7.74
9858214,1999313,1468,513800,2513113,25.70
9858215,9927132,5743,2010050,11937182,20.25
9858216,9741115,3892,1362200,11103315,13.98
9858217,3589553,1202,420700,4010253,11.72
9858218,9936057,2326,814100,10750157,8.19
9858219,9941886,3649,1277150,11219036,12.85
9858220,9935464,4010,1403500,11338964,14.13
9858221,1670668,388,135800,1806468,8.13
9858222,9931835,3020,1057000,10988835,10.64
9858223,9926885,4908,1717800,11644685,17.30
9858224,9932505,4211,1473850,11406355,14.84
9858225,3728916,1242,434700,4163616,11.66
9858226,9916218,3340,1169000,11085218,11.79
9858227,9803872,3488,1220800,11024672,12.45
9858228,9905541,1284,449400,10354941,4.54
9858229,519602,270,94500,614102,18.19
9858230,9890034,6645,2325750,12215784,23.52
9858231,9933743,1715,600250,10533993,6.04
9858232,9930338,3914,1369900,11300238,13.80
9858233,9929250,898,314300,10243550,3.17
9858234,9941355,496,173600,10114955,1.75
9858235,9956719,2202,770700,10727419,7.74
9858236,1492255,792,277200,1769455,18.58
9858237,9960062,4294,1502900,11462962,15.09
9858238,9941741,4484,1569400,11511141,15.79
9858239,9957941,3253,1138550,11096491,11.43
9858240,9972005,2674,935900,10907905,9.39
9858241,9970832,4283,1499050,11469882,15.03
9858242,9994923,4403,1541050,11535973,15.42
9858243,9973975,3368,1178800,11152775,11.82
9858244,9976181,2536,887600,10863781,8.90
9858247,673892,336,117600,791492,17.45
9858248,9953982,4213,1474550,11428532,14.81
9858249,9967552,4075,1426250,11393802,14.31
9858250,9967446,5079,1777650,11745096,17.83
9858251,9976719,6113,2139550,12116269,21.45
9858252,8521659,537,187950,8709609,2.21
9858253,9241505,2558,895300,10136805,9.69
9858254,7380520,2858,1000300,8380820,13.55
9858255,1134788,231,80850,1215638,7.12
9858256,9979742,3731,1305850,11285592,13.09
9858257,9646089,3389,1186150,10832239,12.30
9858258,9899715,3321,1162350,11062065,11.74
9858259,9967205,3689,1291150,11258355,12.95
9858260,9962334,4167,1458450,11420784,14.64
9858261,901943,276,96600,998543,10.71
9858262,9950987,5415,1895250,11846237,19.05
9858264,9974398,5118,1791300,11765698,17.96
9858265,4003228,2893,1012550,5015778,25.29
9858266,9988733,2914,1019900,11008633,10.21
9858267,612013,436,152600,764613,24.93
9858269,9886866,3677,1286950,11173816,13.02
9858270,9992408,5768,2018800,12011208,20.20
9858271,9964768,2369,829150,10793918,8.32
9858272,9961096,3967,1388450,11349546,13.94
9858273,9974649,4996,1748600,11723249,17.53
9858274,9951289,2501,875350,10826639,8.80
9858275,9968154,3114,1089900,11058054,10.93
9858276,9970286,4824,1688400,11658686,16.93
9858277,9975271,4015,1405250,11380521,14.09
9858278,9985900,2508,877800,10863700,8.79
9858279,9987936,3270,1144500,11132436,11.46
9858280,9984626,2891,1011850,10996476,10.13
9858281,9974528,4367,1528450,11502978,15.32
9858282,9997411,3044,1065400,11062811,10.66
9858283,9974992,2654,928900,10903892,9.31
9858284,9991456,1216,425600,10417056,4.26
9858285,9987542,2842,994700,10982242,9.96
9858286,9991316,1246,436100,10427416,4.36
9858287,9983804,4126,1444100,11427904,14.46
9858288,5680136,1810,633500,6313636,11.15
9858289,828769,278,97300,926069,11.74
9858290,9983790,6156,2154600,12138390,21.58
9858291,9981849,1959,685650,10667499,6.87
9858292,2877952,1759,615650,3493602,21.39
9858293,9982662,4944,1730400,11713062,17.33
9858294,6296822,906,317100,6613922,5.04
9858295,8971422,4852,1698200,10669622,18.93
9858296,9961875,3326,1164100,11125975,11.69
9858297,9977084,3668,1283800,11260884,12.87
9858298,9980278,1593,557550,10537828,5.59
9858299,2531721,839,293650,2825371,11.60
9858300,9993633,5100,1785000,11778633,17.86
9858301,252225,128,44800,297025,17.76
9858302,9978643,2967,1038450,11017093,10.41
9858303,9966374,3543,1240050,11206424,12.44
9858304,9961188,4249,1487150,11448338,14.93
9858305,9973261,1291,451850,10425111,4.53
9858306,9965048,3349,1172150,11137198,11.76
9858307,9994125,4146,1451100,11445225,14.52
9858308,9982024,857,299950,10281974,3.00
9858309,9991414,3216,1125600,11117014,11.27
9858310,9997613,3569,1249150,11246763,12.49
9858311,9987959,3944,1380400,11368359,13.82
9858312,9975710,3708,1297800,11273510,13.01
9858313,1193077,722,252700,1445777,21.18
9858314,9982005,5439,1903650,11885655,19.07
9858315,9986523,2571,899850,10886373,9.01
9858316,9991556,5269,1844150,11835706,18.46
9858317,9970903,3048,1066800,11037703,10.70
9858318,9998710,4404,1541400,11540110,15.42
9858319,9973366,4890,1711500,11684866,17.16
9858320,289273,135,47250,336523,16.33
9858321,9962820,1515,530250,10493070,5.32
9858322,9972222,4496,1573600,11545822,15.78
9858323,9981889,6707,2347450,12329339,23.52
9858325,9967339,3135,1097250,11064589,11.01
9858326,9880730,4781,1673350,11554080,16.94
9858327,4054671,5684,1989400,6044071,49.06
9858328,9988415,2957,1034950,11023365,10.36
9858329,9987518,5945,2080750,12068268,20.83
9858330,9986956,3791,1326850,11313806,13.29
9858331,9972853,4138,1448300,11421153,14.52
9858332,3818969,2976,1041600,4860569,27.27
9858333,9990828,4889,1711150,11701978,17.13
9858334,9991397,4631,1620850,11612247,16.22
9858335,9983241,4394,1537900,11521141,15.40
9858336,9979950,5246,1836100,11816050,18.40
9858337,9987382,2637,922950,10910332,9.24
9858338,9990720,4063,1422050,11412770,14.23
9858339,9985390,4349,1522150,11507540,15.24
9858340,9988554,4953,1733550,11722104,17.36
9858341,9980694,1597,558950,10539644,5.60
9858342,8901447,4188,1465800,10367247,16.47
9858343,3653125,1138,398300,4051425,10.90
9858344,9980323,5908,2067800,12048123,20.72
9858345,9988613,3957,1384950,11373563,13.87
9858346,9997670,4058,1420300,11417970,14.21
9858347,9996026,1608,562800,10558826,5.63
9858348,967804,588,205800,1173604,21.26
9858349,9978008,5912,2069200,12047208,20.74
9858350,9970696,970,339500,10310196,3.40
9858351,9994826,6248,2186800,12181626,21.88
9858352,9983976,3364,1177400,11161376,11.79
9858353,9985346,3578,1252300,11237646,12.54
9858354,9974280,6073,2125550,12099830,21.31
9858355,9749273,5093,1782550,11531823,18.28
9858356,9913568,3785,1324750,11238318,13.36
9858357,2363424,1121,392350,2755774,16.60
9858358,9967090,1762,616700,10583790,6.19
9858359,9975491,3115,1090250,11065741,10.93
9858360,9968115,4460,1561000,11529115,15.66
9858361,9968211,4597,1608950,11577161,16.14
9858362,9965414,2881,1008350,10973764,10.12
9858363,9979490,5038,1763300,11742790,17.67
9858364,9988611,5363,1877050,11865661,18.79
9858365,7832243,1975,691250,8523493,8.83
9858366,9965978,2567,898450,10864428,9.02
9858367,9955805,4132,1446200,11402005,14.53
9858368,9974983,601,210350,10185333,2.11
9858369,9985256,3997,1398950,11384206,14.01
9858370,9986849,4904,1716400,11703249,17.19
9858372,1656029,885,309750,1965779,18.70
9858373,9984752,4797,1678950,11663702,16.82
9858374,264087,296,103600,367687,39.23
9858375,9986662,3827,1339450,11326112,13.41
9858376,4965533,2511,878850,5844383,17.70
9858377,9991119,3156,1104600,11095719,11.06
9858378,643925,368,128800,772725,20.00
9858379,9925165,5228,1829800,11754965,18.44
9858380,9978229,3616,1265600,11243829,12.68
9858381,9961600,2754,963900,10925500,9.68
9858382,9952068,2729,955150,10907218,9.60
9858383,9942710,5041,1764350,11707060,17.75
9858384,9952560,4933,1726550,11679110,17.35
9858385,2258503,2002,700700,2959203,31.02
9858386,1147855,522,182700,1330555,15.92
9858387,9986481,2190,766500,10752981,7.68
9858388,9995962,3497,1223950,11219912,12.24
9858389,9979934,4995,1748250,11728184,17.52
9858390,9981514,4560,1596000,11577514,15.99
9858391,9918394,7431,2600850,12519244,26.22
9858392,9500133,5459,1910650,11410783,20.11
9858393,9419404,5078,1777300,11196704,18.87
9858394,9981048,3260,1141000,11122048,11.43
9858395,9970104,1842,644700,10614804,6.47
9858396,9962199,3211,1123850,11086049,11.28
9858397,9988448,2937,1027950,11016398,10.29
9858398,1786168,1677,586950,2373118,32.86
9858399,9961978,3396,1188600,11150578,11.93
9858400,9980974,3022,1057700,11038674,10.60
9858401,6405675,4942,1729700,8135375,27.00
9858402,9948372,3717,1300950,11249322,13.08
9858403,3241041,1541,539350,3780391,16.64
9858404,1830670,1618,566300,2396970,30.93
9858405,9953302,4050,1417500,11370802,14.24
9858406,9966083,3297,1153950,11120033,11.58
9858407,9959155,5244,1835400,11794555,18.43
9858408,9982563,5103,1786050,11768613,17.89
9858409,9981900,4706,1647100,11629000,16.50
9858410,9981939,3027,1059450,11041389,10.61
9858411,9914069,4962,1736700,11650769,17.52
9858412,9989062,1593,557550,10546612,5.58
9858413,2298173,642,224700,2522873,9.78
9858414,9959566,4200,1470000,11429566,14.76
9858415,9979956,2658,930300,10910256,9.32
9858416,9987213,734,256900,10244113,2.57
9858417,9990030,1702,595700,10585730,5.96
9858418,4566212,2560,896000,5462212,19.62
9858419,2632062,1369,479150,3111212,18.20
9858420,9971074,6505,2276750,12247824,22.83
9858421,9966289,5014,1754900,11721189,17.61
9858422,9972324,2815,985250,10957574,9.88
9858423,9979244,941,329350,10308594,3.30
9858424,2984313,2010,703500,3687813,23.57
9858426,9987298,3739,1308650,11295948,13.10
9858427,689120,408,142800,831920,20.72
9858428,9977164,2550,892500,10869664,8.95
9858429,9971457,1070,374500,10345957,3.76
9858430,9980978,3537,1237950,11218928,12.40
9858431,9990955,7194,2517900,12508855,25.20
9858432,9990686,2996,1048600,11039286,10.50
9858433,9995903,789,276150,10272053,2.76
9858434,9984465,5423,1898050,11882515,19.01
9858435,9974000,3028,1059800,11033800,10.63
9858436,9965762,2240,784000,10749762,7.87
9858437,9968459,6173,2160550,12129009,21.67
9858438,9972898,4208,1472800,11445698,14.77
9858439,9982927,2686,940100,10923027,9.42
9858440,9968379,1242,434700,10403079,4.36
9858441,9978097,3864,1352400,11330497,13.55
9858442,9965254,2446,856100,10821354,8.59
9858443,9707079,5540,1939000,11646079,19.98
9858444,9945528,3926,1374100,11319628,13.82
9858445,4247079,1631,570850,4817929,13.44
9858446,9919603,2503,876050,10795653,8.83
9858447,9941705,2273,795550,10737255,8.00
9858448,9940739,3544,1240400,11181139,12.48
9858449,9942048,5265,1842750,11784798,18.53
9858450,9932151,4607,1612450,11544601,16.23
9858451,9939564,3242,1134700,11074264,11.42
9858452,9966617,2951,1032850,10999467,10.36
9858453,9954645,2785,974750,10929395,9.79
9858454,9930917,4308,1507800,11438717,15.18
9858455,9928751,5271,1844850,11773601,18.58
9858456,9226292,3556,1244600,10470892,13.49
9858457,9913616,4717,1650950,11564566,16.65
9858458,9918865,4294,1502900,11421765,15.15
9858459,9924282,4641,1624350,11548632,16.37
9858460,9924503,5033,1761550,11686053,17.75
9858461,1609496,749,262150,1871646,16.29
9858462,9931113,6656,2329600,12260713,23.46
9858463,9950674,6009,2103150,12053824,21.14
9858464,9247571,5803,2031050,11278621,21.96
9858465,9946386,6333,2216550,12162936,22.28
9858466,9933143,4964,1737400,11670543,17.49
9858467,9939644,4735,1657250,11596894,16.67
9858468,993298,273,95550,1088848,9.62
9858469,3702507,999,349650,4052157,9.44
9858470,9934302,5407,1892450,11826752,19.05
9858471,9934310,8332,2916200,12850510,29.35
9858472,9938964,3183,1114050,11053014,11.21
9858473,9932007,5736,2007600,11939607,20.21
9858474,7618862,2421,847350,8466212,11.12
9858475,9937452,3556,1244600,11182052,12.52
9858476,9938908,3503,1226050,11164958,12.34
9858477,9957138,5780,2023000,11980138,20.32
9858478,9928958,6396,2238600,12167558,22.55
9858479,9949438,5972,2090200,12039638,21.01
9858480,3559003,1901,665350,4224353,18.69
9858481,9961218,4469,1564150,11525368,15.70
9858482,9960691,5516,1930600,11891291,19.38
9858483,8225963,1878,657300,8883263,7.99
9858484,9990151,5578,1952300,11942451,19.54
9858485,9982918,3584,1254400,11237318,12.57
9858486,9987965,2789,976150,10964115,9.77
9858487,9985876,3935,1377250,11363126,13.79
9858488,9981220,5575,1951250,11932470,19.55
9858489,9988526,4421,1547350,11535876,15.49
9858490,9996815,4670,1634500,11631315,16.35
9858491,9979132,2859,1000650,10979782,10.03
9858492,9982539,4151,1452850,11435389,14.55
9858493,9720890,5052,1768200,11489090,18.19
9858494,6415894,658,230300,6646194,3.59
9858495,1117171,705,246750,1363921,22.09
9858496,1346780,717,250950,1597730,18.63
9858497,9854757,3642,1274700,11129457,12.93
9858498,9968325,1510,528500,10496825,5.30
9858499,7806923,3703,1296050,9102973,16.60
9858500,9967161,4732,1656200,11623361,16.62
9858501,9965411,5500,1925000,11890411,19.32
9858502,9970720,4757,1664950,11635670,16.70
9858503,9928919,4542,1589700,11518619,16.01
9858504,9960670,5367,1878450,11839120,18.86
9858505,9982696,4067,1423450,11406146,14.26
9858506,9979746,3914,1369900,11349646,13.73
9858507,9973819,5748,2011800,11985619,20.17
9858508,9977935,2446,856100,10834035,8.58
9858509,106390,127,44450,150840,41.78
9858510,9971152,3806,1332100,11303252,13.36
9858511,9980955,7012,2454200,12435155,24.59
9858512,9966779,4061,1421350,11388129,14.26
9858514,9960358,2972,1040200,11000558,10.44
9858515,4073406,3155,1104250,5177656,27.11
9858516,9969208,2764,967400,10936608,9.70
9858517,9967706,3161,1106350,11074056,11.10
9858518,9991369,4401,1540350,11531719,15.42
9858519,9977773,4443,1555050,11532823,15.59
9858520,8898005,1943,680050,9578055,7.64
9858521,9975921,3284,1149400,11125321,11.52
9858522,9958446,4263,1492050,11450496,14.98
9858523,9476321,5766,2018100,11494421,21.30
9858524,9487495,3170,1109500,10596995,11.69
9858525,9967302,1748,611800,10579102,6.14
9858526,9975121,4012,1404200,11379321,14.08
9858527,9982301,5898,2064300,12046601,20.68
9858528,807209,312,109200,916409,13.53
9858529,8769247,3899,1364650,10133897,15.56
9858530,9960532,5081,1778350,11738882,17.85
9858531,3929665,1300,455000,4384665,11.58
9858532,9949538,4072,1425200,11374738,14.32
9858533,9945090,4855,1699250,11644340,17.09
9858535,9969372,3537,1237950,11207322,12.42
9858537,4269092,1013,354550,4623642,8.31
9858538,9952828,3159,1105650,11058478,11.11
9858539,9954698,2905,1016750,10971448,10.21
9858540,9942913,4946,1731100,11674013,17.41
9858541,9960747,5154,1803900,11764647,18.11
9858542,9958545,2534,886900,10845445,8.91
9858543,9963621,2550,892500,10856121,8.96
9858544,9945023,5814,2034900,11979923,20.46
9858545,9961746,4692,1642200,11603946,16.49
9858546,9961514,4037,1412950,11374464,14.18
9858547,9962636,5062,1771700,11734336,17.78
9858548,9973721,4712,1649200,11622921,16.54
9858549,2066252,720,252000,2318252,12.20
9858550,9980028,4651,1627850,11607878,16.31
9858551,8604544,3840,1344000,9948544,15.62
9858552,9976044,5797,2028950,12004994,20.34
9858553,9978775,5742,2009700,11988475,20.14
9858554,9994849,4994,1747900,11742749,17.49
9858555,9994934,3594,1257900,11252834,12.59
9858556,9982776,6788,2375800,12358576,23.80
9858557,9977849,5685,1989750,11967599,19.94
9858558,9978483,3623,1268050,11246533,12.71
9858559,9974294,4342,1519700,11493994,15.24
9858560,9992880,5462,1911700,11904580,19.13
9858561,6128818,5536,1937600,8066418,31.61
9858562,9974980,5354,1873900,11848880,18.79
9858563,9993165,3619,1266650,11259815,12.68
9858564,9983516,4307,1507450,11490966,15.10
9858565,9988458,4509,1578150,11566608,15.80
9858566,9999867,3529,1235150,11235017,12.35
9858567,9986911,2723,953050,10939961,9.54
9858568,6512914,4911,1718850,8231764,26.39
9858569,9302959,4777,1671950,10974909,17.97
9858570,9979683,5257,1839950,11819633,18.44
9858571,9986617,3151,1102850,11089467,11.04
9858572,9979996,4968,1738800,11718796,17.42
9858573,9981575,3555,1244250,11225825,12.47
9858574,9989680,1607,562450,10552130,5.63
9858575,9981250,4495,1573250,11554500,15.76
9858576,9988705,5309,1858150,11846855,18.60
9858577,9981109,4740,1659000,11640109,16.62
9858578,9982671,5290,1851500,11834171,18.55
9858579,9984917,4593,1607550,11592467,16.10
9858580,9998330,2481,868350,10866680,8.68
9858581,9974406,4444,1555400,11529806,15.59
9858582,9976069,6328,2214800,12190869,22.20
9858583,9982619,6533,2286550,12269169,22.91
9858584,9981382,4339,1518650,11500032,15.21
9858585,9994398,4446,1556100,11550498,15.57
9858586,8664025,4141,1449350,10113375,16.73
9858587,9968464,1209,423150,10391614,4.24
9858588,9984773,2608,912800,10897573,9.14
9858589,9999523,3371,1179850,11179373,11.80
9858590,9984898,5731,2005850,11990748,20.09
9858591,2706516,641,224350,2930866,8.29
9858592,9994774,4254,1488900,11483674,14.90
9858593,9864285,2543,890050,10754335,9.02
9858594,9948412,2605,911750,10860162,9.16
9858595,9989788,4699,1644650,11634438,16.46
9858596,9974048,4067,1423450,11397498,14.27
9858597,9832889,3485,1219750,11052639,12.40
9858598,9996364,2298,804300,10800664,8.05
9858599,9983790,1252,438200,10421990,4.39
9858600,9993027,4788,1675800,11668827,16.77
9858601,9990326,3221,1127350,11117676,11.28
9858602,9990504,3326,1164100,11154604,11.65
9858603,9974998,5346,1871100,11846098,18.76
9858604,544389,239,83650,628039,15.37
9858605,9952132,1620,567000,10519132,5.70
9858606,9949894,2323,813050,10762944,8.17
9858607,9954871,1306,457100,10411971,4.59
9858608,9964946,3488,1220800,11185746,12.25
9858609,9972122,3632,1271200,11243322,12.75
9858610,9986689,2625,918750,10905439,9.20
9858611,9980138,5046,1766100,11746238,17.70
9858612,9986544,2034,711900,10698444,7.13
9858613,2393844,2078,727300,3121144,30.38
9858614,9969395,4172,1460200,11429595,14.65
9858615,9984161,2196,768600,10752761,7.70
9858616,9982909,5872,2055200,12038109,20.59
9858617,9975309,3364,1177400,11152709,11.80
9858618,9988137,4208,1472800,11460937,14.75
9858619,9978645,5264,1842400,11821045,18.46
9858620,9995076,4782,1673700,11668776,16.75
9858621,9994206,5444,1905400,11899606,19.07
9858622,9975851,3034,1061900,11037751,10.64
9858623,9985829,4381,1533350,11519179,15.36
9858624,9982477,4090,1431500,11413977,14.34
9858625,9963141,3196,1118600,11081741,11.23
9858626,9972616,2959,1035650,11008266,10.38
9858627,9727631,2490,871500,10599131,8.96
9858628,9969525,5895,2063250,12032775,20.70
9858629,9981481,1870,654500,10635981,6.56
9858630,9989415,3511,1228850,11218265,12.30
9858631,885572,463,162050,1047622,18.30
9858632,9963781,3538,1238300,11202081,12.43
9858633,9981656,4546,1591100,11572756,15.94
9858634,9982481,2912,1019200,11001681,10.21
9858635,9982741,4237,1482950,11465691,14.86
9858636,9689813,1745,610750,10300563,6.30
9858637,9953544,3515,1230250,11183794,12.36
9858638,9959521,3763,1317050,11276571,13.22
9858639,9876060,3776,1321600,11197660,13.38
9858640,9962193,4293,1502550,11464743,15.08
9858641,9971607,4954,1733900,11705507,17.39
9858642,9976579,4960,1736000,11712579,17.40
9858643,9957468,3995,1398250,11355718,14.04
9858644,7581705,2704,946400,8528105,12.48
9858645,9974774,5576,1951600,11926374,19.57
9858646,9957262,2715,950250,10907512,9.54
9858647,9969611,5084,1779400,11749011,17.85
9858648,9969828,5712,1999200,11969028,20.05
9858649,9974806,5398,1889300,11864106,18.94
9858650,9958028,6527,2284450,12242478,22.94
9858651,9956029,2619,916650,10872679,9.21
9858652,9969338,4741,1659350,11628688,16.64
9858653,9962345,4131,1445850,11408195,14.51
9858654,9963306,5561,1946350,11909656,19.54
9858655,9952367,6109,2138150,12090517,21.48
9858656,9970362,4830,1690500,11660862,16.96
9858657,9951634,2056,719600,10671234,7.23
9858658,9966547,6609,2313150,12279697,23.21
9858659,9970005,5554,1943900,11913905,19.50
9858660,9952916,1644,575400,10528316,5.78
9858661,9962328,5760,2016000,11978328,20.24
9858662,9964898,5115,1790250,11755148,17.97
9858663,9977968,3461,1211350,11189318,12.14
9858665,9981989,4658,1630300,11612289,16.33
9858666,9975654,3051,1067850,11043504,10.70
9858667,9971602,7234,2531900,12503502,25.39
9858668,1244637,370,129500,1374137,10.40
9858669,9983502,5339,1868650,11852152,18.72
9858670,1169175,482,168700,1337875,14.43
9858671,3456080,2514,879900,4335980,25.46
9858672,9996955,4127,1444450,11441405,14.45
9858673,9994764,5380,1883000,11877764,18.84
9858674,7349511,3314,1159900,8509411,15.78
9858675,9962100,3797,1328950,11291050,13.34
9858676,9964420,6610,2313500,12277920,23.22
9858677,9969831,4114,1439900,11409731,14.44
9858678,9971175,5341,1869350,11840525,18.75
9858679,9964974,4644,1625400,11590374,16.31
9858680,1036578,629,220150,1256728,21.24
9858681,9980287,4205,1471750,11452037,14.75
9858682,9988875,3485,1219750,11208625,12.21
9858683,9982580,4596,1608600,11591180,16.11
9858684,832028,771,269850,1101878,32.43
9858685,9982738,6444,2255400,12238138,22.59
9858686,9984099,5124,1793400,11777499,17.96
9858687,9973929,4193,1467550,11441479,14.71
9858688,9973712,5341,1869350,11843062,18.74
9858689,2136734,1213,424550,2561284,19.87
9858690,9977464,3682,1288700,11266164,12.92
9858691,9988919,4182,1463700,11452619,14.65
9858692,9983443,5328,1864800,11848243,18.68
9858693,635566,555,194250,829816,30.56
9858694,9965938,4713,1649550,11615488,16.55
9858695,9797896,4053,1418550,11216446,14.48
9858696,9961507,3563,1247050,11208557,12.52
9858697,9971664,6779,2372650,12344314,23.79
9858698,9985886,7224,2528400,12514286,25.32
9858699,1550628,1272,445200,1995828,28.71
9858700,2079692,1425,498750,2578442,23.98
9858701,1083553,481,168350,1251903,15.54
9858702,9973759,4000,1400000,11373759,14.04
9858703,9856114,4991,1746850,11602964,17.72
9858704,9968054,7213,2524550,12492604,25.33
9858705,9860597,4673,1635550,11496147,16.59
9858706,9978465,6847,2396450,12374915,24.02
9858707,9427209,2358,825300,10252509,8.75
9858708,9994288,3122,1092700,11086988,10.93
9858709,9998222,5338,1868300,11866522,18.69
9858710,805531,1000,350000,1155531,43.45
9858711,9976705,5905,2066750,12043455,20.72
9858712,9968831,4187,1465450,11434281,14.70
9858713,9992718,3929,1375150,11367868,13.76
9858714,9996416,3841,1344350,11340766,13.45
9858715,9977168,3349,1172150,11149318,11.75
9858716,9997359,5958,2085300,12082659,20.86
9858717,9992831,864,302400,10295231,3.03
9858718,9974159,3776,1321600,11295759,13.25
9858719,9950529,5080,1778000,11728529,17.87
9858720,9982438,6341,2219350,12201788,22.23
9858721,9992894,3701,1295350,11288244,12.96
9858722,9296151,4985,1744750,11040901,18.77
9858723,9980703,4398,1539300,11520003,15.42
9858724,9997424,3231,1130850,11128274,11.31
9858725,9975063,2626,919100,10894163,9.21
9858727,9995581,6455,2259250,12254831,22.60
9858728,1586824,980,343000,1929824,21.62
9858729,1738500,694,242900,1981400,13.97
9858730,8336733,2871,1004850,9341583,12.05
9858731,9972262,5288,1850800,11823062,18.56
9858732,9969675,6168,2158800,12128475,21.65
9858733,8169628,2689,941150,9110778,11.52
9858734,6141477,2167,758450,6899927,12.35
9858735,9982800,3844,1345400,11328200,13.48
9858736,9990925,4311,1508850,11499775,15.10
9858737,9973731,4654,1628900,11602631,16.33
9858738,9981703,2983,1044050,11025753,10.46
9858739,9991794,5380,1883000,11874794,18.85
9858740,9970728,2303,806050,10776778,8.08
9858741,9989785,5076,1776600,11766385,17.78
9858742,9997440,3990,1396500,11393940,13.97
9858743,9973708,4234,1481900,11455608,14.86
9858744,9926088,5575,1951250,11877338,19.66
9858745,9987467,4013,1404550,11392017,14.06
9858747,1684273,639,223650,1907923,13.28
9858748,9982547,3541,1239350,11221897,12.42
9858749,9965307,4064,1422400,11387707,14.27
9858750,9961626,4511,1578850,11540476,15.85
9858751,9964815,4459,1560650,11525465,15.66
9858752,9977080,3742,1309700,11286780,13.13
9858753,3881300,2054,718900,4600200,18.52
9858754,9978695,6247,2186450,12165145,21.91
9858755,6879792,3081,1078350,7958142,15.67
9858756,1440858,748,261800,1702658,18.17
9858757,9981823,2753,963550,10945373,9.65
9858758,9967626,3437,1202950,11170576,12.07
9858759,9975689,4631,1620850,11596539,16.25
9858760,9972303,4489,1571150,11543453,15.76
9858761,9990988,7738,2708300,12699288,27.11
9858762,9208109,4114,1439900,10648009,15.64
9858763,1666993,876,306600,1973593,18.39
9858764,9999740,5563,1947050,11946790,19.47
9858765,9987327,4154,1453900,11441227,14.56
9858766,9993433,4467,1563450,11556883,15.64
9858768,9997686,3565,1247750,11245436,12.48
9858769,9987730,2790,976500,10964230,9.78
9858770,9883881,2824,988400,10872281,10.00
9858771,3434574,665,232750,3667324,6.78
9858772,9980007,4636,1622600,11602607,16.26
9858773,9974326,4720,1652000,11626326,16.56
9858774,8984068,2864,1002400,9986468,11.16
9858775,9977893,4011,1403850,11381743,14.07
9858776,9979508,5225,1828750,11808258,18.33
9858777,9982830,6684,2339400,12322230,23.43
9858778,9975390,5222,1827700,11803090,18.32
9858779,9974457,7159,2505650,12480107,25.12
9858780,9971399,5538,1938300,11909699,19.44
9858781,9987090,5208,1822800,11809890,18.25
9858782,9978987,6190,2166500,12145487,21.71
9858783,9971354,6424,2248400,12219754,22.55
9858784,9994841,2789,976150,10970991,9.77
9858785,9981357,1931,675850,10657207,6.77
9858786,9976196,5020,1757000,11733196,17.61
9858787,9993050,2400,840000,10833050,8.41
9858788,4165702,475,166250,4331952,3.99
9858789,9958435,5201,1820350,11778785,18.28
9858790,8989882,4989,1746150,10736032,19.42
9858791,9979484,4416,1545600,11525084,15.49
9858792,9990786,2085,729750,10720536,7.30
9858793,9994572,4411,1543850,11538422,15.45
9858794,9991189,7720,2702000,12693189,27.04
9858795,9969303,2586,905100,10874403,9.08
9858796,9928114,3797,1328950,11257064,13.39
9858797,9968242,4780,1673000,11641242,16.78
9858798,9957873,7608,2662800,12620673,26.74
9858799,9977317,5053,1768550,11745867,17.73
9858800,2894658,238,83300,2977958,2.88
9858801,1834363,976,341600,2175963,18.62
9858802,9953795,4542,1589700,11543495,15.97
9858803,9945049,2140,749000,10694049,7.53
9858804,9956985,6677,2336950,12293935,23.47
9858805,9965895,2872,1005200,10971095,10.09
9858807,9960085,5290,1851500,11811585,18.59
9858808,9965995,1761,616350,10582345,6.18
9858809,7830929,4058,1420300,9251229,18.14
9858810,9947658,6075,2126250,12073908,21.37
9858811,9935939,2977,1041950,10977889,10.49
9858812,6641012,3522,1232700,7873712,18.56
9858813,9952208,3322,1162700,11114908,11.68
9858814,9940352,4155,1454250,11394602,14.63
9858815,9939475,3576,1251600,11191075,12.59
9858816,9944104,5277,1846950,11791054,18.57
9858817,9932304,3531,1235850,11168154,12.44
9858818,6475373,1569,549150,7024523,8.48
9858819,9933844,1956,684600,10618444,6.89
9858820,9936784,4358,1525300,11462084,15.35
9858821,9943497,4012,1404200,11347697,14.12
9858822,9961200,4282,1498700,11459900,15.05
9858823,9955998,5277,1846950,11802948,18.55
9858824,9968375,4501,1575350,11543725,15.80
9858825,155074,59,20650,175724,13.32
9858826,9970356,3216,1125600,11095956,11.29
9858827,9962863,4814,1684900,11647763,16.91
9858828,4789596,896,313600,5103196,6.55
9858829,9965101,1726,604100,10569201,6.06
9858830,8973139,4617,1615950,10589089,18.01
9858831,9977314,5305,1856750,11834064,18.61
9858832,9975300,5554,1943900,11919200,19.49
9858833,9991900,6411,2243850,12235750,22.46
9858834,9955933,3316,1160600,11116533,11.66
9858835,9979944,7457,2609950,12589894,26.15
9858836,9770437,4029,1410150,11180587,14.43
9858838,9966045,3594,1257900,11223945,12.62
9858839,9981170,4212,1474200,11455370,14.77
9858840,9979607,4586,1605100,11584707,16.08
9858841,9992586,7332,2566200,12558786,25.68
9858842,9994031,5338,1868300,11862331,18.69
9858843,9988754,2340,819000,10807754,8.20
9858844,1736160,231,80850,1817010,4.66
9858845,9978094,4860,1701000,11679094,17.05
9858846,9987163,6924,2423400,12410563,24.27
9858848,9999134,2115,740250,10739384,7.40
9858849,9970404,3018,1056300,11026704,10.59
9858850,9978298,2568,898800,10877098,9.01
9858851,9980482,5500,1925000,11905482,19.29
9858852,9975282,5515,1930250,11905532,19.35
9858853,9959417,3450,1207500,11166917,12.12
9858854,9964460,6605,2311750,12276210,23.20
9858855,9948816,6179,2162650,12111466,21.74
9858856,9974428,4705,1646750,11621178,16.51
9858857,9985292,4791,1676850,11662142,16.79
9858858,9987258,5501,1925350,11912608,19.28
9858859,9991601,3351,1172850,11164451,11.74
9858860,9971802,4010,1403500,11375302,14.07
9858861,9966329,6228,2179800,12146129,21.87
9858862,9972073,2827,989450,10961523,9.92
9858863,9983803,5999,2099650,12083453,21.03
9858865,9985735,7556,2644600,12630335,26.48
9858866,9995174,2480,868000,10863174,8.68
9858867,3050244,3905,1366750,4416994,44.81
9858868,8976941,3051,1067850,10044791,11.90
9858869,1624655,1469,514150,2138805,31.65
9858870,9984248,4389,1536150,11520398,15.39
9858871,9979921,3982,1393700,11373621,13.97
9858872,9994276,5045,1765750,11760026,17.67
9858873,9974483,4317,1510950,11485433,15.15
9858874,9987923,4168,1458800,11446723,14.61
9858875,9982643,5638,1973300,11955943,19.77
9858876,9989077,2670,934500,10923577,9.36
9858877,9987085,3795,1328250,11315335,13.30
9858878,8154489,2195,768250,8922739,9.42
9858879,9987214,2789,976150,10963364,9.77
9858880,1753151,1351,472850,2226001,26.97
9858881,9981773,4700,1645000,11626773,16.48
9858882,9996799,5265,1842750,11839549,18.43
9858883,661788,127,44450,706238,6.72
9858884,9990457,5816,2035600,12026057,20.38
9858885,9989853,4394,1537900,11527753,15.39
9858886,9977527,5178,1812300,11789827,18.16
9858887,9914927,4004,1401400,11316327,14.13
9858888,9984258,5217,1825950,11810208,18.29
9858889,9996512,4020,1407000,11403512,14.07
9858890,9985419,4799,1679650,11665069,16.82
9858891,6413415,293,102550,6515965,1.60
9858892,9976745,3953,1383550,11360295,13.87
9858893,9974100,4660,1631000,11605100,16.35
9858894,2663295,1340,469000,3132295,17.61
9858895,9972202,2908,1017800,10990002,10.21
9858896,9959433,6447,2256450,12215883,22.66
9858897,9959534,2908,1017800,10977334,10.22
9858899,9955530,4575,1601250,11556780,16.08
9858900,9934689,6612,2314200,12248889,23.29
9858901,9965356,4540,1589000,11554356,15.95
9858902,9957496,5671,1984850,11942346,19.93
9858903,9956214,2726,954100,10910314,9.58
9858904,9516577,5070,1774500,11291077,18.65
9858905,9993006,3490,1221500,11214506,12.22
9858906,9996943,5425,1898750,11895693,18.99
9858907,9983909,4305,1506750,11490659,15.09
9858908,9417317,3236,1132600,10549917,12.03
9858909,9978336,5319,1861650,11839986,18.66
9858910,9983832,2807,982450,10966282,9.84
9858911,9937308,3257,1139950,11077258,11.47
9858913,8752328,4463,1562050,10314378,17.85
9858914,9973790,2167,758450,10732240,7.60
9858915,9990337,6203,2171050,12161387,21.73
9858917,9970462,3373,1180550,11151012,11.84
9858918,9972130,2917,1020950,10993080,10.24
9858919,9968996,9393,3287550,13256546,32.98
9858920,9976570,1890,661500,10638070,6.63
9858921,9995426,4199,1469650,11465076,14.70
9858922,9975559,5351,1872850,11848409,18.77
9858923,9978923,2414,844900,10823823,8.47
9858924,9985191,3073,1075550,11060741,10.77
9858925,9987143,6735,2357250,12344393,23.60
9858926,9992793,2501,875350,10868143,8.76
9858927,9999215,3675,1286250,11285465,12.86
9858928,9984359,4529,1585150,11569509,15.88
9858929,9979260,2233,781550,10760810,7.83
9858930,9979516,1998,699300,10678816,7.01
9858931,3235354,754,263900,3499254,8.16
9858932,9967509,4897,1713950,11681459,17.20
9858933,9978732,3079,1077650,11056382,10.80
9858934,9987925,5857,2049950,12037875,20.52
9858935,9977959,2732,956200,10934159,9.58
9858936,2542784,152,53200,2595984,2.09
9858937,9986735,3360,1176000,11162735,11.78
9858938,9983715,3829,1340150,11323865,13.42
9858939,9973469,3215,1125250,11098719,11.28
9858940,9978620,4141,1449350,11427970,14.52
9858941,9997846,2638,923300,10921146,9.23
9858942,8727129,2095,733250,9460379,8.40
9858944,9981037,4271,1494850,11475887,14.98
9858945,9987159,4149,1452150,11439309,14.54
9858946,9989036,3251,1137850,11126886,11.39
9858947,9997107,3059,1070650,11067757,10.71
9858948,9988161,5055,1769250,11757411,17.71
9858949,9980927,4256,1489600,11470527,14.92
9858950,9840492,2616,915600,10756092,9.30
9858951,9972224,3808,1332800,11305024,13.37
9858952,9962539,4901,1715350,11677889,17.22
9858953,9969849,3601,1260350,11230199,12.64
9858954,9974931,5977,2091950,12066881,20.97
9858955,9964451,4206,1472100,11436551,14.77
9858956,9976543,4823,1688050,11664593,16.92
9858957,9976541,5699,1994650,11971191,19.99
9858958,9990643,1379,482650,10473293,4.83
9858959,9993920,4987,1745450,11739370,17.47
9858960,9985345,3749,1312150,11297495,13.14
9858961,9968995,4884,1709400,11678395,17.15
9858962,9944289,4307,1507450,11451739,15.16
9858963,9975347,4196,1468600,11443947,14.72
9858964,3491670,1378,482300,3973970,13.81
9858965,9980530,4073,1425550,11406080,14.28
9858966,9965764,4645,1625750,11591514,16.31
9858967,9977200,3039,1063650,11040850,10.66
9858968,9978140,4669,1634150,11612290,16.38
9858969,9973214,2274,795900,10769114,7.98
9858970,9984504,5191,1816850,11801354,18.20
9858971,9998462,2361,826350,10824812,8.26
9858972,437414,149,52150,489564,11.92
9858973,9978225,5395,1888250,11866475,18.92
9858974,9969376,4145,1450750,11420126,14.55
9858975,9980728,2508,877800,10858528,8.79
9858976,877768,52,18200,895968,2.07
9858977,9976558,5147,1801450,11778008,18.06
9858978,9984303,1574,550900,10535203,5.52
9858979,8628287,704,246400,8874687,2.86
9858980,9992863,6530,2285500,12278363,22.87
9858981,9975397,2637,922950,10898347,9.25
9858982,9969248,1702,595700,10564948,5.98
9858983,9971639,2866,1003100,10974739,10.06
9858984,8469162,3972,1390200,9859362,16.41
9858985,9950572,4109,1438150,11388722,14.45
9858986,9948835,4394,1537900,11486735,15.46
9858987,8097133,1516,530600,8627733,6.55
9858988,9470179,2163,757050,10227229,7.99
9858989,9940492,5603,1961050,11901542,19.73
9858990,9977303,7430,2600500,12577803,26.06
9858991,9977642,2857,999950,10977592,10.02
9858992,9980559,5542,1939700,11920259,19.43
9858993,9986570,3488,1220800,11207370,12.22
9858994,9984476,3162,1106700,11091176,11.08
9858995,9981459,2839,993650,10975109,9.95
9858996,2291571,2171,759850,3051421,33.16
9858997,574289,304,106400,680689,18.53
9858998,9955847,3130,1095500,11051347,11.00
9858999,7311979,2097,733950,8045929,10.04
9859000,9940913,6087,2130450,12071363,21.43
9859001,1870422,1364,477400,2347822,25.52
9859002,118430,42,14700,133130,12.41
9859003,9900584,3679,1287650,11188234,13.01
9859004,4389737,1679,587650,4977387,13.39
9859005,9930008,2169,759150,10689158,7.65
9859007,9943413,4273,1495550,11438963,15.04
9859008,9431046,5093,1782550,11213596,18.90
9859009,9951798,5691,1991850,11943648,20.01
9859010,9951897,3554,1243900,11195797,12.50
9859011,9965119,4806,1682100,11647219,16.88
9859012,9959401,3494,1222900,11182301,12.28
9859013,9981347,4462,1561700,11543047,15.65
9859014,9982372,3349,1172150,11154522,11.74
9859015,9987499,4571,1599850,11587349,16.02
9859016,9980605,3252,1138200,11118805,11.40
9859017,9974167,5195,1818250,11792417,18.23
9859018,9973095,5391,1886850,11859945,18.92
9859019,9996497,3873,1355550,11352047,13.56
9859020,9989320,2749,962150,10951470,9.63
9859021,9973043,4528,1584800,11557843,15.89
9859022,9986048,4457,1559950,11545998,15.62
9859023,9991799,6657,2329950,12321749,23.32
9859024,9990302,2476,866600,10856902,8.67
9859026,9965389,3808,1332800,11298189,13.37
9859027,873029,425,148750,1021779,17.04
9859028,9954269,3359,1175650,11129919,11.81
9859029,499653,418,146300,645953,29.28
9859030,9948927,3260,1141000,11089927,11.47
9859031,2880742,1238,433300,3314042,15.04
9859032,2291977,1058,370300,2662277,16.16
9859033,9956199,4631,1620850,11577049,16.28
9859034,9183063,4021,1407350,10590413,15.33
9859035,8978403,2166,758100,9736503,8.44
9859036,9953905,5550,1942500,11896405,19.51
9859037,797191,226,79100,876291,9.92
9859038,9962495,3418,1196300,11158795,12.01
9859039,9686797,2907,1017450,10704247,10.50
9859040,9966963,4317,1510950,11477913,15.16
9859041,9908117,4495,1573250,11481367,15.88
9859042,9954534,3527,1234450,11188984,12.40
9859043,9941759,1770,619500,10561259,6.23
9859044,9951025,3669,1284150,11235175,12.90
9859045,9961927,3954,1383900,11345827,13.89
9859046,9977982,4171,1459850,11437832,14.63
9859047,9967885,4721,1652350,11620235,16.58
9859048,616313,261,91350,707663,14.82
9859049,9963479,1719,601650,10565129,6.04
9859050,9977062,1848,646800,10623862,6.48
9859051,187793,144,50400,238193,26.84
9859052,9984857,3830,1340500,11325357,13.43
9859053,9987267,3322,1162700,11149967,11.64
9859054,9983492,5498,1924300,11907792,19.27
9859055,9986256,1328,464800,10451056,4.65
9859057,9982444,2799,979650,10962094,9.81
9859058,9990867,1254,438900,10429767,4.39
9859059,3470296,2912,1019200,4489496,29.37
9859060,9973603,3436,1202600,11176203,12.06
9859061,9988371,3584,1254400,11242771,12.56
9859062,1863925,304,106400,1970325,5.71
9859063,9995183,5739,2008650,12003833,20.10
9859064,3389981,197,68950,3458931,2.03
9859065,1806508,1461,511350,2317858,28.31
9859067,9970989,2738,958300,10929289,9.61
9859068,9978530,4930,1725500,11704030,17.29
9859069,9996422,3363,1177050,11173472,11.77
9859070,9979189,4983,1744050,11723239,17.48
9859071,9980397,1838,643300,10623697,6.45
9859072,1242393,137,47950,1290343,3.86
9859073,9977530,2830,990500,10968030,9.93
9859074,9989459,2400,840000,10829459,8.41
9859075,9978304,1360,476000,10454304,4.77
9859076,9969929,2605,911750,10881679,9.14
9859077,924478,800,280000,1204478,30.29
9859078,9964025,4091,1431850,11395875,14.37
9859079,9956564,4034,1411900,11368464,14.18
9859080,9959783,4279,1497650,11457433,15.04
9859081,6362469,2038,713300,7075769,11.21
9859082,9954198,4426,1549100,11503298,15.56
9859083,9956763,1951,682850,10639613,6.86
9859084,9971007,2562,896700,10867707,8.99
9859085,9965244,5738,2008300,11973544,20.15
9859086,9971315,5243,1835050,11806365,18.40
9859087,9910094,5674,1985900,11895994,20.04
9859088,9969886,2562,896700,10866586,8.99
9859089,9978669,1434,501900,10480569,5.03
9859090,9987456,3120,1092000,11079456,10.93
9859091,9985670,4966,1738100,11723770,17.41
9859092,930090,356,124600,1054690,13.40
9859093,9970708,3144,1100400,11071108,11.04
9859094,9966388,4714,1649900,11616288,16.55
9859095,9971195,3019,1056650,11027845,10.60
9859096,362243,192,67200,429443,18.55
9859097,9970874,5592,1957200,11928074,19.63
9859098,9962095,3040,1064000,11026095,10.68
9859099,9976831,3862,1351700,11328531,13.55
9859100,9969752,5731,2005850,11975602,20.12
9859101,9988771,3036,1062600,11051371,10.64
9859102,9989624,1620,567000,10556624,5.68
9859103,9978222,2280,798000,10776222,8.00
9859104,9990799,4875,1706250,11697049,17.08
9859105,9998935,3321,1162350,11161285,11.62
9859106,9988226,3805,1331750,11319976,13.33
9859107,56209,42,14700,70909,26.15
9859108,9988770,3863,1352050,11340820,13.54
9859109,9988565,3374,1180900,11169465,11.82
9859110,9971780,5230,1830500,11802280,18.36
9859111,9988214,3477,1216950,11205164,12.18
9859112,9975492,3830,1340500,11315992,13.44
9859113,9998449,3912,1369200,11367649,13.69
9859115,422725,225,78750,501475,18.63
9859116,9979956,3794,1327900,11307856,13.31
9859117,6900137,3244,1135400,8035537,16.45
9859118,2255289,1530,535500,2790789,23.74
9859119,9961099,1498,524300,10485399,5.26
9859120,9970512,1606,562100,10532612,5.64
9859121,9826684,2165,757750,10584434,7.71
9859122,9987622,5698,1994300,11981922,19.97
9859123,9982225,5478,1917300,11899525,19.21
9859124,9990194,1174,410900,10401094,4.11
9859126,9978428,3917,1370950,11349378,13.74
9859127,9980721,5205,1821750,11802471,18.25
9859128,9897141,4295,1503250,11400391,15.19
9859129,9964462,2340,819000,10783462,8.22
9859130,9772954,5356,1874600,11647554,19.18
9859131,9982791,620,217000,10199791,2.17
9859132,9992057,2520,882000,10874057,8.83
9859133,9963411,421,147350,10110761,1.48
9859134,1794001,954,333900,2127901,18.61
9859135,1618698,905,316750,1935448,19.57
9859136,1411936,699,244650,1656586,17.33
9859137,9967999,4727,1654450,11622449,16.60
9859139,191846,248,86800,278646,45.24
9859140,9997921,6225,2178750,12176671,21.79
9859141,151646,84,29400,181046,19.39
9859142,9970044,2008,702800,10672844,7.05
9859143,9983530,365,127750,10111280,1.28
9859144,9974810,1649,577150,10551960,5.79
9859145,303881,77,26950,330831,8.87
9859146,9989303,1246,436100,10425403,4.37
9859147,2704279,814,284900,2989179,10.54
9859148,9967303,4429,1550150,11517453,15.55
9859149,9743504,4348,1521800,11265304,15.62
9859150,9973477,3839,1343650,11317127,13.47
9859151,9982033,3849,1347150,11329183,13.50
9859152,9973944,3469,1214150,11188094,12.17
9859154,1767560,644,225400,1992960,12.75
9859155,9992172,3044,1065400,11057572,10.66
9859156,9995933,4357,1524950,11520883,15.26
9859157,9967237,5255,1839250,11806487,18.45
9859159,1415224,487,170450,1585674,12.04
9859160,9979797,4441,1554350,11534147,15.57
9859161,791656,1046,366100,1157756,46.24
9859163,1307233,1105,386750,1693983,29.59
9859164,9968354,2455,859250,10827604,8.62
9859166,9967545,4571,1599850,11567395,16.05
9859167,9954570,4513,1579550,11534120,15.87
9859168,9971920,2267,793450,10765370,7.96
9859169,9957560,5095,1783250,11740810,17.91
9859170,9965299,2587,905450,10870749,9.09
9859171,9980169,3611,1263850,11244019,12.66
9859172,361921,347,121450,483371,33.56
9859173,9956294,3072,1075200,11031494,10.80
9859174,9957209,2733,956550,10913759,9.61
9859175,9960875,4468,1563800,11524675,15.70
9859176,9950949,2349,822150,10773099,8.26
9859177,3325638,1404,491400,3817038,14.78
9859178,9931290,1335,467250,10398540,4.70
9859179,9928028,649,227150,10155178,2.29
9859180,9955366,2756,964600,10919966,9.69
9859181,9964761,3397,1188950,11153711,11.93
9859182,9961943,3804,1331400,11293343,13.36
9859183,9970056,909,318150,10288206,3.19
9859184,9959411,2737,957950,10917361,9.62
9859185,9972067,2813,984550,10956617,9.87
9859186,9977318,1544,540400,10517718,5.42
9859187,3589769,555,194250,3784019,5.41
9859188,9981466,3526,1234100,11215566,12.36
9859189,9982566,5709,1998150,11980716,20.02
9859190,9998440,2474,865900,10864340,8.66
9859191,7476958,2749,962150,8439108,12.87
9859192,9979350,3206,1122100,11101450,11.24
9859193,9046987,1939,678650,9725637,7.50
9859194,304208,92,32200,336408,10.58
9859195,9942664,5070,1774500,11717164,17.85
9859196,9931223,4396,1538600,11469823,15.49
9859197,9937631,3826,1339100,11276731,13.48
9859198,9947673,3500,1225000,11172673,12.31
9859199,1955247,96,33600,1988847,1.72
9859200,9950520,1958,685300,10635820,6.89
9859201,9947860,3153,1103550,11051410,11.09
9859202,9899380,3946,1381100,11280480,13.95
9859203,1108868,587,205450,1314318,18.53
9859204,9921439,4426,1549100,11470539,15.61
9859205,9932187,2940,1029000,10961187,10.36
9859206,2870986,2992,1047200,3918186,36.48
9859207,9918632,2772,970200,10888832,9.78
9859208,9912996,3685,1289750,11202746,13.01
9859209,9912638,1662,581700,10494338,5.87
9859210,9917349,4773,1670550,11587899,16.84
9859211,9876559,5900,2065000,11941559,20.91
9859213,9926848,1749,612150,10538998,6.17
9859215,9956082,5552,1943200,11899282,19.52
9859216,9938708,6392,2237200,12175908,22.51
9859217,9967185,1033,361550,10328735,3.63
9859218,1829590,1366,478100,2307690,26.13
9859219,9951309,4759,1665650,11616959,16.74
9859220,9940454,5285,1849750,11790204,18.61
9859221,3099877,1981,693350,3793227,22.37
9859222,9903094,3183,1114050,11017144,11.25
9859223,9937770,3718,1301300,11239070,13.09
9859224,9939544,1056,369600,10309144,3.72
9859225,9928444,1056,369600,10298044,3.72
9859226,9924338,3086,1080100,11004438,10.88
9859227,101010,51,17850,118860,17.67
9859228,6368493,3075,1076250,7444743,16.90
9859229,9939237,3860,1351000,11290237,13.59
9859230,9921203,2062,721700,10642903,7.27
9859231,9942189,902,315700,10257889,3.18
9859232,9963397,1343,470050,10433447,4.72
9859233,9959365,2094,732900,10692265,7.36
9859234,5035505,2402,840700,5876205,16.70
9859235,9975604,2854,998900,10974504,10.01
9859236,320348,165,57750,378098,18.03
9859237,9980136,4181,1463350,11443486,14.66
9859238,9991335,4503,1576050,11567385,15.77
9859239,9975635,4930,1725500,11701135,17.30
9859240,9888119,5088,1780800,11668919,18.01
9859242,9966070,5817,2035950,12002020,20.43
9859243,9983130,999,349650,10332780,3.50
9859244,9992500,2679,937650,10930150,9.38
9859245,9960185,1896,663600,10623785,6.66
9859246,9986080,410,143500,10129580,1.44
9859247,9971357,4870,1704500,11675857,17.09
9859248,9990278,1488,520800,10511078,5.21
9859249,9974344,2063,722050,10696394,7.24
9859250,9976630,3803,1331050,11307680,13.34
9859251,9948591,1461,511350,10459941,5.14
9859252,3042710,1203,421050,3463760,13.84
9859253,9940326,4531,1585850,11526176,15.95
9859254,9969278,3398,1189300,11158578,11.93
9859255,1080449,388,135800,1216249,12.57
9859256,9998516,6165,2157750,12156266,21.58
9859257,9997834,3100,1085000,11082834,10.85
9859258,9996991,489,171150,10168141,1.71
9859259,9978923,3701,1295350,11274273,12.98
9859260,9736447,6475,2266250,12002697,23.28
9859261,9982559,5583,1954050,11936609,19.57
9859262,9985812,2831,990850,10976662,9.92
9859263,9953492,4549,1592150,11545642,16.00
9859264,8680559,3672,1285200,9965759,14.81
9859265,9972870,4985,1744750,11717620,17.49
9859266,5648550,2512,879200,6527750,15.57
9859267,9959411,5248,1836800,11796211,18.44
9859268,9970409,3289,1151150,11121559,11.55
9859269,9947092,2065,722750,10669842,7.27
9859270,3918524,1683,589050,4507574,15.03
9859271,9945320,4734,1656900,11602220,16.66
9859272,9956798,4408,1542800,11499598,15.49
9859273,4525354,2516,880600,5405954,19.46
9859274,9929244,4439,1553650,11482894,15.65
9859275,9932107,4443,1555050,11487157,15.66
9859276,9922472,1426,499100,10421572,5.03
9859277,9904818,4969,1739150,11643968,17.56
9859278,9915686,3391,1186850,11102536,11.97
9859279,9923242,5077,1776950,11700192,17.91
9859280,6315948,3727,1304450,7620398,20.65
9859281,9941317,2795,978250,10919567,9.84
9859282,9923548,4578,1602300,11525848,16.15
9859283,9932252,1485,519750,10452002,5.23
9859284,9926249,2431,850850,10777099,8.57
9859285,9931938,4390,1536500,11468438,15.47
9859286,9937915,4400,1540000,11477915,15.50
9859287,9946273,1329,465150,10411423,4.68
9859288,9949919,3440,1204000,11153919,12.10
9859289,9945468,1842,644700,10590168,6.48
9859290,9950273,3879,1357650,11307923,13.64
9859291,9958168,4263,1492050,11450218,14.98
9859292,9962582,1114,389900,10352482,3.91
9859293,9962042,1207,422450,10384492,4.24
9859294,9959195,3160,1106000,11065195,11.11
9859295,9966469,1332,466200,10432669,4.68
9859296,9970973,1429,500150,10471123,5.02
9859297,9977167,2379,832650,10809817,8.35
9859298,9953510,6555,2294250,12247760,23.05
9859299,1511916,339,118650,1630566,7.85
9859300,9960659,4495,1573250,11533909,15.79
9859301,9971889,4869,1704150,11676039,17.09
9859302,36712,22,7700,44412,20.97
9859303,9980197,3008,1052800,11032997,10.55
9859304,9989446,2430,850500,10839946,8.51
9859305,2354248,331,115850,2470098,4.92
9859308,9978411,2782,973700,10952111,9.76
9859309,9988327,5554,1943900,11932227,19.46
9859310,9988541,3902,1365700,11354241,13.67
9859311,9977421,5870,2054500,12031921,20.59
9859312,9997591,3784,1324400,11321991,13.25
9859313,9978237,3073,1075550,11053787,10.78
9859314,9992728,2610,913500,10906228,9.14
9859315,9981214,5094,1782900,11764114,17.86
9859316,9963282,807,282450,10245732,2.83
9859317,9970925,5250,1837500,11808425,18.43
9859318,9977293,3215,1125250,11102543,11.28
9859319,9980962,5465,1912750,11893712,19.16
9859320,9982749,3824,1338400,11321149,13.41
9859321,9910847,5311,1858850,11769697,18.76
9859322,9996839,4736,1657600,11654439,16.58
9859323,9969055,1228,429800,10398855,4.31
9859324,9961301,2376,831600,10792901,8.35
9859325,9994578,1877,656950,10651528,6.57
9859326,9970567,1202,420700,10391267,4.22
9859327,9993791,2011,703850,10697641,7.04
9859328,9993436,5012,1754200,11747636,17.55
9859329,9992683,4096,1433600,11426283,14.35
9859330,9998239,3132,1096200,11094439,10.96
9859331,9988660,2526,884100,10872760,8.85
9859332,9996826,2716,950600,10947426,9.51
9859333,9976680,1031,360850,10337530,3.62
9859334,9994527,706,247100,10241627,2.47
9859335,9967692,1710,598500,10566192,6.00
9859336,9978075,3784,1324400,11302475,13.27
9859337,9974095,4618,1616300,11590395,16.20
9859338,9993093,1285,449750,10442843,4.50
9859339,9969690,5452,1908200,11877890,19.14
9859340,9967989,3949,1382150,11350139,13.87
9859341,9979614,5408,1892800,11872414,18.97
9859343,9979409,6520,2282000,12261409,22.87
9859344,9989487,2632,921200,10910687,9.22
9859345,9974582,3992,1397200,11371782,14.01
9859346,1347198,699,244650,1591848,18.16
9859347,9996201,4634,1621900,11618101,16.23
9859348,9958837,3597,1258950,11217787,12.64
9859350,9987822,5098,1784300,11772122,17.86
9859351,9964129,905,316750,10280879,3.18
9859352,9972976,5758,2015300,11988276,20.21
9859353,821252,531,185850,1007102,22.63
9859354,9988137,5805,2031750,12019887,20.34
9859355,9995083,5303,1856050,11851133,18.57
9859356,599141,278,97300,696441,16.24
9859357,9962616,5921,2072350,12034966,20.80
9859358,9969747,4354,1523900,11493647,15.29
9859359,9987397,6884,2409400,12396797,24.12
9859360,9967032,1383,484050,10451082,4.86
9859361,3821869,2634,921900,4743769,24.12
9859362,9960401,2869,1004150,10964551,10.08
9859363,9966792,1887,660450,10627242,6.63
9859364,9947769,1663,582050,10529819,5.85
9859365,1493521,638,223300,1716821,14.95
9859366,1914093,313,109550,2023643,5.72
9859367,9968114,4164,1457400,11425514,14.62
9859368,9958592,2376,831600,10790192,8.35
9859369,3333842,1288,450800,3784642,13.52
9859370,9963732,3651,1277850,11241582,12.83
9859371,4282519,2876,1006600,5289119,23.50
9859372,462308,176,61600,523908,13.32
9859373,2006935,1752,613200,2620135,30.55
9859374,9894959,3032,1061200,10956159,10.72
9859375,9972135,2637,922950,10895085,9.26
9859376,7804545,1451,507850,8312395,6.51
9859377,9959392,2053,718550,10677942,7.21
9859378,9971357,2654,928900,10900257,9.32
9859379,831282,865,302750,1134032,36.42
9859380,1396746,614,214900,1611646,15.39
9859381,9972170,2869,1004150,10976320,10.07
9859382,9981382,3703,1296050,11277432,12.98
9859383,9993818,2999,1049650,11043468,10.50
9859384,9993617,6702,2345700,12339317,23.47
9859385,9983398,3818,1336300,11319698,13.39
9859386,5477167,329,115150,5592317,2.10
9859387,9990292,3550,1242500,11232792,12.44
9859389,9992469,3848,1346800,11339269,13.48
9859390,1254927,543,190050,1444977,15.14
9859391,1440660,1052,368200,1808860,25.56
9859392,9978540,5323,1863050,11841590,18.67
9859393,9971493,4902,1715700,11687193,17.21
9859394,233062,143,50050,283112,21.47
9859395,9958089,3170,1109500,11067589,11.14
9859397,9935019,6106,2137100,12072119,21.51
9859398,9900666,5475,1916250,11816916,19.35
9859399,556001,550,192500,748501,34.62
9859400,1125287,1140,399000,1524287,35.46
9859401,9950684,2875,1006250,10956934,10.11
9859402,1738896,740,259000,1997896,14.89
9859403,9975113,4151,1452850,11427963,14.56
9859405,9985276,3889,1361150,11346426,13.63
9859406,9998330,3886,1360100,11358430,13.60
9859407,9976578,2105,736750,10713328,7.38
9859408,8986380,4175,1461250,10447630,16.26
9859409,9992276,2581,903350,10895626,9.04
9859410,8770498,2785,974750,9745248,11.11
9859411,9979224,4755,1664250,11643474,16.68
9859412,9983790,5507,1927450,11911240,19.31
9859413,9999117,4419,1546650,11545767,15.47
9859414,9989062,3231,1130850,11119912,11.32
9859415,9981998,5116,1790600,11772598,17.94
9859416,2271212,2272,795200,3066412,35.01
9859417,9983683,2582,903700,10887383,9.05
9859418,9955785,3325,1163750,11119535,11.69
9859419,9997195,3028,1059800,11056995,10.60
9859420,381818,118,41300,423118,10.82
9859421,9961531,2477,866950,10828481,8.70
9859422,9982962,4190,1466500,11449462,14.69
9859423,9476496,5490,1921500,11397996,20.28
9859424,9993460,3395,1188250,11181710,11.89
9859425,9976443,3203,1121050,11097493,11.24
9859426,9979680,3573,1250550,11230230,12.53
9859427,9994914,1432,501200,10496114,5.01
9859428,9942812,4644,1625400,11568212,16.35
9859429,9982605,695,243250,10225855,2.44
9859430,9985580,1341,469350,10454930,4.70
9859431,9971791,2286,800100,10771891,8.02
9859432,9966447,4207,1472450,11438897,14.77
9859433,9988126,3962,1386700,11374826,13.88
9859434,9878586,2903,1016050,10894636,10.29
9859435,9990463,4812,1684200,11674663,16.86
9859436,9995411,5521,1932350,11927761,19.33
9859437,9979348,3808,1332800,11312148,13.36
9859438,9969750,2114,739900,10709650,7.42
9859439,9854878,3144,1100400,10955278,11.17
9859440,9954040,1550,542500,10496540,5.45
9859441,9976511,3968,1388800,11365311,13.92
9859442,9970152,1296,453600,10423752,4.55
9859443,9965559,1363,477050,10442609,4.79
9859444,9977833,2466,863100,10840933,8.65
9859445,9986892,3353,1173550,11160442,11.75
9859446,1452290,289,101150,1553440,6.96
9859447,1424511,798,279300,1703811,19.61
9859448,9970311,3667,1283450,11253761,12.87
9859449,2239373,1086,380100,2619473,16.97
9859450,5114814,2731,955850,6070664,18.69
9859451,9937672,3605,1261750,11199422,12.70
9859452,9974100,3452,1208200,11182300,12.11
9859453,1604143,756,264600,1868743,16.49
9859455,9946008,3832,1341200,11287208,13.48
9859457,9963144,2236,782600,10745744,7.85
9859458,9935451,4005,1401750,11337201,14.11
9859459,9944967,7772,2720200,12665167,27.35
9859460,1921689,1010,353500,2275189,18.40
9859461,9935675,1744,610400,10546075,6.14
9859463,9924918,1749,612150,10537068,6.17
9859464,9925776,4454,1558900,11484676,15.71
9859465,9935882,1831,640850,10576732,6.45
9859466,2385350,905,316750,2702100,13.28
9859467,9795506,5313,1859550,11655056,18.98
9859469,9938873,3256,1139600,11078473,11.47
9859470,9939213,2415,845250,10784463,8.50
9859471,9944957,1963,687050,10632007,6.91
9859472,9927547,1396,488600,10416147,4.92
9859473,9953881,3739,1308650,11262531,13.15
9859474,9943169,7807,2732450,12675619,27.48
9859475,1053575,444,155400,1208975,14.75
9859476,9945267,4697,1643950,11589217,16.53
9859477,9944810,3859,1350650,11295460,13.58
9859478,9963754,2704,946400,10910154,9.50
9859479,9960806,1954,683900,10644706,6.87
9859480,9975355,4668,1633800,11609155,16.38
9859481,9987460,4236,1482600,11470060,14.84
9859482,9984352,3631,1270850,11255202,12.73
9859483,9973793,4405,1541750,11515543,15.46
9859484,9991856,2187,765450,10757306,7.66
9859485,9979386,3250,1137500,11116886,11.40
9859486,9985346,3037,1062950,11048296,10.65
9859487,9979539,2642,924700,10904239,9.27
9859488,9981638,3461,1211350,11192988,12.14
9859489,9981306,3053,1068550,11049856,10.71
9859490,9999901,2679,937650,10937551,9.38
9859491,9971438,2500,875000,10846438,8.78
9859492,9976266,4549,1592150,11568416,15.96
9859493,9967238,1909,668150,10635388,6.70
9859494,9711525,1147,401450,10112975,4.13
9859495,9949788,5861,2051350,12001138,20.62
9859496,9966956,2696,943600,10910556,9.47
9859497,1642486,912,319200,1961686,19.43
9859498,2131580,642,224700,2356280,10.54
9859499,9964732,8169,2859150,12823882,28.69
9859500,9950640,4458,1560300,11510940,15.68
9859501,9968363,5693,1992550,11960913,19.99
9859502,9965020,3226,1129100,11094120,11.33
9859503,9977966,2078,727300,10705266,7.29
9859504,1227080,577,201950,1429030,16.46
9859506,9970321,4167,1458450,11428771,14.63
9859507,9978488,4764,1667400,11645888,16.71
9859508,6984027,1478,517300,7501327,7.41
9859509,7049676,1592,557200,7606876,7.90
9859510,9991264,5582,1953700,11944964,19.55
9859511,9983371,3739,1308650,11292021,13.11
9859512,9999705,2082,728700,10728405,7.29
9859513,9980909,4261,1491350,11472259,14.94
9859514,9987747,3430,1200500,11188247,12.02
9859515,9971611,3913,1369550,11341161,13.73
9859516,9973186,1942,679700,10652886,6.82
9859517,9987961,3473,1215550,11203511,12.17
9859518,9990859,2116,740600,10731459,7.41
9859519,268720,182,63700,332420,23.70
9859520,1098089,137,47950,1146039,4.37
9859521,9959817,5443,1905050,11864867,19.13
9859522,7180043,2111,738850,7918893,10.29
9859523,9960938,2138,748300,10709238,7.51
9859524,9970091,1639,573650,10543741,5.75
9859525,9470213,3985,1394750,10864963,14.73
9859527,9953482,1332,466200,10419682,4.68
9859528,9989910,2659,930650,10920560,9.32
9859529,1060182,168,58800,1118982,5.55
9859530,8801313,4179,1462650,10263963,16.62
9859531,9974688,3182,1113700,11088388,11.17
9859532,9944026,3059,1070650,11014676,10.77
9859533,9942801,1042,364700,10307501,3.67
9859534,967424,367,128450,1095874,13.28
9859535,3216807,1363,477050,3693857,14.83
9859536,22160,34,11900,34060,53.70
9859537,9952623,4156,1454600,11407223,14.62
9859538,9965449,4314,1509900,11475349,15.15
9859539,9960430,425,148750,10109180,1.49
9859540,9705889,3292,1152200,10858089,11.87
9859541,9964924,2842,994700,10959624,9.98
9859542,9990711,3419,1196650,11187361,11.98
9859543,9996096,2851,997850,10993946,9.98
9859544,9987924,1290,451500,10439424,4.52
9859545,9990174,3815,1335250,11325424,13.37
9859546,9971179,3289,1151150,11122329,11.54
9859547,9993450,2743,960050,10953500,9.61
9859548,9987515,2161,756350,10743865,7.57
9859549,9989913,4625,1618750,11608663,16.20
9859550,119573,53,18550,138123,15.51
9859551,9959036,4952,1733200,11692236,17.40
9859552,9968069,4217,1475950,11444019,14.81
9859553,9971800,2843,995050,10966850,9.98
9859554,9983849,4430,1550500,11534349,15.53
9859555,9978325,4001,1400350,11378675,14.03
9859556,9994030,1144,400400,10394430,4.01
9859557,1125320,572,200200,1325520,17.79
9859558,134070,42,14700,148770,10.96
9859559,899870,574,200900,1100770,22.33
9859560,9953850,3771,1319850,11273700,13.26
9859561,2143391,1377,481950,2625341,22.49
9859562,9967549,2249,787150,10754699,7.90
9859563,9978404,671,234850,10213254,2.35
9859564,9976249,2004,701400,10677649,7.03
9859565,9983180,3589,1256150,11239330,12.58
9859566,9987382,5431,1900850,11888232,19.03
9859567,4608580,1364,477400,5085980,10.36
9859568,9967416,4096,1433600,11401016,14.38
9859569,9965267,2447,856450,10821717,8.59
9859570,92736,125,43750,136486,47.18
9859571,9955415,2234,781900,10737315,7.85
9859572,9965399,6890,2411500,12376899,24.20
9859573,9971963,2816,985600,10957563,9.88
9859574,9979640,3846,1346100,11325740,13.49
9859576,9968832,3575,1251250,11220082,12.55
9859577,9976574,6027,2109450,12086024,21.14
9859578,9981795,4684,1639400,11621195,16.42
9859579,9985698,4722,1652700,11638398,16.55
9859580,9997631,4162,1456700,11454331,14.57
9859581,756983,418,146300,903283,19.33
9859582,2229289,935,327250,2556539,14.68
9859583,9970929,2210,773500,10744429,7.76
9859584,7125110,2829,990150,8115260,13.90
9859585,9929017,3856,1349600,11278617,13.59
9859586,9964536,4664,1632400,11596936,16.38
9859587,9965438,2706,947100,10912538,9.50
9859588,9957948,3336,1167600,11125548,11.73
9859589,9964519,3298,1154300,11118819,11.58
9859590,9969659,6237,2182950,12152609,21.90
9859591,9869168,5461,1911350,11780518,19.37
9859592,9914089,4444,1555400,11469489,15.69
9859594,9968952,2968,1038800,11007752,10.42
9859595,9806356,4695,1643250,11449606,16.76
9859596,9971788,2096,733600,10705388,7.36
9859599,9964087,4484,1569400,11533487,15.75
9859600,9967162,5718,2001300,11968462,20.08
9859601,9960020,3157,1104950,11064970,11.09
9859602,358001,229,80150,438151,22.39
9859603,9968100,3198,1119300,11087400,11.23
9859604,1402220,1257,439950,1842170,31.38
9859605,1726292,1098,384300,2110592,22.26
9859606,9978185,5813,2034550,12012735,20.39
9859607,9985958,5660,1981000,11966958,19.84
9859608,9966836,3064,1072400,11039236,10.76
9859609,9978803,2632,921200,10900003,9.23
9859610,9991076,4749,1662150,11653226,16.64
9859611,9985249,6163,2157050,12142299,21.60
9859612,3673713,2952,1033200,4706913,28.12
9859613,6429165,3056,1069600,7498765,16.64
9859614,9959510,4442,1554700,11514210,15.61
9859615,9970023,6050,2117500,12087523,21.24
9859616,9980300,5067,1773450,11753750,17.77
9859617,9971281,1136,397600,10368881,3.99
9859618,9975434,4652,1628200,11603634,16.32
9859619,9975369,2447,856450,10831819,8.59
9859620,9977925,3985,1394750,11372675,13.98
9859621,9976932,947,331450,10308382,3.32
9859622,1798427,1512,529200,2327627,29.43
9859623,9974340,4019,1406650,11380990,14.10
9859624,516570,323,113050,629620,21.88
9859625,9964014,3430,1200500,11164514,12.05
9859626,9960536,5020,1757000,11717536,17.64
9859627,9968196,3442,1204700,11172896,12.09
9859628,9961449,2985,1044750,11006199,10.49
9859629,9998211,2894,1012900,11011111,10.13
9859630,9973732,1998,699300,10673032,7.01
9859631,9983865,2664,932400,10916265,9.34
9859632,9988556,4659,1630650,11619206,16.33
9859633,9986747,3376,1181600,11168347,11.83
9859635,9966755,4591,1606850,11573605,16.12
9859636,9984437,5163,1807050,11791487,18.10
9859637,9988014,4663,1632050,11620064,16.34
9859638,9988796,4221,1477350,11466146,14.79
9859639,9982564,2739,958650,10941214,9.60
9859640,357604,168,58800,416404,16.44
9859642,9950166,1977,691950,10642116,6.95
9859643,1222004,314,109900,1331904,8.99
9859644,9946984,3984,1394400,11341384,14.02
9859645,9947340,1242,434700,10382040,4.37
9859646,9941255,634,221900,10163155,2.23
9859647,9952069,1377,481950,10434019,4.84
9859648,9955507,2502,875700,10831207,8.80
9859649,9933641,2312,809200,10742841,8.15
9859651,9940110,2192,767200,10707310,7.72
9859652,9937223,3758,1315300,11252523,13.24
9859653,9961372,3874,1355900,11317272,13.61
9859654,9953874,3497,1223950,11177824,12.30
9859655,9953611,1944,680400,10634011,6.84
9859656,9980599,3230,1130500,11111099,11.33
9859657,196891,127,44450,241341,22.58
9859658,1927965,1028,359800,2287765,18.66
9859659,9971427,1984,694400,10665827,6.96
9859660,9953726,1978,692300,10646026,6.96
9859661,9965701,2371,829850,10795551,8.33
9859662,9968756,3985,1394750,11363506,13.99
9859663,9972592,3226,1129100,11101692,11.32
9859664,9949689,2207,772450,10722139,7.76
9859665,9987138,4311,1508850,11495988,15.11
9859666,9975686,1842,644700,10620386,6.46
9859667,9977812,3174,1110900,11088712,11.13
9859668,265761,156,54600,320361,20.54
9859669,9983373,3989,1396150,11379523,13.98
9859670,9987236,2140,749000,10736236,7.50
9859671,9867690,2454,858900,10726590,8.70
9859672,9980514,1989,696150,10676664,6.98
9859673,9986139,2264,792400,10778539,7.93
9859674,9970443,3565,1247750,11218193,12.51
9859675,650100,649,227150,877250,34.94
9859676,9985192,2322,812700,10797892,8.14
9859677,9980416,3621,1267350,11247766,12.70
9859679,9986262,1204,421400,10407662,4.22
9859680,1714785,953,333550,2048335,19.45
9859681,9974887,5189,1816150,11791037,18.21
9859682,9992190,1843,645050,10637240,6.46
9859683,9968070,851,297850,10265920,2.99
9859684,1799504,575,201250,2000754,11.18
9859685,9982082,4589,1606150,11588232,16.09
9859686,9967862,3077,1076950,11044812,10.80
9859687,9960796,4201,1470350,11431146,14.76
9859688,9963565,3371,1179850,11143415,11.84
9859689,9944203,2517,880950,10825153,8.86
9859690,9978421,3515,1230250,11208671,12.33
9859691,9991166,2570,899500,10890666,9.00
9859692,9998490,4933,1726550,11725040,17.27
9859693,9978936,3904,1366400,11345336,13.69
9859694,9984028,3494,1222900,11206928,12.25
9859695,9986577,4113,1439550,11426127,14.41
9859696,9982441,5545,1940750,11923191,19.44
9859697,9949868,3078,1077300,11027168,10.83
9859698,9977475,4539,1588650,11566125,15.92
9859699,9979697,4244,1485400,11465097,14.88
9859700,9948060,2763,967050,10915110,9.72
9859701,337833,157,54950,392783,16.27
9859702,1616747,1697,593950,2210697,36.74
9859703,8991881,3423,1198050,10189931,13.32
9859704,9986427,4111,1438850,11425277,14.41
9859705,9989464,3416,1195600,11185064,11.97
9859706,9965881,3813,1334550,11300431,13.39
9859707,9984607,1552,543200,10527807,5.44
9859708,9720981,1876,656600,10377581,6.75
9859709,9997461,4078,1427300,11424761,14.28
9859710,9981006,3322,1162700,11143706,11.65
9859711,754954,312,109200,864154,14.46
9859713,379510,219,76650,456160,20.20
9859714,9951156,4997,1748950,11700106,17.58
9859715,48067,74,25900,73967,53.88
9859716,9932326,3689,1291150,11223476,13.00
9859717,9681787,4390,1536500,11218287,15.87
9859719,4762506,1390,486500,5249006,10.22
9859720,6884998,2191,766850,7651848,11.14
9859721,9773738,3076,1076600,10850338,11.02
9859722,9983209,2656,929600,10912809,9.31
9859723,9899180,3978,1392300,11291480,14.06
9859724,9984533,5845,2045750,12030283,20.49
9859725,13972,6,2100,16072,15.03
9859726,1588077,622,217700,1805777,13.71
9859727,9982567,4954,1733900,11716467,17.37
9859729,9959730,6774,2370900,12330630,23.80
9859730,9972902,3027,1059450,11032352,10.62
9859732,9988040,5693,1992550,11980590,19.95
9859733,9958244,2581,903350,10861594,9.07
9859734,141323,94,32900,174223,23.28
9859735,9990190,1498,524300,10514490,5.25
9859736,9992677,409,143150,10135827,1.43
9859738,9975016,2771,969850,10944866,9.72
9859739,9981931,2717,950950,10932881,9.53
9859740,173283,77,26950,200233,15.55
9859741,9983607,2592,907200,10890807,9.09
9859742,9980408,4620,1617000,11597408,16.20
9859743,9999823,3286,1150100,11149923,11.50
9859744,9992486,2970,1039500,11031986,10.40
9859745,6489414,800,280000,6769414,4.31
9859746,1116526,576,201600,1318126,18.06
9859747,9962233,5944,2080400,12042633,20.88
9859748,9958220,3873,1355550,11313770,13.61
9859749,9895684,4089,1431150,11326834,14.46
9859750,9982932,3345,1170750,11153682,11.73
9859751,1174090,686,240100,1414190,20.45
9859752,333644,134,46900,380544,14.06
9859753,1240554,598,209300,1449854,16.87
9859754,9981440,4871,1704850,11686290,17.08
9859755,9977814,2514,879900,10857714,8.82
9859756,9965356,5931,2075850,12041206,20.83
9859757,9989291,1502,525700,10514991,5.26
9859758,1495937,559,195650,1691587,13.08
9859759,9968749,2828,989800,10958549,9.93
9859760,9978136,5260,1841000,11819136,18.45
9859761,9976004,6727,2354450,12330454,23.60
9859762,9960728,4630,1620500,11581228,16.27
9859763,1232066,1035,362250,1594316,29.40
9859764,4093344,2420,847000,4940344,20.69
9859765,9925771,2403,841050,10766821,8.47
9859766,519218,343,120050,639268,23.12
9859767,9908286,4795,1678250,11586536,16.94
9859768,9901914,5500,1925000,11826914,19.44
9859769,9893586,6546,2291100,12184686,23.16
9859770,9919120,2236,782600,10701720,7.89
9859771,9924342,4343,1520050,11444392,15.32
9859772,9917943,2171,759850,10677793,7.66
9859773,9922985,5255,1839250,11762235,18.54
9859774,331011,253,88550,419561,26.75
9859775,1414685,2123,743050,2157735,52.52
9859776,9910805,4985,1744750,11655555,17.60
9859777,9919351,1485,519750,10439101,5.24
9859778,64243,32,11200,75443,17.43
9859779,9015121,1604,561400,9576521,6.23
9859780,9917829,1882,658700,10576529,6.64
9859781,9925691,1521,532350,10458041,5.36
9859782,9945508,3319,1161650,11107158,11.68
9859783,9950886,4955,1734250,11685136,17.43
9859784,9871419,3435,1202250,11073669,12.18
9859785,1695059,1512,529200,2224259,31.22
9859786,9952912,2300,805000,10757912,8.09
9859787,241746,220,77000,318746,31.85
9859788,9825682,5211,1823850,11649532,18.56
9859789,9944354,3060,1071000,11015354,10.77
9859790,9957439,5682,1988700,11946139,19.97
9859791,9962488,3007,1052450,11014938,10.56
9859792,9969850,3702,1295700,11265550,13.00
9859793,9977051,4448,1556800,11533851,15.60
9859794,9992559,4674,1635900,11628459,16.37
9859795,9992752,4890,1711500,11704252,17.13
9859796,9984477,4827,1689450,11673927,16.92
9859797,9985624,4715,1650250,11635874,16.53
9859798,9979917,1429,500150,10480067,5.01
9859799,9955925,2818,986300,10942225,9.91
9859800,9994734,4565,1597750,11592484,15.99
9859801,9979113,3724,1303400,11282513,13.06
9859802,9988074,5819,2036650,12024724,20.39
9859803,9999211,4166,1458100,11457311,14.58
9859804,9983750,1513,529550,10513300,5.30
9859805,9984862,3672,1285200,11270062,12.87
9859807,9968979,3248,1136800,11105779,11.40
9859808,9954086,4178,1462300,11416386,14.69
9859809,9983720,3789,1326150,11309870,13.28
9859810,5291798,2079,727650,6019448,13.75
9859811,9995957,3968,1388800,11384757,13.89
9859812,9974073,5652,1978200,11952273,19.83
9859813,9984157,2245,785750,10769907,7.87
9859814,1155375,725,253750,1409125,21.96
9859815,9964469,2744,960400,10924869,9.64
9859817,9955446,3537,1237950,11193396,12.43
9859818,1402236,460,161000,1563236,11.48
9859819,9979368,3715,1300250,11279618,13.03
9859820,9986579,3679,1287650,11274229,12.89
9859821,9982835,3523,1233050,11215885,12.35
9859822,9991833,3115,1090250,11082083,10.91
9859823,9980237,4174,1460900,11441137,14.64
9859824,9985365,4833,1691550,11676915,16.94
9859825,9990974,2851,997850,10988824,9.99
9859826,9982700,2444,855400,10838100,8.57
9859827,1804390,988,345800,2150190,19.16
9859828,9975430,4118,1441300,11416730,14.45
9859829,690862,288,100800,791662,14.59
9859830,9983089,3415,1195250,11178339,11.97
9859831,9994806,5633,1971550,11966356,19.73
9859832,9986862,5372,1880200,11867062,18.83
9859833,9963943,5138,1798300,11762243,18.05
9859834,9984836,5737,2007950,11992786,20.11
9859835,8967824,3812,1334200,10302024,14.88
9859836,9958785,4610,1613500,11572285,16.20
9859837,9953536,2454,858900,10812436,8.63
9859838,8968856,3840,1344000,10312856,14.99
9859839,9961757,4183,1464050,11425807,14.70
9859840,9977000,5383,1884050,11861050,18.88
9859841,9971435,5481,1918350,11889785,19.24
9859842,9990996,5095,1783250,11774246,17.85
9859843,1414036,2007,702450,2116486,49.68
9859844,9994127,5275,1846250,11840377,18.47
9859845,9985540,7003,2451050,12436590,24.55
9859846,282791,161,56350,339141,19.93
9859847,9956413,4079,1427650,11384063,14.34
9859848,9953001,6853,2398550,12351551,24.10
9859849,9974379,2440,854000,10828379,8.56
9859850,9366384,6065,2122750,11489134,22.66
9859851,9970250,3010,1053500,11023750,10.57
9859852,9977142,1789,626150,10603292,6.28
9859853,197338,130,45500,242838,23.06
9859854,9962237,4928,1724800,11687037,17.31
9859855,9854708,2423,848050,10702758,8.61
9859856,9970390,2923,1023050,10993440,10.26
9859857,9987849,5303,1856050,11843899,18.58
9859858,9485002,5089,1781150,11266152,18.78
9859859,9928267,8102,2835700,12763967,28.56
9859860,9984496,4003,1401050,11385546,14.03
9859861,1013860,139,48650,1062510,4.80
9859862,3533144,5558,1945300,5478444,55.06
9859863,9970086,5104,1786400,11756486,17.92
9859864,4297733,3275,1146250,5443983,26.67
9859865,9981259,6214,2174900,12156159,21.79
9859866,9976128,1134,396900,10373028,3.98
9859867,9966800,2987,1045450,11012250,10.49
9859868,9979308,1555,544250,10523558,5.45
9859869,9983871,3893,1362550,11346421,13.65
9859870,1379411,206,72100,1451511,5.23
9859871,9986764,5804,2031400,12018164,20.34
9859872,9917620,5517,1930950,11848570,19.47
9859873,9990607,5127,1794450,11785057,17.96
9859874,9984521,5728,2004800,11989321,20.08
9859875,9961616,5307,1857450,11819066,18.65
9859876,9980479,2633,921550,10902029,9.23
9859877,9939960,8265,2892750,12832710,29.10
9859878,9967096,5797,2028950,11996046,20.36
9859879,9969505,6356,2224600,12194105,22.31
9859880,208869,105,36750,245619,17.59
9859881,9983068,2725,953750,10936818,9.55
9859882,528642,526,184100,712742,34.83
9859883,9986115,2585,904750,10890865,9.06
9859884,9992621,2970,1039500,11032121,10.40
9859885,9986842,2459,860650,10847492,8.62
9859886,9603990,3732,1306200,10910190,13.60
9859887,9996458,4439,1553650,11550108,15.54
9859888,9979626,4200,1470000,11449626,14.73
9859889,9975785,3307,1157450,11133235,11.60
9859890,9973765,3499,1224650,11198415,12.28
9859891,9978000,2319,811650,10789650,8.13
9859892,9928910,4919,1721650,11650560,17.34
9859893,9959098,2970,1039500,10998598,10.44
9859894,859597,243,85050,944647,9.89
9859895,9953513,2838,993300,10946813,9.98
9859897,9966056,3542,1239700,11205756,12.44
9859898,9977300,3852,1348200,11325500,13.51
9859899,83726,44,15400,99126,18.39
9859900,9971811,2977,1041950,11013761,10.45
9859901,9970938,3584,1254400,11225338,12.58
9859902,9983092,3449,1207150,11190242,12.09
9859903,9982277,2444,855400,10837677,8.57
9859904,9994282,2526,884100,10878382,8.85
9859905,9976952,5513,1929550,11906502,19.34
9859906,9995513,4251,1487850,11483363,14.89
9859907,1142743,1124,393400,1536143,34.43
9859908,9972804,3247,1136450,11109254,11.40
9859909,9707521,4802,1680700,11388221,17.31
9859910,9981831,4575,1601250,11583081,16.04
9859911,9717695,1844,645400,10363095,6.64
9859912,9990316,2808,982800,10973116,9.84
9859913,9690342,3314,1159900,10850242,11.97
9859914,9990768,4058,1420300,11411068,14.22
9859915,9979326,3946,1381100,11360426,13.84
9859916,9978584,4884,1709400,11687984,17.13
9859917,9992651,4763,1667050,11659701,16.68
9859918,9842374,2120,742000,10584374,7.54
9859919,9980227,3345,1170750,11150977,11.73
9859920,9985298,2479,867650,10852948,8.69
9859921,9972416,1115,390250,10362666,3.91
9859922,9978484,3181,1113350,11091834,11.16
9859923,9976280,2548,891800,10868080,8.94
9859924,9973490,710,248500,10221990,2.49
9859925,9960607,5981,2093350,12053957,21.02
9859926,9976907,5099,1784650,11761557,17.89
9859927,9979854,4104,1436400,11416254,14.39
9859928,1273504,463,162050,1435554,12.72
9859929,9972352,7127,2494450,12466802,25.01
9859930,9942507,1784,624400,10566907,6.28
9859931,2876980,2527,884450,3761430,30.74
9859932,9956661,3283,1149050,11105711,11.54
9859933,9949973,3118,1091300,11041273,10.97
9859935,9941814,3318,1161300,11103114,11.68
9859936,9953831,4856,1699600,11653431,17.07
9859937,9960444,673,235550,10195994,2.36
9859938,9976387,2079,727650,10704037,7.29
9859939,9991689,1914,669900,10661589,6.70
9859940,9982553,4376,1531600,11514153,15.34
9859941,9989949,2714,949900,10939849,9.51
9859942,9991355,4276,1496600,11487955,14.98
9859943,9985785,3433,1201550,11187335,12.03
9859944,9997845,3116,1090600,11088445,10.91
9859945,9999197,1817,635950,10635147,6.36
9859946,9988835,1017,355950,10344785,3.56
9859947,9979590,1179,412650,10392240,4.13
9859948,9963360,6243,2185050,12148410,21.93
9859949,9950694,3584,1254400,11205094,12.61
9859950,9945449,3084,1079400,11024849,10.85
9859951,9935210,3072,1075200,11010410,10.82
9859952,9934775,3547,1241450,11176225,12.50
9859954,9946749,4783,1674050,11620799,16.83
9859955,9965212,4687,1640450,11605662,16.46
9859957,712292,690,241500,953792,33.90
9859958,9968570,5265,1842750,11811320,18.49
9859959,1955617,144,50400,2006017,2.58
9859960,9964350,5987,2095450,12059800,21.03
9859961,173619,86,30100,203719,17.34
9859962,9975237,4699,1644650,11619887,16.49
9859963,9983330,4093,1432550,11415880,14.35
9859964,480221,226,79100,559321,16.47
9859965,9980073,4681,1638350,11618423,16.42
9859966,9975119,2929,1025150,11000269,10.28
9859967,9971977,1734,606900,10578877,6.09
9859968,9977522,4033,1411550,11389072,14.15
9859969,9983085,1424,498400,10481485,4.99
9859970,9694395,4650,1627500,11321895,16.79
9859971,9986668,4607,1612450,11599118,16.15
9859972,9967951,3192,1117200,11085151,11.21
9859973,9686931,2317,810950,10497881,8.37
9859974,2276193,1579,552650,2828843,24.28
9859975,9984766,5206,1822100,11806866,18.25
9859977,998272,281,98350,1096622,9.85
9859978,2532577,1267,443450,2976027,17.51
9859979,9991288,4656,1629600,11620888,16.31
9859980,9998530,6973,2440550,12439080,24.41
9859981,9985237,3798,1329300,11314537,13.31
9859982,9999095,3347,1171450,11170545,11.72
9859983,9983284,5324,1863400,11846684,18.67
9859984,9974084,4938,1728300,11702384,17.33
9859985,9994699,2114,739900,10734599,7.40
9859986,9986667,1588,555800,10542467,5.57
9859988,9978331,2380,833000,10811331,8.35
9859989,9971315,1516,530600,10501915,5.32
9859990,9982522,2183,764050,10746572,7.65
9859991,542017,893,312550,854567,57.66
9859992,9974296,2356,824600,10798896,8.27
9859993,9973515,707,247450,10220965,2.48
9859994,9973201,2371,829850,10803051,8.32
9859995,278312,137,47950,326262,17.23
9859996,9970387,4018,1406300,11376687,14.10
9859997,9970578,2932,1026200,10996778,10.29
9859998,9981281,2639,923650,10904931,9.25
9859999,9993693,472,165200,10158893,1.65
9860000,9984179,3386,1185100,11169279,11.87
9860001,9991693,2179,762650,10754343,7.63
9860002,93647,47,16450,110097,17.57
9860003,524547,195,68250,592797,13.01
9860004,9989352,2910,1018500,11007852,10.20
9860005,9989939,2009,703150,10693089,7.04
9860006,3708203,2083,729050,4437253,19.66
9860007,9957564,3606,1262100,11219664,12.67
9860008,9972838,4057,1419950,11392788,14.24
9860009,1002286,948,331800,1334086,33.10
9860010,9971043,3528,1234800,11205843,12.38
9860012,9985935,5525,1933750,11919685,19.36
9860013,9979865,216,75600,10055465,0.76
9860014,9928178,4969,1739150,11667328,17.52
9860016,2279091,861,301350,2580441,13.22
9860017,9950972,3544,1240400,11191372,12.47
9860018,9969598,438,153300,10122898,1.54
9860019,9949490,3721,1302350,11251840,13.09
9860020,9968839,4151,1452850,11421689,14.57
9860021,9965012,4456,1559600,11524612,15.65
9860022,9469615,1150,402500,9872115,4.25
9860023,9968790,3035,1062250,11031040,10.66
9860024,9978365,4293,1502550,11480915,15.06
9860025,9974485,1465,512750,10487235,5.14
9860026,9977101,1531,535850,10512951,5.37
9860027,9980024,3202,1120700,11100724,11.23
9860028,9908751,4662,1631700,11540451,16.47
9860029,9989128,2364,827400,10816528,8.28
9860030,9990396,3823,1338050,11328446,13.39
9860031,9986712,4162,1456700,11443412,14.59
9860032,9965884,2256,789600,10755484,7.92
9860033,9981430,2877,1006950,10988380,10.09
9860034,9869217,4912,1719200,11588417,17.42
9860035,9990872,2121,742350,10733222,7.43
9860036,288824,314,109900,398724,38.05
9860037,9975595,3811,1333850,11309445,13.37
9860038,9978215,3603,1261050,11239265,12.64
9860039,9972347,1901,665350,10637697,6.67
9860040,9978559,1972,690200,10668759,6.92
9860041,9987637,3553,1243550,11231187,12.45
9860042,9975260,3091,1081850,11057110,10.85
9860044,9981047,4441,1554350,11535397,15.57
9860045,9974791,1253,438550,10413341,4.40
9860046,566028,314,109900,675928,19.42
9860047,9946573,2689,941150,10887723,9.46
9860048,9950896,4445,1555750,11506646,15.63
9860049,9945893,1628,569800,10515693,5.73
9860050,9947805,3793,1327550,11275355,13.35
9860051,9949945,2222,777700,10727645,7.82
9860052,9955144,2635,922250,10877394,9.26
9860053,705347,654,228900,934247,32.45
9860054,2571282,879,307650,2878932,11.96
9860055,1427642,947,331450,1759092,23.22
9860056,9916693,4612,1614200,11530893,16.28
9860058,9936498,3654,1278900,11215398,12.87
9860059,9933827,1463,512050,10445877,5.15
9860060,315646,281,98350,413996,31.16
9860061,9908265,3353,1173550,11081815,11.84
9860062,9914069,3568,1248800,11162869,12.60
9860063,9927929,2219,776650,10704579,7.82
9860064,1262129,705,246750,1508879,19.55
9860065,9941012,4727,1654450,11595462,16.64
9860066,9940604,4233,1481550,11422154,14.90
9860067,9893320,1529,535150,10428470,5.41
9860068,9944713,4145,1450750,11395463,14.59
9860069,1902467,298,104300,2006767,5.48
9860070,9947167,3932,1376200,11323367,13.84
9860071,9971489,3423,1198050,11169539,12.01
9860072,1547372,755,264250,1811622,17.08
9860073,9981420,5175,1811250,11792670,18.15
9860074,9964694,7573,2650550,12615244,26.60
9860075,9977630,4909,1718150,11695780,17.22
9860076,136533,53,18550,155083,13.59
9860077,9982170,2456,859600,10841770,8.61
9860078,9980060,2315,810250,10790310,8.12
9860079,421442,147,51450,472892,12.21
9860080,1155824,1124,393400,1549224,34.04
9860082,9948252,6003,2101050,12049302,21.12
9860083,9945292,4961,1736350,11681642,17.46
9860084,307452,131,45850,353302,14.91
9860085,9970078,2264,792400,10762478,7.95
9860086,9955606,3370,1179500,11135106,11.85
9860087,1183455,771,269850,1453305,22.80
9860088,9942039,4579,1602650,11544689,16.12
9860089,9967249,5006,1752100,11719349,17.58
9860090,9956613,2786,975100,10931713,9.79
9860091,1517870,764,267400,1785270,17.62
9860092,9970533,3090,1081500,11052033,10.85
9860093,9975486,2768,968800,10944286,9.71
9860094,9983638,1811,633850,10617488,6.35
9860095,9996607,2303,806050,10802657,8.06
9860096,9977636,3660,1281000,11258636,12.84
9860097,401930,212,74200,476130,18.46
9860098,978094,740,259000,1237094,26.48
9860099,54780,49,17150,71930,31.31
9860100,9960894,3783,1324050,11284944,13.29
9860101,9959070,4262,1491700,11450770,14.98
9860102,9980757,3446,1206100,11186857,12.08
9860103,9973583,3208,1122800,11096383,11.26
9860104,9992290,3141,1099350,11091640,11.00
9860105,9989870,2616,915600,10905470,9.17
9860106,9994087,4166,1458100,11452187,14.59
9860107,9989022,3604,1261400,11250422,12.63
9860108,9818944,5314,1859900,11678844,18.94
9860109,9981969,4959,1735650,11717619,17.39
9860110,9997722,5454,1908900,11906622,19.09
9860111,9995173,2654,928900,10924073,9.29
9860112,9964718,4788,1675800,11640518,16.82
9860113,9960682,2144,750400,10711082,7.53
9860114,9989324,5077,1776950,11766274,17.79
9860116,9985093,3968,1388800,11373893,13.91
9860117,9974787,2382,833700,10808487,8.36
9860118,9990920,4606,1612100,11603020,16.14
9860119,9988476,6819,2386650,12375126,23.89
9860120,1093535,693,242550,1336085,22.18
9860121,9971309,3735,1307250,11278559,13.11
9860122,249006,101,35350,284356,14.20
9860123,4481266,2272,795200,5276466,17.74
9860124,9955543,3773,1320550,11276093,13.26
9860125,9957545,6859,2400650,12358195,24.11
9860126,9961779,5104,1786400,11748179,17.93
9860127,9965006,3269,1144150,11109156,11.48
9860128,9957173,2616,915600,10872773,9.20
9860129,9963899,1931,675850,10639749,6.78
9860130,172527,167,58450,230977,33.88
9860131,2092489,236,82600,2175089,3.95
9860132,7342029,2920,1022000,8364029,13.92
9860133,9925956,3213,1124550,11050506,11.33
9860134,9873998,3877,1356950,11230948,13.74
9860135,9924953,3928,1374800,11299753,13.85
9860136,9928995,3094,1082900,11011895,10.91
9860137,9922190,2716,950600,10872790,9.58
9860138,9739134,4044,1415400,11154534,14.53
9860139,1778980,1737,607950,2386930,34.17
9860141,9952132,5760,2016000,11968132,20.26
9860142,9947571,4427,1549450,11497021,15.58
9860143,9951343,4725,1653750,11605093,16.62
9860144,9956020,5355,1874250,11830270,18.83
9860145,9960857,3328,1164800,11125657,11.69
9860146,9955159,1072,375200,10330359,3.77
9860147,9927660,1685,589750,10517410,5.94
9860148,9937227,1090,381500,10318727,3.84
9860149,200418,411,143850,344268,71.77
9860150,9916912,3077,1076950,10993862,10.86
9860151,1269329,87,30450,1299779,2.40
9860152,9930498,1096,383600,10314098,3.86
9860153,9930655,2037,712950,10643605,7.18
9860154,9928086,2457,859950,10788036,8.66
9860155,9937098,1357,474950,10412048,4.78
9860156,9938367,6122,2142700,12081067,21.56
9860157,9954351,4476,1566600,11520951,15.74
9860158,9955685,6044,2115400,12071085,21.25
9860159,9951116,4072,1425200,11376316,14.32
9860160,9956741,2453,858550,10815291,8.62
9860161,2167022,946,331100,2498122,15.28
9860162,2132592,2363,827050,2959642,38.78
9860163,9953690,4067,1423450,11377140,14.30
9860164,9966357,4478,1567300,11533657,15.73
9860165,9966661,3093,1082550,11049211,10.86
9860166,717831,530,185500,903331,25.84
9860167,1817591,1544,540400,2357991,29.73
9860168,9973471,3000,1050000,11023471,10.53
9860169,9967564,2214,774900,10742464,7.77
9860170,517680,417,145950,663630,28.19
9860171,1249054,651,227850,1476904,18.24
9860172,9913189,2590,906500,10819689,9.14
9860173,9969860,2430,850500,10820360,8.53
9860174,88990,66,23100,112090,25.96
9860175,9978033,5280,1848000,11826033,18.52
9860176,9992461,4491,1571850,11564311,15.73
9860177,9988232,7619,2666650,12654882,26.70
9860178,9978324,1499,524650,10502974,5.26
9860179,9985145,3621,1267350,11252495,12.69
9860180,9969637,1015,355250,10324887,3.56
9860181,9974231,417,145950,10120181,1.46
9860182,9978253,1441,504350,10482603,5.05
9860183,9978649,3442,1204700,11183349,12.07
9860185,9974491,1605,561750,10536241,5.63
9860186,9986784,941,329350,10316134,3.30
9860187,9979915,3300,1155000,11134915,11.57
9860188,9988664,4783,1674050,11662714,16.76
9860189,9983122,2117,740950,10724072,7.42
9860190,9981659,3686,1290100,11271759,12.92
9860191,943437,1229,430150,1373587,45.59
9860192,9976907,5969,2089150,12066057,20.94
9860193,9986256,7150,2502500,12488756,25.06
9860194,344114,490,171500,515614,49.84
9860195,9964826,5612,1964200,11929026,19.71
9860196,9986697,5697,1993950,11980647,19.97
9860197,9988038,3733,1306550,11294588,13.08
9860198,1457581,319,111650,1569231,7.66
9860199,9980021,5779,2022650,12002671,20.27
9860200,9995197,7523,2633050,12628247,26.34
9860201,9991732,5262,1841700,11833432,18.43
9860202,9986504,4197,1468950,11455454,14.71
9860203,9991485,3910,1368500,11359985,13.70
9860204,483063,324,113400,596463,23.48
9860206,9967621,5669,1984150,11951771,19.91
9860207,9969719,4520,1582000,11551719,15.87
9860208,9974976,4583,1604050,11579026,16.08
9860209,1660686,1951,682850,2343536,41.12
9860210,9951508,4166,1458100,11409608,14.65
9860211,9962663,5069,1774150,11736813,17.81
9860212,9977705,3980,1393000,11370705,13.96
9860213,9986141,2186,765100,10751241,7.66
9860214,9983960,5925,2073750,12057710,20.77
9860215,868633,689,241150,1109783,27.76
9860216,9982607,5554,1943900,11926507,19.47
9860217,9962753,5225,1828750,11791503,18.36
9860218,1858142,2027,709450,2567592,38.18
9860219,9980215,8158,2855300,12835515,28.61
9860220,9982755,2447,856450,10839205,8.58
9860221,9984465,4888,1710800,11695265,17.13
9860222,9992322,2647,926450,10918772,9.27
9860223,2946635,1488,520800,3467435,17.67
9860224,9975668,5823,2038050,12013718,20.43
9860225,9979056,1969,689150,10668206,6.91
9860226,9984485,5258,1840300,11824785,18.43
9860227,9994004,2707,947450,10941454,9.48
9860228,9691041,2711,948850,10639891,9.79
9860229,4309928,3053,1068550,5378478,24.79
9860230,9979284,3524,1233400,11212684,12.36
9860231,9959153,2224,778400,10737553,7.82
9860232,9961645,4082,1428700,11390345,14.34
9860233,9942252,2725,953750,10896002,9.59
9860234,9953932,4539,1588650,11542582,15.96
9860235,9963929,4791,1676850,11640779,16.83
9860236,275217,257,89950,365167,32.68
9860237,4092762,2959,1035650,5128412,25.30
9860238,9992599,3239,1133650,11126249,11.34
9860240,9973248,3488,1220800,11194048,12.24
9860241,9987871,5246,1836100,11823971,18.38
9860242,9982199,4009,1403150,11385349,14.06
9860243,9986798,2729,955150,10941948,9.56
9860244,9980570,4783,1674050,11654620,16.77
9860245,9979917,5396,1888600,11868517,18.92
9860246,9978951,4232,1481200,11460151,14.84
9860247,1648887,1225,428750,2077637,26.00
9860248,9969060,5187,1815450,11784510,18.21
9860249,9951386,5001,1750350,11701736,17.59
9860250,99656,62,21700,121356,21.77
9860251,9957976,5261,1841350,11799326,18.49
9860252,9960506,2800,980000,10940506,9.84
9860253,9968271,7545,2640750,12609021,26.49
9860254,9945634,4696,1643600,11589234,16.53
9860255,9949856,6412,2244200,12194056,22.56
9860256,3819895,3041,1064350,4884245,27.86
9860257,4560276,1907,667450,5227726,14.64
9860258,9969242,4680,1638000,11607242,16.43
9860259,9970250,6270,2194500,12164750,22.01
9860260,2124571,1944,680400,2804971,32.03
9860261,9983754,5077,1776950,11760704,17.80
9860262,9978295,2476,866600,10844895,8.68
9860263,456256,562,196700,652956,43.11
9860264,205766,63,22050,227816,10.72
9860265,9947970,4388,1535800,11483770,15.44
9860266,1253390,565,197750,1451140,15.78
9860267,9943840,2654,928900,10872740,9.34
9860268,9957682,2945,1030750,10988432,10.35
9860269,9949561,5545,1940750,11890311,19.51
9860270,9961390,3323,1163050,11124440,11.68
9860271,9975362,5304,1856400,11831762,18.61
9860272,9972356,5396,1888600,11860956,18.94
9860273,9986118,2383,834050,10820168,8.35
9860274,9961521,7236,2532600,12494121,25.42
9860275,9974465,3948,1381800,11356265,13.85
9860276,1753180,1124,393400,2146580,22.44
9860277,5002109,1893,662550,5664659,13.25
9860278,9965813,2763,967050,10932863,9.70
9860279,9184818,3947,1381450,10566268,15.04
9860280,9962941,3796,1328600,11291541,13.34
9860281,9923293,4053,1418550,11341843,14.30
9860282,4172946,2293,802550,4975496,19.23
9860283,9952363,3140,1099000,11051363,11.04
9860284,9970487,6386,2235100,12205587,22.42
9860285,1441977,696,243600,1685577,16.89
9860286,9948026,4365,1527750,11475776,15.36
9860287,9945767,5237,1832950,11778717,18.43
9860288,9942469,6648,2326800,12269269,23.40
9860289,9953700,4362,1526700,11480400,15.34
9860290,9958796,3477,1216950,11175746,12.22
9860291,9948744,1713,599550,10548294,6.03
9860292,9939442,4391,1536850,11476292,15.46
9860293,9963157,6385,2234750,12197907,22.43
9860294,9945351,7061,2471350,12416701,24.85
9860295,9954169,3888,1360800,11314969,13.67
9860296,9977644,1996,698600,10676244,7.00
9860297,9972850,3668,1283800,11256650,12.87
9860298,244046,91,31850,275896,13.05
9860299,9960876,2207,772450,10733326,7.75
9860300,9961117,4680,1638000,11599117,16.44
9860301,9939159,2232,781200,10720359,7.86
9860302,2377961,1723,603050,2981011,25.36
9860303,2883840,699,244650,3128490,8.48
9860304,9944333,4231,1480850,11425183,14.89
9860305,209848,108,37800,247648,18.01
9860306,9932042,2995,1048250,10980292,10.55
9860307,1081066,300,105000,1186066,9.71
9860308,9940419,6136,2147600,12088019,21.60
9860309,9889058,3235,1132250,11021308,11.45
9860310,9943307,2346,821100,10764407,8.26
9860311,630469,265,92750,723219,14.71
9860312,9936481,4367,1528450,11464931,15.38
9860313,9937237,3650,1277500,11214737,12.86
9860314,279590,326,114100,393690,40.81
9860315,482173,355,124250,606423,25.77
9860316,9935397,4443,1555050,11490447,15.65
9860317,9939726,3710,1298500,11238226,13.06
9860318,9921810,4467,1563450,11485260,15.76
9860319,210884,137,47950,258834,22.74
9860320,9930104,1906,667100,10597204,6.72
9860321,9824452,4883,1709050,11533502,17.40
9860322,1001611,999,349650,1351261,34.91
9860323,9935966,5224,1828400,11764366,18.40
9860324,9941428,1196,418600,10360028,4.21
9860325,9940959,2462,861700,10802659,8.67
9860326,9945451,5906,2067100,12012551,20.78
9860327,9960767,1653,578550,10539317,5.81
9860328,9957765,2710,948500,10906265,9.53
9860329,9966193,3858,1350300,11316493,13.55
9860330,9971979,3884,1359400,11331379,13.63
9860331,54570,28,9800,64370,17.96
9860332,9974221,3075,1076250,11050471,10.79
9860333,9954919,1389,486150,10441069,4.88
9860334,9974001,2558,895300,10869301,8.98
9860335,9973447,5468,1913800,11887247,19.19
9860336,9987289,2965,1037750,11025039,10.39
9860337,9992987,1835,642250,10635237,6.43
9860338,98461,127,44450,142911,45.14
9860339,9977523,3781,1323350,11300873,13.26
9860340,9968093,5068,1773800,11741893,17.79
9860341,9974446,5204,1821400,11795846,18.26
9860342,9879122,2091,731850,10610972,7.41
9860343,9914694,4585,1604750,11519444,16.19
9860344,9900416,4474,1565900,11466316,15.82
9860345,9978891,2953,1033550,11012441,10.36
9860347,684340,591,206850,891190,30.23
9860348,725567,242,84700,810267,11.67
9860349,3286068,1965,687750,3973818,20.93
9860350,8984860,4967,1738450,10723310,19.35
9860351,9979195,5449,1907150,11886345,19.11
9860352,146434,46,16100,162534,10.99
9860353,9975124,6620,2317000,12292124,23.23
9860354,9995572,2544,890400,10885972,8.91
9860355,59285,103,36050,95335,60.81
9860356,9966409,5006,1752100,11718509,17.58
9860357,9969193,4863,1702050,11671243,17.07
9860358,9976619,5980,2093000,12069619,20.98
9860359,9980790,2327,814450,10795240,8.16
9860360,9996678,5357,1874950,11871628,18.76
9860361,9980204,2976,1041600,11021804,10.44
9860362,9972972,712,249200,10222172,2.50
9860363,9979007,4278,1497300,11476307,15.00
9860364,9998399,4961,1736350,11734749,17.37
9860365,9981356,6063,2122050,12103406,21.26
9860366,445243,292,102200,547443,22.95
9860367,9922216,4950,1732500,11654716,17.46
9860368,9972146,3059,1070650,11042796,10.74
9860369,9995021,5605,1961750,11956771,19.63
9860370,9982403,3500,1225000,11207403,12.27
9860371,9977195,3441,1204350,11181545,12.07
9860372,9976123,2469,864150,10840273,8.66
9860373,9983468,3324,1163400,11146868,11.65
9860374,9679366,4398,1539300,11218666,15.90
9860375,755390,474,165900,921290,21.96
9860376,9990049,5771,2019850,12009899,20.22
9860377,9991318,5594,1957900,11949218,19.60
9860378,9986911,4981,1743350,11730261,17.46
9860379,9974436,5207,1822450,11796886,18.27
9860380,9994855,4357,1524950,11519805,15.26
9860381,9984986,6315,2210250,12195236,22.14
9860382,9981714,3923,1373050,11354764,13.76
9860383,9985271,3026,1059100,11044371,10.61
9860384,9982609,2424,848400,10831009,8.50
9860385,9986170,2209,773150,10759320,7.74
9860386,9987548,3892,1362200,11349748,13.64
9860387,9986982,3499,1224650,11211632,12.26
9860388,9995543,5274,1845900,11841443,18.47
9860389,9997665,4521,1582350,11580015,15.83
9860390,9989131,3288,1150800,11139931,11.52
9860391,509525,423,148050,657575,29.06
9860392,9964402,2457,859950,10824352,8.63
9860393,9962652,6032,2111200,12073852,21.19
9860394,9981422,3866,1353100,11334522,13.56
9860395,533240,265,92750,625990,17.39
9860396,2683267,1347,471450,3154717,17.57
9860397,9950381,3540,1239000,11189381,12.45
9860398,1072857,507,177450,1250307,16.54
9860399,9942369,2653,928550,10870919,9.34
9860400,9927292,2520,882000,10809292,8.88
9860401,9909097,3823,1338050,11247147,13.50
9860402,9923885,4440,1554000,11477885,15.66
9860403,9925494,6047,2116450,12041944,21.32
9860404,1790918,848,296800,2087718,16.57
9860405,9926233,5778,2022300,11948533,20.37
9860406,1824242,1062,371700,2195942,20.38
9860407,9916835,4349,1522150,11438985,15.35
9860408,9910451,3241,1134350,11044801,11.45
9860409,9932451,4487,1570450,11502901,15.81
9860410,9937492,4400,1540000,11477492,15.50
9860411,9831503,3354,1173900,11005403,11.94
9860412,9939376,5385,1884750,11824126,18.96
9860414,9929179,1116,390600,10319779,3.93
9860415,9939121,3420,1197000,11136121,12.04
9860416,9943680,3153,1103550,11047230,11.10
9860417,9929778,4794,1677900,11607678,16.90
9860418,9931267,3044,1065400,10996667,10.73
9860419,57975,26,9100,67075,15.70
9860420,9948693,3427,1199450,11148143,12.06
9860421,9944926,2704,946400,10891326,9.52
9860422,9958003,4243,1485050,11443053,14.91
9860423,9958612,3593,1257550,11216162,12.63
9860424,9951470,4384,1534400,11485870,15.42
9860425,9969377,4606,1612100,11581477,16.17
9860426,9968465,1027,359450,10327915,3.61
9860427,9979010,672,235200,10214210,2.36
9860428,9968766,2771,969850,10938616,9.73
9860429,1896876,933,326550,2223426,17.22
9860430,3747181,1553,543550,4290731,14.51
9860431,9766804,4233,1481550,11248354,15.17
9860432,9958875,1930,675500,10634375,6.78
9860433,9963011,4437,1552950,11515961,15.59
9860434,457514,506,177100,634614,38.71
9860435,1249808,561,196350,1446158,15.71
9860436,9932116,3495,1223250,11155366,12.32
9860437,9917883,5506,1927100,11844983,19.43
9860438,372887,284,99400,472287,26.66
9860439,9904647,2941,1029350,10933997,10.39
9860440,68197,42,14700,82897,21.56
9860441,9934091,3159,1105650,11039741,11.13
9860442,9941233,4110,1438500,11379733,14.47
9860443,906766,180,63000,969766,6.95
9860444,1686569,589,206150,1892719,12.22
9860445,9926055,3670,1284500,11210555,12.94
9860446,4663035,1865,652750,5315785,14.00
9860447,9932984,3890,1361500,11294484,13.71
9860448,9933764,5145,1800750,11734514,18.13
9860449,9916789,3998,1399300,11316089,14.11
9860450,9923477,4881,1708350,11631827,17.22
9860451,1263846,728,254800,1518646,20.16
9860452,9952606,5316,1860600,11813206,18.69
9860453,9937568,2554,893900,10831468,9.00
9860454,9949063,3624,1268400,11217463,12.75
9860455,1029905,354,123900,1153805,12.03
9860456,9938932,4950,1732500,11671432,17.43
9860457,9954054,469,164150,10118204,1.65
9860458,9955031,3039,1063650,11018681,10.68
9860459,9967887,546,191100,10158987,1.92
9860460,9966274,2590,906500,10872774,9.10
9860461,9988730,2936,1027600,11016330,10.29
9860462,9994148,3672,1285200,11279348,12.86
9860463,9999636,2315,810250,10809886,8.10
9860464,9979404,6290,2201500,12180904,22.06
9860466,531181,314,109900,641081,20.69
9860467,9962757,3571,1249850,11212607,12.55
9860468,9972718,3097,1083950,11056668,10.87
9860469,9963689,7305,2556750,12520439,25.66
9860470,9957367,2930,1025500,10982867,10.30
9860472,2078341,1250,437500,2515841,21.05
9860473,9957849,5793,2027550,11985399,20.36
9860474,9968471,3000,1050000,11018471,10.53
9860475,9931857,3487,1220450,11152307,12.29
9860476,9958687,1905,666750,10625437,6.70
9860477,9971716,2245,785750,10757466,7.88
9860478,9968428,2810,983500,10951928,9.87
9860479,9992137,1489,521150,10513287,5.22
9860480,185184,188,65800,250984,35.53
9860481,9896574,3318,1161300,11057874,11.73
9860482,9980628,4164,1457400,11438028,14.60
9860483,525849,306,107100,632949,20.37
9860484,9991989,3505,1226750,11218739,12.28
9860485,9988690,2288,800800,10789490,8.02
9860486,9984015,5144,1800400,11784415,18.03
9860487,9988993,3219,1126650,11115643,11.28
9860488,9987095,4521,1582350,11569445,15.84
9860489,9994313,4740,1659000,11653313,16.60
9860490,9979686,1444,505400,10485086,5.06
9860491,9998866,2253,788550,10787416,7.89
9860492,9999749,3320,1162000,11161749,11.62
9860493,876342,484,169400,1045742,19.33
9860494,9868456,3527,1234450,11102906,12.51
9860495,407066,239,83650,490716,20.55
9860496,9865560,1649,577150,10442710,5.85
9860497,8957056,2634,921900,9878956,10.29
9860498,9969241,3989,1396150,11365391,14.00
9860499,9964570,3536,1237600,11202170,12.42
9860500,9975933,2786,975100,10951033,9.77
9860501,9963974,3070,1074500,11038474,10.78
9860502,9985666,5887,2060450,12046116,20.63
9860503,888743,277,96950,985693,10.91
9860504,9973432,5491,1921850,11895282,19.27
9860505,3618093,2019,706650,4324743,19.53
9860506,9965781,3956,1384600,11350381,13.89
9860507,1295827,389,136150,1431977,10.51
9860508,9979796,4301,1505350,11485146,15.08
9860509,9979865,1745,610750,10590615,6.12
9860510,9964733,3959,1385650,11350383,13.91
9860511,9970192,1902,665700,10635892,6.68
9860512,9956124,3212,1124200,11080324,11.29
9860513,9960691,3222,1127700,11088391,11.32
9860514,9984782,4250,1487500,11472282,14.90
9860515,4573212,3395,1188250,5761462,25.98
9860516,9978663,5934,2076900,12055563,20.81
9860517,9877816,4510,1578500,11456316,15.98
9860518,9880314,6758,2365300,12245614,23.94
9860519,8733559,5609,1963150,10696709,22.48
9860520,4323601,2543,890050,5213651,20.59
9860521,9980075,5476,1916600,11896675,19.20
9860522,9985151,6703,2346050,12331201,23.50
9860523,9973210,6254,2188900,12162110,21.95
9860524,9987829,1992,697200,10685029,6.98
9860525,9954573,3897,1363950,11318523,13.70
9860526,9992458,3482,1218700,11211158,12.20
9860527,9943850,2248,786800,10730650,7.91
9860528,9955988,1401,490350,10446338,4.93
9860529,949135,258,90300,1039435,9.51
9860530,1877814,1636,572600,2450414,30.49
9860531,278021,42,14700,292721,5.29
9860532,434364,582,203700,638064,46.90
9860533,1966814,491,171850,2138664,8.74
9860534,9960740,5844,2045400,12006140,20.53
9860535,1569423,619,216650,1786073,13.80
9860536,1192112,579,202650,1394762,17.00
9860537,9899562,5212,1824200,11723762,18.43
9860538,1184523,686,240100,1424623,20.27
9860539,9968329,3859,1350650,11318979,13.55
9860540,9971978,4542,1589700,11561678,15.94
9860541,8989170,2979,1042650,10031820,11.60
9860542,9989865,4521,1582350,11572215,15.84
9860543,9730750,4864,1702400,11433150,17.50
9860544,9986139,5009,1753150,11739289,17.56
9860545,9995540,4517,1580950,11576490,15.82
9860546,9986650,2686,940100,10926750,9.41
9860547,9971121,3518,1231300,11202421,12.35
9860548,9981078,3437,1202950,11184028,12.05
9860549,9991673,5697,1993950,11985623,19.96
9860550,9991233,4681,1638350,11629583,16.40
9860551,9987237,2719,951650,10938887,9.53
9860552,9982885,3193,1117550,11100435,11.19
9860553,9961859,2027,709450,10671309,7.12
9860554,9975193,4616,1615600,11590793,16.20
9860555,9967453,3530,1235500,11202953,12.40
9860556,9972242,1028,359800,10332042,3.61
9860557,2221083,975,341250,2562333,15.36
9860558,9965402,1893,662550,10627952,6.65
9860559,9978587,390,136500,10115087,1.37
9860560,9956763,2683,939050,10895813,9.43
9860561,9987894,3868,1353800,11341694,13.55
9860562,1068382,471,164850,1233232,15.43
9860563,9960574,4107,1437450,11398024,14.43
9860564,9953623,2065,722750,10676373,7.26
9860565,9965710,2451,857850,10823560,8.61
9860566,9967155,678,237300,10204455,2.38
9860568,9940044,2673,935550,10875594,9.41
9860569,9954148,3064,1072400,11026548,10.77
9860570,9962219,2049,717150,10679369,7.20
9860571,9931736,2389,836150,10767886,8.42
9860572,9949203,3276,1146600,11095803,11.52
9860573,1585779,611,213850,1799629,13.49
9860574,9960296,5261,1841350,11801646,18.49
9860575,9969300,2056,719600,10688900,7.22
9860576,9979423,437,152950,10132373,1.53
9860577,9991168,3612,1264200,11255368,12.65
9860578,9894416,4764,1667400,11561816,16.85
9860579,165751,95,33250,199001,20.06
9860580,9980233,6189,2166150,12146383,21.70
9860581,1309865,1489,521150,1831015,39.79
9860582,9985040,4494,1572900,11557940,15.75
9860583,9929992,2418,846300,10776292,8.52
9860584,9988422,4055,1419250,11407672,14.21
9860585,9908135,1473,515550,10423685,5.20
9860586,9693551,2028,709800,10403351,7.32
9860587,9988457,369,129150,10117607,1.29
9860588,56209,42,14700,70909,26.15
9860589,9980241,3216,1125600,11105841,11.28
9860590,118418,42,14700,133118,12.41
9860591,198761,47,16450,215211,8.28
9860592,9989035,1875,656250,10645285,6.57
9860593,9991272,4732,1656200,11647472,16.58
9860595,1112060,1289,451150,1563210,40.57
9860596,9961320,5022,1757700,11719020,17.65
9860597,9931235,6770,2369500,12300735,23.86
9860598,9953387,4563,1597050,11550437,16.05
9860599,2165944,472,165200,2331144,7.63
9860600,1722621,1080,378000,2100621,21.94
9860601,9969719,5656,1979600,11949319,19.86
9860602,9957643,2851,997850,10955493,10.02
9860603,9943797,6476,2266600,12210397,22.79
9860604,9935386,5252,1838200,11773586,18.50
9860605,9940707,3460,1211000,11151707,12.18
9860606,9949809,4389,1536150,11485959,15.44
9860607,9955817,3419,1196650,11152467,12.02
9860608,9969762,957,334950,10304712,3.36
9860609,1450393,685,239750,1690143,16.53
9860610,9951048,2284,799400,10750448,8.03
9860611,9967582,2962,1036700,11004282,10.40
9860612,9975571,4034,1411900,11387471,14.15
9860613,9975010,3011,1053850,11028860,10.56
9860614,9974358,3300,1155000,11129358,11.58
9860615,2606594,1876,656600,3263194,25.19
9860616,9990930,5021,1757350,11748280,17.59
9860617,9987079,4311,1508850,11495929,15.11
9860618,9956490,5515,1930250,11886740,19.39
9860619,9995882,6517,2280950,12276832,22.82
9860620,9987974,5697,1993950,11981924,19.96
9860621,9983120,4976,1741600,11724720,17.45
9860622,9948562,5424,1898400,11846962,19.08
9860623,9958262,5277,1846950,11805212,18.55
9860624,9972465,5003,1751050,11723515,17.56
9860625,9959972,1519,531650,10491622,5.34
9860626,9980876,6070,2124500,12105376,21.29
9860627,9949268,498,174300,10123568,1.75
9860628,9959662,5567,1948450,11908112,19.56
9860629,9428595,2837,992950,10421545,10.53
9860630,9005369,697,243950,9249319,2.71
9860631,9143862,4981,1743350,10887212,19.07
9860632,8389188,2004,701400,9090588,8.36
9860633,9896218,2422,847700,10743918,8.57
9860634,9760974,1308,457800,10218774,4.69
9860635,422841,265,92750,515591,21.93
9860636,9891693,5048,1766800,11658493,17.86
9860637,9984600,7848,2746800,12731400,27.51
9860638,9987840,8695,3043250,13031090,30.47
9860639,9987576,3872,1355200,11342776,13.57
9860640,9969020,3018,1056300,11025320,10.60
9860641,9956989,2717,950950,10907939,9.55
9860642,9979751,3585,1254750,11234501,12.57
9860643,9970071,4949,1732150,11702221,17.37
9860644,9999739,8245,2885750,12885489,28.86
9860645,9996717,5322,1862700,11859417,18.63
9860646,9994266,5289,1851150,11845416,18.52
9860647,9987901,6698,2344300,12332201,23.47
9860648,9991379,6508,2277800,12269179,22.80
9860649,9989326,4967,1738450,11727776,17.40
9860650,3534799,1740,609000,4143799,17.23
9860651,9968621,5395,1888250,11856871,18.94
9860652,9980135,5892,2062200,12042335,20.66
9860653,1533626,485,169750,1703376,11.07
9860654,9981913,4498,1574300,11556213,15.77
9860655,9978315,6364,2227400,12205715,22.32
9860656,847619,664,232400,1080019,27.42
9860657,9967306,9063,3172050,13139356,31.82
9860658,9969911,5647,1976450,11946361,19.82
9860659,9964584,1661,581350,10545934,5.83
9860660,9963324,564,197400,10160724,1.98
9860661,9979931,6015,2105250,12085181,21.09
9860662,9968057,4000,1400000,11368057,14.04
9860663,9953671,4867,1703450,11657121,17.11
9860664,3265233,1522,532700,3797933,16.31
9860665,9973174,6326,2214100,12187274,22.20
9860666,2264954,1668,583800,2848754,25.78
9860667,439594,157,54950,494544,12.50
9860668,6120009,1630,570500,6690509,9.32
9860669,9965564,4747,1661450,11627014,16.67
9860670,9973158,3045,1065750,11038908,10.69
9860671,9991214,4447,1556450,11547664,15.58
9860672,9986833,5451,1907850,11894683,19.10
9860673,5949613,4043,1415050,7364663,23.78
9860674,9989952,5537,1937950,11927902,19.40
9860675,9651925,6212,2174200,11826125,22.53
9860676,9973495,5414,1894900,11868395,19.00
9860677,9982078,3801,1330350,11312428,13.33
9860678,514654,448,156800,671454,30.47
9860679,3232722,2694,942900,4175622,29.17
9860680,9957380,6431,2250850,12208230,22.60
9860681,9970901,2763,967050,10937951,9.70
9860682,1814343,1580,553000,2367343,30.48
9860683,9498136,3280,1148000,10646136,12.09
9860684,9975124,4709,1648150,11623274,16.52
9860685,9954483,3064,1072400,11026883,10.77
9860686,9969428,4450,1557500,11526928,15.62
9860687,9965011,5812,2034200,11999211,20.41
9860688,211756,128,44800,256556,21.16
9860689,9954431,4309,1508150,11462581,15.15
9860690,9954002,3907,1367450,11321452,13.74
9860691,9939371,5768,2018800,11958171,20.31
9860692,9934892,4993,1747550,11682442,17.59
9860693,9930216,4770,1669500,11599716,16.81
9860694,9925485,4716,1650600,11576085,16.63
9860695,9942512,3853,1348550,11291062,13.56
9860696,9956397,1905,666750,10623147,6.70
9860697,9933534,4632,1621200,11554734,16.32
9860698,9933077,3564,1247400,11180477,12.56
9860699,9933917,6721,2352350,12286267,23.68
9860700,1796140,623,218050,2014190,12.14
9860701,9952637,4992,1747200,11699837,17.56
9860702,9952108,6235,2182250,12134358,21.93
9860703,9959522,1411,493850,10453372,4.96
9860704,9939993,5641,1974350,11914343,19.86
9860705,9935958,6388,2235800,12171758,22.50
9860706,9937156,6481,2268350,12205506,22.83
9860707,9949922,6150,2152500,12102422,21.63
9860708,9958060,4194,1467900,11425960,14.74
9860709,9950843,2436,852600,10803443,8.57
9860710,9968778,4702,1645700,11614478,16.51
9860711,9979582,5176,1811600,11791182,18.15
9860712,9985909,5718,2001300,11987209,20.04
9860713,9981111,6234,2181900,12163011,21.86
9860714,9969617,2675,936250,10905867,9.39
9860715,1745634,610,213500,1959134,12.23
9860716,9982334,5193,1817550,11799884,18.21
9860717,9981337,3190,1116500,11097837,11.19
9860718,9976919,5420,1897000,11873919,19.01
9860719,9986229,5781,2023350,12009579,20.26
9860720,9989508,3852,1348200,11337708,13.50
9860721,3519375,703,246050,3765425,6.99
9860722,9973032,5695,1993250,11966282,19.99
9860723,9970377,1083,379050,10349427,3.80
9860724,9977185,4075,1426250,11403435,14.30
9860725,9765465,1601,560350,10325815,5.74
9860726,9931944,1163,407050,10338994,4.10
9860727,9643342,6474,2265900,11909242,23.50
9860728,9977894,5686,1990100,11967994,19.95
9860729,9976521,4435,1552250,11528771,15.56
9860730,1831547,2735,957250,2788797,52.26
9860731,9987190,6397,2238950,12226140,22.42
9860732,9999397,4870,1704500,11703897,17.05
9860733,9986342,1814,634900,10621242,6.36
9860734,8993430,2427,849450,9842880,9.45
9860735,9951037,5534,1936900,11887937,19.46
9860736,9985296,3607,1262450,11247746,12.64
9860737,1119798,63,22050,1141848,1.97
9860738,9971214,4327,1514450,11485664,15.19
9860739,9961755,5051,1767850,11729605,17.75
9860740,3826460,3250,1137500,4963960,29.73
9860742,9934808,4056,1419600,11354408,14.29
9860743,8789915,4332,1516200,10306115,17.25
9860744,8786852,2076,726600,9513452,8.27
9860745,9934112,5716,2000600,11934712,20.14
9860746,9940646,4332,1516200,11456846,15.25
9860747,4791848,2121,742350,5534198,15.49
9860748,9946864,6357,2224950,12171814,22.37
9860749,9955147,5426,1899100,11854247,19.08
9860750,9957976,2459,860650,10818626,8.64
9860751,9982557,2733,956550,10939107,9.58
9860753,9959797,1889,661150,10620947,6.64
9860754,6912036,3993,1397550,8309586,20.22
9860755,9995227,3514,1229900,11225127,12.30
9860756,9994907,5234,1831900,11826807,18.33
9860757,338126,284,99400,437526,29.40
9860758,9982157,3851,1347850,11330007,13.50
9860759,9970629,3917,1370950,11341579,13.75
9860760,9947206,3071,1074850,11022056,10.81
9860761,7167874,3903,1366050,8533924,19.06
9860762,9965566,3692,1292200,11257766,12.97
9860763,9960856,4271,1494850,11455706,15.01
9860764,9969023,3183,1114050,11083073,11.18
9860765,9985040,2432,851200,10836240,8.52
9860766,9951731,3195,1118250,11069981,11.24
9860767,999181,585,204750,1203931,20.49
9860768,9857941,5139,1798650,11656591,18.25
9860769,9980337,5825,2038750,12019087,20.43
9860770,9988900,4776,1671600,11660500,16.73
9860771,9950988,3627,1269450,11220438,12.76
9860772,9764985,2152,753200,10518185,7.71
9860773,491995,318,111300,603295,22.62
9860774,9888051,3423,1198050,11086101,12.12
9860775,9894512,7342,2569700,12464212,25.97
9860776,4237175,3081,1078350,5315525,25.45
9860777,9964535,3391,1186850,11151385,11.91
9860778,9983220,4627,1619450,11602670,16.22
9860779,9977150,4239,1483650,11460800,14.87
9860780,9970439,3061,1071350,11041789,10.75
9860781,9964612,5273,1845550,11810162,18.52
9860782,9972785,4535,1587250,11560035,15.92
9860783,9969536,4034,1411900,11381436,14.16
9860784,9968814,4752,1663200,11632014,16.68
9860785,9978127,2333,816550,10794677,8.18
9860786,9974852,5665,1982750,11957602,19.88
9860787,8980408,4386,1535100,10515508,17.09
9860788,9973855,5905,2066750,12040605,20.72
9860789,9993106,5886,2060100,12053206,20.62
9860790,9987883,2931,1025850,11013733,10.27
9860791,9991279,5930,2075500,12066779,20.77
9860792,9990590,5323,1863050,11853640,18.65
9860793,9981290,6864,2402400,12383690,24.07
9860794,9989804,5134,1796900,11786704,17.99
9860795,9987126,5681,1988350,11975476,19.91
9860796,9855998,6227,2179450,12035448,22.11
9860797,9985925,4865,1702750,11688675,17.05
9860798,9975063,7042,2464700,12439763,24.71
9860799,9993802,4962,1736700,11730502,17.38
9860800,9981450,4679,1637650,11619100,16.41
9860802,9984695,3857,1349950,11334645,13.52
9860803,9977933,5091,1781850,11759783,17.86
9860804,9977514,5492,1922200,11899714,19.27
9860805,9984048,4436,1552600,11536648,15.55
9860806,9987892,6856,2399600,12387492,24.03
9860807,9973348,4939,1728650,11701998,17.33
9860808,9995055,6741,2359350,12354405,23.61
9860809,9995734,7010,2453500,12449234,24.55
9860810,9994889,5433,1901550,11896439,19.03
9860811,9977124,4896,1713600,11690724,17.18
9860812,9981482,6413,2244550,12226032,22.49
9860813,9974166,6162,2156700,12130866,21.62
9860814,9983339,4533,1586550,11569889,15.89
9860815,9975482,7042,2464700,12440182,24.71
9860816,9982978,5458,1910300,11893278,19.14
9860817,9993038,4779,1672650,11665688,16.74
9860818,9985274,4820,1687000,11672274,16.89
9860819,367316,366,128100,495416,34.87
9860820,9952818,6665,2332750,12285568,23.44
9860821,9959641,6245,2185750,12145391,21.95
9860822,9952269,5341,1869350,11821619,18.78
9860823,9763793,4473,1565550,11329343,16.03
9860825,9973932,4686,1640100,11614032,16.44
9860826,9996929,6329,2215150,12212079,22.16
9860827,9977918,5444,1905400,11883318,19.10
9860828,9996009,4690,1641500,11637509,16.42
9860830,9988798,4220,1477000,11465798,14.79
9860831,9985491,5354,1873900,11859391,18.77
9860832,9996412,6705,2346750,12343162,23.48
9860833,9980076,8982,3143700,13123776,31.50
9860834,9985586,3897,1363950,11349536,13.66
9860835,9977586,7485,2619750,12597336,26.26
9860836,9956388,5377,1881950,11838338,18.90
9860837,9979141,5598,1959300,11938441,19.63
9860838,9979953,4294,1502900,11482853,15.06
9860839,8512716,3707,1297450,9810166,15.24
9860841,9969471,4058,1420300,11389771,14.25
9860843,9937247,3021,1057350,10994597,10.64
9860844,9977847,4844,1695400,11673247,16.99
9860845,9970492,7515,2630250,12600742,26.38
9860846,9976065,3740,1309000,11285065,13.12
9860847,8564016,2800,980000,9544016,11.44
9860849,8904345,4781,1673350,10577695,18.79
9860850,9987843,8994,3147900,13135743,31.52
9860851,9972394,5645,1975750,11948144,19.81
9860852,9993710,6395,2238250,12231960,22.40
9860853,9980561,4256,1489600,11470161,14.93
9860854,1028614,803,281050,1309664,27.32
9860855,9977591,8405,2941750,12919341,29.48
9860856,9965122,1503,526050,10491172,5.28
9860857,9965491,3738,1308300,11273791,13.13
9860858,9765748,4792,1677200,11442948,17.17
9860859,9972468,5247,1836450,11808918,18.42
9860860,9980313,4974,1740900,11721213,17.44
9860861,9284525,3641,1274350,10558875,13.73
9860862,9978560,4405,1541750,11520310,15.45
9860863,9973393,2690,941500,10914893,9.44
9860864,9971198,5736,2007600,11978798,20.13
9860865,9976361,3932,1376200,11352561,13.79
9860866,9977704,5964,2087400,12065104,20.92
9860867,7681983,4489,1571150,9253133,20.45
9860868,5660154,3740,1309000,6969154,23.13
9860869,9224060,7250,2537500,11761560,27.51
9860870,9965249,4482,1568700,11533949,15.74
9860871,9963101,6774,2370900,12334001,23.80
9860872,9972596,4910,1718500,11691096,17.23
9860873,1725790,835,292250,2018040,16.93
9860874,7608906,2967,1038450,8647356,13.65
9860875,9949616,5331,1865850,11815466,18.75
9860876,9951049,4044,1415400,11366449,14.22
9860877,9962063,5828,2039800,12001863,20.48
9860878,9959399,5811,2033850,11993249,20.42
9860879,1200240,495,173250,1373490,14.43
9860880,4344334,1718,601300,4945634,13.84
9860881,9991278,4098,1434300,11425578,14.36
9860884,367391,250,87500,454891,23.82
9860885,9953353,2120,742000,10695353,7.45
9860886,9955702,6026,2109100,12064802,21.18
9860887,9966651,6774,2370900,12337551,23.79
9860888,9952646,6516,2280600,12233246,22.91
9860889,9982095,4900,1715000,11697095,17.18
9860890,9992624,3873,1355550,11348174,13.57
9860891,9962800,5015,1755250,11718050,17.62
9860892,9995550,1681,588350,10583900,5.89
9860893,847795,1108,387800,1235595,45.74
9860894,9978795,4434,1551900,11530695,15.55
9860895,9962706,6546,2291100,12253806,23.00
9860896,9964983,5004,1751400,11716383,17.58
9860898,9976211,1500,525000,10501211,5.26
9860899,9956514,2624,918400,10874914,9.22
9860900,9990142,2196,768600,10758742,7.69
9860901,9969982,3877,1356950,11326932,13.61
9860902,9973590,4020,1407000,11380590,14.11
9860903,9984211,6390,2236500,12220711,22.40
9860904,9985482,5391,1886850,11872332,18.90
9860905,9977118,4472,1565200,11542318,15.69
9860906,9904934,1661,581350,10486284,5.87
9860907,9979952,4846,1696100,11676052,17.00
9860908,9978468,7407,2592450,12570918,25.98
9860909,9979714,5330,1865500,11845214,18.69
9860910,9968691,4396,1538600,11507291,15.43
9860911,9927454,3662,1281700,11209154,12.91
9860912,1685246,729,255150,1940396,15.14
9860913,9953160,2798,979300,10932460,9.84
9860914,3381630,1287,450450,3832080,13.32
9860915,9977155,5872,2055200,12032355,20.60
9860916,9968300,6042,2114700,12083000,21.21
9860917,9978736,5869,2054150,12032886,20.59
9860918,9984372,4861,1701350,11685722,17.04
9860919,9998423,3608,1262800,11261223,12.63
9860920,9979252,3064,1072400,11051652,10.75
9860921,9989990,4161,1456350,11446340,14.58
9860923,9986115,2799,979650,10965765,9.81
9860924,9984511,5097,1783950,11768461,17.87
9860926,9959718,5359,1875650,11835368,18.83
9860927,9975832,3181,1113350,11089182,11.16
9860928,9994299,6407,2242450,12236749,22.44
9860929,9965242,5975,2091250,12056492,20.99
9860930,9990952,3494,1222900,11213852,12.24
9860931,9974103,4839,1693650,11667753,16.98
9860932,5025834,1944,680400,5706234,13.54
9860933,9966769,2235,782250,10749019,7.85
9860934,9951426,4536,1587600,11539026,15.95
9860935,9954893,4101,1435350,11390243,14.42
9860936,9946010,1164,407400,10353410,4.10
9860937,9752926,4771,1669850,11422776,17.12
9860938,4561486,3202,1120700,5682186,24.57
9860939,9979876,7067,2473450,12453326,24.78
9860940,9978575,2948,1031800,11010375,10.34
9860941,9989708,4884,1709400,11699108,17.11
9860942,9967563,4445,1555750,11523313,15.61
9860943,9973834,3288,1150800,11124634,11.54
9860944,9952919,1955,684250,10637169,6.87
9860945,9976872,1961,686350,10663222,6.88
9860946,9978970,6778,2372300,12351270,23.77
9860947,241818,134,46900,288718,19.39
9860948,9995923,4607,1612450,11608373,16.13
9860949,9972993,5885,2059750,12032743,20.65
9860950,9989887,4872,1705200,11695087,17.07
9860951,9996439,4444,1555400,11551839,15.56
9860952,9994970,6566,2298100,12293070,22.99
9860954,9971765,3913,1369550,11341315,13.73
9860955,9986238,4987,1745450,11731688,17.48
9860956,9693005,2814,984900,10677905,10.16
9860957,9997279,4173,1460550,11457829,14.61
9860958,9990040,2177,761950,10751990,7.63
9860959,9985912,4608,1612800,11598712,16.15
9860960,9984409,1507,527450,10511859,5.28
9860961,9972988,2925,1023750,10996738,10.27
9860962,9995410,4044,1415400,11410810,14.16
9860963,9996729,2092,732200,10728929,7.32
9860964,7794434,4327,1514450,9308884,19.43
9860965,9975525,5243,1835050,11810575,18.40
9860966,9980612,5582,1953700,11934312,19.57
9860967,9981085,3109,1088150,11069235,10.90
9860968,9989707,3132,1096200,11085907,10.97
9860969,9973536,6129,2145150,12118686,21.51
9860970,9990028,5164,1807400,11797428,18.09
9860971,9982083,4837,1692950,11675033,16.96
9860972,2305640,1886,660100,2965740,28.63
9860973,9993706,3421,1197350,11191056,11.98
9860974,156943,79,27650,184593,17.62
9860975,9958446,2831,990850,10949296,9.95
9860976,9979395,1466,513100,10492495,5.14
9860977,9973687,2332,816200,10789887,8.18
9860978,9995713,5426,1899100,11894813,19.00
9860979,9981106,3318,1161300,11142406,11.63
9860980,9997064,1094,382900,10379964,3.83
9860981,9972525,4710,1648500,11621025,16.53
9860982,9985933,2530,885500,10871433,8.87
9860983,9995918,3749,1312150,11308068,13.13
9860984,130586,92,32200,162786,24.66
9860986,9982598,4091,1431850,11414448,14.34
9860987,9999485,1791,626850,10626335,6.27
9860988,9971558,4948,1731800,11703358,17.37
9860989,9991812,3514,1229900,11221712,12.31
9860990,9995424,4203,1471050,11466474,14.72
9860991,9994007,2225,778750,10772757,7.79
9860992,2677175,1904,666400,3343575,24.89
9860994,9655772,6107,2137450,11793222,22.14
9860995,1616168,1313,459550,2075718,28.43
9860996,9969242,3609,1263150,11232392,12.67
9860997,9971237,3257,1139950,11111187,11.43
9860998,9968654,3089,1081150,11049804,10.85
9860999,9975120,3877,1356950,11332070,13.60
9861000,868553,656,229600,1098153,26.43
9861001,9956968,2047,716450,10673418,7.20
9861002,4812978,2229,780150,5593128,16.21
9861003,9947402,5456,1909600,11857002,19.20
9861004,9952159,2283,799050,10751209,8.03
9861005,2009461,683,239050,2248511,11.90
9861006,9955889,3492,1222200,11178089,12.28
9861007,9946904,4322,1512700,11459604,15.21
9861008,4213928,1910,668500,4882428,15.86
9861009,9929164,3484,1219400,11148564,12.28
9861010,9927160,3197,1118950,11046110,11.27
9861011,9929734,4722,1652700,11582434,16.64
9861012,9942188,5494,1922900,11865088,19.34
9861013,9930137,4519,1581650,11511787,15.93
9861014,9941765,4856,1699600,11641365,17.10
9861015,9412517,2100,735000,10147517,7.81
9861016,9948101,5047,1766450,11714551,17.76
9861017,9959426,1199,419650,10379076,4.21
9861018,9951649,655,229250,10180899,2.30
9861019,1915937,1873,655550,2571487,34.22
9861020,9915934,608,212800,10128734,2.15
9861021,1735595,1388,485800,2221395,27.99
9861022,9929065,4617,1615950,11545015,16.27
9861023,9928098,4231,1480850,11408948,14.92
9861024,9937850,3903,1366050,11303900,13.75
9861025,2697773,896,313600,3011373,11.62
9861026,9952676,4138,1448300,11400976,14.55
9861027,9953108,4141,1449350,11402458,14.56
9861028,9938924,4137,1447950,11386874,14.57
9861029,9926995,5824,2038400,11965395,20.53
9861030,9928605,6409,2243150,12171755,22.59
9861031,9921263,4105,1436750,11358013,14.48
9861032,9942594,5692,1992200,11934794,20.04
9861033,9931597,3273,1145550,11077147,11.53
9861034,9940505,6348,2221800,12162305,22.35
9861035,9951230,5549,1942150,11893380,19.52
9861036,9968508,4576,1601600,11570108,16.07
9861037,9978785,3282,1148700,11127485,11.51
9861038,9973808,1390,486500,10460308,4.88
9861039,9985942,3598,1259300,11245242,12.61
9861040,9966343,2129,745150,10711493,7.48
9861041,9974592,3122,1092700,11067292,10.95
9861042,9991721,4900,1715000,11706721,17.16
9861043,9972215,2922,1022700,10994915,10.26
9861044,9979771,2072,725200,10704971,7.27
9861045,1767887,738,258300,2026187,14.61
9861046,2686378,627,219450,2905828,8.17
9861047,9965996,7408,2592800,12558796,26.02
9861048,9963159,3071,1074850,11038009,10.79
9861049,1395172,782,273700,1668872,19.62
9861050,9968780,5373,1880550,11849330,18.86
9861051,9997395,2394,837900,10835295,8.38
9861052,5518503,2886,1010100,6528603,18.30
9861053,9977587,1754,613900,10591487,6.15
9861054,9985751,5108,1787800,11773551,17.90
9861055,9989574,5599,1959650,11949224,19.62
9861056,500272,199,69650,569922,13.92
9861057,9959175,2228,779800,10738975,7.83
9861058,9965839,3363,1177050,11142889,11.81
9861059,9986226,1618,566300,10552526,5.67
9861060,9977578,1005,351750,10329328,3.53
9861061,9893965,5468,1913800,11807765,19.34
9861062,9967648,1651,577850,10545498,5.80
9861063,9969272,2084,729400,10698672,7.32
9861064,9989298,5902,2065700,12054998,20.68
9861065,9981411,3901,1365350,11346761,13.68
9861066,9980182,2474,865900,10846082,8.68
9861067,9982159,604,211400,10193559,2.12
9861069,9997666,1386,485100,10482766,4.85
9861070,9992540,2313,809550,10802090,8.10
9861071,9988771,5188,1815800,11804571,18.18
9861072,9965381,6254,2188900,12154281,21.97
9861073,9974495,6349,2222150,12196645,22.28
9861074,9999767,4321,1512350,11512117,15.12
9861075,9985122,1980,693000,10678122,6.94
9861076,9983708,1968,688800,10672508,6.90
9861077,9976893,2766,968100,10944993,9.70
9861078,9967968,2912,1019200,10987168,10.22
9861079,9980192,3779,1322650,11302842,13.25
9861080,9991833,5052,1768200,11760033,17.70
9861081,9998953,5350,1872500,11871453,18.73
9861083,9965258,2658,930300,10895558,9.34
9861084,4134083,1706,597100,4731183,14.44
9861085,9945299,4795,1678250,11623549,16.87
9861086,9983353,4318,1511300,11494653,15.14
9861087,9996177,4045,1415750,11411927,14.16
9861088,9522787,3889,1361150,10883937,14.29
9861089,9505931,1469,514150,10020081,5.41
9861090,9979426,2685,939750,10919176,9.42
9861091,9959147,3247,1136450,11095597,11.41
9861092,509349,559,195650,704999,38.41
9861093,1009555,442,154700,1164255,15.32
9861094,954392,188,65800,1020192,6.89
9861095,9986849,4259,1490650,11477499,14.93
9861096,9998320,4648,1626800,11625120,16.27
9861097,9964328,4688,1640800,11605128,16.47
9861098,9978078,3444,1205400,11183478,12.08
9861099,9969376,4667,1633450,11602826,16.38
9861101,9973209,2523,883050,10856259,8.85
9861102,9974301,3146,1101100,11075401,11.04
9861103,9995770,3424,1198400,11194170,11.99
9861104,9985722,3590,1256500,11242222,12.58
9861105,9979342,2460,861000,10840342,8.63
9861106,9984014,4545,1590750,11574764,15.93
9861107,9999130,3385,1184750,11183880,11.85
9861108,9998556,4111,1438850,11437406,14.39
9861109,1760491,1033,361550,2122041,20.54
9861110,9983686,1213,424550,10408236,4.25
9861111,9986260,998,349300,10335560,3.50
9861112,9990796,4521,1582350,11573146,15.84
9861113,9997111,3948,1381800,11378911,13.82
9861114,9980266,3615,1265250,11245516,12.68
9861115,1526828,781,273350,1800178,17.90
9861116,9983887,2993,1047550,11031437,10.49
9861117,1702873,683,239050,1941923,14.04
9861118,9955252,3752,1313200,11268452,13.19
9861119,9984674,2290,801500,10786174,8.03
9861120,9973674,4797,1678950,11652624,16.83
9861121,9987911,2505,876750,10864661,8.78
9861122,1212147,825,288750,1500897,23.82
9861123,9994313,1106,387100,10381413,3.87
9861124,74534,25,8750,83284,11.74
9861125,9984341,1060,371000,10355341,3.72
9861126,9988306,6300,2205000,12193306,22.08
9861127,9982758,1056,369600,10352358,3.70
9861128,9959961,5466,1913100,11873061,19.21
9861129,354747,123,43050,397797,12.14
9861130,9981971,2276,796600,10778571,7.98
9861131,9983582,1771,619850,10603432,6.21
9861132,9972723,3687,1290450,11263173,12.94
9861133,9976168,4193,1467550,11443718,14.71
9861134,972157,532,186200,1158357,19.15
9861135,3337347,1457,509950,3847297,15.28
9861136,9986610,3660,1281000,11267610,12.83
9861137,9994383,3770,1319500,11313883,13.20
9861138,9991549,2174,760900,10752449,7.62
9861139,9590896,2799,979650,10570546,10.21
9861140,9987678,4165,1457750,11445428,14.60
9861141,9975737,2430,850500,10826237,8.53
9861142,9999170,2719,951650,10950820,9.52
9861143,9986913,6363,2227050,12213963,22.30
9861144,9993663,4202,1470700,11464363,14.72
9861145,9978071,1031,360850,10338921,3.62
9861147,4843990,2564,897400,5741390,18.53
9861148,9958664,2730,955500,10914164,9.59
9861149,9959104,4038,1413300,11372404,14.19
9861150,9971139,4152,1453200,11424339,14.57
9861151,9965114,2194,767900,10733014,7.71
9861152,9960840,1508,527800,10488640,5.30
9861153,9958487,6912,2419200,12377687,24.29
9861154,9963420,4639,1623650,11587070,16.30
9861155,9969638,4859,1700650,11670288,17.06
9861156,1861792,825,288750,2150542,15.51
9861157,9994025,2791,976850,10970875,9.77
9861158,9981440,4892,1712200,11693640,17.15
9861159,9992623,3085,1079750,11072373,10.81
9861160,2633392,982,343700,2977092,13.05
9861161,9991393,3211,1123850,11115243,11.25
9861162,9982812,3576,1251600,11234412,12.54
9861163,9924279,6053,2118550,12042829,21.35
9861164,9994863,4508,1577800,11572663,15.79
9861165,9991654,2818,986300,10977954,9.87
9861166,9959140,2443,855050,10814190,8.59
9861167,9994933,1796,628600,10623533,6.29
9861168,9988181,4446,1556100,11544281,15.58
9861169,6877766,4371,1529850,8407616,22.24
9861170,2168206,539,188650,2356856,8.70
9861171,9979607,4290,1501500,11481107,15.05
9861172,9984385,6257,2189950,12174335,21.93
9861173,9975680,2979,1042650,11018330,10.45
9861174,9987565,3420,1197000,11184565,11.98
9861175,9980281,3859,1350650,11330931,13.53
9861176,1674910,1889,661150,2336060,39.47
9861177,1251428,452,158200,1409628,12.64
9861178,1203353,1147,401450,1604803,33.36
9861179,3452840,2854,998900,4451740,28.93
9861180,9991940,3267,1143450,11135390,11.44
9861181,9610479,2077,726950,10337429,7.56
9861182,9992243,2110,738500,10730743,7.39
9861183,9987943,1265,442750,10430693,4.43
9861184,9962791,3320,1162000,11124791,11.66
9861185,9981451,5409,1893150,11874601,18.97
9861186,9993973,3605,1261750,11255723,12.63
9861187,737894,455,159250,897144,21.58
9861188,9985299,2006,702100,10687399,7.03
9861189,9985080,1798,629300,10614380,6.30
9861190,2304420,982,343700,2648120,14.91
9861191,9949688,1972,690200,10639888,6.94
9861192,9968815,4336,1517600,11486415,15.22
9861193,9977845,2990,1046500,11024345,10.49
9861195,9984731,4874,1705900,11690631,17.09
9861196,875045,422,147700,1022745,16.88
9861197,8051846,2602,910700,8962546,11.31
9861198,9983626,4089,1431150,11414776,14.33
9861199,9982864,2212,774200,10757064,7.76
9861200,3406410,1298,454300,3860710,13.34
9861201,9973603,2499,874650,10848253,8.77
9861202,9984017,3064,1072400,11056417,10.74
9861203,9904263,2884,1009400,10913663,10.19
9861204,9966550,3972,1390200,11356750,13.95
9861205,9966546,4435,1552250,11518796,15.57
9861206,9965584,4665,1632750,11598334,16.38
9861207,9966712,3875,1356250,11322962,13.61
9861208,1122959,770,269500,1392459,24.00
9861209,9961669,3620,1267000,11228669,12.72
9861210,6637294,1633,571550,7208844,8.61
9861211,9160772,4278,1497300,10658072,16.34
9861212,9971398,4025,1408750,11380148,14.13
9861213,3173001,2225,778750,3951751,24.54
9861214,9994028,5243,1835050,11829078,18.36
9861215,9986205,2766,968100,10954305,9.69
9861216,9034030,4510,1578500,10612530,17.47
9861217,4833677,1652,578200,5411877,11.96
9861218,9987040,4328,1514800,11501840,15.17
9861219,9991543,2905,1016750,11008293,10.18
9861220,9992443,2297,803950,10796393,8.05
9861221,9994814,2416,845600,10840414,8.46
9861222,9984761,4065,1422750,11407511,14.25
9861223,9987818,4959,1735650,11723468,17.38
9861226,9964719,2948,1031800,10996519,10.35
9861227,9980110,3362,1176700,11156810,11.79
9861228,9990971,3838,1343300,11334271,13.45
9861229,9988925,2465,862750,10851675,8.64
9861230,9983677,3008,1052800,11036477,10.55
9861231,9979313,3824,1338400,11317713,13.41
9861232,1160285,389,136150,1296435,11.73
9861233,6921755,3616,1265600,8187355,18.28
9861234,9971321,4735,1657250,11628571,16.62
9861235,9999716,4017,1405950,11405666,14.06
9861236,9982969,2636,922600,10905569,9.24
9861237,8625014,3939,1378650,10003664,15.98
9861238,9973168,4146,1451100,11424268,14.55
9861239,9969872,2874,1005900,10975772,10.09
9861240,9976858,4293,1502550,11479408,15.06
9861241,9989488,2962,1036700,11026188,10.38
9861242,9966649,5685,1989750,11956399,19.96
9861243,9972431,2946,1031100,11003531,10.34
9861244,9971664,5470,1914500,11886164,19.20
9861245,6793604,1475,516250,7309854,7.60
9861246,9969823,2546,891100,10860923,8.94
9861247,9963201,3691,1291850,11255051,12.97
9861248,9964649,2282,798700,10763349,8.02
9861249,3030152,784,274400,3304552,9.06
9861250,9966759,2878,1007300,10974059,10.11
9861251,9983894,4548,1591800,11575694,15.94
9861252,9993432,3060,1071000,11064432,10.72
9861253,9992446,2147,751450,10743896,7.52
9861254,9989231,2838,993300,10982531,9.94
9861255,9972534,626,219100,10191634,2.20
9861256,9983921,3412,1194200,11178121,11.96
9861257,9992262,5492,1922200,11914462,19.24
9861258,9975679,5523,1933050,11908729,19.38
9861259,9987033,1890,661500,10648533,6.62
9861260,9995854,1018,356300,10352154,3.56
9861261,9998342,2427,849450,10847792,8.50
9861262,9989117,849,297150,10286267,2.97
9861263,9974595,1754,613900,10588495,6.15
9861264,9986370,3074,1075900,11062270,10.77
9861266,9988257,3755,1314250,11302507,13.16
9861267,9984247,3387,1185450,11169697,11.87
9861268,9998502,3926,1374100,11372602,13.74
9861269,9959220,2864,1002400,10961620,10.07
9861270,9989887,3399,1189650,11179537,11.91
9861271,104209,42,14700,118909,14.11
9861272,9239002,4230,1480500,10719502,16.02
9861273,9980698,3130,1095500,11076198,10.98
9861274,9988841,3863,1352050,11340891,13.54
9861275,9987818,3761,1316350,11304168,13.18
9861276,9997054,2698,944300,10941354,9.45
9861277,9987778,935,327250,10315028,3.28
9861278,9982357,1527,534450,10516807,5.35
9861279,9961316,1090,381500,10342816,3.83
9861280,9961534,569,199150,10160684,2.00
9861281,9966675,1524,533400,10500075,5.35
9861282,9961870,4955,1734250,11696120,17.41
9861283,9957060,3757,1314950,11272010,13.21
9861284,9962191,1950,682500,10644691,6.85
9861285,9984466,2941,1029350,11013816,10.31
9861286,9983209,3811,1333850,11317059,13.36
9861287,9988031,2573,900550,10888581,9.02
9861288,2734469,412,144200,2878669,5.27
9861289,9983726,1724,603400,10587126,6.04
9861290,9980231,7154,2503900,12484131,25.09
9861291,9294245,3658,1280300,10574545,13.78
9861292,9970709,2046,716100,10686809,7.18
9861293,9978998,3303,1156050,11135048,11.58
9861294,4427654,584,204400,4632054,4.62
9861295,9993793,3160,1106000,11099793,11.07
9861296,9985126,1678,587300,10572426,5.88
9861297,9995582,3283,1149050,11144632,11.50
9861298,9988620,3148,1101800,11090420,11.03
9861299,9981812,2341,819350,10801162,8.21
9861300,9982495,1834,641900,10624395,6.43
9861301,9979864,3923,1373050,11352914,13.76
9861302,7165094,2275,796250,7961344,11.11
9861303,971189,447,156450,1127639,16.11
9861304,9981450,2618,916300,10897750,9.18
9861305,9959977,4115,1440250,11400227,14.46
9861306,9991473,3082,1078700,11070173,10.80
9861307,9987483,2328,814800,10802283,8.16
9861308,9079017,2298,804300,9883317,8.86
9861309,9980153,1990,696500,10676653,6.98
9861310,4929669,2284,799400,5729069,16.22
9861311,9915662,3013,1054550,10970212,10.64
9861312,489143,276,96600,585743,19.75
9861313,9914188,2420,847000,10761188,8.54
9861314,521322,226,79100,600422,15.17
9861315,4805297,1164,407400,5212697,8.48
9861316,2794220,867,303450,3097670,10.86
9861317,9956972,1927,674450,10631422,6.77
9861318,3776817,1456,509600,4286417,13.49
9861319,9468692,3790,1326500,10795192,14.01
9861320,9974475,3821,1337350,11311825,13.41
9861321,9973564,1483,519050,10492614,5.20
9861322,4194542,1314,459900,4654442,10.96
9861323,782286,231,80850,863136,10.34
9861324,9966862,3673,1285550,11252412,12.90
9861325,1367078,1174,410900,1777978,30.06
9861326,9987148,3358,1175300,11162448,11.77
9861327,9982001,2310,808500,10790501,8.10
9861328,9988612,1624,568400,10557012,5.69
9861329,9985473,623,218050,10203523,2.18
9861330,9897189,1224,428400,10325589,4.33
9861331,9995402,3853,1348550,11343952,13.49
9861332,9980525,3115,1090250,11070775,10.92
9861334,9981121,1551,542850,10523971,5.44
9861335,9984280,4605,1611750,11596030,16.14
9861336,9984202,3091,1081850,11066052,10.84
9861337,9948735,1851,647850,10596585,6.51
9861338,5544457,1057,369950,5914407,6.67
9861339,9974866,2852,998200,10973066,10.01
9861340,9980072,3877,1356950,11337022,13.60
9861341,9972704,2815,985250,10957954,9.88
9861342,9972360,4133,1446550,11418910,14.51
9861343,9720672,3259,1140650,10861322,11.73
9861344,9983049,3569,1249150,11232199,12.51
9861345,9987980,1507,527450,10515430,5.28
9861346,9997134,2721,952350,10949484,9.53
9861347,5822635,709,248150,6070785,4.26
9861348,9971662,3737,1307950,11279612,13.12
9861350,9983378,1553,543550,10526928,5.44
9861351,9967843,3472,1215200,11183043,12.19
9861352,6904158,4479,1567650,8471808,22.71
9861353,9962255,3687,1290450,11252705,12.95
9861354,9954200,3208,1122800,11077000,11.28
9861355,9955399,1508,527800,10483199,5.30
9861356,9952765,4820,1687000,11639765,16.95
9861357,9973138,1929,675150,10648288,6.77
9861358,9952175,2448,856800,10808975,8.61
9861359,9958364,2964,1037400,10995764,10.42
9861360,1306263,903,316050,1622313,24.19
9861361,9960476,3436,1202600,11163076,12.07
9861362,9965536,3738,1308300,11273836,13.13
9861363,9971826,4401,1540350,11512176,15.45
9861364,1453253,246,86100,1539353,5.92
9861365,9980077,2234,781900,10761977,7.83
9861366,9479505,2696,943600,10423105,9.95
9861367,9993927,3048,1066800,11060727,10.67
9861368,9998455,3744,1310400,11308855,13.11
9861369,9982547,2307,807450,10789997,8.09
9861370,9988341,3377,1181950,11170291,11.83
9861371,9970488,3872,1355200,11325688,13.59
9861372,9977020,3077,1076950,11053970,10.79
9861373,9991606,2995,1048250,11039856,10.49
9861374,9984535,3626,1269100,11253635,12.71
9861375,8462360,3200,1120000,9582360,13.24
9861376,3231319,1132,396200,3627519,12.26
9861377,9967260,2610,913500,10880760,9.17
9861378,9951807,3773,1320550,11272357,13.27
9861379,1572758,602,210700,1783458,13.40
9861380,8775718,3321,1162350,9938068,13.25
9861382,9974497,4848,1696800,11671297,17.01
9861383,9964252,3370,1179500,11143752,11.84
9861384,9974536,2420,847000,10821536,8.49
9861385,9982838,3574,1250900,11233738,12.53
9861386,9984050,3130,1095500,11079550,10.97
9861387,9988847,2925,1023750,11012597,10.25
9861389,9980076,2599,909650,10889726,9.11
9861390,1140004,591,206850,1346854,18.14
9861391,9556990,2942,1029700,10586690,10.77
9861392,9964591,3046,1066100,11030691,10.70
9861393,6176104,3050,1067500,7243604,17.28
9861394,7902637,3143,1100050,9002687,13.92
9861395,9968218,3609,1263150,11231368,12.67
9861396,9968029,3453,1208550,11176579,12.12
9861397,9973048,2948,1031800,11004848,10.35
9861398,9986919,4284,1499400,11486319,15.01
9861399,9988375,4277,1496950,11485325,14.99
9861400,9980338,1823,638050,10618388,6.39
9861401,9990673,1778,622300,10612973,6.23
9861402,9978210,3350,1172500,11150710,11.75
9861403,4580126,2130,745500,5325626,16.28
9861404,9986481,3407,1192450,11178931,11.94
9861405,9996531,2101,735350,10731881,7.36
9861406,9988400,3804,1331400,11319800,13.33
9861407,9981685,3233,1131550,11113235,11.34
9861408,1271740,322,112700,1384440,8.86
9861409,9985797,5619,1966650,11952447,19.69
9861410,9985448,5027,1759450,11744898,17.62
9861411,9991634,1845,645750,10637384,6.46
9861412,9986528,5532,1936200,11922728,19.39
9861413,9985677,1881,658350,10644027,6.59
9861414,9987545,5022,1757700,11745245,17.60
9861415,9985792,4948,1731800,11717592,17.34
9861416,9995755,5870,2054500,12050255,20.55
9861417,9983082,2170,759500,10742582,7.61
9861418,9988806,2437,852950,10841756,8.54
9861419,9992224,4198,1469300,11461524,14.70
9861420,9908064,4987,1745450,11653514,17.62
9861421,9985909,4262,1491700,11477609,14.94
9861422,9979785,4635,1622250,11602035,16.26
9861423,9984456,2356,824600,10809056,8.26
9861424,9966281,3906,1367100,11333381,13.72
9861425,8204597,1788,625800,8830397,7.63
9861426,9981707,5905,2066750,12048457,20.71
9861428,9510254,364,127400,9637654,1.34
9861429,9979891,2678,937300,10917191,9.39
9861430,9975688,2114,739900,10715588,7.42
9861431,9569918,2940,1029000,10598918,10.75
9861432,9997772,3226,1129100,11126872,11.29
9861433,9975340,3448,1206800,11182140,12.10
9861434,9978746,3185,1114750,11093496,11.17
9861435,9995825,2463,862050,10857875,8.62
9861436,9981951,4256,1489600,11471551,14.92
9861437,6017884,3039,1063650,7081534,17.67
9861438,9980361,3796,1328600,11308961,13.31
9861439,9963504,1782,623700,10587204,6.26
9861440,1713427,924,323400,2036827,18.87
9861441,8475377,3111,1088850,9564227,12.85
9861442,9961025,3669,1284150,11245175,12.89
9861443,664867,248,86800,751667,13.06
9861444,9934306,1779,622650,10556956,6.27
9861445,9951340,2375,831250,10782590,8.35
9861446,9947202,3943,1380050,11327252,13.87
9861447,9960686,2960,1036000,10996686,10.40
9861448,9959528,3395,1188250,11147778,11.93
9861449,9976265,3114,1089900,11066165,10.92
9861450,9962378,3236,1132600,11094978,11.37
9861451,576746,403,141050,717796,24.46
9861452,9933590,2975,1041250,10974840,10.48
9861453,9955546,101,35350,9990896,0.36
9861454,9688511,2481,868350,10556861,8.96
9861455,8962973,3318,1161300,10124273,12.96
9861456,9984006,3282,1148700,11132706,11.51
9861457,9958249,5729,2005150,11963399,20.14
9861458,9959331,3397,1188950,11148281,11.94
9861459,3283540,1262,441700,3725240,13.45
9861460,9963498,2674,935900,10899398,9.39
9861461,9959783,1204,421400,10381183,4.23
9861462,9975131,3251,1137850,11112981,11.41
9861463,8395030,2040,714000,9109030,8.51
9861464,1059570,174,60900,1120470,5.75
9861465,9981289,4695,1643250,11624539,16.46
9861466,1639016,491,171850,1810866,10.48
9861467,9963350,2860,1001000,10964350,10.05
9861468,9937889,2688,940800,10878689,9.47
9861469,9951716,3484,1219400,11171116,12.25
9861470,9962222,1183,414050,10376272,4.16
9861471,9962838,1859,650650,10613488,6.53
9861472,3055269,228,79800,3135069,2.61
9861474,9990996,3906,1367100,11358096,13.68
9861476,1902722,995,348250,2250972,18.30
9861477,9968326,2148,751800,10720126,7.54
9861478,9959125,354,123900,10083025,1.24
9861479,9969395,2793,977550,10946945,9.81
9861480,9964305,3565,1247750,11212055,12.52
9861481,9983028,3606,1262100,11245128,12.64
9861482,9969830,1918,671300,10641130,6.73
9861483,9965822,2574,900900,10866722,9.04
9861484,4148217,2139,748650,4896867,18.05
9861485,9948474,4126,1444100,11392574,14.52
9861486,9987439,1951,682850,10670289,6.84
9861487,9991995,5434,1901900,11893895,19.03
9861488,9999519,2262,791700,10791219,7.92
9861489,9974898,3329,1165150,11140048,11.68
9861490,9826898,4095,1433250,11260148,14.58
9861491,9982595,1917,670950,10653545,6.72
9861492,9989852,3256,1139600,11129452,11.41
9861493,9999887,2878,1007300,11007187,10.07
9861494,9990874,4104,1436400,11427274,14.38
9861495,9983748,2078,727300,10711048,7.28
9861496,9982213,2798,979300,10961513,9.81
9861497,2110622,718,251300,2361922,11.91
9861498,9977209,4146,1451100,11428309,14.54
9861499,9980366,4883,1709050,11689416,17.12
9861500,9996378,3986,1395100,11391478,13.96
9861501,9902263,5319,1861650,11763913,18.80
9861502,9981795,4835,1692250,11674045,16.95
9861503,9980777,5529,1935150,11915927,19.39
9861504,9977579,4158,1455300,11432879,14.59
9861505,9980305,3060,1071000,11051305,10.73
9861506,2757389,1179,412650,3170039,14.97
9861507,9990115,3982,1393700,11383815,13.95
9861508,9981530,1523,533050,10514580,5.34
9861510,9971218,4172,1460200,11431418,14.64
9861511,9969109,3070,1074500,11043609,10.78
9861512,9968037,4140,1449000,11417037,14.54
9861513,9986509,3717,1300950,11287459,13.03
9861514,6215053,2853,998550,7213603,16.07
9861515,9917401,3863,1352050,11269451,13.63
9861516,9958028,3707,1297450,11255478,13.03
9861517,9712406,3244,1135400,10847806,11.69
9861518,9958268,2866,1003100,10961368,10.07
9861519,9956046,6542,2289700,12245746,23.00
9861520,9974883,2733,956550,10931433,9.59
9861521,9974578,3691,1291850,11266428,12.95
9861522,9996328,1751,612850,10609178,6.13
9861523,4285232,2301,805350,5090582,18.79
9861524,9982867,3835,1342250,11325117,13.45
9861525,9985062,3694,1292900,11277962,12.95
9861526,9984463,5632,1971200,11955663,19.74
9861527,9972475,2160,756000,10728475,7.58
9861528,9993935,1163,407050,10400985,4.07
9861529,9975391,3939,1378650,11354041,13.82
9861530,9983856,3924,1373400,11357256,13.76
9861531,9976896,2308,807800,10784696,8.10
9861533,9982018,4736,1657600,11639618,16.61
9861534,9976533,1257,439950,10416483,4.41
9861536,2472289,1959,685650,3157939,27.73
9861537,2172021,447,156450,2328471,7.20
9861538,9986817,3160,1106000,11092817,11.07
9861539,9989968,4930,1725500,11715468,17.27
9861540,9985621,3272,1145200,11130821,11.47
9861542,9984876,3631,1270850,11255726,12.73
9861543,9989148,3757,1314950,11304098,13.16
9861544,9976798,4371,1529850,11506648,15.33
9861545,6239676,3002,1050700,7290376,16.84
9861546,9975012,5015,1755250,11730262,17.60
9861547,9985262,6111,2138850,12124112,21.42
9861548,9974590,5497,1923950,11898540,19.29
9861549,9977925,3478,1217300,11195225,12.20
9861550,2040601,1716,600600,2641201,29.43
9861551,9967901,4071,1424850,11392751,14.29
9861552,9969012,5838,2043300,12012312,20.50
9861553,9971052,3883,1359050,11330102,13.63
9861554,1488009,541,189350,1677359,12.73
9861555,9960829,3261,1141350,11102179,11.46
9861556,9958795,5162,1806700,11765495,18.14
9861557,4349694,1104,386400,4736094,8.88
9861558,9942019,2253,788550,10730569,7.93
9861559,2641788,856,299600,2941388,11.34
9861561,9953049,3656,1279600,11232649,12.86
9861563,9957764,3878,1357300,11315064,13.63
9861564,9974492,4103,1436050,11410542,14.40
9861565,9979734,3130,1095500,11075234,10.98
9861566,9972689,4481,1568350,11541039,15.73
9861567,6523380,3776,1321600,7844980,20.26
9861568,9987061,5388,1885800,11872861,18.88
9861569,9983314,5203,1821050,11804364,18.24
9861570,9981185,2771,969850,10951035,9.72
9861571,9980591,3949,1382150,11362741,13.85
9861572,9991145,4426,1549100,11540245,15.50
9861573,4568724,2003,701050,5269774,15.34
9861574,9969786,2676,936600,10906386,9.39
9861575,9982502,2786,975100,10957602,9.77
9861576,9989954,1986,695100,10685054,6.96
9861577,9999068,3810,1333500,11332568,13.34
9861578,9986035,2736,957600,10943635,9.59
9861579,9986523,5478,1917300,11903823,19.20
9861580,9986328,4056,1419600,11405928,14.22
9861581,9997350,5854,2048900,12046250,20.49
9861582,9985423,2137,747950,10733373,7.49
9861583,9980466,3013,1054550,11035016,10.57
9861584,9982620,3737,1307950,11290570,13.10
9861585,9999609,5174,1810900,11810509,18.11
9861586,9974982,3884,1359400,11334382,13.63
9861588,9969978,3699,1294650,11264628,12.99
9861589,6867804,1408,492800,7360604,7.18
9861590,9963484,2736,957600,10921084,9.61
9861592,9937200,5390,1886500,11823700,18.98
9861593,9940146,2932,1026200,10966346,10.32
9861594,2373657,986,345100,2718757,14.54
9861596,9931923,5908,2067800,11999723,20.82
9861597,8868827,4670,1634500,10503327,18.43
9861598,9935178,5847,2046450,11981628,20.60
9861599,9941609,4268,1493800,11435409,15.03
9861600,9959384,3311,1158850,11118234,11.64
9861601,1160548,1325,463750,1624298,39.96
9861602,9926112,4212,1474200,11400312,14.85
9861603,1434233,2042,714700,2148933,49.83
9861604,9921465,3289,1151150,11072615,11.60
9861605,9915891,3648,1276800,11192691,12.88
9861606,9924122,3218,1126300,11050422,11.35
9861607,9938353,2851,997850,10936203,10.04
9861608,9943578,4245,1485750,11429328,14.94
9861609,9941492,3603,1261050,11202542,12.68
9861610,9333116,3848,1346800,10679916,14.43
9861611,9948481,1684,589400,10537881,5.92
9861612,9947911,3982,1393700,11341611,14.01
9861613,9932458,5191,1816850,11749308,18.29
9861614,9950221,4176,1461600,11411821,14.69
9861615,9933998,4498,1574300,11508298,15.85
9861616,9766824,5269,1844150,11610974,18.88
9861617,9950570,7318,2561300,12511870,25.74
9861618,9951818,4833,1691550,11643368,17.00
9861619,9963512,5843,2045050,12008562,20.53
9861620,4283818,847,296450,4580268,6.92
9861621,9971398,3925,1373750,11345148,13.78
9861622,9976428,3422,1197700,11174128,12.01
9861623,9970833,4618,1616300,11587133,16.21
9861624,9962682,5671,1984850,11947532,19.92
9861625,9945746,3892,1362200,11307946,13.70
9861626,9943837,4755,1664250,11608087,16.74
9861627,9956831,3543,1240050,11196881,12.45
9861628,9960468,2928,1024800,10985268,10.29
9861629,9956837,5164,1807400,11764237,18.15
9861630,9959094,4612,1614200,11573294,16.21
9861632,9974107,3619,1266650,11240757,12.70
9861633,9949281,2645,925750,10875031,9.30
9861634,7016568,1659,580650,7597218,8.28
9861635,9971016,2774,970900,10941916,9.74
9861637,9956615,4519,1581650,11538265,15.89
9861638,9935071,5758,2015300,11950371,20.28
9861639,9941100,4577,1601950,11543050,16.11
9861640,9944506,3221,1127350,11071856,11.34
9861641,9921851,3793,1327550,11249401,13.38
9861642,6404825,3813,1334550,7739375,20.84
9861643,9914830,3868,1353800,11268630,13.65
9861644,9919188,3289,1151150,11070338,11.61
9861646,9922981,2932,1026200,10949181,10.34
9861647,9917546,3149,1102150,11019696,11.11
9861649,7830726,2523,883050,8713776,11.28
9861650,9100868,3390,1186500,10287368,13.04
9861651,9918986,3919,1371650,11290636,13.83
9861652,9931555,3405,1191750,11123305,12.00
9861653,9920105,5045,1765750,11685855,17.80
9861654,3262698,1719,601650,3864348,18.44
9861655,9917532,4136,1447600,11365132,14.60
9861656,9914113,1248,436800,10350913,4.41
9861657,6299684,1161,406350,6706034,6.45
9861658,9920427,5899,2064650,11985077,20.81
9861659,9925303,3420,1197000,11122303,12.06
9861660,9914879,5663,1982050,11896929,19.99
9861661,9938275,2671,934850,10873125,9.41
9861662,7408471,805,281750,7690221,3.80
9861663,3039802,871,304850,3344652,10.03
9861664,9950026,4829,1690150,11640176,16.99
9861665,7430161,1944,680400,8110561,9.16
9861666,9947280,1890,661500,10608780,6.65
9861667,9951006,2972,1040200,10991206,10.45
9861668,9934401,2916,1020600,10955001,10.27
9861669,2628632,1489,521150,3149782,19.83
9861670,9956013,5595,1958250,11914263,19.67
9861671,9954116,3760,1316000,11270116,13.22
9861673,9935061,4243,1485050,11420111,14.95
9861674,9944282,5351,1872850,11817132,18.83
9861675,9938246,5099,1784650,11722896,17.96
9861676,2712826,1514,529900,3242726,19.53
9861677,9948482,3968,1388800,11337282,13.96
9861678,9959589,3075,1076250,11035839,10.81
9861679,9961174,3766,1318100,11279274,13.23
9861680,6080880,4098,1434300,7515180,23.59
9861681,9953299,4111,1438850,11392149,14.46
9861682,9960833,3681,1288350,11249183,12.93
9861683,9959951,3397,1188950,11148901,11.94
9861684,9970642,3428,1199800,11170442,12.03
9861685,9978159,1415,495250,10473409,4.96
9861687,9958572,3426,1199100,11157672,12.04
9861688,9946329,1215,425250,10371579,4.28
9861689,9944810,2266,793100,10737910,7.98
9861690,9958342,1949,682150,10640492,6.85
9861691,9962993,2685,939750,10902743,9.43
9861692,3456366,1225,428750,3885116,12.40
9861693,882569,526,184100,1066669,20.86
9861695,9931114,3851,1347850,11278964,13.57
9861696,9934027,2600,910000,10844027,9.16
9861697,9926645,3711,1298850,11225495,13.08
9861698,9929280,1766,618100,10547380,6.23
9861699,9937468,4216,1475600,11413068,14.85
9861700,9922947,3972,1390200,11313147,14.01
9861701,2605724,994,347900,2953624,13.35
9861702,9943136,5151,1802850,11745986,18.13
9861703,9945445,2344,820400,10765845,8.25
9861704,9927910,2940,1029000,10956910,10.36
9861705,9938295,3516,1230600,11168895,12.38
9861706,9931583,4237,1482950,11414533,14.93
9861707,9947018,6628,2319800,12266818,23.32
9861708,9923618,2556,894600,10818218,9.01
9861709,9971187,5070,1774500,11745687,17.80
9861710,9961485,3635,1272250,11233735,12.77
9861711,3860147,2432,851200,4711347,22.05
9861712,9989198,2261,791350,10780548,7.92
9861713,9941736,4513,1579550,11521286,15.89
9861714,2497803,974,340900,2838703,13.65
9861715,4916113,2209,773150,5689263,15.73
9861716,9969211,4266,1493100,11462311,14.98
9861717,9986631,4032,1411200,11397831,14.13
9861718,3493451,1856,649600,4143051,18.59
9861719,7652811,1576,551600,8204411,7.21
9861720,9999927,1826,639100,10639027,6.39
9861721,9996957,6252,2188200,12185157,21.89
9861722,9980123,1186,415100,10395223,4.16
9861723,9987912,5665,1982750,11970662,19.85
9861724,721595,357,124950,846545,17.32
9861725,9969690,2695,943250,10912940,9.46
9861726,9967948,1632,571200,10539148,5.73
9861727,9945569,3460,1211000,11156569,12.18
9861728,9973435,3216,1125600,11099035,11.29
9861729,9983676,5079,1777650,11761326,17.81
9861730,9990522,1915,670250,10660772,6.71
9861731,9995272,2192,767200,10762472,7.68
9861733,9964585,965,337750,10302335,3.39
9861734,9980179,3210,1123500,11103679,11.26
9861735,9985940,3027,1059450,11045390,10.61
9861736,9967212,5181,1813350,11780562,18.19
9861737,9970875,4165,1457750,11428625,14.62
9861738,9984822,2715,950250,10935072,9.52
9861739,9972781,4460,1561000,11533781,15.65
9861740,9740959,3304,1156400,10897359,11.87
9861741,9986072,1969,689150,10675222,6.90
9861742,9965588,3955,1384250,11349838,13.89
9861743,9974625,2367,828450,10803075,8.31
9861744,9985517,2341,819350,10804867,8.21
9861745,9991091,4823,1688050,11679141,16.90
9861746,9971843,3722,1302700,11274543,13.06
9861747,7764998,1379,482650,8247648,6.22
9861748,9910145,3134,1096900,11007045,11.07
9861749,9972620,3502,1225700,11198320,12.29
9861750,3267730,811,283850,3551580,8.69
9861751,9976765,4976,1741600,11718365,17.46
9861752,4616527,686,240100,4856627,5.20
9861753,9986147,3062,1071700,11057847,10.73
9861754,1339848,465,162750,1502598,12.15
9861755,9964883,1820,637000,10601883,6.39
9861756,9967349,2102,735700,10703049,7.38
9861757,9975700,1709,598150,10573850,6.00
9861758,9994478,2891,1011850,11006328,10.12
9861759,9967228,2732,956200,10923428,9.59
9861760,9980964,3188,1115800,11096764,11.18
9861761,2622154,458,160300,2782454,6.11
9861762,9979659,3661,1281350,11261009,12.84
9861763,9984975,2414,844900,10829875,8.46
9861764,9986136,5676,1986600,11972736,19.89
9861765,9980544,2708,947800,10928344,9.50
9861766,9984657,3141,1099350,11084007,11.01
9861767,9970064,3601,1260350,11230414,12.64
9861768,9966618,3400,1190000,11156618,11.94
9861769,6914950,2191,766850,7681800,11.09
9861770,9959664,3860,1351000,11310664,13.56
9861771,9946214,1921,672350,10618564,6.76
9861772,9922595,3181,1113350,11035945,11.22
9861773,9943593,3156,1104600,11048193,11.11
9861774,9927570,4289,1501150,11428720,15.12
9861775,8725921,2878,1007300,9733221,11.54
9861776,9960807,2269,794150,10754957,7.97
9861777,9935523,3020,1057000,10992523,10.64
9861778,9954138,3942,1379700,11333838,13.86
9861779,9956362,3386,1185100,11141462,11.90
9861780,9956918,4268,1493800,11450718,15.00
9861781,9947278,2613,914550,10861828,9.19
9861782,9767151,5916,2070600,11837751,21.20
9861783,9963218,2272,795200,10758418,7.98
9861784,9968861,3215,1125250,11094111,11.29
9861785,9989647,1299,454650,10444297,4.55
9861786,9990292,3820,1337000,11327292,13.38
9861787,9980261,3663,1282050,11262311,12.85
9861788,9990140,5296,1853600,11843740,18.55
9861789,9983123,3383,1184050,11167173,11.86
9861790,9973340,2891,1011850,10985190,10.15
9861791,9583978,4846,1696100,11280078,17.70
9861792,9879747,1994,697900,10577647,7.06
9861793,9990029,2947,1031450,11021479,10.32
9861794,9980399,3663,1282050,11262449,12.85
9861795,9995839,7843,2745050,12740889,27.46
9861796,9979566,2866,1003100,10982666,10.05
9861797,9982966,2916,1020600,11003566,10.22
9861798,9983620,3336,1167600,11151220,11.70
9861799,9983291,3446,1206100,11189391,12.08
9861800,9979191,4739,1658650,11637841,16.62
9861801,9582286,3188,1115800,10698086,11.64
9861802,1077537,804,281400,1358937,26.12
9861803,6333346,2317,810950,7144296,12.80
9861804,9987755,4041,1414350,11402105,14.16
9861805,9984005,4442,1554700,11538705,15.57
9861806,9998197,3061,1071350,11069547,10.72
9861807,9985828,6633,2321550,12307378,23.25
9861808,9809890,2347,821450,10631340,8.37
9861809,9975556,1835,642250,10617806,6.44
9861810,9984218,2494,872900,10857118,8.74
9861811,9970923,2316,810600,10781523,8.13
9861812,9988860,5155,1804250,11793110,18.06
9861813,8992612,2698,944300,9936912,10.50
9861814,9981837,2513,879550,10861387,8.81
9861815,9778614,4126,1444100,11222714,14.77
9861816,9993823,7077,2476950,12470773,24.78
9861817,9916455,1928,674800,10591255,6.80
9861818,9975937,5222,1827700,11803637,18.32
9861819,9961514,6925,2423750,12385264,24.33
9861820,9994121,4997,1748950,11743071,17.50
9861821,9986896,3359,1175650,11162546,11.77
9861822,9996752,3712,1299200,11295952,13.00
9861823,9974294,3758,1315300,11289594,13.19
9861824,9983133,3995,1398250,11381383,14.01
9861825,8004216,3367,1178450,9182666,14.72
9861826,1227617,426,149100,1376717,12.15
9861827,6940667,2885,1009750,7950417,14.55
9861828,667444,285,99750,767194,14.95
9861829,9986977,5507,1927450,11914427,19.30
9861830,9979031,3834,1341900,11320931,13.45
9861831,9994655,2562,896700,10891355,8.97
9861832,9973332,3619,1266650,11239982,12.70
9861833,9968094,2202,770700,10738794,7.73
9861834,9725148,4157,1454950,11180098,14.96
9861835,9968984,2480,868000,10836984,8.71
9861836,9955142,6230,2180500,12135642,21.90
9861837,9967772,3487,1220450,11188222,12.24
9861838,9958606,2704,946400,10905006,9.50
9861839,9973542,4640,1624000,11597542,16.28
9861840,9954491,3036,1062600,11017091,10.67
9861841,9738832,3953,1383550,11122382,14.21
9861842,9989340,6053,2118550,12107890,21.21
9861843,9987018,4470,1564500,11551518,15.67
9861844,9986461,2958,1035300,11021761,10.37
9861845,9986949,3391,1186850,11173799,11.88
9861846,9991203,3878,1357300,11348503,13.58
9861847,9592505,2841,994350,10586855,10.37
9861848,9990091,4429,1550150,11540241,15.52
9861849,9985075,4768,1668800,11653875,16.71
9861850,9979786,2608,912800,10892586,9.15
9861851,2595988,2005,701750,3297738,27.03
9861852,9985973,4923,1723050,11709023,17.25
9861853,9986199,4129,1445150,11431349,14.47
9861854,4543546,3853,1348550,5892096,29.68
9861855,2879322,1098,384300,3263622,13.35
9861856,9984519,4776,1671600,11656119,16.74
9861857,9978694,1148,401800,10380494,4.03
9861858,3673451,1670,584500,4257951,15.91
9861860,4814423,2496,873600,5688023,18.15
9861861,9980859,3412,1194200,11175059,11.96
9861862,9981450,2481,868350,10849800,8.70
9861863,541736,157,54950,596686,10.14
9861864,4851344,1587,555450,5406794,11.45
9861865,9966825,5836,2042600,12009425,20.49
9861866,9969490,3885,1359750,11329240,13.64
9861867,9989827,2478,867300,10857127,8.68
9861868,4120639,1655,579250,4699889,14.06
9861869,9960426,3882,1358700,11319126,13.64
9861870,9982162,4214,1474900,11457062,14.78
9861871,9968580,2955,1034250,11002830,10.38
9861872,9980904,4616,1615600,11596504,16.19
9861874,6145555,2589,906150,7051705,14.74
9861875,9976442,5727,2004450,11980892,20.09
9861876,3872620,1286,450100,4322720,11.62
9861877,9969721,2799,979650,10949371,9.83
9861878,9970673,2044,715400,10686073,7.18
9861879,9981139,2974,1040900,11022039,10.43
9861880,9927923,3322,1162700,11090623,11.71
9861881,9990720,4018,1406300,11397020,14.08
9861882,1464420,504,176400,1640820,12.05
9861883,9963596,3681,1288350,11251946,12.93
9861884,641017,109,38150,679167,5.95
9861886,9957908,2709,948150,10906058,9.52
9861887,9964166,5177,1811950,11776116,18.18
9861888,9981698,3594,1257900,11239598,12.60
9861889,9976062,4112,1439200,11415262,14.43
9861890,9988540,3738,1308300,11296840,13.10
9861891,9995636,3064,1072400,11068036,10.73
9861892,9998076,4139,1448650,11446726,14.49
9861893,9997623,3757,1314950,11312573,13.15
9861894,9982990,3376,1181600,11164590,11.84
9861895,9981629,5113,1789550,11771179,17.93
9861896,1975123,1475,516250,2491373,26.14
9861897,9972338,4479,1567650,11539988,15.72
9861898,9982214,3567,1248450,11230664,12.51
9861899,9957078,3467,1213450,11170528,12.19
9861900,9958501,2120,742000,10700501,7.45
9861901,9954081,4475,1566250,11520331,15.73
9861902,9944758,1994,697900,10642658,7.02
9861903,9962565,3919,1371650,11334215,13.77
9861904,9968925,3210,1123500,11092425,11.27
9861905,9982212,2544,890400,10872612,8.92
9861906,9959820,2009,703150,10662970,7.06
9861907,9985200,2642,924700,10909900,9.26
9861908,7226847,1943,680050,7906897,9.41
9861909,9914912,2653,928550,10843462,9.37
9861910,9991469,4017,1405950,11397419,14.07
9861911,9988106,3905,1366750,11354856,13.68
9861912,9987722,2823,988050,10975772,9.89
9861913,9966807,3067,1073450,11040257,10.77
9861914,9963891,3924,1373400,11337291,13.78
9861915,9966166,4537,1587950,11554116,15.93
9861916,9984320,4256,1489600,11473920,14.92
9861917,9987411,3177,1111950,11099361,11.13
9861918,9979016,3972,1390200,11369216,13.93
9861919,9956269,2923,1023050,10979319,10.28
9861920,9970313,2155,754250,10724563,7.56
9861921,9983685,5479,1917650,11901335,19.21
9861922,9976658,2210,773500,10750158,7.75
9861923,9972522,3164,1107400,11079922,11.10
9861924,9972334,4500,1575000,11547334,15.79
9861925,9983463,2599,909650,10893113,9.11
9861926,9988463,2180,763000,10751463,7.64
9861927,9996201,4074,1425900,11422101,14.26
9861929,9964821,2729,955150,10919971,9.59
9861931,9625870,3358,1175300,10801170,12.21
9861932,9777899,3410,1193500,10971399,12.21
9861933,9966430,3269,1144150,11110580,11.48
9861934,9961041,4087,1430450,11391491,14.36
9861935,3873634,1060,371000,4244634,9.58
9861936,9974611,4054,1418900,11393511,14.23
9861937,5978384,2516,880600,6858984,14.73
9861938,9977798,4281,1498350,11476148,15.02
9861939,9990357,3804,1331400,11321757,13.33
9861941,9974813,1001,350350,10325163,3.51
9861942,9957271,4142,1449700,11406971,14.56
9861943,9963102,3423,1198050,11161152,12.02
9861944,1553936,562,196700,1750636,12.66
9861945,820159,428,149800,969959,18.26
9861946,9984287,1926,674100,10658387,6.75
9861947,5744309,2282,798700,6543009,13.90
9861948,9961285,4971,1739850,11701135,17.47
9861949,9950745,2393,837550,10788295,8.42
9861950,9976790,1420,497000,10473790,4.98
9861951,9978249,3471,1214850,11193099,12.17
9861952,9984103,2798,979300,10963403,9.81
9861954,9578836,4513,1579550,11158386,16.49
9861955,3955352,1134,396900,4352252,10.03
9861956,9947004,5919,2071650,12018654,20.83
9861957,9950961,2881,1008350,10959311,10.13
9861958,9950377,3782,1323700,11274077,13.30
9861959,9956848,2890,1011500,10968348,10.16
9861960,9956531,4611,1613850,11570381,16.21
9861961,9969934,2227,779450,10749384,7.82
9861962,9977118,2818,986300,10963418,9.89
9861963,208601,72,25200,233801,12.08
9861964,9972110,3616,1265600,11237710,12.69
9861965,9961212,2166,758100,10719312,7.61
9861966,9979146,4278,1497300,11476446,15.00
9861967,9983807,4925,1723750,11707557,17.27
9861968,8075262,2403,841050,8916312,10.42
9861969,9941107,4329,1515150,11456257,15.24
9861970,9978858,4124,1443400,11422258,14.46
9861971,9982524,3259,1140650,11123174,11.43
9861972,9986784,4324,1513400,11500184,15.15
9861973,9990682,2807,982450,10973132,9.83
9861974,9970448,3849,1347150,11317598,13.51
9861975,9993748,3117,1090950,11084698,10.92
9861976,9988993,5571,1949850,11938843,19.52
9861977,9984913,3656,1279600,11264513,12.82
9861978,9988807,3838,1343300,11332107,13.45
9861979,9995589,4172,1460200,11455789,14.61
9861980,9975092,6345,2220750,12195842,22.26
9861981,9970188,3298,1154300,11124488,11.58
9861982,9966381,2963,1037050,11003431,10.41
9861983,9953837,4958,1735300,11689137,17.43
9861984,9951483,4556,1594600,11546083,16.02
9861985,9959221,5457,1909950,11869171,19.18
9861986,9823065,2614,914900,10737965,9.31
9861987,9982698,2622,917700,10900398,9.19
9861988,9029291,2558,895300,9924591,9.92
9861989,7451061,3379,1182650,8633711,15.87
9861990,9986274,2246,786100,10772374,7.87
9861991,124406,42,14700,139106,11.82
9861992,9987989,3130,1095500,11083489,10.97
9861993,9986952,3803,1331050,11318002,13.33
9861994,9981581,4083,1429050,11410631,14.32
9861995,8010078,2774,970900,8980978,12.12
9861997,9991788,1778,622300,10614088,6.23
9861998,9981360,2502,875700,10857060,8.77
9861999,9991665,3326,1164100,11155765,11.65
9862000,7175330,2457,859950,8035280,11.98
9862001,6700818,2498,874300,7575118,13.05
9862002,9981164,4341,1519350,11500514,15.22
9862003,9987971,3304,1156400,11144371,11.58
9862004,9996883,2635,922250,10919133,9.23
9862005,9995512,2180,763000,10758512,7.63
9862006,9986893,3795,1328250,11315143,13.30
9862007,9971409,5125,1793750,11765159,17.99
9862008,8987153,3213,1124550,10111703,12.51
9862009,9984531,3845,1345750,11330281,13.48
9862010,9978746,4102,1435700,11414446,14.39
9862011,9980063,1359,475650,10455713,4.77
9862012,9982448,4265,1492750,11475198,14.95
9862013,9991643,3434,1201900,11193543,12.03
9862014,9988318,3905,1366750,11355068,13.68
9862015,9981685,5277,1846950,11828635,18.50
9862016,9997900,4063,1422050,11419950,14.22
9862017,9979147,2721,952350,10931497,9.54
9862018,9983773,4237,1482950,11466723,14.85
9862019,9980037,4421,1547350,11527387,15.50
9862020,9991946,2876,1006600,10998546,10.07
9862021,9981785,5150,1802500,11784285,18.06
9862022,9964840,2740,959000,10923840,9.62
9862023,9981681,3151,1102850,11084531,11.05
9862024,9980936,3120,1092000,11072936,10.94
9862025,9992277,5390,1886500,11878777,18.88
9862026,3504901,571,199850,3704751,5.70
9862027,9881956,2636,922600,10804556,9.34
9862028,9986864,3201,1120350,11107214,11.22
9862029,9992679,2567,898450,10891129,8.99
9862030,9961468,2010,703500,10664968,7.06
9862031,2571807,783,274050,2845857,10.66
9862032,9989906,1111,388850,10378756,3.89
9862033,1319980,180,63000,1382980,4.77
9862034,9989071,4976,1741600,11730671,17.44
9862035,8818406,3371,1179850,9998256,13.38
9862036,9950010,2316,810600,10760610,8.15
9862037,9952972,5506,1927100,11880072,19.36
9862038,9953914,3499,1224650,11178564,12.30
9862040,9956163,4518,1581300,11537463,15.88
9862041,9949536,3768,1318800,11268336,13.25
9862042,9959516,5127,1794450,11753966,18.02
9862043,9978143,4827,1689450,11667593,16.93
9862044,9978067,3697,1293950,11272017,12.97
9862045,5863818,2117,740950,6604768,12.64
9862046,9984788,3478,1217300,11202088,12.19
9862047,9979832,3888,1360800,11340632,13.64
9862048,9916774,4222,1477700,11394474,14.90
9862049,9978497,4421,1547350,11525847,15.51
9862050,9978958,3747,1311450,11290408,13.14
9862051,9995329,5927,2074450,12069779,20.75
9862052,9979933,4821,1687350,11667283,16.91
9862053,9973513,5561,1946350,11919863,19.52
9862054,9984522,6272,2195200,12179722,21.99
9862055,9983445,3482,1218700,11202145,12.21
9862056,9938866,5670,1984500,11923366,19.97
9862057,9965474,4799,1679650,11645124,16.85
9862058,9982720,2925,1023750,11006470,10.26
9862059,9968612,2454,858900,10827512,8.62
9862060,9968147,1982,693700,10661847,6.96
9862061,4224482,765,267750,4492232,6.34
9862062,9955772,1913,669550,10625322,6.73
9862063,9952829,865,302750,10255579,3.04
9862064,9953246,5231,1830850,11784096,18.39
9862065,9939667,5104,1786400,11726067,17.97
9862066,9948614,2391,836850,10785464,8.41
9862067,9949326,4577,1601950,11551276,16.10
9862068,9951299,3993,1397550,11348849,14.04
9862069,9951739,3056,1069600,11021339,10.75
9862070,9944350,975,341250,10285600,3.43
9862071,9935808,3238,1133300,11069108,11.41
9862072,9961167,4578,1602300,11563467,16.09
9862074,9987018,4078,1427300,11414318,14.29
9862075,9974116,5575,1951250,11925366,19.56
9862077,9991874,2384,834400,10826274,8.35
9862078,9980548,4221,1477350,11457898,14.80
9862079,9977700,1957,684950,10662650,6.86
9862080,9990543,3611,1263850,11254393,12.65
9862081,9982301,5184,1814400,11796701,18.18
9862083,9989801,4438,1553300,11543101,15.55
9862084,9983190,5024,1758400,11741590,17.61
9862085,9978923,2252,788200,10767123,7.90
9862086,9971095,2679,937650,10908745,9.40
9862087,9990212,6182,2163700,12153912,21.66
9862088,9988996,2009,703150,10692146,7.04
9862090,9987380,2995,1048250,11035630,10.50
9862091,9666968,3920,1372000,11038968,14.19
9862092,3270248,1170,409500,3679748,12.52
9862093,9956295,2676,936600,10892895,9.41
9862094,9966910,5704,1996400,11963310,20.03
9862095,9971861,3458,1210300,11182161,12.14
9862096,9986581,3816,1335600,11322181,13.37
9862097,9967170,1889,661150,10628320,6.63
9862098,9974252,3143,1100050,11074302,11.03
9862099,6548949,3072,1075200,7624149,16.42
9862100,9957159,3967,1388450,11345609,13.94
9862101,9978740,1212,424200,10402940,4.25
9862102,9982082,5468,1913800,11895882,19.17
9862104,9975009,2508,877800,10852809,8.80
9862105,9978966,4161,1456350,11435316,14.59
9862106,9987004,4494,1572900,11559904,15.75
9862107,9988609,3118,1091300,11079909,10.93
9862108,9985676,4837,1692950,11678626,16.95
9862109,9221191,1662,581700,9802891,6.31
9862110,9964155,1057,369950,10334105,3.71
9862111,684732,498,174300,859032,25.46
9862112,9979322,2441,854350,10833672,8.56
9862114,9978113,6474,2265900,12244013,22.71
9862115,9963330,2518,881300,10844630,8.85
9862116,9934823,1228,429800,10364623,4.33
9862117,9976289,1941,679350,10655639,6.81
9862118,8980429,1881,658350,9638779,7.33
9862119,9684942,6046,2116100,11801042,21.85
9862121,9968109,2963,1037050,11005159,10.40
9862122,9977120,528,184800,10161920,1.85
9862123,9891314,2943,1030050,10921364,10.41
9862124,9969842,5004,1751400,11721242,17.57
9862125,9983115,2503,876050,10859165,8.78
9862126,9986301,2122,742700,10729001,7.44
9862127,9990426,6068,2123800,12114226,21.26
9862128,9754710,2668,933800,10688510,9.57
9862129,9987177,4339,1518650,11505827,15.21
9862130,9978696,3464,1212400,11191096,12.15
9862131,9997625,2561,896350,10893975,8.97
9862132,9976357,3285,1149750,11126107,11.52
9862133,9993168,4286,1500100,11493268,15.01
9862134,9993034,3345,1170750,11163784,11.72
9862135,9993987,5227,1829450,11823437,18.31
9862136,9999874,2301,805350,10805224,8.05
9862137,9973603,6685,2339750,12313353,23.46
9862138,9979727,2772,970200,10949927,9.72
9862139,9987710,2510,878500,10866210,8.80
9862140,9995549,5297,1853950,11849499,18.55
9862141,9993296,7432,2601200,12594496,26.03
9862142,9982065,2120,742000,10724065,7.43
9862143,9977687,4257,1489950,11467637,14.93
9862144,9966811,2378,832300,10799111,8.35
9862145,9984246,6429,2250150,12234396,22.54
9862146,9989328,2794,977900,10967228,9.79
9862147,9987707,3391,1186850,11174557,11.88
9862148,9971017,3406,1192100,11163117,11.96
9862149,9993351,3949,1382150,11375501,13.83
9862150,9999029,5477,1916950,11915979,19.17
9862151,9983866,5947,2081450,12065316,20.85
9862152,9985045,2429,850150,10835195,8.51
9862153,9990591,2255,789250,10779841,7.90
9862154,9990249,3981,1393350,11383599,13.95
9862155,9990768,3680,1288000,11278768,12.89
9862156,9989337,2329,815150,10804487,8.16
9862157,9982715,3491,1221850,11204565,12.24
9862158,9977676,3352,1173200,11150876,11.76
9862159,9994370,2542,889700,10884070,8.90
9862160,3802907,674,235900,4038807,6.20
9862161,9980598,5331,1865850,11846448,18.69
9862162,9976377,1624,568400,10544777,5.70
9862163,9985047,2927,1024450,11009497,10.26
9862164,9997535,4028,1409800,11407335,14.10
9862165,6826881,2229,780150,7607031,11.43
9862166,9972115,4085,1429750,11401865,14.34
9862167,9967313,2430,850500,10817813,8.53
9862168,5722245,2027,709450,6431695,12.40
9862169,9954106,2749,962150,10916256,9.67
9862170,9946604,4130,1445500,11392104,14.53
9862171,9967448,804,281400,10248848,2.82
9862172,9971974,5789,2026150,11998124,20.32
9862173,9977792,1220,427000,10404792,4.28
9862174,524346,284,99400,623746,18.96
9862175,9960538,1555,544250,10504788,5.46
9862176,9940852,2041,714350,10655202,7.19
9862177,9949159,1748,611800,10560959,6.15
9862178,9944220,1974,690900,10635120,6.95
9862179,9949820,3252,1138200,11088020,11.44
9862180,9964713,1502,525700,10490413,5.28
9862181,9942368,924,323400,10265768,3.25
9862182,9942928,5137,1797950,11740878,18.08
9862183,332933,258,90300,423233,27.12
9862184,9948532,2788,975800,10924332,9.81
9862185,9961329,5786,2025100,11986429,20.33
9862186,9961415,1623,568050,10529465,5.70
9862187,9976345,6867,2403450,12379795,24.09
9862188,9948162,3250,1137500,11085662,11.43
9862189,9985117,2929,1025150,11010267,10.27
9862190,5905387,2049,717150,6622537,12.14
9862192,9961651,4087,1430450,11392101,14.36
9862193,9960492,2565,897750,10858242,9.01
9862195,9962678,2079,727650,10690328,7.30
9862196,9966801,3493,1222550,11189351,12.27
9862197,9966719,3119,1091650,11058369,10.95
9862198,9964726,2490,871500,10836226,8.75
9862199,9974730,5571,1949850,11924580,19.55
9862200,9973327,6372,2230200,12203527,22.36
9862201,9978531,4774,1670900,11649431,16.74
9862202,9977991,2215,775250,10753241,7.77
9862203,565168,195,68250,633418,12.08
9862204,9973550,5123,1793050,11766600,17.98
9862205,9993672,2096,733600,10727272,7.34
9862206,9997840,3500,1225000,11222840,12.25
9862207,9991828,3154,1103900,11095728,11.05
9862208,1389203,707,247450,1636653,17.81
9862209,9998418,1357,474950,10473368,4.75
9862210,9999796,2232,781200,10780996,7.81
9862211,1986601,1357,474950,2461551,23.91
9862212,2164760,868,303800,2468560,14.03
9862213,9965232,6866,2403100,12368332,24.11
9862214,4079715,810,283500,4363215,6.95
9862215,2066097,420,147000,2213097,7.11
9862216,8477282,2871,1004850,9482132,11.85
9862217,9963430,3082,1078700,11042130,10.83
9862218,9960788,2322,812700,10773488,8.16
9862219,9973923,1709,598150,10572073,6.00
9862220,9985497,3943,1380050,11365547,13.82
9862221,9986157,3173,1110550,11096707,11.12
9862222,9999589,2293,802550,10802139,8.03
9862223,9985554,5161,1806350,11791904,18.09
9862224,9981954,3700,1295000,11276954,12.97
9862225,9993985,3689,1291150,11285135,12.92
9862226,9969727,4144,1450400,11420127,14.55
9862227,9986777,3175,1111250,11098027,11.13
9862228,1403627,404,141400,1545027,10.07
9862229,9964196,3523,1233050,11197246,12.37
9862230,9986356,1667,583450,10569806,5.84
9862231,9976214,2766,968100,10944314,9.70
9862232,2351449,518,181300,2532749,7.71
9862233,1220530,532,186200,1406730,15.26
9862234,9980027,3871,1354850,11334877,13.58
9862235,9985730,4105,1436750,11422480,14.39
9862236,704732,225,78750,783482,11.17
9862237,9986453,2241,784350,10770803,7.85
9862238,9994604,1253,438550,10433154,4.39
9862239,3108748,1001,350350,3459098,11.27
9862240,9972127,1517,530950,10503077,5.32
9862241,2956673,735,257250,3213923,8.70
9862242,9963594,4200,1470000,11433594,14.75
9862243,9953929,5201,1820350,11774279,18.29
9862244,9974791,4020,1407000,11381791,14.11
9862245,9963831,4045,1415750,11379581,14.21
9862246,9960304,3054,1068900,11029204,10.73
9862247,9968451,2306,807100,10775551,8.10
9862248,9945464,3099,1084650,11030114,10.91
9862249,9965855,1238,433300,10399155,4.35
9862250,9978717,3483,1219050,11197767,12.22
9862251,9249415,3863,1352050,10601465,14.62
9862252,9997369,3995,1398250,11395619,13.99
9862253,1686124,1161,406350,2092474,24.10
9862254,9975427,5436,1902600,11878027,19.07
9862255,9968603,4468,1563800,11532403,15.69
9862256,9892134,2499,874650,10766784,8.84
9862257,9972368,7378,2582300,12554668,25.89
9862258,9959193,4220,1477000,11436193,14.83
9862259,9809211,1635,572250,10381461,5.83
9862260,9966316,3397,1188950,11155266,11.93
9862261,4279469,770,269500,4548969,6.30
9862262,4031430,2742,959700,4991130,23.81
9862263,9939060,3277,1146950,11086010,11.54
9862264,9955198,4161,1456350,11411548,14.63
9862265,9947177,3222,1127700,11074877,11.34
9862266,9955590,2442,854700,10810290,8.59
9862267,9976491,4794,1677900,11654391,16.82
9862268,9986746,3208,1122800,11109546,11.24
9862269,9947428,6072,2125200,12072628,21.36
9862270,9968673,4086,1430100,11398773,14.35
9862271,9989897,3622,1267700,11257597,12.69
9862272,9984972,5034,1761900,11746872,17.65
9862273,9979429,1908,667800,10647229,6.69
9862274,9982066,3342,1169700,11151766,11.72
9862275,9993495,2593,907550,10901045,9.08
9862276,7402334,3111,1088850,8491184,14.71
9862277,9981843,3264,1142400,11124243,11.44
9862278,250290,289,101150,351440,40.41
9862279,9995914,3432,1201200,11197114,12.02
9862280,9985261,3446,1206100,11191361,12.08
9862281,2907541,1131,395850,3303391,13.61
9862282,9990971,5727,2004450,11995421,20.06
9862283,9995483,4071,1424850,11420333,14.25
9862284,9915296,4423,1548050,11463346,15.61
9862285,9993820,3051,1067850,11061670,10.69
9862286,9995828,2602,910700,10906528,9.11
9862287,9979145,4252,1488200,11467345,14.91
9862288,9985102,3485,1219750,11204852,12.22
9862289,9989232,1102,385700,10374932,3.86
9862290,9969587,2619,916650,10886237,9.19
9862291,9842462,2656,929600,10772062,9.44
9862292,9984992,2575,901250,10886242,9.03
9862293,2798913,760,266000,3064913,9.50
9862294,9962547,3489,1221150,11183697,12.26
9862295,9969727,2734,956900,10926627,9.60
9862296,8051700,2190,766500,8818200,9.52
9862297,9834875,3946,1381100,11215975,14.04
9862298,9997241,2336,817600,10814841,8.18
9862299,9985473,5570,1949500,11934973,19.52
9862300,9951531,3326,1164100,11115631,11.70
9862301,9988537,4295,1503250,11491787,15.05
9862302,9988363,2897,1013950,11002313,10.15
9862303,9993891,5971,2089850,12083741,20.91
9862304,9988591,3343,1170050,11158641,11.71
9862305,9975541,3268,1143800,11119341,11.47
9862306,9985874,3172,1110200,11096074,11.12
9862307,9991007,2591,906850,10897857,9.08
9862308,9981257,4942,1729700,11710957,17.33
9862309,9978533,3560,1246000,11224533,12.49
9862310,9994000,2683,939050,10933050,9.40
9862311,9988932,4203,1471050,11459982,14.73
9862312,9986564,3276,1146600,11133164,11.48
9862313,9999196,4020,1407000,11406196,14.07
9862314,9993327,2957,1034950,11028277,10.36
9862315,9987279,2982,1043700,11030979,10.45
9862316,9978543,3018,1056300,11034843,10.59
9862317,9982353,1161,406350,10388703,4.07
9862318,9966718,2938,1028300,10995018,10.32
9862319,9964450,4398,1539300,11503750,15.45
9862320,9971971,3295,1153250,11125221,11.56
9862321,9993849,5116,1790600,11784449,17.92
9862322,4278816,2950,1032500,5311316,24.13
9862323,9979013,1661,581350,10560363,5.83
9862324,9955139,2381,833350,10788489,8.37
9862325,6646968,2809,983150,7630118,14.79
9862326,9963839,2904,1016400,10980239,10.20
9862327,9971386,3430,1200500,11171886,12.04
9862328,777798,352,123200,900998,15.84
9862329,9966578,3514,1229900,11196478,12.34
9862330,9987261,2736,957600,10944861,9.59
9862331,9977903,3201,1120350,11098253,11.23
9862332,9963916,2473,865550,10829466,8.69
9862333,9955917,4296,1503600,11459517,15.10
9862334,9960169,3860,1351000,11311169,13.56
9862335,9936289,2154,753900,10690189,7.59
9862336,9955257,1814,634900,10590157,6.38
9862337,9968692,2601,910350,10879042,9.13
9862339,9983076,1837,642950,10626026,6.44
9862340,9979083,4615,1615250,11594333,16.19
9862341,9980901,1928,674800,10655701,6.76
9862342,9961579,3571,1249850,11211429,12.55
9862343,9972888,3475,1216250,11189138,12.20
9862344,9812359,3501,1225350,11037709,12.49
9862345,9987144,2378,832300,10819444,8.33
9862346,9995972,2577,901950,10897922,9.02
9862347,9991510,3420,1197000,11188510,11.98
9862348,9990089,4041,1414350,11404439,14.16
9862349,9998314,4103,1436050,11434364,14.36
9862350,9999556,5760,2016000,12015556,20.16
9862351,9986595,5533,1936550,11923145,19.39
9862352,9982340,4209,1473150,11455490,14.76
9862353,2443412,2358,825300,3268712,33.78
9862354,1817593,1381,483350,2300943,26.59
9862355,9958292,2826,989100,10947392,9.93
9862356,6996266,2258,790300,7786566,11.30
9862357,3070650,1128,394800,3465450,12.86
9862358,9947922,7073,2475550,12423472,24.89
9862359,9968956,1846,646100,10615056,6.48
9862360,9976871,4804,1681400,11658271,16.85
9862361,9982112,2855,999250,10981362,10.01
9862362,286863,162,56700,343563,19.77
9862363,9966492,2738,958300,10924792,9.62
9862364,3266265,1198,419300,3685565,12.84
9862365,9992115,4495,1573250,11565365,15.74
9862366,9994221,4999,1749650,11743871,17.51
9862367,9992332,3741,1309350,11301682,13.10
9862368,9978375,1888,660800,10639175,6.62
9862369,9973300,3658,1280300,11253600,12.84
9862370,9951263,3512,1229200,11180463,12.35
9862371,9969413,3712,1299200,11268613,13.03
9862372,9982207,3470,1214500,11196707,12.17
9862373,9979091,3029,1060150,11039241,10.62
9862374,9972151,3107,1087450,11059601,10.90
9862375,9965284,2998,1049300,11014584,10.53
9862376,9980131,3095,1083250,11063381,10.85
9862377,9983498,3694,1292900,11276398,12.95
9862378,5705818,1369,479150,6184968,8.40
9862379,1948793,826,289100,2237893,14.83
9862380,9961778,2667,933450,10895228,9.37
9862381,9463122,2676,936600,10399722,9.90
9862382,9950405,3564,1247400,11197805,12.54
9862383,9968618,4031,1410850,11379468,14.15
9862384,9960498,2889,1011150,10971648,10.15
9862385,9951437,2690,941500,10892937,9.46
9862386,9977953,2839,993650,10971603,9.96
9862387,9989746,3733,1306550,11296296,13.08
9862389,9983454,2994,1047900,11031354,10.50
9862390,9971428,4745,1660750,11632178,16.66
9862391,9989107,4104,1436400,11425507,14.38
9862392,9965883,4591,1606850,11572733,16.12
9862393,9987237,3167,1108450,11095687,11.10
9862394,3517613,1901,665350,4182963,18.91
9862395,131942,131,45850,177792,34.75
9862396,9976736,3609,1263150,11239886,12.66
9862397,9974537,4746,1661100,11635637,16.65
9862398,9975252,835,292250,10267502,2.93
9862399,6577883,1777,621950,7199833,9.46
9862400,9997279,4077,1426950,11424229,14.27
9862401,9990577,3244,1135400,11125977,11.36
9862402,9482882,4090,1431500,10914382,15.10
9862403,9997573,2965,1037750,11035323,10.38
9862404,9989943,3797,1328950,11318893,13.30
9862405,9982178,2951,1032850,11015028,10.35
9862406,9987905,4360,1526000,11513905,15.28
9862407,9986545,2914,1019900,11006445,10.21
9862408,9987473,1759,615650,10603123,6.16
9862409,9982649,4219,1476650,11459299,14.79
9862410,9975610,3777,1321950,11297560,13.25
9862411,1020284,285,99750,1120034,9.78
9862412,6944341,2789,976150,7920491,14.06
9862413,9990110,3693,1292550,11282660,12.94
9862414,9998141,1328,464800,10462941,4.65
9862415,9984075,2720,952000,10936075,9.54
9862416,9993127,3532,1236200,11229327,12.37
9862417,9997583,3314,1159900,11157483,11.60
9862418,9973095,2975,1041250,11014345,10.44
9862419,9975366,1526,534100,10509466,5.35
9862420,9980987,3789,1326150,11307137,13.29
9862421,974949,393,137550,1112499,14.11
9862422,9981094,3361,1176350,11157444,11.79
9862423,9985098,3199,1119650,11104748,11.21
9862424,9907100,4451,1557850,11464950,15.72
9862425,9981602,3094,1082900,11064502,10.85
9862426,9980285,2686,940100,10920385,9.42
9862427,53747,30,10500,64247,19.54
9862428,9988909,3396,1188600,11177509,11.90
9862429,8095249,3887,1360450,9455699,16.81
9862430,9999968,1965,687750,10687718,6.88
9862431,8169769,2736,957600,9127369,11.72
9862432,9982184,3972,1390200,11372384,13.93
9862433,9961988,3651,1277850,11239838,12.83
9862434,9984185,4578,1602300,11586485,16.05
9862435,9980929,4473,1565550,11546479,15.69
9862436,9985837,4466,1563100,11548937,15.65
9862437,9982945,3548,1241800,11224745,12.44
9862438,5104568,2847,996450,6101018,19.52
9862439,1955904,926,324100,2280004,16.57
9862440,3421549,3010,1053500,4475049,30.79
9862441,9983846,4143,1450050,11433896,14.52
9862442,9988068,3557,1244950,11233018,12.46
9862443,9986679,1503,526050,10512729,5.27
9862445,9997966,3510,1228500,11226466,12.29
9862446,9982588,4229,1480150,11462738,14.83
9862447,9986812,399,139650,10126462,1.40
9862448,9998387,4027,1409450,11407837,14.10
9862449,9984468,5614,1964900,11949368,19.68
9862450,9958709,4224,1478400,11437109,14.85
9862451,9985869,4485,1569750,11555619,15.72
9862452,9980300,3349,1172150,11152450,11.74
9862453,9975798,5143,1800050,11775848,18.04
9862454,9979340,5588,1955800,11935140,19.60
9862455,9999400,4797,1678950,11678350,16.79
9862456,9998221,2058,720300,10718521,7.20
9862457,7418675,5478,1917300,9335975,25.84
9862459,9438549,3734,1306900,10745449,13.85
9862460,9980413,4026,1409100,11389513,14.12
9862461,9990954,5496,1923600,11914554,19.25
9862462,9984972,5202,1820700,11805672,18.23
9862463,9980865,2063,722050,10702915,7.23
9862464,9992659,3903,1366050,11358709,13.67
9862465,9984002,2756,964600,10948602,9.66
9862466,9979332,6714,2349900,12329232,23.55
9862467,9986682,3735,1307250,11293932,13.09
9862468,9981365,1692,592200,10573565,5.93
9862469,9993418,2263,792050,10785468,7.93
9862470,9623960,3640,1274000,10897960,13.24
9862471,9975558,1344,470400,10445958,4.72
9862472,9975226,3226,1129100,11104326,11.32
9862473,9984128,2947,1031450,11015578,10.33
9862474,9994179,2198,769300,10763479,7.70
9862475,9992586,3615,1265250,11257836,12.66
9862476,9978906,3526,1234100,11213006,12.37
9862477,9984587,4078,1427300,11411887,14.30
9862478,9981055,4300,1505000,11486055,15.08
9862479,603785,398,139300,743085,23.07
9862480,9985898,5118,1791300,11777198,17.94
9862482,9620807,6005,2101750,11722557,21.85
9862483,9976823,1676,586600,10563423,5.88
9862484,6128504,844,295400,6423904,4.82
9862485,9951206,4245,1485750,11436956,14.93
9862486,9964814,2570,899500,10864314,9.03
9862487,9968464,4165,1457750,11426214,14.62
9862488,9982736,3138,1098300,11081036,11.00
9862489,9991689,3804,1331400,11323089,13.33
9862491,8204261,1620,567000,8771261,6.91
9862492,9931270,3526,1234100,11165370,12.43
9862493,9971444,3271,1144850,11116294,11.48
9862494,9972904,3116,1090600,11063504,10.94
9862495,9970927,4380,1533000,11503927,15.37
9862496,9979554,4273,1495550,11475104,14.99
9862497,9986753,4283,1499050,11485803,15.01
9862498,9968073,2311,808850,10776923,8.11
9862499,9983908,3891,1361850,11345758,13.64
9862500,3316493,965,337750,3654243,10.18
9862501,9991548,3370,1179500,11171048,11.80
9862502,41209,42,14700,55909,35.67
9862503,9965340,4347,1521450,11486790,15.27
9862504,9968459,3040,1064000,11032459,10.67
9862505,9959765,2604,911400,10871165,9.15
9862506,5246657,2272,795200,6041857,15.16
9862508,9144061,3903,1366050,10510111,14.94
9862509,9963237,3985,1394750,11357987,14.00
9862510,9961659,2889,1011150,10972809,10.15
9862511,9972917,3137,1097950,11070867,11.01
9862512,9983333,2186,765100,10748433,7.66
9862514,9756162,3358,1175300,10931462,12.05
9862515,7177321,2559,895650,8072971,12.48
9862516,240573,167,58450,299023,24.30
9862517,9985194,4356,1524600,11509794,15.27
9862518,9979594,4322,1512700,11492294,15.16
9862519,9993191,4157,1454950,11448141,14.56
9862520,3428053,1095,383250,3811303,11.18
9862521,9989604,5832,2041200,12030804,20.43
9862522,9984165,1869,654150,10638315,6.55
9862523,9990068,3697,1293950,11284018,12.95
9862524,9989937,4655,1629250,11619187,16.31
9862525,9982420,3333,1166550,11148970,11.69
9862526,9985167,6079,2127650,12112817,21.31
9862527,3826504,1785,624750,4451254,16.33
9862528,9993949,5267,1843450,11837399,18.45
9862529,9990152,3849,1347150,11337302,13.48
9862530,9979302,2664,932400,10911702,9.34
9862531,9987095,2749,962150,10949245,9.63
9862532,9977841,3781,1323350,11301191,13.26
9862533,9989783,3235,1132250,11122033,11.33
9862534,9981395,5002,1750700,11732095,17.54
9862535,1678011,742,259700,1937711,15.48
9862536,1023983,301,105350,1129333,10.29
9862537,1541361,487,170450,1711811,11.06
9862538,9975205,3364,1177400,11152605,11.80
9862539,9972654,3008,1052800,11025454,10.56
9862540,9988782,1869,654150,10642932,6.55
9862541,9986301,5457,1909950,11896251,19.13
9862542,9988806,1382,483700,10472506,4.84
9862543,9979212,3260,1141000,11120212,11.43
9862544,9973267,3071,1074850,11048117,10.78
9862545,9988933,2734,956900,10945833,9.58
9862546,9986784,2385,834750,10821534,8.36
9862547,9984322,2650,927500,10911822,9.29
9862548,9985470,4249,1487150,11472620,14.89
9862549,9991171,4228,1479800,11470971,14.81
9862550,9979934,4469,1564150,11544084,15.67
9862551,9997337,4552,1593200,11590537,15.94
9862552,9986004,2133,746550,10732554,7.48
9862553,9969201,560,196000,10165201,1.97
9862554,9969052,2529,885150,10854202,8.88
9862555,1468048,616,215600,1683648,14.69
9862556,9944203,2941,1029350,10973553,10.35
9862557,9946453,2607,912450,10858903,9.17
9862558,9961644,3747,1311450,11273094,13.16
9862559,9912562,5990,2096500,12009062,21.15
9862560,9953169,2833,991550,10944719,9.96
9862561,9954166,5397,1888950,11843116,18.98
9862562,9947969,1785,624750,10572719,6.28
9862563,9956925,5497,1923950,11880875,19.32
9862564,9962320,2985,1044750,11007070,10.49
9862565,9956051,2807,982450,10938501,9.87
9862566,9973795,1722,602700,10576495,6.04
9862567,9963665,4137,1447950,11411615,14.53
9862568,9965901,4515,1580250,11546151,15.86
9862569,9971214,3195,1118250,11089464,11.21
9862570,1070055,195,68250,1138305,6.38
9862571,9959637,3383,1184050,11143687,11.89
9862572,9976427,4369,1529150,11505577,15.33
9862573,9983368,3226,1129100,11112468,11.31
9862574,9988935,3618,1266300,11255235,12.68
9862575,9810836,1423,498050,10308886,5.08
9862576,9991281,4231,1480850,11472131,14.82
9862577,9997002,4240,1484000,11481002,14.84
9862578,9987362,2417,845950,10833312,8.47
9862579,9978707,711,248850,10227557,2.49
9862580,9987791,2868,1003800,10991591,10.05
9862581,9979398,1670,584500,10563898,5.86
9862582,8984492,1055,369250,9353742,4.11
9862583,9981041,2293,802550,10783591,8.04
9862584,9536512,4368,1528800,11065312,16.03
9862585,9988455,3795,1328250,11316705,13.30
9862586,9993919,4380,1533000,11526919,15.34
9862587,9988546,2434,851900,10840446,8.53
9862588,9966839,3080,1078000,11044839,10.82
9862589,9983767,1001,350350,10334117,3.51
9862590,9932329,3540,1239000,11171329,12.47
9862591,9940902,2921,1022350,10963252,10.28
9862592,9957843,4657,1629950,11587793,16.37
9862593,9972480,2527,884450,10856930,8.87
9862594,9987509,3741,1309350,11296859,13.11
9862595,1125304,785,274750,1400054,24.42
9862596,9997446,3789,1326150,11323596,13.26
9862597,9980169,3724,1303400,11283569,13.06
9862598,9995186,3779,1322650,11317836,13.23
9862599,9987733,4657,1629950,11617683,16.32
9862600,9993176,3920,1372000,11365176,13.73
9862601,9977933,2958,1035300,11013233,10.38
9862602,9926754,2988,1045800,10972554,10.54
9862603,9983349,2432,851200,10834549,8.53
9862604,9996808,3813,1334550,11331358,13.35
9862605,9984231,2167,758450,10742681,7.60
9862606,9985681,2969,1039150,11024831,10.41
9862607,9919040,2643,925050,10844090,9.33
9862608,9974577,708,247800,10222377,2.48
9862609,9978943,3737,1307950,11286893,13.11
9862610,9979360,5171,1809850,11789210,18.14
9862611,9984571,3225,1128750,11113321,11.30
9862612,9986947,3797,1328950,11315897,13.31
9862613,9974175,3337,1167950,11142125,11.71
9862614,9988594,2024,708400,10696994,7.09
9862615,9980958,3374,1180900,11161858,11.83
9862616,9991079,3942,1379700,11370779,13.81
9862617,4868036,1707,597450,5465486,12.27
9862618,9918021,3147,1101450,11019471,11.11
9862619,9976973,3475,1216250,11193223,12.19
9862620,9992050,3397,1188950,11181000,11.90
9862621,9981476,3293,1152550,11134026,11.55
9862622,9983053,2284,799400,10782453,8.01
9862623,9994305,3075,1076250,11070555,10.77
9862624,9975138,5012,1754200,11729338,17.59
9862625,9988664,2796,978600,10967264,9.80
9862626,9958916,1583,554050,10512966,5.56
9862627,2217347,2343,820050,3037397,36.98
9862628,9972204,2183,764050,10736254,7.66
9862629,9958239,4039,1413650,11371889,14.20
9862630,9954435,3242,1134700,11089135,11.40
9862631,9979585,2327,814450,10794035,8.16
9862632,9972223,1277,446950,10419173,4.48
9862633,8471329,1788,625800,9097129,7.39
9862634,9984060,3811,1333850,11317910,13.36
9862635,9981689,3902,1365700,11347389,13.68
9862636,9982841,2892,1012200,10995041,10.14
9862637,9961661,3527,1234450,11196111,12.39
9862638,9985552,2899,1014650,11000202,10.16
9862639,9988369,947,331450,10319819,3.32
9862640,9979910,3046,1066100,11046010,10.68
9862641,6717415,2469,864150,7581565,12.86
9862642,9951153,3479,1217650,11168803,12.24
9862643,9960765,2900,1015000,10975765,10.19
9862644,9965117,2781,973350,10938467,9.77
9862645,9965571,2794,977900,10943471,9.81
9862646,9977975,2896,1013600,10991575,10.16
9862647,9984394,2498,874300,10858694,8.76
9862649,5079974,1703,596050,5676024,11.73
9862650,9951769,1955,684250,10636019,6.88
9862651,9958459,4852,1698200,11656659,17.05
9862652,9965358,2990,1046500,11011858,10.50
9862653,9959863,2758,965300,10925163,9.69
9862654,9953898,3377,1181950,11135848,11.87
9862655,9945879,3176,1111600,11057479,11.18
9862656,9936437,4795,1678250,11614687,16.89
9862657,9947467,2213,774550,10722017,7.79
9862658,9935178,3808,1332800,11267978,13.41
9862659,9949060,3090,1081500,11030560,10.87
9862660,9945055,4338,1518300,11463355,15.27
9862661,9956873,987,345450,10302323,3.47
9862662,9954464,4266,1493100,11447564,15.00
9862663,9939040,3157,1104950,11043990,11.12
9862664,9944351,4189,1466150,11410501,14.74
9862665,9958176,2246,786100,10744276,7.89
9862666,9950999,5152,1803200,11754199,18.12
9862667,9960089,4174,1460900,11420989,14.67
9862668,9957942,3044,1065400,11023342,10.70
9862669,9936023,4223,1478050,11414073,14.88
9862670,9977874,3067,1073450,11051324,10.76
9862671,9974779,5082,1778700,11753479,17.83
9862672,632894,229,80150,713044,12.66
9862673,9980182,2159,755650,10735832,7.57
9862674,9976006,1593,557550,10533556,5.59
9862675,9984573,696,243600,10228173,2.44
9862676,9978488,825,288750,10267238,2.89
9862677,9987760,2406,842100,10829860,8.43
9862678,9988796,3347,1171450,11160246,11.73
9862679,9997611,4281,1498350,11495961,14.99
9862680,9992298,3834,1341900,11334198,13.43
9862681,9979823,3601,1260350,11240173,12.63
9862682,9982186,2336,817600,10799786,8.19
9862683,9981271,5644,1975400,11956671,19.79
9862684,9988369,4118,1441300,11429669,14.43
9862685,9981052,3129,1095150,11076202,10.97
9862686,9981879,2188,765800,10747679,7.67
9862687,9990718,2013,704550,10695268,7.05
9862688,9988502,4784,1674400,11662902,16.76
9862689,2930028,1450,507500,3437528,17.32
9862690,9978143,2953,1033550,11011693,10.36
9862691,9989139,5686,1990100,11979239,19.92
9862692,9999263,470,164500,10163763,1.65
9862693,9973301,1997,698950,10672251,7.01
9862694,9979316,3044,1065400,11044716,10.68
9862695,9993305,4696,1643600,11636905,16.45
9862696,9983021,2728,954800,10937821,9.56
9862697,9982044,3354,1173900,11155944,11.76
9862698,8346160,1613,564550,8910710,6.76
9862699,9983750,2393,837550,10821300,8.39
9862700,9988716,1671,584850,10573566,5.86
9862701,9982046,4437,1552950,11534996,15.56
9862702,9996666,3132,1096200,11092866,10.97
9862703,9981565,3903,1366050,11347615,13.69
9862704,7180270,3280,1148000,8328270,15.99
9862705,9966312,3435,1202250,11168562,12.06
9862706,9983986,3650,1277500,11261486,12.80
9862707,6022906,3185,1114750,7137656,18.51
9862708,9974639,4254,1488900,11463539,14.93
9862709,9976477,2521,882350,10858827,8.84
9862710,9965127,2394,837900,10803027,8.41
9862711,9947378,2849,997150,10944528,10.02
9862712,9968261,2200,770000,10738261,7.72
9862713,1377138,603,211050,1588188,15.33
9862714,9950809,3900,1365000,11315809,13.72
9862715,7445138,1870,654500,8099638,8.79
9862716,9944800,2465,862750,10807550,8.68
9862717,9955067,3093,1082550,11037617,10.87
9862718,9959087,3718,1301300,11260387,13.07
9862719,9963134,2925,1023750,10986884,10.28
9862720,9973937,3304,1156400,11130337,11.59
9862721,9974434,5185,1814750,11789184,18.19
9862722,9981809,3180,1113000,11094809,11.15
9862723,9970560,2090,731500,10702060,7.34
9862724,3578392,565,197750,3776142,5.53
9862725,9987330,3422,1197700,11185030,11.99
9862726,9993847,4704,1646400,11640247,16.47
9862727,9972353,4319,1511650,11484003,15.16
9862728,9980537,5160,1806000,11786537,18.10
9862729,9994305,4894,1712900,11707205,17.14
9862730,9982131,2631,920850,10902981,9.22
9862731,9986026,2386,835100,10821126,8.36
9862732,9983969,2486,870100,10854069,8.71
9862733,9987495,4678,1637300,11624795,16.39
9862734,9988990,3480,1218000,11206990,12.19
9862735,9995825,4737,1657950,11653775,16.59
9862736,9665295,4101,1435350,11100645,14.85
9862737,9990103,4131,1445850,11435953,14.47
9862738,9973213,4044,1415400,11388613,14.19
9862739,9983499,2993,1047550,11031049,10.49
9862740,9998689,1984,694400,10693089,6.94
9862741,9975845,3564,1247400,11223245,12.50
9862742,9983823,3789,1326150,11309973,13.28
9862743,9985338,4555,1594250,11579588,15.97
9862744,9985696,4048,1416800,11402496,14.19
9862745,9973067,2652,928200,10901267,9.31
9862746,9977355,4533,1586550,11563905,15.90
9862747,9970322,4117,1440950,11411272,14.45
9862748,9968427,2373,830550,10798977,8.33
9862749,9967655,3571,1249850,11217505,12.54
9862750,9994858,2806,982100,10976958,9.83
9862751,9971078,2054,718900,10689978,7.21
9862752,9975217,3151,1102850,11078067,11.06
9862753,9985103,3020,1057000,11042103,10.59
9862754,9998838,1645,575750,10574588,5.76
9862755,9984881,3991,1396850,11381731,13.99
9862756,9990011,4886,1710100,11700111,17.12
9862757,9983557,1705,596750,10580307,5.98
9862758,9980905,3851,1347850,11328755,13.50
9862759,9982911,2353,823550,10806461,8.25
9862760,9989413,4765,1667750,11657163,16.70
9862761,9980020,1959,685650,10665670,6.87
9862762,9976233,3212,1124200,11100433,11.27
9862763,9978025,2502,875700,10853725,8.78
9862764,9971623,2229,780150,10751773,7.82
9862765,9979029,2699,944650,10923679,9.47
9862766,9978368,1489,521150,10499518,5.22
9862767,9980259,4847,1696450,11676709,17.00
9862768,9989566,5222,1827700,11817266,18.30
9862769,9966796,2797,978950,10945746,9.82
9862770,9957800,3129,1095150,11052950,11.00
9862771,9972322,1734,606900,10579222,6.09
9862772,9969528,2291,801850,10771378,8.04
9862773,5571076,1543,540050,6111126,9.69
9862774,9999469,1070,374500,10373969,3.75
9862775,9984637,482,168700,10153337,1.69
9862776,9303142,2650,927500,10230642,9.97
9862777,9985573,2620,917000,10902573,9.18
9862778,9980996,3510,1228500,11209496,12.31
9862779,9981445,2478,867300,10848745,8.69
9862780,9989214,1725,603750,10592964,6.04
9862781,9997156,2724,953400,10950556,9.54
9862782,9982344,4082,1428700,11411044,14.31
9862783,9997904,1255,439250,10437154,4.39
9862784,9992989,861,301350,10294339,3.02
9862785,9988220,3303,1156050,11144270,11.57
9862786,9980460,3063,1072050,11052510,10.74
9862787,9995921,6479,2267650,12263571,22.69
9862788,9979931,1270,444500,10424431,4.45
9862789,9993129,4731,1655850,11648979,16.57
9862790,9995927,4881,1708350,11704277,17.09
9862791,9975666,2838,993300,10968966,9.96
9862792,9987307,4104,1436400,11423707,14.38
9862793,9993111,3191,1116850,11109961,11.18
9862794,8969715,3992,1397200,10366915,15.58
9862795,9994523,3502,1225700,11220223,12.26
9862796,278310,119,41650,319960,14.97
9862797,9995132,3496,1223600,11218732,12.24
9862798,9982603,3610,1263500,11246103,12.66
9862799,9980202,2048,716800,10697002,7.18
9862800,9981321,2759,965650,10946971,9.67
9862801,9979822,2135,747250,10727072,7.49
9862802,9980188,2558,895300,10875488,8.97
9862803,9994298,2322,812700,10806998,8.13
9862804,97359,39,13650,111009,14.02
9862805,9976566,2928,1024800,11001366,10.27
9862806,9966424,3017,1055950,11022374,10.60
9862807,9977648,3147,1101450,11079098,11.04
9862809,9956845,1533,536550,10493395,5.39
9862810,9980400,3319,1161650,11142050,11.64
9862811,9956915,3531,1235850,11192765,12.41
9862812,9988938,3827,1339450,11328388,13.41
9862813,9998247,2939,1028650,11026897,10.29
9862814,879719,431,150850,1030569,17.15
9862815,9968800,3384,1184400,11153200,11.88
9862816,9957109,3752,1313200,11270309,13.19
9862817,9950170,2212,774200,10724370,7.78
9862818,9948569,4282,1498700,11447269,15.06
9862819,9971482,2828,989800,10961282,9.93
9862820,9970712,2979,1042650,11013362,10.46
9862821,9967058,3507,1227450,11194508,12.32
9862822,9972537,2817,985950,10958487,9.89
9862824,9939593,1777,621950,10561543,6.26
9862825,9951177,3568,1248800,11199977,12.55
9862826,3941246,566,198100,4139346,5.03
9862827,9959930,4643,1625050,11584980,16.32
9862828,9958545,3498,1224300,11182845,12.29
9862829,9972385,3383,1184050,11156435,11.87
9862830,9991504,1737,607950,10599454,6.08
9862831,9998628,3719,1301650,11300278,13.02
9862832,9984781,3745,1310750,11295531,13.13
9862833,9974673,3292,1152200,11126873,11.55
9862834,9994699,1675,586250,10580949,5.87
9862835,9983359,3526,1234100,11217459,12.36
9862836,9998331,3673,1285550,11283881,12.86
9862837,9988994,3143,1100050,11089044,11.01
9862838,9984368,3416,1195600,11179968,11.97
9862839,9989503,2965,1037750,11027253,10.39
9862840,9975082,3430,1200500,11175582,12.03
9862841,9992939,2220,777000,10769939,7.78
9862842,3146411,1641,574350,3720761,18.25
9862843,9992918,4994,1747900,11740818,17.49
9862844,9981929,1666,583100,10565029,5.84
9862845,6288499,2361,826350,7114849,13.14
9862846,9962786,3585,1254750,11217536,12.59
9862847,9960287,4860,1701000,11661287,17.08
9862848,9982245,1580,553000,10535245,5.54
9862850,9950114,4323,1513050,11463164,15.21
9862851,9974525,1110,388500,10363025,3.89
9862852,9970557,2516,880600,10851157,8.83
9862853,9964702,4692,1642200,11606902,16.48
9862854,1338713,535,187250,1525963,13.99
9862855,9973421,3287,1150450,11123871,11.54
9862856,9980258,3765,1317750,11298008,13.20
9862857,9984676,2313,809550,10794226,8.11
9862858,180615,42,14700,195315,8.14
9862859,9976987,2212,774200,10751187,7.76
9862860,9963812,3544,1240400,11204212,12.45
9862861,9957706,2383,834050,10791756,8.38
9862862,9964191,3367,1178450,11142641,11.83
9862863,9961844,2426,849100,10810944,8.52
9862864,9973110,2474,865900,10839010,8.68
9862865,9982199,2965,1037750,11019949,10.40
9862866,9966709,4131,1445850,11412559,14.51
9862867,9987623,3011,1053850,11041473,10.55
9862868,9980808,3881,1358350,11339158,13.61
9862869,9982117,5103,1786050,11768167,17.89
9862870,9976748,1208,422800,10399548,4.24
9862871,9993873,3601,1260350,11254223,12.61
9862872,9968017,3615,1265250,11233267,12.69
9862873,9912669,3553,1243550,11156219,12.55
9862874,9913356,3067,1073450,10986806,10.83
9862875,9986821,3317,1160950,11147771,11.62
9862876,9994444,3181,1113350,11107794,11.14
9862877,9943907,2498,874300,10818207,8.79
9862878,9976788,1014,354900,10331688,3.56
9862879,9969039,3439,1203650,11172689,12.07
9862880,9976391,3594,1257900,11234291,12.61
9862881,9913686,3097,1083950,10997636,10.93
9862882,9987118,3409,1193150,11180268,11.95
9862883,9988646,3157,1104950,11093596,11.06
9862884,3794163,2058,720300,4514463,18.98
9862885,9984238,3491,1221850,11206088,12.24
9862886,9983482,3625,1268750,11252232,12.71
9862887,9984716,1194,417900,10402616,4.19
9862888,6619987,4162,1456700,8076687,22.00
9862889,9963372,652,228200,10191572,2.29
9862890,9975820,2958,1035300,11011120,10.38
9862891,9989842,3383,1184050,11173892,11.85
9862892,9971899,3543,1240050,11211949,12.44
9862893,9977361,1637,572950,10550311,5.74
9862894,9966278,4439,1553650,11519928,15.59
9862895,9988422,3826,1339100,11327522,13.41
9862896,2748347,1817,635950,3384297,23.14
9862897,9996215,3432,1201200,11197415,12.02
9862898,9990228,5984,2094400,12084628,20.96
9862899,9980116,5303,1856050,11836166,18.60
9862900,9992520,3320,1162000,11154520,11.63
9862901,9973518,4107,1437450,11410968,14.41
9862902,9986413,3649,1277150,11263563,12.79
9862903,9984895,1421,497350,10482245,4.98
9862904,9995813,3867,1353450,11349263,13.54
9862905,9973553,3537,1237950,11211503,12.41
9862906,9985161,3058,1070300,11055461,10.72
9862907,9980117,3785,1324750,11304867,13.27
9862908,9979647,4699,1644650,11624297,16.48
9862909,9998720,2513,879550,10878270,8.80
9862910,9989327,3952,1383200,11372527,13.85
9862911,9992970,1128,394800,10387770,3.95
9862912,9988025,357,124950,10112975,1.25
9862913,5474972,449,157150,5632122,2.87
9862914,9983982,2189,766150,10750132,7.67
9862915,9995142,5083,1779050,11774192,17.80
9862916,9997886,5267,1843450,11841336,18.44
9862917,9988073,2318,811300,10799373,8.12
9862918,9980936,2519,881650,10862586,8.83
9862919,1009751,207,72450,1082201,7.18
9862920,9954864,4147,1451450,11406314,14.58
9862921,9972608,2804,981400,10954008,9.84
9862923,9990626,3373,1180550,11171176,11.82
9862924,9981381,2014,704900,10686281,7.06
9862925,9969341,4098,1434300,11403641,14.39
9862926,9986165,1548,541800,10527965,5.43
9862927,9996264,1709,598150,10594414,5.98
9862928,9974916,2936,1027600,11002516,10.30
9862929,9999946,1881,658350,10658296,6.58
9862930,9997604,3306,1157100,11154704,11.57
9862931,9981859,2602,910700,10892559,9.12
9862932,5204148,1205,421750,5625898,8.10
9862933,9980222,3070,1074500,11054722,10.77
9862934,9940952,2410,843500,10784452,8.49
9862935,9736033,3784,1324400,11060433,13.60
9862936,9972143,2353,823550,10795693,8.26
9862937,9973476,3058,1070300,11043776,10.73
9862938,9999794,4520,1582000,11581794,15.82
9862939,9991994,2820,987000,10978994,9.88
9862940,9975505,2527,884450,10859955,8.87
9862941,9980548,3223,1128050,11108598,11.30
9862942,9982242,3448,1206800,11189042,12.09
9862943,9984392,2082,728700,10713092,7.30
9862944,9998227,3873,1355550,11353777,13.56
9862945,9988748,1514,529900,10518648,5.30
9862946,9981186,4971,1739850,11721036,17.43
9862947,9973432,4194,1467900,11441332,14.72
9862948,9916921,4576,1601600,11518521,16.15
9862949,9966783,1784,624400,10591183,6.26
9862950,9958565,4193,1467550,11426115,14.74
9862951,9974106,1682,588700,10562806,5.90
9862952,9949268,3081,1078350,11027618,10.84
9862953,9947805,4723,1653050,11600855,16.62
9862954,9984993,2937,1027950,11012943,10.29
9862955,9985242,3053,1068550,11053792,10.70
9862956,9985705,2943,1030050,11015755,10.32
9862957,9957909,3421,1197350,11155259,12.02
9862958,9978814,3353,1173550,11152364,11.76
9862959,9986535,3395,1188250,11174785,11.90
9862960,9977516,3660,1281000,11258516,12.84
9862961,9985520,4081,1428350,11413870,14.30
9862962,9974009,3035,1062250,11036259,10.65
9862963,7485216,952,333200,7818416,4.45
9862964,9993326,2023,708050,10701376,7.09
9862965,374725,110,38500,413225,10.27
9862966,9968184,3604,1261400,11229584,12.65
9862967,9971765,1451,507850,10479615,5.09
9862968,9937001,3615,1265250,11202251,12.73
9862969,9962619,5053,1768550,11731169,17.75
9862970,9973616,4531,1585850,11559466,15.90
9862971,1252046,556,194600,1446646,15.54
9862972,9950758,2807,982450,10933208,9.87
9862973,9959722,1928,674800,10634522,6.78
9862974,9954862,1776,621600,10576462,6.24
9862975,9952912,2518,881300,10834212,8.85
9862976,8965332,822,287700,9253032,3.21
9862977,8983888,3699,1294650,10278538,14.41
9862978,9973634,3095,1083250,11056884,10.86
9862979,9964317,3790,1326500,11290817,13.31
9862980,9971125,1225,428750,10399875,4.30
9862981,9989497,4178,1462300,11451797,14.64
9862982,9982192,2074,725900,10708092,7.27
9862983,9997268,2775,971250,10968518,9.72
9862984,9990952,2109,738150,10729102,7.39
9862985,9983352,3459,1210650,11194002,12.13
9862986,9984415,5587,1955450,11939865,19.59
9862987,9955847,3862,1351700,11307547,13.58
9862988,9987647,2655,929250,10916897,9.30
9862989,3676410,1762,616700,4293110,16.77
9862990,9979593,1596,558600,10538193,5.60
9862991,9413367,4767,1668450,11081817,17.72
9862992,9975754,2634,921900,10897654,9.24
9862993,9986802,5565,1947750,11934552,19.50
9862994,9957483,6269,2194150,12151633,22.04
9862995,9888974,4473,1565550,11454524,15.83
9862996,9969995,3403,1191050,11161045,11.95
9862997,9987901,3733,1306550,11294451,13.08
9862998,9995770,2292,802200,10797970,8.03
9862999,9973566,5914,2069900,12043466,20.75
9863000,9974989,4282,1498700,11473689,15.02
9863001,9974783,4439,1553650,11528433,15.58
9863002,9968713,4582,1603700,11572413,16.09
9863003,9993067,4573,1600550,11593617,16.02
9863004,9984973,5749,2012150,11997123,20.15
9863005,9996341,3963,1387050,11383391,13.88
9863006,9983953,3155,1104250,11088203,11.06
9863007,9984199,4438,1553300,11537499,15.56
9863008,9986511,3632,1271200,11257711,12.73
9863010,9969968,2266,793100,10763068,7.95
9863011,9980086,1998,699300,10679386,7.01
9863012,9963990,1711,598850,10562840,6.01
9863013,9975066,3848,1346800,11321866,13.50
9863014,9806231,3850,1347500,11153731,13.74
9863015,9990602,1928,674800,10665402,6.75
9863016,9995078,3770,1319500,11314578,13.20
9863017,9979454,4497,1573950,11553404,15.77
9863018,9966938,1167,408450,10375388,4.10
9863019,9977435,2942,1029700,11007135,10.32
9863020,9979504,4715,1650250,11629754,16.54
9863021,9983120,4830,1690500,11673620,16.93
9863022,9991460,1405,491750,10483210,4.92
9863023,2829678,835,292250,3121928,10.33
9863024,9983311,1616,565600,10548911,5.67
9863025,9983069,1564,547400,10530469,5.48
9863026,9987493,3121,1092350,11079843,10.94
9863027,9965867,3052,1068200,11034067,10.72
9863028,9981904,2657,929950,10911854,9.32
9863029,9985753,2869,1004150,10989903,10.06
9863030,9974290,2322,812700,10786990,8.15
9863031,9970424,2730,955500,10925924,9.58
9863032,9983279,2491,871850,10855129,8.73
9863033,9967727,3398,1189300,11157027,11.93
9863034,9955660,1234,431900,10387560,4.34
9863036,9961593,1281,448350,10409943,4.50
9863037,9960770,3852,1348200,11308970,13.54
9863038,9975262,4337,1517950,11493212,15.22
9863039,9893342,3459,1210650,11103992,12.24
9863040,9972064,6329,2215150,12187214,22.21
9863041,9972291,2060,721000,10693291,7.23
9863042,9976462,2200,770000,10746462,7.72
9863043,8980636,3091,1081850,10062486,12.05
9863044,9994421,2919,1021650,11016071,10.22
9863045,9985029,2847,996450,10981479,9.98
9863046,9980843,2578,902300,10883143,9.04
9863047,5224260,1502,525700,5749960,10.06
9863048,9986628,2904,1016400,11003028,10.18
9863050,9983123,2311,808850,10791973,8.10
9863051,9983569,2311,808850,10792419,8.10
9863053,9976509,2662,931700,10908209,9.34
9863054,9967457,3419,1196650,11164107,12.01
9863055,9975199,2576,901600,10876799,9.04
9863056,9982024,4388,1535800,11517824,15.39
9863057,9959615,2566,898100,10857715,9.02
9863058,9976053,1253,438550,10414603,4.40
9863059,9063923,1868,653800,9717723,7.21
9863060,9981115,2976,1041600,11022715,10.44
9863061,9980494,1492,522200,10502694,5.23
9863062,9866345,3461,1211350,11077695,12.28
9863063,9993290,3101,1085350,11078640,10.86
9863064,9982035,3272,1145200,11127235,11.47
9863066,9967770,3309,1158150,11125920,11.62
9863067,9987341,2965,1037750,11025091,10.39
9863069,9997157,2311,808850,10806007,8.09
9863070,9970304,4254,1488900,11459204,14.93
9863071,9961742,3504,1226400,11188142,12.31
9863072,9962532,4353,1523550,11486082,15.29
9863073,9965734,2990,1046500,11012234,10.50
9863074,9953637,2903,1016050,10969687,10.21
9863075,9895188,5084,1779400,11674588,17.98
9863076,9982299,4026,1409100,11391399,14.12
9863077,9973332,4177,1461950,11435282,14.66
9863078,1269196,1117,390950,1660146,30.80
9863079,9977856,2140,749000,10726856,7.51
9863080,9977039,2086,730100,10707139,7.32
9863081,8989918,3104,1086400,10076318,12.08
9863082,9988953,1413,494550,10483503,4.95
9863083,9993389,2374,830900,10824289,8.31
9863084,9974469,5898,2064300,12038769,20.70
9863085,9985477,3231,1130850,11116327,11.32
9863086,9703376,4986,1745100,11448476,17.98
9863087,9972648,1550,542500,10515148,5.44
9863088,9988428,2044,715400,10703828,7.16
9863089,9997714,3478,1217300,11215014,12.18
9863090,9979921,1886,660100,10640021,6.61
9863091,9980223,2135,747250,10727473,7.49
9863092,9983845,2793,977550,10961395,9.79
9863093,9991162,3969,1389150,11380312,13.90
9863094,9981776,2679,937650,10919426,9.39
9863095,9994082,4662,1631700,11625782,16.33
9863096,9987626,3765,1317750,11305376,13.19
9863097,8969387,3069,1074150,10043537,11.98
9863098,9984023,3165,1107750,11091773,11.10
9863099,9966492,3388,1185800,11152292,11.90
9863100,9988342,2398,839300,10827642,8.40
9863101,9955341,4198,1469300,11424641,14.76
9863102,8552994,1722,602700,9155694,7.05
9863103,9980363,3535,1237250,11217613,12.40
9863104,9981881,2288,800800,10782681,8.02
9863105,9993523,5059,1770650,11764173,17.72
9863106,9962988,2137,747950,10710938,7.51
9863107,2564540,909,318150,2882690,12.41
9863108,2677396,1777,621950,3299346,23.23
9863109,9475096,3804,1331400,10806496,14.05
9863110,9989153,4967,1738450,11727603,17.40
9863111,9982609,3437,1202950,11185559,12.05
9863112,9995557,2401,840350,10835907,8.41
9863113,9979539,2058,720300,10699839,7.22
9863114,9988333,2959,1035650,11023983,10.37
9863115,9986403,2588,905800,10892203,9.07
9863116,9981960,2789,976150,10958110,9.78
9863117,9983658,3246,1136100,11119758,11.38
9863118,9981294,3579,1252650,11233944,12.55
9863119,9991187,2042,714700,10705887,7.15
9863120,9973679,4726,1654100,11627779,16.58
9863121,9982817,2710,948500,10931317,9.50
9863122,9987994,3013,1054550,11042544,10.56
9863123,9974125,3281,1148350,11122475,11.51
9863124,9987878,3198,1119300,11107178,11.21
9863125,9963658,1806,632100,10595758,6.34
9863126,9982858,4011,1403850,11386708,14.06
9863127,9971130,3175,1111250,11082380,11.14
9863128,3304407,372,130200,3434607,3.94
9863129,9982358,3300,1155000,11137358,11.57
9863130,9998907,3032,1061200,11060107,10.61
9863131,9979011,2285,799750,10778761,8.01
9863132,9970057,1767,618450,10588507,6.20
9863133,9965065,2444,855400,10820465,8.58
9863134,9911413,2378,832300,10743713,8.40
9863135,9980231,1220,427000,10407231,4.28
9863136,9976848,1611,563850,10540698,5.65
9863137,9989823,2511,878850,10868673,8.80
9863138,9985627,4684,1639400,11625027,16.42
9863139,9986758,1993,697550,10684308,6.98
9863140,9973801,1886,660100,10633901,6.62
9863141,4069538,1957,684950,4754488,16.83
9863142,1222946,520,182000,1404946,14.88
9863143,9961425,3326,1164100,11125525,11.69
9863144,9989302,4645,1625750,11615052,16.27
9863145,9964745,1410,493500,10458245,4.95
9863146,9967017,4185,1464750,11431767,14.70
9863147,9983654,4515,1580250,11563904,15.83
9863148,9972950,3024,1058400,11031350,10.61
9863149,9969916,2484,869400,10839316,8.72
9863150,9995109,6286,2200100,12195209,22.01
9863151,9981178,3740,1309000,11290178,13.11
9863152,9974003,5027,1759450,11733453,17.64
9863153,9980267,2290,801500,10781767,8.03
9863154,733882,310,108500,842382,14.78
9863155,9952326,2883,1009050,10961376,10.14
9863156,9964098,3369,1179150,11143248,11.83
9863157,9944652,1851,647850,10592502,6.51
9863158,9965544,5536,1937600,11903144,19.44
9863159,5315152,3372,1180200,6495352,22.20
9863160,9964123,2142,749700,10713823,7.52
9863161,9974340,2095,733250,10707590,7.35
9863162,9981393,2144,750400,10731793,7.52
9863163,9989733,3877,1356950,11346683,13.58
9863164,9982931,3910,1368500,11351431,13.71
9863165,9981932,2846,996100,10978032,9.98
9863166,9997090,3303,1156050,11153140,11.56
9863167,8981162,1653,578550,9559712,6.44
9863168,9993667,1463,512050,10505717,5.12
9863170,9977859,5140,1799000,11776859,18.03
9863171,9964107,2351,822850,10786957,8.26
9863172,9972845,2391,836850,10809695,8.39
9863173,9988171,5248,1836800,11824971,18.39
9863174,9975299,2427,849450,10824749,8.52
9863175,9973026,4981,1743350,11716376,17.48
9863176,9988542,2404,841400,10829942,8.42
9863177,9985570,3765,1317750,11303320,13.20
9863178,9989207,3332,1166200,11155407,11.67
9863179,9396878,4830,1690500,11087378,17.99
9863180,9966854,6086,2130100,12096954,21.37
9863181,9968321,2264,792400,10760721,7.95
9863182,9963962,5108,1787800,11751762,17.94
9863183,9963465,2973,1040550,11004015,10.44
9863184,9977556,3251,1137850,11115406,11.40
9863185,9968074,3695,1293250,11261324,12.97
9863186,6330158,3221,1127350,7457508,17.81
9863187,9952578,3102,1085700,11038278,10.91
9863188,4688500,3250,1137500,5826000,24.26
9863189,9964103,3249,1137150,11101253,11.41
9863190,9960277,3112,1089200,11049477,10.94
9863191,9394278,4133,1446550,10840828,15.40
9863193,9998355,3020,1057000,11055355,10.57
9863194,9226133,1709,598150,9824283,6.48
9863195,9988126,2408,842800,10830926,8.44
9863196,9983381,3461,1211350,11194731,12.13
9863197,9828656,3286,1150100,10978756,11.70
9863199,9970209,1891,661850,10632059,6.64
9863200,9959660,3134,1096900,11056560,11.01
9863201,9957356,2459,860650,10818006,8.64
9863202,9959063,3666,1283100,11242163,12.88
9863203,9965273,3568,1248800,11214073,12.53
9863204,9964716,2884,1009400,10974116,10.13
9863205,8826317,4618,1616300,10442617,18.31
9863206,9963244,2802,980700,10943944,9.84
9863207,9959063,4251,1487850,11446913,14.94
9863208,9961056,2115,740250,10701306,7.43
9863209,9975413,3845,1345750,11321163,13.49
9863210,9840060,2229,780150,10620210,7.93
9863211,9959303,4818,1686300,11645603,16.93
9863212,9993379,2826,989100,10982479,9.90
9863213,9980969,4188,1465800,11446769,14.69
9863214,9999481,2390,836500,10835981,8.37
9863215,9980875,4714,1649900,11630775,16.53
9863216,2322153,1445,505750,2827903,21.78
9863217,9977059,2486,870100,10847159,8.72
9863218,9861641,4255,1489250,11350891,15.10
9863219,9974956,2718,951300,10926256,9.54
9863220,9985228,1494,522900,10508128,5.24
9863221,9984349,4730,1655500,11639849,16.58
9863222,9971251,5356,1874600,11845851,18.80
9863224,8984966,3592,1257200,10242166,13.99
9863225,9978885,4788,1675800,11654685,16.79
9863226,9977351,5193,1817550,11794901,18.22
9863228,9982086,3019,1056650,11038736,10.59
9863229,9976410,3786,1325100,11301510,13.28
9863230,9975578,1805,631750,10607328,6.33
9863231,9970184,3768,1318800,11288984,13.23
9863232,9984307,4604,1611400,11595707,16.14
9863233,9974526,4987,1745450,11719976,17.50
9863234,9938342,4865,1702750,11641092,17.13
9863235,9972451,3754,1313900,11286351,13.18
9863236,9992060,2551,892850,10884910,8.94
9863237,540387,357,124950,665337,23.12
9863238,9955936,2646,926100,10882036,9.30
9863239,9979088,3587,1255450,11234538,12.58
9863240,9972986,3928,1374800,11347786,13.79
9863241,9976916,3337,1167950,11144866,11.71
9863242,9997654,2506,877100,10874754,8.77
9863243,9983824,3327,1164450,11148274,11.66
9863244,9973309,3756,1314600,11287909,13.18
9863245,9979269,3087,1080450,11059719,10.83
9863246,8993548,3745,1310750,10304298,14.57
9863247,9989405,4512,1579200,11568605,15.81
9863248,9986354,4407,1542450,11528804,15.45
9863249,5967540,3294,1152900,7120440,19.32
9863250,9995671,3432,1201200,11196871,12.02
9863251,9991665,4788,1675800,11667465,16.77
9863252,9972331,3787,1325450,11297781,13.29
9863253,9988455,2965,1037750,11026205,10.39
9863255,9978488,5798,2029300,12007788,20.34
9863256,9974267,6160,2156000,12130267,21.62
9863257,9975466,3945,1380750,11356216,13.84
9863258,9974214,3755,1314250,11288464,13.18
9863259,9998679,3663,1282050,11280729,12.82
9863260,9991728,5989,2096150,12087878,20.98
9863261,9923609,3370,1179500,11103109,11.89
9863262,9964914,3459,1210650,11175564,12.15
9863263,9973700,4042,1414700,11388400,14.18
9863264,9986990,2987,1045450,11032440,10.47
9863265,9483312,3393,1187550,10670862,12.52
9863266,9972750,2482,868700,10841450,8.71
9863267,9981850,2528,884800,10866650,8.86
9863269,9989586,4295,1503250,11492836,15.05
9863270,9963355,2985,1044750,11008105,10.49
9863271,9982440,6642,2324700,12307140,23.29
9863272,9973697,2956,1034600,11008297,10.37
9863273,9999498,1972,690200,10689698,6.90
9863274,9909165,6717,2350950,12260115,23.73
9863275,9978704,2423,848050,10826754,8.50
9863276,9991534,4169,1459150,11450684,14.60
9863277,9998853,3074,1075900,11074753,10.76
9863278,9996608,4176,1461600,11458208,14.62
9863279,9982082,3614,1264900,11246982,12.67
9863280,8976576,3679,1287650,10264226,14.34
9863281,9972965,3579,1252650,11225615,12.56
9863282,9953796,1995,698250,10652046,7.01
9863283,9979163,3953,1383550,11362713,13.86
9863284,9975326,3460,1211000,11186326,12.14
9863285,1311188,341,119350,1430538,9.10
9863286,9984669,2514,879900,10864569,8.81
9863287,9975203,5130,1795500,11770703,18.00
9863288,9945028,4274,1495900,11440928,15.04
9863289,9981485,2054,718900,10700385,7.20
9863290,9970095,2919,1021650,10991745,10.25
9863291,9972034,2733,956550,10928584,9.59
9863292,9967459,2818,986300,10953759,9.90
9863293,9983173,5442,1904700,11887873,19.08
9863294,9986058,3982,1393700,11379758,13.96
9863295,9980051,1777,621950,10602001,6.23
9863296,9983043,4044,1415400,11398443,14.18
9863298,9980126,1291,451850,10431976,4.53
9863300,9977764,3178,1112300,11090064,11.15
9863301,9993200,2083,729050,10722250,7.30
9863302,4159231,2655,929250,5088481,22.34
9863303,9963875,2506,877100,10840975,8.80
9863305,9884269,4600,1610000,11494269,16.29
9863306,9971745,3437,1202950,11174695,12.06
9863307,9989598,2215,775250,10764848,7.76
9863308,9989232,1794,627900,10617132,6.29
9863309,9817155,4435,1552250,11369405,15.81
9863310,9988175,3882,1358700,11346875,13.60
9863311,9990300,2956,1034600,11024900,10.36
9863312,9989268,3599,1259650,11248918,12.61
9863313,9976413,2897,1013950,10990363,10.16
9863314,9993812,3385,1184750,11178562,11.85
9863315,9983668,2877,1006950,10990618,10.09
9863316,9981490,3848,1346800,11328290,13.49
9863317,9997576,2925,1023750,11021326,10.24
9863318,9999013,2633,921550,10920563,9.22
9863319,9989613,2075,726250,10715863,7.27
9863320,9989814,2538,888300,10878114,8.89
9863321,9987432,3971,1389850,11377282,13.92
9863322,9974255,3407,1192450,11166705,11.96
9863323,9985009,1400,490000,10475009,4.91
9863324,9977711,2566,898100,10875811,9.00
9863325,9983755,2577,901950,10885705,9.03
9863326,9819709,2827,989450,10809159,10.08
9863327,9960240,3672,1285200,11245440,12.90
9863328,9973933,5769,2019150,11993083,20.24
9863329,9975717,2928,1024800,11000517,10.27
9863330,9992616,4325,1513750,11506366,15.15
9863331,9986748,4086,1430100,11416848,14.32
9863332,9991436,3931,1375850,11367286,13.77
9863333,9986969,3159,1105650,11092619,11.07
9863334,9971973,3291,1151850,11123823,11.55
9863335,9999234,3955,1384250,11383484,13.84
9863336,9975112,5234,1831900,11807012,18.36
9863337,9977038,3821,1337350,11314388,13.40
9863338,9489597,3778,1322300,10811897,13.93
9863339,9977711,1611,563850,10541561,5.65
9863341,9977475,3179,1112650,11090125,11.15
9863342,9976128,4218,1476300,11452428,14.80
9863343,9987807,2667,933450,10921257,9.35
9863344,9991719,3065,1072750,11064469,10.74
9863345,9995108,4268,1493800,11488908,14.95
9863346,9979664,3566,1248100,11227764,12.51
9863347,9987946,5834,2041900,12029846,20.44
9863348,1540017,816,285600,1825617,18.55
9863349,9985791,2065,722750,10708541,7.24
9863350,9987380,3726,1304100,11291480,13.06
9863351,9985870,3229,1130150,11116020,11.32
9863352,9992347,4746,1661100,11653447,16.62
9863354,9993802,3781,1323350,11317152,13.24
9863355,9984697,5500,1925000,11909697,19.28
9863356,9970541,2709,948150,10918691,9.51
9863357,9985361,1781,623350,10608711,6.24
9863358,9983744,3712,1299200,11282944,13.01
9863359,9985673,3526,1234100,11219773,12.36
9863360,9994260,5890,2061500,12055760,20.63
9863362,9979393,2883,1009050,10988443,10.11
9863363,9978490,2256,789600,10768090,7.91
9863364,9993290,3690,1291500,11284790,12.92
9863365,9978391,7928,2774800,12753191,27.81
9863366,9953126,3118,1091300,11044426,10.96
9863367,9996346,3884,1359400,11355746,13.60
9863368,9977117,3245,1135750,11112867,11.38
9863369,9990669,3470,1214500,11205169,12.16
9863370,9988319,4200,1470000,11458319,14.72
9863371,9986649,2976,1041600,11028249,10.43
9863372,9985172,2518,881300,10866472,8.83
9863373,9975055,3090,1081500,11056555,10.84
9863374,9987515,2482,868700,10856215,8.70
9863375,9984725,2948,1031800,11016525,10.33
9863376,9970385,1676,586600,10556985,5.88
9863377,9968267,1998,699300,10667567,7.02
9863378,9978776,4544,1590400,11569176,15.94
9863379,9973740,1686,590100,10563840,5.92
9863381,9954630,2952,1033200,10987830,10.38
9863382,9951682,3729,1305150,11256832,13.11
9863383,9957637,3358,1175300,11132937,11.80
9863384,9913584,3091,1081850,10995434,10.91
9863385,9943490,3558,1245300,11188790,12.52
9863386,9924214,3915,1370250,11294464,13.81
9863387,9912411,4256,1489600,11402011,15.03
9863388,9918568,2956,1034600,10953168,10.43
9863389,9925872,1252,438200,10364072,4.41
9863390,9930542,3719,1301650,11232192,13.11
9863391,9918833,1812,634200,10553033,6.39
9863392,9912537,3686,1290100,11202637,13.01
9863393,9496004,2536,887600,10383604,9.35
9863394,9689745,3964,1387400,11077145,14.32
9863395,9901887,2053,718550,10620437,7.26
9863396,9914734,2214,774900,10689634,7.82
9863397,9931337,2791,976850,10908187,9.84
9863398,9913245,1503,526050,10439295,5.31
9863399,9823950,6567,2298450,12122400,23.40
9863400,9925535,4524,1583400,11508935,15.95
9863401,9937058,4883,1709050,11646108,17.20
9863402,9833921,4081,1428350,11262271,14.52
9863403,9921433,3305,1156750,11078183,11.66
9863404,3111880,837,292950,3404830,9.41
9863405,9897579,2054,718900,10616479,7.26
9863406,9899585,3194,1117900,11017485,11.29
9863407,9898530,2690,941500,10840030,9.51
9863408,9901541,2688,940800,10842341,9.50
9863409,9910764,4064,1422400,11333164,14.35
9863410,9904547,3875,1356250,11260797,13.69
9863411,9923222,3591,1256850,11180072,12.67
9863412,9941042,2488,870800,10811842,8.76
9863413,9934955,5787,2025450,11960405,20.39
9863414,9915273,3686,1290100,11205373,13.01
9863415,9929754,2351,822850,10752604,8.29
9863416,9923652,5687,1990450,11914102,20.06
9863417,9935526,3663,1282050,11217576,12.90
9863418,9924837,683,239050,10163887,2.41
9863419,977992,333,116550,1094542,11.92
9863420,9904680,3802,1330700,11235380,13.44
9863421,9907074,3362,1176700,11083774,11.88
9863422,825664,259,90650,916314,10.98
9863423,9912963,4268,1493800,11406763,15.07
9863424,1059967,757,264950,1324917,25.00
9863425,9902351,2632,921200,10823551,9.30
9863426,8624611,3641,1274350,9898961,14.78
9863427,9900827,3380,1183000,11083827,11.95
9863429,6298383,1569,549150,6847533,8.72
9863430,4479131,1332,466200,4945331,10.41
9863431,9927197,4263,1492050,11419247,15.03
9863432,3772793,1115,390250,4163043,10.34
9863433,9927980,4334,1516900,11444880,15.28
9863434,9762078,4924,1723400,11485478,17.65
9863435,9947976,5319,1861650,11809626,18.71
9863436,9947631,4438,1553300,11500931,15.61
9863437,9956044,4250,1487500,11443544,14.94
9863438,9956332,2492,872200,10828532,8.76
9863439,9950063,1668,583800,10533863,5.87
9863440,9951207,2654,928900,10880107,9.33
9863441,9950898,4095,1433250,11384148,14.40
9863442,9958980,1788,625800,10584780,6.28
9863443,9972974,2859,1000650,10973624,10.03
9863444,9976531,2511,878850,10855381,8.81
9863445,3886582,1097,383950,4270532,9.88
9863446,9599224,4013,1404550,11003774,14.63
9863447,9991989,2278,797300,10789289,7.98
9863448,9978664,4885,1709750,11688414,17.13
9863449,1171523,957,334950,1506473,28.59
9863450,9987142,3549,1242150,11229292,12.44
9863451,9964790,3930,1375500,11340290,13.80
9863452,9015127,3302,1155700,10170827,12.82
9863453,9974395,4747,1661450,11635845,16.66
9863454,9985000,2548,891800,10876800,8.93
9863455,9982637,2727,954450,10937087,9.56
9863456,9985615,1783,624050,10609665,6.25
9863457,9996094,3195,1118250,11114344,11.19
9863458,9982582,2327,814450,10797032,8.16
9863459,9996240,2207,772450,10768690,7.73
9863460,9979693,1180,413000,10392693,4.14
9863461,9890442,4508,1577800,11468242,15.95
9863462,9981909,4719,1651650,11633559,16.55
9863463,9990195,2132,746200,10736395,7.47
9863464,9980459,7273,2545550,12526009,25.51
9863465,9991549,2987,1045450,11036999,10.46
9863466,9979815,5363,1877050,11856865,18.81
9863467,9996314,1586,555100,10551414,5.55
9863468,9970695,5584,1954400,11925095,19.60
9863469,9942856,3236,1132600,11075456,11.39
9863470,9977058,3286,1150100,11127158,11.53
9863471,9972335,1988,695800,10668135,6.98
9863472,2210033,1822,637700,2847733,28.85
9863473,9981835,3910,1368500,11350335,13.71
9863474,9972755,2967,1038450,11011205,10.41
9863475,9882587,5575,1951250,11833837,19.74
9863476,9985599,2775,971250,10956849,9.73
9863477,7326942,3182,1113700,8440642,15.20
9863478,9959302,3244,1135400,11094702,11.40
9863479,9950835,1645,575750,10526585,5.79
9863480,9965858,4657,1629950,11595808,16.36
9863481,9954343,796,278600,10232943,2.80
9863482,9953159,905,316750,10269909,3.18
9863483,9962373,877,306950,10269323,3.08
9863485,9942097,2277,796950,10739047,8.02
9863486,9961382,3032,1061200,11022582,10.65
9863487,477768,289,101150,578918,21.17
9863488,9604208,2515,880250,10484458,9.17
9863489,9969520,4227,1479450,11448970,14.84
9863490,9850551,5093,1782550,11633101,18.10
9863491,9986676,4570,1599500,11586176,16.02
9863492,9982742,5341,1869350,11852092,18.73
9863493,9976446,2235,782250,10758696,7.84
9863494,9974027,4057,1419950,11393977,14.24
9863495,7499734,604,211400,7711134,2.82
9863496,9974773,3520,1232000,11206773,12.35
9863498,9981258,3693,1292550,11273808,12.95
9863499,9983896,2077,726950,10710846,7.28
9863500,9990788,1972,690200,10680988,6.91
9863501,9985699,4449,1557150,11542849,15.59
9863502,2979525,985,344750,3324275,11.57
9863503,4302664,1661,581350,4884014,13.51
9863504,500655,237,82950,583605,16.57
9863505,9950297,3208,1122800,11073097,11.28
9863506,9971039,3129,1095150,11066189,10.98
9863508,8962998,1801,630350,9593348,7.03
9863509,9943081,4280,1498000,11441081,15.07
9863510,9958743,2463,862050,10820793,8.66
9863511,9965897,3349,1172150,11138047,11.76
9863512,714031,214,74900,788931,10.49
9863513,9590857,3847,1346450,10937307,14.04
9863514,9970089,1212,424200,10394289,4.25
9863515,9884563,2628,919800,10804363,9.31
9863516,9972843,3420,1197000,11169843,12.00
9863517,9971538,2088,730800,10702338,7.33
9863518,9985988,3159,1105650,11091638,11.07
9863519,9972764,4133,1446550,11419314,14.51
9863520,9980082,4368,1528800,11508882,15.32
9863521,9926522,1600,560000,10486522,5.64
9863522,9992784,2741,959350,10952134,9.60
9863523,9975887,4459,1560650,11536537,15.64
9863524,5074606,1216,425600,5500206,8.39
9863525,9993718,2648,926800,10920518,9.27
9863526,6975091,3604,1261400,8236491,18.08
9863527,9967505,2465,862750,10830255,8.66
9863528,9972581,3276,1146600,11119181,11.50
9863529,1120190,943,330050,1450240,29.46
9863530,9970653,1781,623350,10594003,6.25
9863531,9986075,1501,525350,10511425,5.26
9863532,5644048,2094,732900,6376948,12.99
9863533,9958357,2239,783650,10742007,7.87
9863534,9958505,3200,1120000,11078505,11.25
9863535,9961965,4272,1495200,11457165,15.01
9863536,9965264,4175,1461250,11426514,14.66
9863537,9969314,2111,738850,10708164,7.41
9863538,9946068,5518,1931300,11877368,19.42
9863539,9970153,4606,1612100,11582253,16.17
9863540,9979788,2167,758450,10738238,7.60
9863541,9970913,3542,1239700,11210613,12.43
9863542,9557328,5794,2027900,11585228,21.22
9863543,3120832,1364,477400,3598232,15.30
9863544,6957395,3851,1347850,8305245,19.37
9863545,4114253,1518,531300,4645553,12.91
9863546,9955183,4296,1503600,11458783,15.10
9863548,9991144,3817,1335950,11327094,13.37
9863549,9978490,7869,2754150,12732640,27.60
9863550,9986301,3319,1161650,11147951,11.63
9863551,9971442,4917,1720950,11692392,17.26
9863552,9967654,3131,1095850,11063504,10.99
9863553,9974721,4233,1481550,11456271,14.85
9863554,4505571,2268,793800,5299371,17.62
9863555,9945008,3620,1267000,11212008,12.74
9863556,9966350,2772,970200,10936550,9.73
9863557,9964636,2686,940100,10904736,9.43
9863558,9977733,2701,945350,10923083,9.47
9863559,9982344,3363,1177050,11159394,11.79
9863560,7476305,1903,666050,8142355,8.91
9863561,8987302,3934,1376900,10364202,15.32
9863562,9929910,5632,1971200,11901110,19.85
9863563,9982872,6610,2313500,12296372,23.17
9863564,4840455,1081,378350,5218805,7.82
9863565,9990787,3104,1086400,11077187,10.87
9863566,4733920,1809,633150,5367070,13.37
9863567,9967572,4161,1456350,11423922,14.61
9863568,9976835,5170,1809500,11786335,18.14
9863569,9985589,2689,941150,10926739,9.43
9863570,9982524,3064,1072400,11054924,10.74
9863571,9987788,4204,1471400,11459188,14.73
9863572,9990228,4299,1504650,11494878,15.06
9863573,9989052,4090,1431500,11420552,14.33
9863574,9981618,6559,2295650,12277268,23.00
9863575,9985704,3834,1341900,11327604,13.44
9863576,9966071,2843,995050,10961121,9.98
9863577,6124486,2294,802900,6927386,13.11
9863578,9957648,3133,1096550,11054198,11.01
9863579,1153619,377,131950,1285569,11.44
9863580,9968269,4290,1501500,11469769,15.06
9863581,9963642,4410,1543500,11507142,15.49
9863582,9976598,4283,1499050,11475648,15.03
9863583,9967389,4075,1426250,11393639,14.31
9863584,9989212,2323,813050,10802262,8.14
9863585,9990150,2768,968800,10958950,9.70
9863586,2771915,1847,646450,3418365,23.32
9863587,9974013,3534,1236900,11210913,12.40
9863588,9982704,3471,1214850,11197554,12.17
9863589,9964325,3360,1176000,11140325,11.80
9863590,9984935,3757,1314950,11299885,13.17
9863591,1709013,1484,519400,2228413,30.39
9863592,9967438,4054,1418900,11386338,14.24
9863593,9982649,3731,1305850,11288499,13.08
9863594,9983653,2811,983850,10967503,9.85
9863595,9996952,3712,1299200,11296152,13.00
9863596,9995101,5232,1831200,11826301,18.32
9863597,9984049,4330,1515500,11499549,15.18
9863598,3445358,1747,611450,4056808,17.75
9863599,523594,130,45500,569094,8.69
9863600,9990627,2467,863450,10854077,8.64
9863601,9992036,2914,1019900,11011936,10.21
9863603,9998302,3422,1197700,11196002,11.98
9863604,9985542,3330,1165500,11151042,11.67
9863605,9982266,3493,1222550,11204816,12.25
9863606,2320100,239,83650,2403750,3.61
9863607,7271140,1699,594650,7865790,8.18
9863608,9977283,2703,946050,10923333,9.48
9863609,9980184,2110,738500,10718684,7.40
9863610,9892119,3366,1178100,11070219,11.91
9863612,9977109,749,262150,10239259,2.63
9863613,9986157,3857,1349950,11336107,13.52
9863614,9978908,2089,731150,10710058,7.33
9863615,4305505,1109,388150,4693655,9.02
9863617,9962654,2819,986650,10949304,9.90
9863618,9946941,1921,672350,10619291,6.76
9863619,9948471,2907,1017450,10965921,10.23
9863620,9966315,2966,1038100,11004415,10.42
9863621,9960818,3109,1088150,11048968,10.92
9863622,9975264,2111,738850,10714114,7.41
9863623,4460040,1939,678650,5138690,15.22
9863624,3157725,244,85400,3243125,2.70
9863625,9981523,1848,646800,10628323,6.48
9863626,9971670,2734,956900,10928570,9.60
9863627,4807784,1613,564550,5372334,11.74
9863628,9983178,1621,567350,10550528,5.68
9863629,9978475,2620,917000,10895475,9.19
9863630,9976153,2017,705950,10682103,7.08
9863631,9982077,2259,790650,10772727,7.92
9863632,6921212,3003,1051050,7972262,15.19
9863633,9989697,3284,1149400,11139097,11.51
9863634,9993615,3189,1116150,11109765,11.17
9863635,9987957,3887,1360450,11348407,13.62
9863636,9979156,3748,1311800,11290956,13.15
9863637,9985962,3740,1309000,11294962,13.11
9863638,9986921,3329,1165150,11152071,11.67
9863639,9949834,3405,1191750,11141584,11.98
9863640,9981031,3402,1190700,11171731,11.93
9863641,9984255,3110,1088500,11072755,10.90
9863643,9983942,3856,1349600,11333542,13.52
9863644,9973063,2692,942200,10915263,9.45
9863645,7639956,2959,1035650,8675606,13.56
9863646,9967612,1474,515900,10483512,5.18
9863647,9972661,2322,812700,10785361,8.15
9863648,9987361,1896,663600,10650961,6.64
9863649,6549865,2317,810950,7360815,12.38
9863650,4542543,685,239750,4782293,5.28
9863651,9979910,5047,1766450,11746360,17.70
9863652,9678020,1913,669550,10347570,6.92
9863653,9976648,3079,1077650,11054298,10.80
9863654,9975783,4253,1488550,11464333,14.92
9863655,9991717,2488,870800,10862517,8.72
9863656,1952475,550,192500,2144975,9.86
9863657,9976827,4891,1711850,11688677,17.16
9863658,9965792,3792,1327200,11292992,13.32
9863659,9966918,3134,1096900,11063818,11.01
9863660,2288122,793,277550,2565672,12.13
9863661,9944665,1448,506800,10451465,5.10
9863663,9942543,2278,797300,10739843,8.02
9863664,9918286,3663,1282050,11200336,12.93
9863665,9962733,4330,1515500,11478233,15.21
9863666,9957891,3180,1113000,11070891,11.18
9863667,9608283,2201,770350,10378633,8.02
9863668,9971890,1562,546700,10518590,5.48
9863669,9967367,2127,744450,10711817,7.47
9863670,9963529,2731,955850,10919379,9.59
9863671,9971760,2001,700350,10672110,7.02
9863672,9986080,2922,1022700,11008780,10.24
9863673,9985573,3691,1291850,11277423,12.94
9863674,311192,183,64050,375242,20.58
9863675,1599822,600,210000,1809822,13.13
9863676,9965784,2466,863100,10828884,8.66
9863677,9862003,3627,1269450,11131453,12.87
9863678,9974191,4594,1607900,11582091,16.12
9863679,1581943,823,288050,1869993,18.21
9863680,9958517,5195,1818250,11776767,18.26
9863681,9959762,1839,643650,10603412,6.46
9863682,704667,445,155750,860417,22.10
9863683,9946046,5282,1848700,11794746,18.59
9863684,9957721,2020,707000,10664721,7.10
9863685,9960299,3067,1073450,11033749,10.78
9863686,9964625,4837,1692950,11657575,16.99
9863687,9968896,2535,887250,10856146,8.90
9863688,517745,170,59500,577245,11.49
9863689,9964611,2051,717850,10682461,7.20
9863690,9970771,3044,1065400,11036171,10.69
9863691,9984589,4775,1671250,11655839,16.74
9863692,9977137,1472,515200,10492337,5.16
9863693,9987201,2775,971250,10958451,9.72
9863694,9970115,1192,417200,10387315,4.18
9863695,9987086,2855,999250,10986336,10.01
9863696,9982145,1641,574350,10556495,5.75
9863697,9956414,3121,1092350,11048764,10.97
9863698,9987824,2021,707350,10695174,7.08
9863699,8991152,2282,798700,9789852,8.88
9863700,9980753,3305,1156750,11137503,11.59
9863701,9996562,5226,1829100,11825662,18.30
9863702,1733783,385,134750,1868533,7.77
9863703,9969837,4217,1475950,11445787,14.80
9863704,2914383,1085,379750,3294133,13.03
9863705,9953500,3301,1155350,11108850,11.61
9863706,9966032,2443,855050,10821082,8.58
9863707,9958799,2783,974050,10932849,9.78
9863708,9971838,1515,530250,10502088,5.32
9863709,9983114,4723,1653050,11636164,16.56
9863710,9986917,4078,1427300,11414217,14.29
9863711,5712715,4882,1708700,7421415,29.91
9863712,9985733,2330,815500,10801233,8.17
9863713,9985057,4029,1410150,11395207,14.12
9863714,441888,319,111650,553538,25.27
9863715,9981025,1936,677600,10658625,6.79
9863716,9966277,3644,1275400,11241677,12.80
9863717,9990533,1822,637700,10628233,6.38
9863718,9979469,3633,1271550,11251019,12.74
9863719,9996549,5320,1862000,11858549,18.63
9863720,9999068,6283,2199050,12198118,21.99
9863721,9988219,4162,1456700,11444919,14.58
9863722,9972981,2639,923650,10896631,9.26
9863723,9973853,4985,1744750,11718603,17.49
9863724,9976359,5282,1848700,11825059,18.53
9863725,9390450,3731,1305850,10696300,13.91
9863726,5346107,4171,1459850,6805957,27.31
9863727,9973315,4267,1493450,11466765,14.97
9863728,9974784,4740,1659000,11633784,16.63
9863729,9982932,3609,1263150,11246082,12.65
9863730,9990562,2392,837200,10827762,8.38
9863731,9997268,2865,1002750,11000018,10.03
9863732,5815917,3513,1229550,7045467,21.14
9863733,9984317,3902,1365700,11350017,13.68
9863734,9986313,925,323750,10310063,3.24
9863735,8949923,3896,1363600,10313523,15.24
9863736,9984143,3934,1376900,11361043,13.79
9863737,9992225,1592,557200,10549425,5.58
9863738,1861051,960,336000,2197051,18.05
9863739,9978246,1792,627200,10605446,6.29
9863741,9977114,1611,563850,10540964,5.65
9863742,9948403,3790,1326500,11274903,13.33
9863743,9940080,4747,1661450,11601530,16.71
9863744,9961433,3892,1362200,11323633,13.67
9863745,9970250,3058,1070300,11040550,10.73
9863746,9957278,5607,1962450,11919728,19.71
9863747,9969769,5756,2014600,11984369,20.21
9863748,9976456,5780,2023000,11999456,20.28
9863749,9966989,3424,1198400,11165389,12.02
9863750,9964367,4387,1535450,11499817,15.41
9863751,9987175,3346,1171100,11158275,11.73
9863752,9990047,3340,1169000,11159047,11.70
9863753,9985516,3177,1111950,11097466,11.14
9863754,9994251,2871,1004850,10999101,10.05
9863755,9973737,3837,1342950,11316687,13.46
9863756,9900363,5365,1877750,11778113,18.97
9863757,9978391,5336,1867600,11845991,18.72
9863758,9792681,3772,1320200,11112881,13.48
9863759,9973883,4291,1501850,11475733,15.06
9863760,2878199,1596,558600,3436799,19.41
9863761,9983662,5103,1786050,11769712,17.89
9863762,9494717,3727,1304450,10799167,13.74
9863763,9970929,3766,1318100,11289029,13.22
9863764,9967347,5882,2058700,12026047,20.65
9863765,8667331,3971,1389850,10057181,16.04
9863766,9994055,3308,1157800,11151855,11.58
9863767,9980172,2831,990850,10971022,9.93
9863769,9893326,4010,1403500,11296826,14.19
9863770,9983755,6611,2313850,12297605,23.18
9863771,1456556,812,284200,1740756,19.51
9863772,697223,263,92050,789273,13.20
9863773,9982277,6377,2231950,12214227,22.36
9863774,9938801,1591,556850,10495651,5.60
9863775,9985819,2194,767900,10753719,7.69
9863776,9987935,3790,1326500,11314435,13.28
9863777,9974535,2814,984900,10959435,9.87
9863778,9971564,5851,2047850,12019414,20.54
9863779,9980818,4352,1523200,11504018,15.26
9863780,9981392,2634,921900,10903292,9.24
9863781,9978935,5108,1787800,11766735,17.92
9863782,9991955,4262,1491700,11483655,14.93
9863783,9993739,4292,1502200,11495939,15.03
9863784,9984110,4359,1525650,11509760,15.28
9863785,9983943,2408,842800,10826743,8.44
9863786,9992434,4702,1645700,11638134,16.47
9863788,3012216,1452,508200,3520416,16.87
9863789,9978892,3859,1350650,11329542,13.54
9863790,9986435,2539,888650,10875085,8.90
9863791,5896378,1670,584500,6480878,9.91
9863792,3553658,1353,473550,4027208,13.33
9863793,9954570,3699,1294650,11249220,13.01
9863794,9971925,5185,1814750,11786675,18.20
9863795,9975532,5272,1845200,11820732,18.50
9863796,2818649,1589,556150,3374799,19.73
9863797,9948432,4044,1415400,11363832,14.23
9863798,9949154,3140,1099000,11048154,11.05
9863799,9954224,2729,955150,10909374,9.60
9863800,9957734,3422,1197700,11155434,12.03
9863801,9976901,6511,2278850,12255751,22.84
9863802,9053210,2203,771050,9824260,8.52
9863804,9468034,3834,1341900,10809934,14.17
9863805,9969315,4443,1555050,11524365,15.60
9863806,9978528,5216,1825600,11804128,18.30
9863807,5673786,2173,760550,6434336,13.40
9863808,9985642,3123,1093050,11078692,10.95
9863809,9988478,2136,747600,10736078,7.48
9863810,9999314,4157,1454950,11454264,14.55
9863811,9989714,2095,733250,10722964,7.34
9863812,9621047,5482,1918700,11539747,19.94
9863813,9993451,3465,1212750,11206201,12.14
9863814,9979021,2364,827400,10806421,8.29
9863815,2883851,925,323750,3207601,11.23
9863816,1689916,638,223300,1913216,13.21
9863817,9974222,3290,1151500,11125722,11.54
9863818,4792387,2284,799400,5591787,16.68
9863819,9993685,5757,2014950,12008635,20.16
9863820,9999195,4964,1737400,11736595,17.38
9863821,9992027,3379,1182650,11174677,11.84
9863822,9987671,1242,434700,10422371,4.35
9863823,9984279,5378,1882300,11866579,18.85
9863825,5796536,2339,818650,6615186,14.12
9863826,9982009,5644,1975400,11957409,19.79
9863827,9973602,3283,1149050,11122652,11.52
9863828,9993541,1788,625800,10619341,6.26
9863829,9984540,3192,1117200,11101740,11.19
9863830,9989305,3242,1134700,11124005,11.36
9863831,9974623,5104,1786400,11761023,17.91
9863832,9968421,2086,730100,10698521,7.32
9863833,9896895,1024,358400,10255295,3.62
9863834,1572667,866,303100,1875767,19.27
9863835,9978153,4007,1402450,11380603,14.06
9863836,9998471,3825,1338750,11337221,13.39
9863837,9996971,2432,851200,10848171,8.51
9863838,9984201,2021,707350,10691551,7.08
9863839,9978058,7509,2628150,12606208,26.34
9863840,2010237,569,199150,2209387,9.91
9863841,9982069,2662,931700,10913769,9.33
9863842,3780204,1198,419300,4199504,11.09
9863843,5885328,2913,1019550,6904878,17.32
9863844,9970076,5011,1753850,11723926,17.59
9863845,9976477,3479,1217650,11194127,12.21
9863846,8782048,3124,1093400,9875448,12.45
9863847,9967156,2381,833350,10800506,8.36
9863848,9969551,2789,976150,10945701,9.79
9863849,9986499,4133,1446550,11433049,14.49
9863850,9961198,3478,1217300,11178498,12.22
9863851,6544171,3722,1302700,7846871,19.91
9863852,9975560,3340,1169000,11144560,11.72
9863853,9972660,4891,1711850,11684510,17.17
9863854,9975253,4240,1484000,11459253,14.88
9863855,9961323,4430,1550500,11511823,15.57
9863856,9151424,3436,1202600,10354024,13.14
9863857,9976407,4543,1590050,11566457,15.94
9863858,9968878,3484,1219400,11188278,12.23
9863859,9978688,4854,1698900,11677588,17.03
9863860,3514864,1433,501550,4016414,14.27
9863861,9985630,4950,1732500,11718130,17.35
9863862,3957119,1673,585550,4542669,14.80
9863863,9730700,4056,1419600,11150300,14.59
9863864,9992216,1972,690200,10682416,6.91
9863865,9979364,4293,1502550,11481914,15.06
9863866,9976018,2734,956900,10932918,9.59
9863867,9994673,3140,1099000,11093673,11.00
9863868,9984292,5616,1965600,11949892,19.69
9863869,9994486,2507,877450,10871936,8.78
9863870,9984228,5298,1854300,11838528,18.57
9863871,9993067,5575,1951250,11944317,19.53
9863872,9899178,4126,1444100,11343278,14.59
9863873,9984028,1902,665700,10649728,6.67
9863874,4427148,2708,947800,5374948,21.41
9863875,9985949,3983,1394050,11379999,13.96
9863876,9972692,1438,503300,10475992,5.05
9863877,9960824,4046,1416100,11376924,14.22
9863878,9972948,2888,1010800,10983748,10.14
9863879,9868044,5366,1878100,11746144,19.03
9863880,9992245,3066,1073100,11065345,10.74
9863881,9989683,4039,1413650,11403333,14.15
9863882,9990209,2512,879200,10869409,8.80
9863883,9989504,2706,947100,10936604,9.48
9863884,9989129,2920,1022000,11011129,10.23
9863885,9972731,2403,841050,10813781,8.43
9863886,9957425,1721,602350,10559775,6.05
9863888,9953166,3033,1061550,11014716,10.67
9863889,9955104,4970,1739500,11694604,17.47
9863890,2755361,1388,485800,3241161,17.63
9863891,1360426,434,151900,1512326,11.17
9863892,2922181,1554,543900,3466081,18.61
9863893,3161873,649,227150,3389023,7.18
9863894,9966556,3803,1331050,11297606,13.36
9863895,9973934,3034,1061900,11035834,10.65
9863896,5623781,1607,562450,6186231,10.00
9863897,9981259,713,249550,10230809,2.50
9863898,1251586,558,195300,1446886,15.60
9863899,9993378,3417,1195950,11189328,11.97
9863900,844649,118,41300,885949,4.89
9863901,7761762,2466,863100,8624862,11.12
9863902,2234779,1239,433650,2668429,19.40
9863903,9250358,4229,1480150,10730508,16.00
9863904,9980656,2164,757400,10738056,7.59
9863905,9981601,3422,1197700,11179301,12.00
9863906,9986303,2735,957250,10943553,9.59
9863907,9960994,2862,1001700,10962694,10.06
9863908,7034073,1931,675850,7709923,9.61
9863909,9982344,1805,631750,10614094,6.33
9863910,9989054,2291,801850,10790904,8.03
9863911,9984141,4456,1559600,11543741,15.62
9863912,9983950,2125,743750,10727700,7.45
9863913,9989509,3187,1115450,11104959,11.17
9863914,9960438,4318,1511300,11471738,15.17
9863915,6244103,2448,856800,7100903,13.72
9863916,9992752,5298,1854300,11847052,18.56
9863917,9979816,2281,798350,10778166,8.00
9863918,3471194,1532,536200,4007394,15.45
9863919,9959345,4364,1527400,11486745,15.34
9863920,9977621,2366,828100,10805721,8.30
9863921,8656813,3822,1337700,9994513,15.45
9863922,9119018,3253,1138550,10257568,12.49
9863923,9965317,1630,570500,10535817,5.72
9863924,9987087,3744,1310400,11297487,13.12
9863925,9984104,3987,1395450,11379554,13.98
9863926,9954154,4483,1569050,11523204,15.76
9863927,9973929,1666,583100,10557029,5.85
9863928,9976809,5298,1854300,11831109,18.59
9863929,9986104,3728,1304800,11290904,13.07
9863930,9983444,5978,2092300,12075744,20.96
9863931,9983186,3755,1314250,11297436,13.16
9863932,9974142,4700,1645000,11619142,16.49
9863933,9968460,3278,1147300,11115760,11.51
9863934,9987484,5298,1854300,11841784,18.57
9863935,9997947,83,29050,10026997,0.29
9863936,7227341,2195,768250,7995591,10.63
9863937,7472200,2247,786450,8258650,10.53
9863938,9983998,3772,1320200,11304198,13.22
9863939,9956272,7019,2456650,12412922,24.67
9863940,9955696,2048,716800,10672496,7.20
9863941,9996729,1867,653450,10650179,6.54
9863942,9985556,2612,914200,10899756,9.16
9863943,9520648,4487,1570450,11091098,16.50
9863944,9978184,4353,1523550,11501734,15.27
9863945,9966916,3443,1205050,11171966,12.09
9863946,2904097,1692,592200,3496297,20.39
9863947,9986263,3487,1220450,11206713,12.22
9863948,9986620,4341,1519350,11505970,15.21
9863949,5909330,1914,669900,6579230,11.34
9863950,3830508,2761,966350,4796858,25.23
9863951,9968509,2678,937300,10905809,9.40
9863952,9978145,2524,883400,10861545,8.85
9863953,4836381,714,249900,5086281,5.17
9863954,9986947,4206,1472100,11459047,14.74
9863955,9989098,2646,926100,10915198,9.27
9863956,8995199,3316,1160600,10155799,12.90
9863957,9988435,4675,1636250,11624685,16.38
9863958,317090,236,82600,399690,26.05
9863959,9982321,3614,1264900,11247221,12.67
9863960,4664267,2035,712250,5376517,15.27
9863961,9991361,3400,1190000,11181361,11.91
9863962,9829584,4056,1419600,11249184,14.44
9863963,9995561,3760,1316000,11311561,13.17
9863964,9975024,1544,540400,10515424,5.42
9863965,9998691,4717,1650950,11649641,16.51
9863966,9965064,1217,425950,10391014,4.27
9863967,9980957,793,277550,10258507,2.78
9863968,9969198,1343,470050,10439248,4.72
9863969,9985737,3742,1309700,11295437,13.12
9863970,4081046,1356,474600,4555646,11.63
9863971,9979541,3866,1353100,11332641,13.56
9863972,9995825,3998,1399300,11395125,14.00
9863973,9879189,3123,1093050,10972239,11.06
9863974,9980668,2729,955150,10935818,9.57
9863976,9987393,4047,1416450,11403843,14.18
9863977,9981582,1811,633850,10615432,6.35
9863978,9978465,2509,878150,10856615,8.80
9863979,9970744,3435,1202250,11172994,12.06
9863980,9972383,2813,984550,10956933,9.87
9863981,9997725,5539,1938650,11936375,19.39
9863982,9984329,4717,1650950,11635279,16.54
9863983,9795475,5873,2055550,11851025,20.98
9863985,9954757,3485,1219750,11174507,12.25
9863987,9953470,5070,1774500,11727970,17.83
9863988,9944964,4457,1559950,11504914,15.69
9863989,9946482,2304,806400,10752882,8.11
9863990,9956092,4054,1418900,11374992,14.25
9863991,9968688,4287,1500450,11469138,15.05
9863992,9974444,6994,2447900,12422344,24.54
9863994,8951709,4629,1620150,10571859,18.10
9863995,9944094,5038,1763300,11707394,17.73
9863996,9938968,3188,1115800,11054768,11.23
9863997,9940370,5465,1912750,11853120,19.24
9863998,9964584,3043,1065050,11029634,10.69
9863999,7976963,6682,2338700,10315663,29.32
9864000,9942813,3086,1080100,11022913,10.86
9864001,9903140,4141,1449350,11352490,14.64
9864002,9942847,7048,2466800,12409647,24.81
9864003,9952862,784,274400,10227262,2.76
9864004,9960170,1631,570850,10531020,5.73
9864005,9965945,3423,1198050,11163995,12.02
9864006,9977224,2739,958650,10935874,9.61
9864007,9978298,2093,732550,10710848,7.34
9864008,9983912,5985,2094750,12078662,20.98
9864009,9931992,3756,1314600,11246592,13.24
9864010,3664059,1225,428750,4092809,11.70
9864011,9973774,4650,1627500,11601274,16.32
9864012,9971900,4577,1601950,11573850,16.06
9864013,9989691,3270,1144500,11134191,11.46
9864014,9972282,2504,876400,10848682,8.79
9864015,9956239,4804,1681400,11637639,16.89
9864016,8857008,4504,1576400,10433408,17.80
9864017,9988361,4369,1529150,11517511,15.31
9864018,9963262,4224,1478400,11441662,14.84
9864019,9968427,4619,1616650,11585077,16.22
9864020,8980305,2242,784700,9765005,8.74
9864021,9989087,4373,1530550,11519637,15.32
9864022,9989425,4372,1530200,11519625,15.32
9864023,9949488,5328,1864800,11814288,18.74
9864024,9980714,2006,702100,10682814,7.03
9864025,9992693,4911,1718850,11711543,17.20
9864026,9971845,1633,571550,10543395,5.73
9864027,9972086,3790,1326500,11298586,13.30
9864028,9984631,6185,2164750,12149381,21.68
9864029,8991729,2415,845250,9836979,9.40
9864030,3192154,1232,431200,3623354,13.51
9864031,9984139,4498,1574300,11558439,15.77
9864032,9979792,1641,574350,10554142,5.76
9864033,5018958,1998,699300,5718258,13.93
9864034,9970535,3667,1283450,11253985,12.87
9864035,9969800,4089,1431150,11400950,14.35
9864036,9974321,5358,1875300,11849621,18.80
9864037,9992431,3137,1097950,11090381,10.99
9864038,6124402,2306,807100,6931502,13.18
9864039,9978652,3560,1246000,11224652,12.49
9864040,9972945,5210,1823500,11796445,18.28
9864041,9982890,1933,676550,10659440,6.78
9864042,9581164,2482,868700,10449864,9.07
9864043,9981845,4266,1493100,11474945,14.96
9864044,9994694,865,302750,10297444,3.03
9864045,9965897,5111,1788850,11754747,17.95
9864046,9955139,1819,636650,10591789,6.40
9864047,9969742,5532,1936200,11905942,19.42
9864049,9963451,3776,1321600,11285051,13.26
9864050,9108233,2224,778400,9886633,8.55
9864051,9976611,2867,1003450,10980061,10.06
9864052,9967930,2747,961450,10929380,9.65
9864053,8446594,3695,1293250,9739844,15.31
9864054,9964887,1598,559300,10524187,5.61
9864057,9950480,1517,530950,10481430,5.34
9864058,9947757,1072,375200,10322957,3.77
9864059,9939965,2577,901950,10841915,9.07
9864060,9942799,4078,1427300,11370099,14.36
9864061,9959791,2318,811300,10771091,8.15
9864062,9795106,3653,1278550,11073656,13.05
9864063,9964444,3771,1319850,11284294,13.25
9864064,9983057,3294,1152900,11135957,11.55
9864065,9904515,3414,1194900,11099415,12.06
9864066,9980067,4766,1668100,11648167,16.71
9864067,5280557,969,339150,5619707,6.42
9864068,9974969,1781,623350,10598319,6.25
9864069,6201831,1379,482650,6684481,7.78
9864070,9987870,5091,1781850,11769720,17.84
9864071,9989392,3508,1227800,11217192,12.29
9864072,9981032,1530,535500,10516532,5.37
9864073,2505151,839,293650,2798801,11.72
9864074,9990035,3223,1128050,11118085,11.29
9864075,9995344,4040,1414000,11409344,14.15
9864076,9987947,3247,1136450,11124397,11.38
9864077,1823106,642,224700,2047806,12.33
9864078,9906795,2488,870800,10777595,8.79
9864079,9976930,3924,1373400,11350330,13.77
9864080,9987833,1936,677600,10665433,6.78
9864081,9980006,2211,773850,10753856,7.75
9864082,6651587,3168,1108800,7760387,16.67
9864083,9972062,2390,836500,10808562,8.39
9864084,9957478,4235,1482250,11439728,14.89
9864085,9970577,2930,1025500,10996077,10.29
9864086,9975598,4972,1740200,11715798,17.44
9864087,9994695,2751,962850,10957545,9.63
9864088,1290533,586,205100,1495633,15.89
9864089,9971665,3949,1382150,11353815,13.86
9864090,9977351,4027,1409450,11386801,14.13
9864091,9989864,4235,1482250,11472114,14.84
9864092,826595,405,141750,968345,17.15
9864093,9980741,1954,683900,10664641,6.85
9864094,9970019,6246,2186100,12156119,21.93
9864095,9980325,4179,1462650,11442975,14.66
9864096,9972454,3328,1164800,11137254,11.68
9864097,9972853,5573,1950550,11923403,19.56
9864098,9986371,2474,865900,10852271,8.67
9864099,9978757,1055,369250,10348007,3.70
9864100,9974343,5189,1816150,11790493,18.21
9864101,9985198,4492,1572200,11557398,15.75
9864102,9927962,2562,896700,10824662,9.03
9864103,9990858,3782,1323700,11314558,13.25
9864104,8886567,4824,1688400,10574967,19.00
9864105,9683550,5680,1988000,11671550,20.53
9864106,9980092,1346,471100,10451192,4.72
9864107,9979881,3861,1351350,11331231,13.54
9864108,9967303,1321,462350,10429653,4.64
9864109,9967987,4404,1541400,11509387,15.46
9864110,9974460,2060,721000,10695460,7.23
9864111,9975076,4385,1534750,11509826,15.39
9864112,9979199,2329,815150,10794349,8.17
9864114,9879853,2303,806050,10685903,8.16
9864115,9985716,4191,1466850,11452566,14.69
9864116,9979471,2812,984200,10963671,9.86
9864117,9968959,3370,1179500,11148459,11.83
9864118,9942593,2559,895650,10838243,9.01
9864119,9984705,3448,1206800,11191505,12.09
9864120,9985478,5086,1780100,11765578,17.83
9864121,9980196,2887,1010450,10990646,10.12
9864122,9981519,6040,2114000,12095519,21.18
9864123,9974845,3990,1396500,11371345,14.00
9864124,9991016,3947,1381450,11372466,13.83
9864125,9994392,5466,1913100,11907492,19.14
9864126,9983795,1421,497350,10481145,4.98
9864127,9982419,3183,1114050,11096469,11.16
9864128,9996922,3666,1283100,11280022,12.83
9864129,9915763,3811,1333850,11249613,13.45
9864130,9980128,2373,830550,10810678,8.32
9864131,9980755,4764,1667400,11648155,16.71
9864132,9999582,2679,937650,10937232,9.38
9864133,9877074,2815,985250,10862324,9.98
9864134,2007997,633,221550,2229547,11.03
9864135,9981752,2762,966700,10948452,9.68
9864136,9974713,4219,1476650,11451363,14.80
9864137,9966100,3552,1243200,11209300,12.47
9864138,9976632,3808,1332800,11309432,13.36
9864139,9959754,2970,1039500,10999254,10.44
9864140,4599024,721,252350,4851374,5.49
9864141,9974579,4075,1426250,11400829,14.30
9864142,658318,203,71050,729368,10.79
9864143,9974461,2501,875350,10849811,8.78
9864144,9964362,1955,684250,10648612,6.87
9864145,9955686,4962,1736700,11692386,17.44
9864146,1748424,641,224350,1972774,12.83
9864147,2339467,1208,422800,2762267,18.07
9864148,9952016,3881,1358350,11310366,13.65
9864149,9759222,3152,1103200,10862422,11.30
9864150,9954002,4302,1505700,11459702,15.13
9864151,9952792,4386,1535100,11487892,15.42
9864152,9956924,2524,883400,10840324,8.87
9864153,7377882,1795,628250,8006132,8.52
9864154,9661646,4053,1418550,11080196,14.68
9864155,9947562,3915,1370250,11317812,13.77
9864156,9946068,1209,423150,10369218,4.25
9864157,9948015,5741,2009350,11957365,20.20
9864158,9935360,4051,1417850,11353210,14.27
9864159,9948627,1620,567000,10515627,5.70
9864160,9962025,5624,1968400,11930425,19.76
9864161,9957020,5418,1896300,11853320,19.04
9864162,9970669,4793,1677550,11648219,16.82
9864163,9970860,1533,536550,10507410,5.38
9864164,9972699,3374,1180900,11153599,11.84
9864165,6762539,1563,547050,7309589,8.09
9864166,9961297,3016,1055600,11016897,10.60
9864167,9983286,2376,831600,10814886,8.33
9864168,9993274,1916,670600,10663874,6.71
9864169,9994293,4497,1573950,11568243,15.75
9864170,9975372,4833,1691550,11666922,16.96
9864171,9990227,4238,1483300,11473527,14.85
9864172,4714142,999,349650,5063792,7.42
9864173,3822125,982,343700,4165825,8.99
9864175,9976032,3540,1239000,11215032,12.42
9864176,9975815,3378,1182300,11158115,11.85
9864177,9957872,4984,1744400,11702272,17.52
9864178,9965923,1739,608650,10574573,6.11
9864180,5608081,483,169050,5777131,3.01
9864181,8798390,2469,864150,9662540,9.82
9864182,9982594,4215,1475250,11457844,14.78
9864183,9973000,3877,1356950,11329950,13.61
9864184,9992447,3859,1350650,11343097,13.52
9864185,9984075,3531,1235850,11219925,12.38
9864186,9987876,4363,1527050,11514926,15.29
9864187,9989375,5414,1894900,11884275,18.97
9864188,9999603,1238,433300,10432903,4.33
9864189,519505,214,74900,594405,14.42
9864190,9974730,5327,1864450,11839180,18.69
9864191,9965027,1560,546000,10511027,5.48
9864192,484476,84,29400,513876,6.07
9864193,9563227,2191,766850,10330077,8.02
9864194,9957222,4035,1412250,11369472,14.18
9864195,9949501,2879,1007650,10957151,10.13
9864196,9972921,3796,1328600,11301521,13.32
9864198,9952924,3959,1385650,11338574,13.92
9864199,9941779,3550,1242500,11184279,12.50
9864200,9943036,2462,861700,10804736,8.67
9864201,9971157,5570,1949500,11920657,19.55
9864202,9624239,4753,1663550,11287789,17.29
9864203,9992875,1905,666750,10659625,6.67
9864204,9985814,3442,1204700,11190514,12.06
9864205,9983045,3316,1160600,11143645,11.63
9864206,9979032,3752,1313200,11292232,13.16
9864207,2280751,1184,414400,2695151,18.17
9864208,9991089,3633,1271550,11262639,12.73
9864209,9998038,3208,1122800,11120838,11.23
9864210,9977671,2471,864850,10842521,8.67
9864211,9990786,4197,1468950,11459736,14.70
9864212,9988669,1047,366450,10355119,3.67
9864213,9985341,3685,1289750,11275091,12.92
9864214,9996226,3271,1144850,11141076,11.45
9864215,9966120,2996,1048600,11014720,10.52
9864216,9982588,4358,1525300,11507888,15.28
9864217,813864,560,196000,1009864,24.08
9864218,9956772,4571,1599850,11556622,16.07
9864219,9979569,4615,1615250,11594819,16.19
9864220,7835373,2788,975800,8811173,12.45
9864221,9152737,4467,1563450,10716187,17.08
9864222,9992558,4154,1453900,11446458,14.55
9864223,2795910,536,187600,2983510,6.71
9864224,9989541,3676,1286600,11276141,12.88
9864225,9993327,3877,1356950,11350277,13.58
9864226,594672,206,72100,666772,12.12
9864227,9966424,4602,1610700,11577124,16.16
9864228,9974432,3480,1218000,11192432,12.21
9864229,9977112,3120,1092000,11069112,10.95
9864231,9959136,5605,1961750,11920886,19.70
9864232,376558,119,41650,418208,11.06
9864233,9948205,1185,414750,10362955,4.17
9864234,9967061,4402,1540700,11507761,15.46
9864235,9972035,1788,625800,10597835,6.28
9864236,9971352,1014,354900,10326252,3.56
9864237,9978899,2644,925400,10904299,9.27
9864238,9970964,1622,567700,10538664,5.69
9864239,4291373,1685,589750,4881123,13.74
9864240,9959508,3131,1095850,11055358,11.00
9864241,9980073,5020,1757000,11737073,17.61
9864242,9970167,2923,1023050,10993217,10.26
9864243,9958360,3107,1087450,11045810,10.92
9864244,9983398,1196,418600,10401998,4.19
9864245,9972845,4448,1556800,11529645,15.61
9864246,258418,391,136850,395268,52.96
9864247,9973757,3866,1353100,11326857,13.57
9864250,9995938,3638,1273300,11269238,12.74
9864251,9979419,2292,802200,10781619,8.04
9864252,1824906,470,164500,1989406,9.01
9864253,9954143,4963,1737050,11691193,17.45
9864254,9969173,1903,666050,10635223,6.68
9864255,9969868,2820,987000,10956868,9.90
9864256,5649434,2591,906850,6556284,16.05
9864257,9964731,4371,1529850,11494581,15.35
9864258,9991206,4334,1516900,11508106,15.18
9864259,9980680,3335,1167250,11147930,11.70
9864260,9982868,4886,1710100,11692968,17.13
9864261,2966856,2723,953050,3919906,32.12
9864262,9969096,2636,922600,10891696,9.25
9864263,5802085,1612,564200,6366285,9.72
9864264,9947768,4496,1573600,11521368,15.82
9864265,9955181,4773,1670550,11625731,16.78
9864266,9960047,3597,1258950,11218997,12.64
9864267,9979868,2150,752500,10732368,7.54
9864268,9980823,3283,1149050,11129873,11.51
9864269,9971034,4278,1497300,11468334,15.02
9864270,9973584,3572,1250200,11223784,12.54
9864271,9982464,4850,1697500,11679964,17.00
9864272,9977704,1452,508200,10485904,5.09
9864273,9966639,2984,1044400,11011039,10.48
9864274,9983751,2617,915950,10899701,9.17
9864275,9982195,3838,1343300,11325495,13.46
9864276,9980938,1525,533750,10514688,5.35
9864277,9989034,977,341950,10330984,3.42
9864278,9873184,3231,1130850,11004034,11.45
9864279,9954807,3406,1192100,11146907,11.98
9864280,9966122,2622,917700,10883822,9.21
9864281,9965098,3252,1138200,11103298,11.42
9864282,9954970,3962,1386700,11341670,13.93
9864283,9960597,6636,2322600,12283197,23.32
9864284,9948879,3119,1091650,11040529,10.97
9864285,9941759,6218,2176300,12118059,21.89
9864286,9955730,3610,1263500,11219230,12.69
9864287,9948666,4690,1641500,11590166,16.50
9864288,705137,364,127400,832537,18.07
9864289,9949332,5494,1922900,11872232,19.33
9864290,9969491,4041,1414350,11383841,14.19
9864291,9950008,2300,805000,10755008,8.09
9864292,9961678,4893,1712550,11674228,17.19
9864293,9980417,4172,1460200,11440617,14.63
9864294,9989970,3031,1060850,11050820,10.62
9864295,9990578,5009,1753150,11743728,17.55
9864296,3063650,1410,493500,3557150,16.11
9864297,2023391,1905,666750,2690141,32.95
9864298,9968248,4591,1606850,11575098,16.12
9864299,9981817,2404,841400,10823217,8.43
9864300,9974655,2945,1030750,11005405,10.33
9864301,9968760,5112,1789200,11757960,17.95
9864302,9967584,4903,1716050,11683634,17.22
9864303,9969985,5585,1954750,11924735,19.61
9864305,9959568,5673,1985550,11945118,19.94
9864306,9970767,5406,1892100,11862867,18.98
9864307,9955893,4854,1698900,11654793,17.06
9864308,9966915,4165,1457750,11424665,14.63
9864310,9958941,4263,1492050,11450991,14.98
9864311,9946885,4347,1521450,11468335,15.30
9864312,9877593,6794,2377900,12255493,24.07
9864313,464830,118,41300,506130,8.88
9864314,9945300,5254,1838900,11784200,18.49
9864315,1543423,1168,408800,1952223,26.49
9864316,9952858,3643,1275050,11227908,12.81
9864317,9965596,6181,2163350,12128946,21.71
9864318,9960293,1534,536900,10497193,5.39
9864319,9959258,3792,1327200,11286458,13.33
9864320,9968345,2965,1037750,11006095,10.41
9864321,400018,299,104650,504668,26.16
9864322,9938818,1915,670250,10609068,6.74
9864324,8965160,4854,1698900,10664060,18.95
9864325,9820251,3752,1313200,11133451,13.37
9864326,9973586,4442,1554700,11528286,15.59
9864327,1172422,1058,370300,1542722,31.58
9864328,36308,68,23800,60108,65.55
9864329,9940011,2864,1002400,10942411,10.08
9864330,9948835,3865,1352750,11301585,13.60
9864331,9941395,5266,1843100,11784495,18.54
9864332,9961476,1838,643300,10604776,6.46
9864333,9958660,3264,1142400,11101060,11.47
9864334,9959794,3560,1246000,11205794,12.51
9864335,6829389,3454,1208900,8038289,17.70
9864336,9980435,3578,1252300,11232735,12.55
9864337,9984922,3737,1307950,11292872,13.10
9864338,1375078,576,201600,1576678,14.66
9864339,9974238,6421,2247350,12221588,22.53
9864340,9971553,3775,1321250,11292803,13.25
9864341,661370,422,147700,809070,22.33
9864342,2917622,2006,702100,3619722,24.06
9864343,9984269,4200,1470000,11454269,14.72
9864344,9983771,1948,681800,10665571,6.83
9864345,9970345,1248,436800,10407145,4.38
9864347,9885367,3551,1242850,11128217,12.57
9864348,9954370,5629,1970150,11924520,19.79
9864349,9968584,3609,1263150,11231734,12.67
9864350,9968023,1731,605850,10573873,6.08
9864351,3264370,1379,482650,3747020,14.79
9864352,3678064,1116,390600,4068664,10.62
9864353,9947131,2934,1026900,10974031,10.32
9864354,9957224,3477,1216950,11174174,12.22
9864355,9955379,4672,1635200,11590579,16.43
9864356,485865,128,44800,530665,9.22
9864357,9932961,4015,1405250,11338211,14.15
9864358,9882674,3629,1270150,11152824,12.85
9864359,9932101,5726,2004100,11936201,20.18
9864360,5892679,1751,612850,6505529,10.40
9864361,9920198,3251,1137850,11058048,11.47
9864362,9925843,1189,416150,10341993,4.19
9864363,9938199,3125,1093750,11031949,11.01
9864364,3573248,1687,590450,4163698,16.52
9864365,99478,74,25900,125378,26.04
9864366,9923167,4194,1467900,11391067,14.79
9864367,9922100,3011,1053850,10975950,10.62
9864368,7237139,2778,972300,8209439,13.43
9864369,9936016,4671,1634850,11570866,16.45
9864370,2979131,1297,453950,3433081,15.24
9864371,9952960,4488,1570800,11523760,15.78
9864372,9930826,5502,1925700,11856526,19.39
9864374,8415201,2778,972300,9387501,11.55
9864375,9920450,4748,1661800,11582250,16.75
9864376,9904390,3722,1302700,11207090,13.15
9864377,1994402,504,176400,2170802,8.84
9864378,9904867,4771,1669850,11574717,16.86
9864379,3659504,1597,558950,4218454,15.27
9864380,1553780,1002,350700,1904480,22.57
9864381,9869494,2636,922600,10792094,9.35
9864382,9859154,3755,1314250,11173404,13.33
9864383,9810023,2252,788200,10598223,8.03
9864384,9884034,6379,2232650,12116684,22.59
9864385,1086479,429,150150,1236629,13.82
9864386,9878201,2705,946750,10824951,9.58
9864387,9873039,3663,1282050,11155089,12.99
9864388,9890483,2847,996450,10886933,10.07
9864389,3359747,1084,379400,3739147,11.29
9864390,4969414,1992,697200,5666614,14.03
9864391,9893421,3107,1087450,10980871,10.99
9864392,9907690,4193,1467550,11375240,14.81
9864393,9905815,4625,1618750,11524565,16.34
9864394,9909784,2462,861700,10771484,8.70
9864395,9905616,3545,1240750,11146366,12.53
9864396,9555879,4628,1619800,11175679,16.95
9864397,1088386,730,255500,1343886,23.48
9864398,9896900,3787,1325450,11222350,13.39
9864399,9889379,3971,1389850,11279229,14.05
9864400,9882855,4142,1449700,11332555,14.67
9864401,9885213,3745,1310750,11195963,13.26
9864402,9911347,3192,1117200,11028547,11.27
9864403,9907975,3575,1251250,11159225,12.63
9864404,9918788,2500,875000,10793788,8.82
9864405,9919148,3342,1169700,11088848,11.79
9864406,9684515,6022,2107700,11792215,21.76
9864407,9679405,2612,914200,10593605,9.44
9864408,9920547,3165,1107750,11028297,11.17
9864409,9926851,3574,1250900,11177751,12.60
9864410,9950089,4636,1622600,11572689,16.31
9864411,9940819,3698,1294300,11235119,13.02
9864412,9952760,4365,1527750,11480510,15.35
9864413,9965245,3753,1313550,11278795,13.18
9864414,9974208,5162,1806700,11780908,18.11
9864415,9977778,3932,1376200,11353978,13.79
9864416,5679896,1202,420700,6100596,7.41
9864417,9991677,3877,1356950,11348627,13.58
9864418,9978365,4692,1642200,11620565,16.46
9864419,9991916,4554,1593900,11585816,15.95
9864420,9990822,6440,2254000,12244822,22.56
9864421,2473008,2049,717150,3190158,29.00
9864422,6658248,3885,1359750,8017998,20.42
9864423,102057,105,36750,138807,36.01
9864424,9975546,4426,1549100,11524646,15.53
9864425,9977462,4111,1438850,11416312,14.42
9864426,1169326,1241,434350,1603676,37.15
9864427,9976620,4281,1498350,11474970,15.02
9864428,9995457,6292,2202200,12197657,22.03
9864429,9989610,1535,537250,10526860,5.38
9864430,7980544,2302,805700,8786244,10.10
9864431,8983970,3382,1183700,10167670,13.18
9864432,9978860,4637,1622950,11601810,16.26
9864433,915364,425,148750,1064114,16.25
9864434,9944842,4244,1485400,11430242,14.94
9864435,9990697,4235,1482250,11472947,14.84
9864436,9958879,6373,2230550,12189429,22.40
9864437,9979966,3251,1137850,11117816,11.40
9864438,9658513,3157,1104950,10763463,11.44
9864439,9986662,5032,1761200,11747862,17.64
9864440,9999977,3887,1360450,11360427,13.60
9864441,9975141,2900,1015000,10990141,10.18
9864442,9993753,6011,2103850,12097603,21.05
9864443,9983940,3832,1341200,11325140,13.43
9864444,9981256,4438,1553300,11534556,15.56
9864445,9977124,6585,2304750,12281874,23.10
9864446,9976750,2227,779450,10756200,7.81
9864447,9981431,3841,1344350,11325781,13.47
9864448,9979338,3647,1276450,11255788,12.79
9864450,9997763,3066,1073100,11070863,10.73
9864451,9995737,5221,1827350,11823087,18.28
9864452,9985988,1949,682150,10668138,6.83
9864453,841701,521,182350,1024051,21.66
9864454,9958248,3211,1123850,11082098,11.29
9864455,9965609,3932,1376200,11341809,13.81
9864456,9865559,3943,1380050,11245609,13.99
9864457,9971772,3415,1195250,11167022,11.99
9864458,9961887,4068,1423800,11385687,14.29
9864459,9986286,6116,2140600,12126886,21.44
9864460,9985961,4048,1416800,11402761,14.19
9864461,9886546,7086,2480100,12366646,25.09
9864462,9987297,5819,2036650,12023947,20.39
9864463,9985692,3688,1290800,11276492,12.93
9864464,9978724,5435,1902250,11880974,19.06
9864465,9975053,5125,1793750,11768803,17.98
9864466,9994261,5648,1976800,11971061,19.78
9864467,9976370,3604,1261400,11237770,12.64
9864468,9980764,5200,1820000,11800764,18.24
9864469,9993554,4617,1615950,11609504,16.17
9864470,9489722,2397,838950,10328672,8.84
9864471,9978165,4567,1598450,11576615,16.02
9864472,9975402,4350,1522500,11497902,15.26
9864473,9983173,3255,1139250,11122423,11.41
9864474,9997789,6151,2152850,12150639,21.53
9864475,9989166,4568,1598800,11587966,16.01
9864476,886664,322,112700,999364,12.71
9864477,9956132,3987,1395450,11351582,14.02
9864478,5864216,2112,739200,6603416,12.61
9864479,9946572,3153,1103550,11050122,11.09
9864480,1635688,206,72100,1707788,4.41
9864481,9951262,1736,607600,10558862,6.11
9864482,3326793,3572,1250200,4576993,37.58
9864483,9930878,1978,692300,10623178,6.97
9864484,9924216,2755,964250,10888466,9.72
9864485,2197889,1601,560350,2758239,25.49
9864486,9915778,4892,1712200,11627978,17.27
9864487,9922564,3257,1139950,11062514,11.49
9864489,9901533,4103,1436050,11337583,14.50
9864490,9916221,767,268450,10184671,2.71
9864491,9905515,2903,1016050,10921565,10.26
9864492,9001531,3503,1226050,10227581,13.62
9864493,9912770,4714,1649900,11562670,16.64
9864494,6117843,2095,733250,6851093,11.99
9864495,9922941,3921,1372350,11295291,13.83
9864496,9939909,1210,423500,10363409,4.26
9864497,9934440,4028,1409800,11344240,14.19
9864498,9937832,2951,1032850,10970682,10.39
9864499,9942726,2529,885150,10827876,8.90
9864500,9943503,5308,1857800,11801303,18.68
9864501,9470734,5194,1817900,11288634,19.19
9864502,9962624,3440,1204000,11166624,12.09
9864503,2372517,685,239750,2612267,10.11
9864504,9956760,3025,1058750,11015510,10.63
9864505,9963875,3095,1083250,11047125,10.87
9864506,9978527,1225,428750,10407277,4.30
9864507,9976526,4320,1512000,11488526,15.16
9864508,9952843,1863,652050,10604893,6.55
9864509,9889298,3488,1220800,11110098,12.34
9864511,9745868,4863,1702050,11447918,17.46
9864512,9961241,2951,1032850,10994091,10.37
9864513,2333527,1066,373100,2706627,15.99
9864514,9960512,2913,1019550,10980062,10.24
9864515,9963465,3913,1369550,11333015,13.75
9864516,9973393,1708,597800,10571193,5.99
9864517,9988044,2322,812700,10800744,8.14
9864518,9974471,1530,535500,10509971,5.37
9864519,6653575,3190,1116500,7770075,16.78
9864520,9971566,2155,754250,10725816,7.56
9864521,9970553,2646,926100,10896653,9.29
9864522,9958664,5044,1765400,11724064,17.73
9864523,9978402,4238,1483300,11461702,14.87
9864525,9958481,3738,1308300,11266781,13.14
9864526,9978167,2072,725200,10703367,7.27
9864527,9967901,5419,1896650,11864551,19.03
9864528,9994377,3245,1135750,11130127,11.36
9864529,9986991,4085,1429750,11416741,14.32
9864530,9991206,1707,597450,10588656,5.98
9864531,9987814,3122,1092700,11080514,10.94
9864532,5127694,1920,672000,5799694,13.11
9864533,9656766,3335,1167250,10824016,12.09
9864534,9884497,4670,1634500,11518997,16.54
9864535,9972011,3517,1230950,11202961,12.34
9864536,9995730,4399,1539650,11535380,15.40
9864537,9987154,4665,1632750,11619904,16.35
9864538,9988216,3950,1382500,11370716,13.84
9864539,1185048,342,119700,1304748,10.10
9864540,9961293,1108,387800,10349093,3.89
9864541,9966952,4111,1438850,11405802,14.44
9864542,9978375,3795,1328250,11306625,13.31
9864544,3817504,1209,423150,4240654,11.08
9864545,9974100,4268,1493800,11467900,14.98
9864546,9961744,4902,1715700,11677444,17.22
9864547,3594784,2038,713300,4308084,19.84
9864548,9981217,3319,1161650,11142867,11.64
9864549,9954135,1328,464800,10418935,4.67
9864550,9962746,3031,1060850,11023596,10.65
9864551,4112930,1197,418950,4531880,10.19
9864552,5998169,1779,622650,6620819,10.38
9864553,1998868,2296,803600,2802468,40.20
9864554,9965764,3159,1105650,11071414,11.09
9864555,9974310,3300,1155000,11129310,11.58
9864556,9985271,1899,664650,10649921,6.66
9864557,9980595,2027,709450,10690045,7.11
9864559,9974895,1707,597450,10572345,5.99
9864560,9971406,818,286300,10257706,2.87
9864561,9987581,5057,1769950,11757531,17.72
9864562,9978975,3044,1065400,11044375,10.68
9864564,9965616,5561,1946350,11911966,19.53
9864565,9957265,3146,1101100,11058365,11.06
9864566,9975440,2456,859600,10835040,8.62
9864567,9983173,5234,1831900,11815073,18.35
9864568,2394205,435,152250,2546455,6.36
9864569,9993046,1927,674450,10667496,6.75
9864570,2810653,1072,375200,3185853,13.35
9864571,9954879,3090,1081500,11036379,10.86
9864572,9962070,2840,994000,10956070,9.98
9864573,9948727,4079,1427650,11376377,14.35
9864574,9965801,5172,1810200,11776001,18.16
9864575,9967760,2108,737800,10705560,7.40
9864576,9956879,4080,1428000,11384879,14.34
9864577,9980356,5130,1795500,11775856,17.99
9864579,9970026,5947,2081450,12051476,20.88
9864580,3485647,973,340550,3826197,9.77
9864582,9944441,2202,770700,10715141,7.75
9864583,9934792,243,85050,10019842,0.86
9864584,9944554,2927,1024450,10969004,10.30
9864585,9962500,3966,1388100,11350600,13.93
9864586,9973020,4035,1412250,11385270,14.16
9864587,9962436,1250,437500,10399936,4.39
9864588,9952119,1105,386750,10338869,3.89
9864589,9974188,775,271250,10245438,2.72
9864590,9961839,3278,1147300,11109139,11.52
9864591,9970322,4947,1731450,11701772,17.37
9864592,9971307,967,338450,10309757,3.39
9864593,6284310,4608,1612800,7897110,25.66
9864594,9977426,4799,1679650,11657076,16.83
9864595,9944467,2499,874650,10819117,8.80
9864596,2293926,2107,737450,3031376,32.15
9864597,9948491,3598,1259300,11207791,12.66
9864598,9970475,3978,1392300,11362775,13.96
9864599,9949638,3060,1071000,11020638,10.76
9864600,9681027,2798,979300,10660327,10.12
9864602,9973263,5351,1872850,11846113,18.78
9864603,9955227,4209,1473150,11428377,14.80
9864604,9973374,3981,1393350,11366724,13.97
9864605,6928674,4177,1461950,8390624,21.10
9864606,9951813,3921,1372350,11324163,13.79
9864607,9965990,5316,1860600,11826590,18.67
9864608,9947908,4394,1537900,11485808,15.46
9864609,804055,524,183400,987455,22.81
9864610,8960492,2173,760550,9721042,8.49
9864611,9955162,4004,1401400,11356562,14.08
9864612,9961144,5873,2055550,12016694,20.64
9864613,9889437,6170,2159500,12048937,21.84
9864614,1961470,1536,537600,2499070,27.41
9864615,1331352,467,163450,1494802,12.28
9864616,9984738,2303,806050,10790788,8.07
9864617,9959045,6641,2324350,12283395,23.34
9864618,9990156,4702,1645700,11635856,16.47
9864619,9980824,3456,1209600,11190424,12.12
9864620,6337212,3251,1137850,7475062,17.96
9864621,9999679,3451,1207850,11207529,12.08
9864622,9998968,1328,464800,10463768,4.65
9864623,9970685,1424,498400,10469085,5.00
9864624,9925208,1323,463050,10388258,4.67
9864625,9968045,4740,1659000,11627045,16.64
9864626,6171801,2252,788200,6960001,12.77
9864627,9988434,4010,1403500,11391934,14.05
9864628,9977509,3277,1146950,11124459,11.50
9864629,4976418,3196,1118600,6095018,22.48
9864630,9990952,4108,1437800,11428752,14.39
9864631,9985036,2225,778750,10763786,7.80
9864632,9977271,4651,1627850,11605121,16.32
9864633,9992990,6497,2273950,12266940,22.76
9864634,9982855,1429,500150,10483005,5.01
9864635,3005606,1276,446600,3452206,14.86
9864636,9961147,4951,1732850,11693997,17.40
9864638,9975062,4136,1447600,11422662,14.51
9864639,9964083,4927,1724450,11688533,17.31
9864640,9976109,5918,2071300,12047409,20.76
9864641,9971392,3054,1068900,11040292,10.72
9864642,9982473,4286,1500100,11482573,15.03
9864644,9958522,4520,1582000,11540522,15.89
9864645,1386493,695,243250,1629743,17.54
9864646,9960079,4236,1482600,11442679,14.89
9864648,9946679,5247,1836450,11783129,18.46
9864649,9947609,1332,466200,10413809,4.69
9864650,9952705,1730,605500,10558205,6.08
9864651,9963142,4327,1514450,11477592,15.20
9864652,699919,433,151550,851469,21.65
9864653,9933296,4670,1634500,11567796,16.45
9864654,3625715,1605,561750,4187465,15.49
9864655,9914312,5115,1790250,11704562,18.06
9864656,9932136,549,192150,10124286,1.93
9864657,9930281,1151,402850,10333131,4.06
9864658,9912769,5205,1821750,11734519,18.38
9864659,9927273,3972,1390200,11317473,14.00
9864660,9924730,4424,1548400,11473130,15.60
9864661,9935928,1944,680400,10616328,6.85
9864662,9936625,6604,2311400,12248025,23.26
9864663,9958412,1324,463400,10421812,4.65
9864664,9936848,1904,666400,10603248,6.71
9864665,9939558,5254,1838900,11778458,18.50
9864666,5956440,3275,1146250,7102690,19.24
9864667,9952620,2248,786800,10739420,7.91
9864668,9969977,2129,745150,10715127,7.47
9864669,3938291,1747,611450,4549741,15.53
9864670,9969177,5657,1979950,11949127,19.86
9864671,9971422,3243,1135050,11106472,11.38
9864672,9951145,3639,1273650,11224795,12.80
9864673,9961334,3647,1276450,11237784,12.81
9864674,9892944,5517,1930950,11823894,19.52
9864675,9985224,4026,1409100,11394324,14.11
9864676,9984157,2113,739550,10723707,7.41
9864677,9999195,3424,1198400,11197595,11.98
9864678,9979003,3741,1309350,11288353,13.12
9864679,9978327,3999,1399650,11377977,14.03
9864680,9996859,3211,1123850,11120709,11.24
9864681,9986086,4890,1711500,11697586,17.14
9864682,9987120,2872,1005200,10992320,10.06
9864683,9992040,5838,2043300,12035340,20.45
9864684,9981588,3545,1240750,11222338,12.43
9864685,9989823,5695,1993250,11983073,19.95
9864686,9986849,4651,1627850,11614699,16.30
9864687,9986023,1014,354900,10340923,3.55
9864689,9983542,2054,718900,10702442,7.20
9864690,1135321,132,46200,1181521,4.07
9864691,9987020,3953,1383550,11370570,13.85
9864692,9984222,3466,1213100,11197322,12.15
9864693,9990775,2635,922250,10913025,9.23
9864695,9971158,4044,1415400,11386558,14.19
9864696,9969534,4457,1559950,11529484,15.65
9864697,9989744,4688,1640800,11630544,16.42
9864698,9996457,2195,768250,10764707,7.69
9864699,9983466,4121,1442350,11425816,14.45
9864700,9989070,3911,1368850,11357920,13.70
9864701,8999515,4322,1512700,10512215,16.81
9864702,9984450,4774,1670900,11655350,16.74
9864704,9984960,1913,669550,10654510,6.71
9864705,9956913,4746,1661100,11618013,16.68
9864706,9979173,3441,1204350,11183523,12.07
9864707,9989473,5238,1833300,11822773,18.35
9864708,9629060,5377,1881950,11511010,19.54
9864709,2122940,1124,393400,2516340,18.53
9864710,9999903,4791,1676850,11676753,16.77
9864712,9112688,3406,1192100,10304788,13.08
9864713,9932268,3444,1205400,11137668,12.14
9864714,9988994,4128,1444800,11433794,14.46
9864715,9992999,2693,942550,10935549,9.43
9864716,9989445,4439,1553650,11543095,15.55
9864717,9998023,3819,1336650,11334673,13.37
9864718,4951578,1341,469350,5420928,9.48
9864719,9973214,2895,1013250,10986464,10.16
9864720,9985781,4031,1410850,11396631,14.13
9864721,9968531,3505,1226750,11195281,12.31
9864722,595391,175,61250,656641,10.29
9864723,8378408,4468,1563800,9942208,18.66
9864724,9962553,4976,1741600,11704153,17.48
9864725,5311742,1258,440300,5752042,8.29
9864726,3529548,1948,681800,4211348,19.32
9864727,9600032,3720,1302000,10902032,13.56
9864728,9965127,4824,1688400,11653527,16.94
9864729,9967878,3845,1345750,11313628,13.50
9864730,9989906,2411,843850,10833756,8.45
9864731,4201251,1876,656600,4857851,15.63
9864733,9876622,5496,1923600,11800222,19.48
9864734,9988341,3151,1102850,11091191,11.04
9864735,9992753,4236,1482600,11475353,14.84
9864736,9979442,3444,1205400,11184842,12.08
9864737,9865616,4457,1559950,11425566,15.81
9864738,9978344,2651,927850,10906194,9.30
9864739,9981845,2223,778050,10759895,7.79
9864740,5795604,1834,641900,6437504,11.08
9864741,454484,136,47600,502084,10.47
9864742,9960967,1999,699650,10660617,7.02
9864743,9978672,4291,1501850,11480522,15.05
9864745,9964271,482,168700,10132971,1.69
9864746,9966827,2317,810950,10777777,8.14
9864747,9968001,2782,973700,10941701,9.77
9864748,6456243,2108,737800,7194043,11.43
9864749,9982015,4425,1548750,11530765,15.52
9864750,9994578,3937,1377950,11372528,13.79
9864751,9999012,4809,1683150,11682162,16.83
9864753,9982623,4682,1638700,11621323,16.42
9864754,9972955,4756,1664600,11637555,16.69
9864755,9963740,2214,774900,10738640,7.78
9864756,9975437,3512,1229200,11204637,12.32
9864757,1641210,660,231000,1872210,14.07
9864758,9985502,4880,1708000,11693502,17.10
9864759,9895186,6402,2240700,12135886,22.64
9864760,8978355,4788,1675800,10654155,18.66
9864761,9489430,4716,1650600,11140030,17.39
9864762,9981835,5525,1933750,11915585,19.37
9864763,9986263,4296,1503600,11489863,15.06
9864764,2226554,599,209650,2436204,9.42
9864765,9993563,4645,1625750,11619313,16.27
9864766,9635142,3522,1232700,10867842,12.79
9864767,9992342,3606,1262100,11254442,12.63
9864768,9981320,1991,696850,10678170,6.98
9864769,9985692,4036,1412600,11398292,14.15
9864770,9988089,1452,508200,10496289,5.09
9864771,9985554,5622,1967700,11953254,19.71
9864772,9992443,3473,1215550,11207993,12.16
9864773,9986550,5151,1802850,11789400,18.05
9864774,9993977,4778,1672300,11666277,16.73
9864775,9985699,2455,859250,10844949,8.60
9864776,9983096,875,306250,10289346,3.07
9864777,9992609,1974,690900,10683509,6.91
9864778,9997565,4978,1742300,11739865,17.43
9864779,9986098,3736,1307600,11293698,13.09
9864780,9997378,4090,1431500,11428878,14.32
9864781,9972259,3926,1374100,11346359,13.78
9864782,9988405,4293,1502550,11490955,15.04
9864784,9979915,4275,1496250,11476165,14.99
9864785,9983138,1825,638750,10621888,6.40
9864786,2249601,819,286650,2536251,12.74
9864787,9939093,5436,1902600,11841693,19.14
9864788,9972740,3452,1208200,11180940,12.12
9864789,9986221,3648,1276800,11263021,12.79
9864790,9997355,6704,2346400,12343755,23.47
9864791,9971308,3954,1383900,11355208,13.88
9864792,6080883,2927,1024450,7105333,16.85
9864793,9948784,4031,1410850,11359634,14.18
9864794,9994639,3739,1308650,11303289,13.09
9864795,9991645,3775,1321250,11312895,13.22
9864796,9983668,4779,1672650,11656318,16.75
9864797,9992837,4481,1568350,11561187,15.69
9864798,9982104,3789,1326150,11308254,13.29
9864799,9995185,4189,1466150,11461335,14.67
9864800,9972827,2840,994000,10966827,9.97
9864801,9984308,4047,1416450,11400758,14.19
9864802,9972649,2082,728700,10701349,7.31
9864803,7879464,3459,1210650,9090114,15.36
9864804,9973685,3485,1219750,11193435,12.23
9864805,9974930,2045,715750,10690680,7.18
9864806,3878169,1548,541800,4419969,13.97
9864807,951077,389,136150,1087227,14.32
9864808,4889903,1666,583100,5473003,11.92
9864809,9946764,4757,1664950,11611714,16.74
9864810,9925922,4948,1731800,11657722,17.45
9864811,9944219,2975,1041250,10985469,10.47
9864812,9944625,3945,1380750,11325375,13.88
9864813,9940999,5058,1770300,11711299,17.81
9864814,9949385,2669,934150,10883535,9.39
9864815,9958053,5478,1917300,11875353,19.25
9864817,9958883,3315,1160250,11119133,11.65
9864818,9968575,4201,1470350,11438925,14.75
9864819,9958701,1708,597800,10556501,6.00
9864820,9981950,4171,1459850,11441800,14.62
9864821,9981713,3692,1292200,11273913,12.95
9864822,9984325,3938,1378300,11362625,13.80
9864823,9473014,3595,1258250,10731264,13.28
9864824,9961018,1769,619150,10580168,6.22
9864825,9947880,3437,1202950,11150830,12.09
9864826,9969877,4028,1409800,11379677,14.14
9864827,9968314,5536,1937600,11905914,19.44
9864828,9858413,5616,1965600,11824013,19.94
9864829,9980018,5458,1910300,11890318,19.14
9864830,9980110,4107,1437450,11417560,14.40
9864831,9983401,3068,1073800,11057201,10.76
9864832,9986668,3700,1295000,11281668,12.97
9864833,8013298,3285,1149750,9163048,14.35
9864834,9972724,5109,1788150,11760874,17.93
9864835,9987458,3219,1126650,11114108,11.28
9864836,9967926,2710,948500,10916426,9.52
9864837,9969950,2494,872900,10842850,8.76
9864838,9972886,3820,1337000,11309886,13.41
9864839,9677267,4177,1461950,11139217,15.11
9864840,9967376,5634,1971900,11939276,19.78
9864841,1785103,529,185150,1970253,10.37
9864842,9950339,2242,784700,10735039,7.89
9864843,9953295,5244,1835400,11788695,18.44
9864844,9963155,3078,1077300,11040455,10.81
9864845,4373463,1484,519400,4892863,11.88
9864846,9970826,3241,1134350,11105176,11.38
9864847,9975340,5573,1950550,11925890,19.55
9864848,9987827,2068,723800,10711627,7.25
9864849,9994659,4548,1591800,11586459,15.93
9864850,9983846,2453,858550,10842396,8.60
9864851,9974589,5268,1843800,11818389,18.48
9864852,9966075,3161,1106350,11072425,11.10
9864853,9978504,2416,845600,10824104,8.47
9864854,9991013,2364,827400,10818413,8.28
9864855,9987302,5046,1766100,11753402,17.68
9864856,9988291,5159,1805650,11793941,18.08
9864857,9890544,2373,830550,10721094,8.40
9864858,5990129,1728,604800,6594929,10.10
9864859,9889680,4329,1515150,11404830,15.32
9864860,9997427,4902,1715700,11713127,17.16
9864861,9987740,3067,1073450,11061190,10.75
9864862,646633,213,74550,721183,11.53
9864863,9970655,2376,831600,10802255,8.34
9864864,9984184,3739,1308650,11292834,13.11
9864865,1125126,818,286300,1411426,25.45
9864866,9986119,4193,1467550,11453669,14.70
9864867,9972597,2869,1004150,10976747,10.07
9864868,9866387,4415,1545250,11411637,15.66
9864869,9989826,4448,1556800,11546626,15.58
9864870,9988651,3695,1293250,11281901,12.95
9864871,1805497,481,168350,1973847,9.32
9864872,798983,522,182700,981683,22.87
9864873,9996611,1752,613200,10609811,6.13
9864874,9987377,6884,2409400,12396777,24.12
9864875,9984430,3367,1178450,11162880,11.80
9864876,9994980,5339,1868650,11863630,18.70
9864877,9990945,3500,1225000,11215945,12.26
9864878,9976953,3328,1164800,11141753,11.67
9864879,9989055,3666,1283100,11272155,12.85
9864880,9999096,1917,670950,10670046,6.71
9864881,9999126,3377,1181950,11181076,11.82
9864882,9999370,4289,1501150,11500520,15.01
9864883,9997451,3005,1051750,11049201,10.52
9864884,9962409,2593,907550,10869959,9.11
9864885,9995932,2963,1037050,11032982,10.37
9864886,9986609,4915,1720250,11706859,17.23
9864887,9989103,5450,1907500,11896603,19.10
9864888,6933685,2619,916650,7850335,13.22
9864889,9975305,5192,1817200,11792505,18.22
9864890,9984300,4245,1485750,11470050,14.88
9864891,9971408,2978,1042300,11013708,10.45
9864893,9965521,5015,1755250,11720771,17.61
9864894,9955358,3524,1233400,11188758,12.39
9864895,9966195,4078,1427300,11393495,14.32
9864896,9965178,614,214900,10180078,2.16
9864897,9987790,4217,1475950,11463740,14.78
9864898,1189041,750,262500,1451541,22.08
9864899,9955957,5173,1810550,11766507,18.19
9864900,9963626,3748,1311800,11275426,13.17
9864901,9977343,8839,3093650,13070993,31.01
9864902,9983006,3935,1377250,11360256,13.80
9864903,9929026,4253,1488550,11417576,14.99
9864904,9987708,3700,1295000,11282708,12.97
9864905,3981235,4332,1516200,5497435,38.08
9864906,9797995,4874,1705900,11503895,17.41
9864907,9981067,1619,566650,10547717,5.68
9864908,9992341,3961,1386350,11378691,13.87
9864909,9975882,4591,1606850,11582732,16.11
9864910,9988150,5747,2011450,11999600,20.14
9864911,9981798,417,145950,10127748,1.46
9864912,9969201,4801,1680350,11649551,16.86
9864913,9997507,5805,2031750,12029257,20.32
9864914,9990507,3225,1128750,11119257,11.30
9864915,8053131,3264,1142400,9195531,14.19
9864916,7987364,5157,1804950,9792314,22.60
9864917,9961606,5665,1982750,11944356,19.90
9864918,1170696,461,161350,1332046,13.78
9864919,9869557,3724,1303400,11172957,13.21
9864920,1867404,810,283500,2150904,15.18
9864921,4733816,768,268800,5002616,5.68
9864922,9953351,4404,1541400,11494751,15.49
9864923,9896701,5310,1858500,11755201,18.78
9864924,1695287,1006,352100,2047387,20.77
9864925,9961850,5583,1954050,11915900,19.62
9864926,9972455,3869,1354150,11326605,13.58
9864927,9918302,3892,1362200,11280502,13.73
9864928,281455,112,39200,320655,13.93
9864929,9975619,2799,979650,10955269,9.82
9864930,9973032,3927,1374450,11347482,13.78
9864931,2803334,1396,488600,3291934,17.43
9864932,9973815,4086,1430100,11403915,14.34
9864933,9980746,3036,1062600,11043346,10.65
9864934,9970866,4208,1472800,11443666,14.77
9864935,1673136,829,290150,1963286,17.34
9864936,9973100,3992,1397200,11370300,14.01
9864937,9973779,4444,1555400,11529179,15.59
9864938,9980809,3363,1177050,11157859,11.79
9864939,9992104,5808,2032800,12024904,20.34
9864940,9898664,3952,1383200,11281864,13.97
9864942,8971088,4195,1468250,10439338,16.37
9864943,9964002,649,227150,10191152,2.28
9864944,9981319,3224,1128400,11109719,11.31
9864945,2240337,893,312550,2552887,13.95
9864946,9984142,2697,943950,10928092,9.45
9864947,9967315,2827,989450,10956765,9.93
9864948,9999057,4493,1572550,11571607,15.73
9864949,1987945,1159,405650,2393595,20.41
9864951,9965501,1025,358750,10324251,3.60
9864952,9959933,3788,1325800,11285733,13.31
9864953,9949785,5092,1782200,11731985,17.91
9864954,4327578,2730,955500,5283078,22.08
9864955,1982935,428,149800,2132735,7.55
9864956,9972567,3644,1275400,11247967,12.79
9864957,9970975,5333,1866550,11837525,18.72
9864958,8754925,3380,1183000,9937925,13.51
9864959,9984603,3409,1193150,11177753,11.95
9864960,9969757,4151,1452850,11422607,14.57
9864961,6521572,3537,1237950,7759522,18.98
9864962,9954589,2663,932050,10886639,9.36
9864963,9962143,3725,1303750,11265893,13.09
9864964,9958675,3065,1072750,11031425,10.77
9864965,9987190,6420,2247000,12234190,22.50
9864966,9971842,4343,1520050,11491892,15.24
9864968,9999627,3744,1310400,11310027,13.10
9864969,9994275,4621,1617350,11611625,16.18
9864970,9981100,4715,1650250,11631350,16.53
9864971,9979509,6466,2263100,12242609,22.68
9864972,9975941,3185,1114750,11090691,11.17
9864973,9992249,4158,1455300,11447549,14.56
9864974,9951491,4523,1583050,11534541,15.91
9864975,9962939,2656,929600,10892539,9.33
9864976,9976456,3294,1152900,11129356,11.56
9864977,9978446,3839,1343650,11322096,13.47
9864978,9640804,1427,499450,10140254,5.18
9864979,9978256,2641,924350,10902606,9.26
9864980,9999179,2642,924700,10923879,9.25
9864981,9949841,3004,1051400,11001241,10.57
9864982,9967549,408,142800,10110349,1.43
9864983,9969413,4281,1498350,11467763,15.03
9864984,9959092,1912,669200,10628292,6.72
9864985,9970294,3993,1397550,11367844,14.02
9864986,9986611,2231,780850,10767461,7.82
9864987,9992528,4972,1740200,11732728,17.42
9864988,9989993,2813,984550,10974543,9.86
9864989,9977678,2041,714350,10692028,7.16
9864990,9990827,2115,740250,10731077,7.41
9864991,9991687,2209,773150,10764837,7.74
9864992,9958524,4162,1456700,11415224,14.63
9864993,9992278,3405,1191750,11184028,11.93
9864995,3143470,249,87150,3230620,2.77
9864996,9643814,4328,1514800,11158614,15.71
9864997,9994185,3637,1272950,11267135,12.74
9864998,9986481,1423,498050,10484531,4.99
9864999,9991930,3101,1085350,11077280,10.86
9865000,9971548,2635,922250,10893798,9.25
9865001,2603514,658,230300,2833814,8.85
9865002,9999585,4946,1731100,11730685,17.31
9865003,9986053,3162,1106700,11092753,11.08
9865004,9989539,3981,1393350,11382889,13.95
9865005,9982060,2745,960750,10942810,9.62
9865006,6947379,3453,1208550,8155929,17.40
9865007,9849802,2879,1007650,10857452,10.23
9865008,9988412,2113,739550,10727962,7.40
9865009,9993812,3980,1393000,11386812,13.94
9865010,9972324,3824,1338400,11310724,13.42
9865011,7474114,3047,1066450,8540564,14.27
9865012,9987888,5110,1788500,11776388,17.91
9865013,9987441,2981,1043350,11030791,10.45
9865014,9030329,5142,1799700,10830029,19.93
9865015,5881197,2208,772800,6653997,13.14
9865016,9973972,5446,1906100,11880072,19.11
9865017,9968957,4109,1438150,11407107,14.43
9865019,9940078,4349,1522150,11462228,15.31
9865020,3836387,334,116900,3953287,3.05
9865021,9948070,2780,973000,10921070,9.78
9865022,9955286,3835,1342250,11297536,13.48
9865023,9965123,3948,1381800,11346923,13.87
9865024,9966456,3468,1213800,11180256,12.18
9865025,9982687,2340,819000,10801687,8.20
9865026,9997215,5390,1886500,11883715,18.87
9865027,9984699,3695,1293250,11277949,12.95
9865028,9986682,4671,1634850,11621532,16.37
9865029,9987604,3602,1260700,11248304,12.62
9865030,3402933,1443,505050,3907983,14.84
9865031,9966401,5605,1961750,11928151,19.68
9865032,9980192,2729,955150,10935342,9.57
9865033,9975657,2682,938700,10914357,9.41
9865034,9981525,1910,668500,10650025,6.70
9865035,1499180,549,192150,1691330,12.82
9865036,9954873,700,245000,10199873,2.46
9865037,9960082,4690,1641500,11601582,16.48
9865038,9960702,2522,882700,10843402,8.86
9865039,9965840,3667,1283450,11249290,12.88
9865040,9962917,5298,1854300,11817217,18.61
9865041,9975527,2345,820750,10796277,8.23
9865042,9966845,1622,567700,10534545,5.70
9865043,474453,524,183400,657853,38.66
9865044,9957885,5470,1914500,11872385,19.23
9865045,9967097,4001,1400350,11367447,14.05
9865046,9963899,1672,585200,10549099,5.87
9865047,9969902,5382,1883700,11853602,18.89
9865048,9982012,2298,804300,10786312,8.06
9865049,9979350,1450,507500,10486850,5.09
9865050,9994769,1676,586600,10581369,5.87
9865051,9973487,3155,1104250,11077737,11.07
9865052,9575866,2274,795900,10371766,8.31
9865053,9968602,3503,1226050,11194652,12.30
9865054,1329855,1055,369250,1699105,27.77
9865055,9972561,3263,1142050,11114611,11.45
9865056,9975396,1996,698600,10673996,7.00
9865057,2694674,1784,624400,3319074,23.17
9865058,9943865,1631,570850,10514715,5.74
9865059,9946136,5723,2003050,11949186,20.14
9865060,9969412,4580,1603000,11572412,16.08
9865061,9945070,2010,703500,10648570,7.07
9865062,9961308,4163,1457050,11418358,14.63
9865063,9963874,1832,641200,10605074,6.44
9865064,9957590,3602,1260700,11218290,12.66
9865065,9968984,3828,1339800,11308784,13.44
9865066,144864,61,21350,166214,14.74
9865067,9992080,3370,1179500,11171580,11.80
9865068,1989828,1239,433650,2423478,21.79
9865069,9965634,3041,1064350,11029984,10.68
9865070,9969906,4171,1459850,11429756,14.64
9865071,2308492,1526,534100,2842592,23.14
9865072,9963671,2207,772450,10736121,7.75
9865073,9976540,4427,1549450,11525990,15.53
9865074,9987755,3847,1346450,11334205,13.48
9865075,9973129,1819,636650,10609779,6.38
9865076,3772435,732,256200,4028635,6.79
9865077,1756119,672,235200,1991319,13.39
9865078,9974567,2905,1016750,10991317,10.19
9865079,9983287,1159,405650,10388937,4.06
9865080,9963130,5647,1976450,11939580,19.84
9865081,1935512,1043,365050,2300562,18.86
9865082,9976165,3219,1126650,11102815,11.29
9865083,8665153,3110,1088500,9753653,12.56
9865084,1295957,446,156100,1452057,12.05
9865085,9962030,2495,873250,10835280,8.77
9865086,9965778,3131,1095850,11061628,11.00
9865087,9972786,3614,1264900,11237686,12.68
9865088,9981563,1182,413700,10395263,4.14
9865090,9966033,4637,1622950,11588983,16.28
9865091,8789362,2526,884100,9673462,10.06
9865092,922989,169,59150,982139,6.41
9865093,9989625,3282,1148700,11138325,11.50
9865094,9984135,3634,1271900,11256035,12.74
9865095,9992798,3512,1229200,11221998,12.30
9865096,9978403,2822,987700,10966103,9.90
9865097,9980351,2327,814450,10794801,8.16
9865098,9983901,3837,1342950,11326851,13.45
9865099,9981843,3569,1249150,11230993,12.51
9865100,9979413,3508,1227800,11207213,12.30
9865101,9904396,3195,1118250,11022646,11.29
9865102,9992025,1918,671300,10663325,6.72
9865103,9985655,2755,964250,10949905,9.66
9865104,3973467,1099,384650,4358117,9.68
9865105,9971984,5506,1927100,11899084,19.33
9865106,9974811,1336,467600,10442411,4.69
9865107,9989097,2552,893200,10882297,8.94
9865108,9988834,4682,1638700,11627534,16.41
9865110,9959528,2435,852250,10811778,8.56
9865111,9983549,4298,1504300,11487849,15.07
9865112,4522201,1812,634200,5156401,14.02
9865113,9975226,3767,1318450,11293676,13.22
9865114,788808,494,172900,961708,21.92
9865115,9966565,1987,695450,10662015,6.98
9865116,9976953,2927,1024450,11001403,10.27
9865117,9978639,1254,438900,10417539,4.40
9865118,9988418,429,150150,10138568,1.50
9865119,9989860,974,340900,10330760,3.41
9865120,9975893,2053,718550,10694443,7.20
9865121,9990214,3378,1182300,11172514,11.83
9865122,3501313,1663,582050,4083363,16.62
9865123,9985970,5110,1788500,11774470,17.91
9865124,1101432,507,177450,1278882,16.11
9865125,9993014,4481,1568350,11561364,15.69
9865126,9979955,3187,1115450,11095405,11.18
9865127,9979102,4818,1686300,11665402,16.90
9865128,9986521,3294,1152900,11139421,11.54
9865129,9015255,929,325150,9340405,3.61
9865130,7927702,3500,1225000,9152702,15.45
9865131,9979424,3512,1229200,11208624,12.32
9865132,9970511,4634,1621900,11592411,16.27
9865133,9958957,2927,1024450,10983407,10.29
9865134,9953146,3483,1219050,11172196,12.25
9865135,9762402,3478,1217300,10979702,12.47
9865136,9932901,4154,1453900,11386801,14.64
9865137,9965569,4709,1648150,11613719,16.54
9865138,9964713,2175,761250,10725963,7.64
9865139,6860943,423,148050,7008993,2.16
9865140,7484542,573,200550,7685092,2.68
9865141,6725553,2623,918050,7643603,13.65
9865142,8978081,3067,1073450,10051531,11.96
9865143,9981505,3142,1099700,11081205,11.02
9865144,7250854,2155,754250,8005104,10.40
9865145,9978732,2382,833700,10812432,8.35
9865146,9973156,2664,932400,10905556,9.35
9865147,4971102,1094,382900,5354002,7.70
9865148,5279372,1471,514850,5794222,9.75
9865149,9952635,3691,1291850,11244485,12.98
9865151,9950815,2919,1021650,10972465,10.27
9865152,9953586,4282,1498700,11452286,15.06
9865153,9939827,2759,965650,10905477,9.71
9865154,9689835,4878,1707300,11397135,17.62
9865155,9970017,1102,385700,10355717,3.87
9865156,9963934,5034,1761900,11725834,17.68
9865157,9965900,5439,1903650,11869550,19.10
9865158,1084617,692,242200,1326817,22.33
9865159,9973012,1542,539700,10512712,5.41
9865160,9982503,4238,1483300,11465803,14.86
9865161,9987070,7627,2669450,12656520,26.73
9865162,72273,19,6650,78923,9.20
9865163,2130494,1208,422800,2553294,19.85
9865164,9989774,1586,555100,10544874,5.56
9865165,9980184,3135,1097250,11077434,10.99
9865166,9977868,4538,1588300,11566168,15.92
9865167,9958074,1187,415450,10373524,4.17
9865168,9955150,4901,1715350,11670500,17.23
9865169,9953519,3625,1268750,11222269,12.75
9865170,9965814,4352,1523200,11489014,15.28
9865171,9956822,5975,2091250,12048072,21.00
9865172,9957285,4509,1578150,11535435,15.85
9865173,9981341,3431,1200850,11182191,12.03
9865175,9963085,3526,1234100,11197185,12.39
9865176,9968591,4334,1516900,11485491,15.22
9865177,9960002,1374,480900,10440902,4.83
9865178,4385168,1332,466200,4851368,10.63
9865179,9966703,5766,2018100,11984803,20.25
9865180,9972625,4628,1619800,11592425,16.24
9865181,9974896,1929,675150,10650046,6.77
9865182,9968817,3811,1333850,11302667,13.38
9865183,9984862,4307,1507450,11492312,15.10
9865184,9980328,3416,1195600,11175928,11.98
9865185,180633,96,33600,214233,18.60
9865186,9940495,4367,1528450,11468945,15.38
9865187,9976016,5094,1782900,11758916,17.87
9865188,9983965,3826,1339100,11323065,13.41
9865189,9988135,4168,1458800,11446935,14.61
9865190,9976287,3806,1332100,11308387,13.35
9865191,9976953,4900,1715000,11691953,17.19
9865192,9991645,4114,1439900,11431545,14.41
9865193,9985262,1417,495950,10481212,4.97
9865194,9910335,3983,1394050,11304385,14.07
9865195,9967246,2358,825300,10792546,8.28
9865196,9977225,2557,894950,10872175,8.97
9865197,9991411,2756,964600,10956011,9.65
9865198,8327720,2998,1049300,9377020,12.60
9865199,9970464,5635,1972250,11942714,19.78
9865200,9966884,1924,673400,10640284,6.76
9865201,9957498,2429,850150,10807648,8.54
9865202,4687576,2675,936250,5623826,19.97
9865203,9945936,3424,1198400,11144336,12.05
9865204,9933547,2961,1036350,10969897,10.43
9865205,9962208,4648,1626800,11589008,16.33
9865206,9967049,5058,1770300,11737349,17.76
9865207,9972340,2708,947800,10920140,9.50
9865208,9956432,4708,1647800,11604232,16.55
9865209,9942865,3248,1136800,11079665,11.43
9865211,9981611,1486,520100,10501711,5.21
9865212,9986816,1563,547050,10533866,5.48
9865214,3357232,2252,788200,4145432,23.48
9865215,9885074,2905,1016750,10901824,10.29
9865216,9965579,4161,1456350,11421929,14.61
9865217,9967247,5097,1783950,11751197,17.90
9865218,1109410,363,127050,1236460,11.45
9865219,9951763,6104,2136400,12088163,21.47
9865220,3596490,733,256550,3853040,7.13
9865221,4806044,1373,480550,5286594,10.00
9865222,3897002,2489,871150,4768152,22.35
9865223,9956515,1159,405650,10362165,4.07
9865224,9960130,4154,1453900,11414030,14.60
9865225,9955085,5198,1819300,11774385,18.28
9865226,9957598,3353,1173550,11131148,11.79
9865228,9961942,4151,1452850,11414792,14.58
9865229,9978089,2650,927500,10905589,9.30
9865230,9989150,2956,1034600,11023750,10.36
9865231,8647542,6107,2137450,10784992,24.72
9865232,9976116,2682,938700,10914816,9.41
9865233,9992907,3381,1183350,11176257,11.84
9865234,9991640,4315,1510250,11501890,15.12
9865235,6330590,602,210700,6541290,3.33
9865236,9994455,3913,1369550,11364005,13.70
9865237,9981306,4989,1746150,11727456,17.49
9865238,8393684,1913,669550,9063234,7.98
9865239,9989150,3116,1090600,11079750,10.92
9865240,542703,193,67550,610253,12.45
9865241,9032871,4072,1425200,10458071,15.78
9865242,9930426,2888,1010800,10941226,10.18
9865243,8708790,3954,1383900,10092690,15.89
9865244,9965405,2539,888650,10854055,8.92
9865245,9951329,2274,795900,10747229,8.00
9865247,9968312,5228,1829800,11798112,18.36
9865248,9689702,2480,868000,10557702,8.96
9865249,9987551,5319,1861650,11849201,18.64
9865250,9973627,3866,1353100,11326727,13.57
9865251,1162638,356,124600,1287238,10.72
9865252,9971825,3740,1309000,11280825,13.13
9865253,9980919,3109,1088150,11069069,10.90
9865254,9980648,3623,1268050,11248698,12.71
9865255,9975705,1381,483350,10459055,4.85
9865256,1870467,830,290500,2160967,15.53
9865257,2300315,623,218050,2518365,9.48
9865258,9966020,5161,1806350,11772370,18.13
9865259,7154718,1733,606550,7761268,8.48
9865260,9978256,3949,1382150,11360406,13.85
9865261,9956741,1486,520100,10476841,5.22
9865262,9962128,4157,1454950,11417078,14.60
9865263,9615123,2442,854700,10469823,8.89
9865264,9974293,3840,1344000,11318293,13.47
9865265,9975180,5043,1765050,11740230,17.69
9865266,9990715,3895,1363250,11353965,13.65
9865267,9987566,2668,933800,10921366,9.35
9865268,9982875,2908,1017800,11000675,10.20
9865269,9986642,3962,1386700,11373342,13.89
9865271,9978851,5296,1853600,11832451,18.58
9865272,9979706,3456,1209600,11189306,12.12
9865273,9982738,3063,1072050,11054788,10.74
9865274,9974768,4758,1665300,11640068,16.70
9865275,9479062,2058,720300,10199362,7.60
9865276,9481623,1399,489650,9971273,5.16
9865278,9979431,4434,1551900,11531331,15.55
9865279,9968966,4202,1470700,11439666,14.75
9865280,9978765,1687,590450,10569215,5.92
9865281,9998745,3711,1298850,11297595,12.99
9865282,9980748,3523,1233050,11213798,12.35
9865283,4123515,880,308000,4431515,7.47
9865284,9980373,2541,889350,10869723,8.91
9865285,8962211,3402,1190700,10152911,13.29
9865286,9979998,4550,1592500,11572498,15.96
9865287,9980537,973,340550,10321087,3.41
9865288,5940799,410,143500,6084299,2.42
9865289,9986783,3229,1130150,11116933,11.32
9865290,9992884,4901,1715350,11708234,17.17
9865291,9828815,2828,989800,10818615,10.07
9865292,8989513,4206,1472100,10461613,16.38
9865293,9965605,3694,1292900,11258505,12.97
9865294,9975658,3171,1109850,11085508,11.13
9865295,9971498,4671,1634850,11606348,16.40
9865296,9995490,2021,707350,10702840,7.08
9865297,9979657,4667,1633450,11613107,16.37
9865299,9982809,6164,2157400,12140209,21.61
9865300,9972342,4649,1627150,11599492,16.32
9865301,9977129,1855,649250,10626379,6.51
9865302,9957949,3270,1144500,11102449,11.49
9865303,9182644,2282,798700,9981344,8.70
9865304,9979043,5243,1835050,11814093,18.39
9865305,9992881,3687,1290450,11283331,12.91
9865306,9985045,1413,494550,10479595,4.95
9865308,1685471,570,199500,1884971,11.84
9865309,9969351,698,244300,10213651,2.45
9865310,9960536,1780,623000,10583536,6.25
9865311,9948301,1965,687750,10636051,6.91
9865312,9946181,4929,1725150,11671331,17.34
9865313,9940277,5219,1826650,11766927,18.38
9865314,6701998,3700,1295000,7996998,19.32
9865315,9935317,4497,1573950,11509267,15.84
9865316,9953799,1973,690550,10644349,6.94
9865317,143630,95,33250,176880,23.15
9865318,5336712,1671,584850,5921562,10.96
9865319,9926378,4737,1657950,11584328,16.70
9865320,9943389,2658,930300,10873689,9.36
9865321,9953365,2845,995750,10949115,10.00
9865322,9944877,1668,583800,10528677,5.87
9865323,9945723,3333,1166550,11112273,11.73
9865324,9962400,3770,1319500,11281900,13.24
9865325,9967252,1445,505750,10473002,5.07
9865326,9964199,4538,1588300,11552499,15.94
9865328,9956994,3331,1165850,11122844,11.71
9865329,9964124,2197,768950,10733074,7.72
9865330,9949687,4594,1607900,11557587,16.16
9865331,9960024,2968,1038800,10998824,10.43
9865332,9933427,3013,1054550,10987977,10.62
9865333,9928562,1337,467950,10396512,4.71
9865334,9937413,1335,467250,10404663,4.70
9865335,9941524,4414,1544900,11486424,15.54
9865336,1524795,1172,410200,1934995,26.90
9865337,9950305,1878,657300,10607605,6.61
9865338,1360536,1069,374150,1734686,27.50
9865340,9933650,2862,1001700,10935350,10.08
9865341,483364,212,74200,557564,15.35
9865342,9921746,4334,1516900,11438646,15.29
9865343,9917543,3256,1139600,11057143,11.49
9865344,9668590,3896,1363600,11032190,14.10
9865345,9898459,2354,823900,10722359,8.32
9865346,9904099,2694,942900,10846999,9.52
9865347,9921588,5052,1768200,11689788,17.82
9865348,9598293,5685,1989750,11588043,20.73
9865349,9935822,5128,1794800,11730622,18.06
9865350,9932858,4345,1520750,11453608,15.31
9865351,9935010,3399,1189650,11124660,11.97
9865352,9948938,1931,675850,10624788,6.79
9865353,9943912,4253,1488550,11432462,14.97
9865354,9947570,3453,1208550,11156120,12.15
9865355,2231040,630,220500,2451540,9.88
9865356,9945737,4450,1557500,11503237,15.66
9865357,7740525,3423,1198050,8938575,15.48
9865358,9941748,5715,2000250,11941998,20.12
9865359,9904362,2002,700700,10605062,7.07
9865360,3873746,707,247450,4121196,6.39
9865361,9926678,5903,2066050,11992728,20.81
9865362,9948345,4086,1430100,11378445,14.38
9865364,9918202,2607,912450,10830652,9.20
9865365,7748598,5148,1801800,9550398,23.25
9865366,9888987,3037,1062950,10951937,10.75
9865367,9927301,4429,1550150,11477451,15.62
9865368,9923365,5630,1970500,11893865,19.86
9865369,3902254,1514,529900,4432154,13.58
9865370,2332224,772,270200,2602424,11.59
9865371,9943258,6917,2420950,12364208,24.35
9865372,9949159,4540,1589000,11538159,15.97
9865373,9938948,671,234850,10173798,2.36
9865374,9944867,3394,1187900,11132767,11.94
9865375,2936038,1241,434350,3370388,14.79
9865376,9965311,5374,1880900,11846211,18.87
9865377,9983652,5207,1822450,11806102,18.25
9865378,9973642,3804,1331400,11305042,13.35
9865379,9993561,5988,2095800,12089361,20.97
9865380,9985080,4101,1435350,11420430,14.37
9865381,9967509,2601,910350,10877859,9.13
9865382,9966134,3402,1190700,11156834,11.95
9865383,9985333,1621,567350,10552683,5.68
9865384,9975512,3863,1352050,11327562,13.55
9865385,9986461,2297,803950,10790411,8.05
9865386,9983451,2058,720300,10703751,7.21
9865387,9991475,2958,1035300,11026775,10.36
9865388,9985610,5232,1831200,11816810,18.34
9865389,8299972,2044,715400,9015372,8.62
9865390,9996790,4887,1710450,11707240,17.11
9865391,9973952,2826,989100,10963052,9.92
9865392,1926855,1083,379050,2305905,19.67
9865393,9966095,4453,1558550,11524645,15.64
9865394,9958549,3355,1174250,11132799,11.79
9865395,9966666,3923,1373050,11339716,13.78
9865396,9968638,3416,1195600,11164238,11.99
9865397,9981268,4069,1424150,11405418,14.27
9865398,4733022,1278,447300,5180322,9.45
9865399,9977713,2086,730100,10707813,7.32
9865400,8988465,4185,1464750,10453215,16.30
9865401,9980415,3903,1366050,11346465,13.69
9865402,9996093,807,282450,10278543,2.83
9865403,1295554,574,200900,1496454,15.51
9865404,9977095,2862,1001700,10978795,10.04
9865405,647883,494,172900,820783,26.69
9865406,9943320,2813,984550,10927870,9.90
9865407,2744219,1757,614950,3359169,22.41
9865408,9931008,3914,1369900,11300908,13.79
9865409,9919719,3056,1069600,10989319,10.78
9865410,9926336,2299,804650,10730986,8.11
9865412,9921219,2670,934500,10855719,9.42
9865413,29885,24,8400,38285,28.11
9865414,9908711,3805,1331750,11240461,13.44
9865415,9908863,2841,994350,10903213,10.03
9865416,1275863,348,121800,1397663,9.55
9865417,7748169,1728,604800,8352969,7.81
9865418,957511,325,113750,1071261,11.88
9865419,9914989,3450,1207500,11122489,12.18
9865420,9937278,2881,1008350,10945628,10.15
9865421,9926668,2693,942550,10869218,9.50
9865422,9928431,3182,1113700,11042131,11.22
9865423,9938651,950,332500,10271151,3.35
9865424,2020550,487,170450,2191000,8.44
9865425,9816120,2415,845250,10661370,8.61
9865426,9931177,3201,1120350,11051527,11.28
9865427,9921699,2333,816550,10738249,8.23
9865428,9936140,3740,1309000,11245140,13.17
9865429,9931245,4282,1498700,11429945,15.09
9865430,9956142,2912,1019200,10975342,10.24
9865431,9942431,3268,1143800,11086231,11.50
9865433,9956543,3905,1366750,11323293,13.73
9865434,9951717,1375,481250,10432967,4.84
9865435,9962598,1900,665000,10627598,6.67
9865436,9966274,2891,1011850,10978124,10.15
9865437,9927933,5641,1974350,11902283,19.89
9865438,9948968,3886,1360100,11309068,13.67
9865439,9959930,3905,1366750,11326680,13.72
9865440,9971193,1690,591500,10562693,5.93
9865441,9961369,1665,582750,10544119,5.85
9865442,9964888,2273,795550,10760438,7.98
9865443,8050237,2780,973000,9023237,12.09
9865444,9989971,4395,1538250,11528221,15.40
9865445,9996766,2675,936250,10933016,9.37
9865446,9977837,3183,1114050,11091887,11.17
9865447,9984988,1217,425950,10410938,4.27
9865448,3007659,515,180250,3187909,5.99
9865449,9973223,3857,1349950,11323173,13.54
9865450,9974270,4595,1608250,11582520,16.12
9865451,1624693,903,316050,1940743,19.45
9865453,9960027,3430,1200500,11160527,12.05
9865454,1240925,731,255850,1496775,20.62
9865455,9977762,5397,1888950,11866712,18.93
9865456,9961235,2747,961450,10922685,9.65
9865457,9975742,3300,1155000,11130742,11.58
9865458,9971802,2725,953750,10925552,9.56
9865459,9975952,3591,1256850,11232802,12.60
9865460,9967333,3827,1339450,11306783,13.44
9865461,3028993,448,156800,3185793,5.18
9865462,3377489,1270,444500,3821989,13.16
9865463,9961913,5271,1844850,11806763,18.52
9865465,9956762,2085,729750,10686512,7.33
9865466,9968142,4067,1423450,11391592,14.28
9865467,9984976,2351,822850,10807826,8.24
9865468,2193646,441,154350,2347996,7.04
9865469,9974132,5703,1996050,11970182,20.01
9865470,9629289,3814,1334900,10964189,13.86
9865471,2065048,626,219100,2284148,10.61
9865472,9973704,893,312550,10286254,3.13
9865473,9191081,3555,1244250,10435331,13.54
9865474,9991750,3842,1344700,11336450,13.46
9865475,9961166,3921,1372350,11333516,13.78
9865476,9995618,3064,1072400,11068018,10.73
9865477,9982204,5336,1867600,11849804,18.71
9865478,1368877,552,193200,1562077,14.11
9865479,9972932,7056,2469600,12442532,24.76
9865480,9981852,2246,786100,10767952,7.88
9865481,9985877,1366,478100,10463977,4.79
9865482,9971582,3041,1064350,11035932,10.67
9865483,1431322,495,173250,1604572,12.10
9865484,9965935,3244,1135400,11101335,11.39
9865485,9954565,5974,2090900,12045465,21.00
9865486,9960744,2679,937650,10898394,9.41
9865487,9969555,1713,599550,10569105,6.01
9865488,9974420,3051,1067850,11042270,10.71
9865489,9969327,2096,733600,10702927,7.36
9865490,9978558,4825,1688750,11667308,16.92
9865491,9972156,2132,746200,10718356,7.48
9865492,9993444,3443,1205050,11198494,12.06
9865493,9991991,2104,736400,10728391,7.37
9865494,9975460,1660,581000,10556460,5.82
9865495,9978682,970,339500,10318182,3.40
9865496,9999335,2174,760900,10760235,7.61
9865497,6715882,1948,681800,7397682,10.15
9865498,500732,98,34300,535032,6.85
9865499,8350046,2631,920850,9270896,11.03
9865500,9975967,1521,532350,10508317,5.34
9865501,5723328,1791,626850,6350178,10.95
9865502,9972143,2728,954800,10926943,9.57
9865503,9973778,4557,1594950,11568728,15.99
9865504,9969064,2721,952350,10921414,9.55
9865505,9977664,1118,391300,10368964,3.92
9865506,9974277,3726,1304100,11278377,13.07
9865507,5136508,1114,389900,5526408,7.59
9865508,9969597,3921,1372350,11341947,13.77
9865509,9961388,2753,963550,10924938,9.67
9865510,9970065,3164,1107400,11077465,11.11
9865511,9962705,5288,1850800,11813505,18.58
9865512,9977520,2504,876400,10853920,8.78
9865513,9907416,1492,522200,10429616,5.27
9865514,9964954,4456,1559600,11524554,15.65
9865515,9978332,1849,647150,10625482,6.49
9865516,9977832,2841,994350,10972182,9.97
9865517,9909407,5576,1951600,11861007,19.69
9865519,9977854,4834,1691900,11669754,16.96
9865520,9989528,5038,1763300,11752828,17.65
9865521,9996581,2368,828800,10825381,8.29
9865522,1954054,423,148050,2102104,7.58
9865523,9995670,3588,1255800,11251470,12.56
9865524,545323,44,15400,560723,2.82
9865525,9985365,2337,817950,10803315,8.19
9865526,9987302,2106,737100,10724402,7.38
9865527,9972012,321,112350,10084362,1.13
9865528,9981215,3383,1184050,11165265,11.86
9865529,9995457,3803,1331050,11326507,13.32
9865530,1371784,357,124950,1496734,9.11
9865531,4584975,855,299250,4884225,6.53
9865532,9958720,3976,1391600,11350320,13.97
9865533,9975944,3748,1311800,11287744,13.15
9865534,9985403,2426,849100,10834503,8.50
9865535,9987262,898,314300,10301562,3.15
9865536,1434220,396,138600,1572820,9.66
9865537,9976433,4254,1488900,11465333,14.92
9865540,9956048,2549,892150,10848198,8.96
9865541,9967030,4052,1418200,11385230,14.23
9865542,9972621,3027,1059450,11032071,10.62
9865543,9981466,2240,784000,10765466,7.85
9865545,9971059,3410,1193500,11164559,11.97
9865546,9966537,4066,1423100,11389637,14.28
9865547,9207931,3064,1072400,10280331,11.65
9865548,547557,250,87500,635057,15.98
9865549,9999074,2133,746550,10745624,7.47
9865550,9622348,1157,404950,10027298,4.21
9865551,9991133,2228,779800,10770933,7.80
9865552,9983918,1605,561750,10545668,5.63
9865553,9990763,3726,1304100,11294863,13.05
9865554,9987729,5119,1791650,11779379,17.94
9865557,9753818,1309,458150,10211968,4.70
9865558,9978790,1447,506450,10485240,5.08
9865559,9974895,3232,1131200,11106095,11.34
9865560,1469481,687,240450,1709931,16.36
9865561,9967984,3343,1170050,11138034,11.74
9865562,9988983,772,270200,10259183,2.70
9865563,9975025,2419,846650,10821675,8.49
9865564,9993812,876,306600,10300412,3.07
9865565,9970697,3187,1115450,11086147,11.19
9865566,9998979,2791,976850,10975829,9.77
9865567,7282588,2691,941850,8224438,12.93
9865568,9978600,1285,449750,10428350,4.51
9865569,9715469,2393,837550,10553019,8.62
9865570,3689022,1205,421750,4110772,11.43
9865571,297433,119,41650,339083,14.00
9865572,9996553,4336,1517600,11514153,15.18
9865573,9971212,3692,1292200,11263412,12.96
9865574,9886434,3912,1369200,11255634,13.85
9865575,9982464,1542,539700,10522164,5.41
9865576,681706,763,267050,948756,39.17
9865577,9979296,4039,1413650,11392946,14.17
9865578,9974601,4931,1725850,11700451,17.30
9865579,240007,149,52150,292157,21.73
9865580,9975944,5646,1976100,11952044,19.81
9865581,8988374,4586,1605100,10593474,17.86
9865582,9970826,3259,1140650,11111476,11.44
9865583,9977686,3210,1123500,11101186,11.26
9865584,9996114,3564,1247400,11243514,12.48
9865585,9973120,2781,973350,10946470,9.76
9865586,7362499,2216,775600,8138099,10.53
9865587,9957296,1773,620550,10577846,6.23
9865588,9887672,4127,1444450,11332122,14.61
9865589,9871913,5172,1810200,11682113,18.34
9865590,9975777,1407,492450,10468227,4.94
9865591,9990897,1555,544250,10535147,5.45
9865592,9971046,4852,1698200,11669246,17.03
9865593,9973435,3272,1145200,11118635,11.48
9865594,9946620,937,327950,10274570,3.30
9865595,9978792,3359,1175650,11154442,11.78
9865596,9970371,886,310100,10280471,3.11
9865597,9980743,1915,670250,10650993,6.72
9865598,9986602,5695,1993250,11979852,19.96
9865599,3038589,355,124250,3162839,4.09
9865600,5574151,2666,933100,6507251,16.74
9865601,2565676,1794,627900,3193576,24.47
9865602,2386998,558,195300,2582298,8.18
9865603,9967192,4392,1537200,11504392,15.42
9865604,9995690,4926,1724100,11719790,17.25
9865605,9973270,2770,969500,10942770,9.72
9865607,9998575,1075,376250,10374825,3.76
9865608,9984118,1552,543200,10527318,5.44
9865609,9976600,6362,2226700,12203300,22.32
9865610,9983189,4469,1564150,11547339,15.67
9865611,9979366,5290,1851500,11830866,18.55
9865612,9994234,4286,1500100,11494334,15.01
9865613,9984059,2987,1045450,11029509,10.47
9865614,9978983,1339,468650,10447633,4.70
9865615,9995666,6011,2103850,12099516,21.05
9865616,987898,407,142450,1130348,14.42
9865617,9201435,3529,1235150,10436585,13.42
9865618,9981042,4284,1499400,11480442,15.02
9865619,9985413,4520,1582000,11567413,15.84
9865620,9493085,3602,1260700,10753785,13.28
9865621,2699534,1027,359450,3058984,13.32
9865622,9970992,4156,1454600,11425592,14.59
9865623,9976643,4950,1732500,11709143,17.37
9865624,9980422,3396,1188600,11169022,11.91
9865625,9994260,5374,1880900,11875160,18.82
9865626,9972551,1186,415100,10387651,4.16
9865627,9979175,1255,439250,10418425,4.40
9865628,9984443,6198,2169300,12153743,21.73
9865629,9987202,4817,1685950,11673152,16.88
9865630,9984064,3415,1195250,11179314,11.97
9865631,9984037,2070,724500,10708537,7.26
9865632,9976536,1982,693700,10670236,6.95
9865633,7013347,3876,1356600,8369947,19.34
9865634,9949843,2833,991550,10941393,9.97
9865635,9956475,1116,390600,10347075,3.92
9865636,3794364,2458,860300,4654664,22.67
9865637,9941420,4237,1482950,11424370,14.92
9865638,8734637,937,327950,9062587,3.75
9865639,9933356,2034,711900,10645256,7.17
9865640,187976,64,22400,210376,11.92
9865641,1479210,1130,395500,1874710,26.74
9865642,9963538,1747,611450,10574988,6.14
9865643,9977150,1733,606550,10583700,6.08
9865644,9984776,879,307650,10292426,3.08
9865645,1801806,789,276150,2077956,15.33
9865646,8964015,3502,1225700,10189715,13.67
9865647,9894322,5982,2093700,11988022,21.16
9865648,9982028,1882,658700,10640728,6.60
9865649,9968932,2373,830550,10799482,8.33
9865650,9982949,2449,857150,10840099,8.59
9865651,9981516,1998,699300,10680816,7.01
9865652,326125,151,52850,378975,16.21
9865653,9970644,4936,1727600,11698244,17.33
9865655,9938230,6141,2149350,12087580,21.63
9865656,1409368,435,152250,1561618,10.80
9865657,77209,42,14700,91909,19.04
9865658,9938128,5459,1910650,11848778,19.23
9865659,9930004,3765,1317750,11247754,13.27
9865660,192520,47,16450,208970,8.54
9865661,9926121,953,333550,10259671,3.36
9865662,9932880,1014,354900,10287780,3.57
9865663,9931518,955,334250,10265768,3.37
9865664,9924942,3877,1356950,11281892,13.67
9865665,9934001,1519,531650,10465651,5.35
9865666,1780441,1079,377650,2158091,21.21
9865667,9929393,4831,1690850,11620243,17.03
9865668,9943948,4264,1492400,11436348,15.01
9865669,213364,140,49000,262364,22.97
9865670,9912306,3746,1311100,11223406,13.23
9865671,8733447,778,272300,9005747,3.12
9865672,726285,191,66850,793135,9.20
9865673,3564291,1366,478100,4042391,13.41
9865674,9921002,3559,1245650,11166652,12.56
9865675,371710,159,55650,427360,14.97
9865676,2662281,1152,403200,3065481,15.14
9865677,9839415,5850,2047500,11886915,20.81
9865678,9919636,4276,1496600,11416236,15.09
9865679,9912635,1802,630700,10543335,6.36
9865680,9922279,5477,1916950,11839229,19.32
9865681,9898728,7714,2699900,12598628,27.28
9865682,9924012,2543,890050,10814062,8.97
9865683,9914916,1069,374150,10289066,3.77
9865684,9628809,4114,1439900,11068709,14.95
9865685,435082,670,234500,669582,53.90
9865686,9925012,1730,605500,10530512,6.10
9865687,9885332,1878,657300,10542632,6.65
9865688,9926869,3175,1111250,11038119,11.19
9865689,9929157,2481,868350,10797507,8.75
9865690,9934096,5408,1892800,11826896,19.05
9865691,9954649,2353,823550,10778199,8.27
9865692,9961678,4778,1672300,11633978,16.79
9865693,9946093,1325,463750,10409843,4.66
9865694,9937337,5239,1833650,11770987,18.45
9865695,9961323,3774,1320900,11282223,13.26
9865696,9965287,2125,743750,10709037,7.46
9865697,9969396,4193,1467550,11436946,14.72
9865698,9967958,1140,399000,10366958,4.00
9865699,9980357,3879,1357650,11338007,13.60
9865700,9988121,5124,1793400,11781521,17.96
9865701,9981583,2344,820400,10801983,8.22
9865702,9977837,3445,1205750,11183587,12.08
9865703,9983833,3847,1346450,11330283,13.49
9865704,9965355,6480,2268000,12233355,22.76
9865705,351481,247,86450,437931,24.60
9865706,9930689,3825,1338750,11269439,13.48
9865707,6026588,2996,1048600,7075188,17.40
9865708,9923162,1556,544600,10467762,5.49
9865709,9921307,4757,1664950,11586257,16.78
9865710,9929142,1258,440300,10369442,4.43
9865711,9932822,1791,626850,10559672,6.31
9865712,9931258,4318,1511300,11442558,15.22
9865713,9949446,2591,906850,10856296,9.11
9865714,9855128,3187,1115450,10970578,11.32
9865715,1100435,380,133000,1233435,12.09
9865716,9936947,4968,1738800,11675747,17.50
9865717,9942673,2698,944300,10886973,9.50
9865718,9950627,7024,2458400,12409027,24.71
9865719,9958330,2860,1001000,10959330,10.05
9865720,2343799,807,282450,2626249,12.05
9865721,9908137,5710,1998500,11906637,20.17
9865722,603433,313,109550,712983,18.15
9865723,3813118,1889,661150,4474268,17.34
9865724,9978180,6592,2307200,12285380,23.12
9865725,9971717,5638,1973300,11945017,19.79
9865726,2148992,495,173250,2322242,8.06
9865727,9989458,5302,1855700,11845158,18.58
9865728,9992116,4585,1604750,11596866,16.06
9865729,9982987,6310,2208500,12191487,22.12
9865730,9989340,5701,1995350,11984690,19.97
9865731,9969563,2193,767550,10737113,7.70
9865732,9969857,1169,409150,10379007,4.10
9865733,9961755,3239,1133650,11095405,11.38
9865734,9985785,4665,1632750,11618535,16.35
9865735,9972940,1779,622650,10595590,6.24
9865736,114865,36,12600,127465,10.97
9865737,9968076,2083,729050,10697126,7.31
9865738,2752868,1202,420700,3173568,15.28
9865739,3779350,1695,593250,4372600,15.70
9865740,9973629,7271,2544850,12518479,25.52
9865741,9977260,3714,1299900,11277160,13.03
9865742,9979055,1620,567000,10546055,5.68
9865744,9997404,1917,670950,10668354,6.71
9865745,9989032,2519,881650,10870682,8.83
9865747,9971381,1533,536550,10507931,5.38
9865748,9882892,5610,1963500,11846392,19.87
9865749,1022091,603,211050,1233141,20.65
9865750,9973995,4906,1717100,11691095,17.22
9865751,9982779,4433,1551550,11534329,15.54
9865752,9999841,5118,1791300,11791141,17.91
9865753,9989924,1194,417900,10407824,4.18
9865754,9982096,1482,518700,10500796,5.20
9865755,9998245,2356,824600,10822845,8.25
9865756,9975649,6020,2107000,12082649,21.12
9865757,3623352,1529,535150,4158502,14.77
9865758,9989032,3414,1194900,11183932,11.96
9865759,9999767,4686,1640100,11639867,16.40
9865760,9976477,4934,1726900,11703377,17.31
9865761,9970336,4617,1615950,11586286,16.21
9865762,9979603,3123,1093050,11072653,10.95
9865763,9998467,3499,1224650,11223117,12.25
9865764,9979135,2063,722050,10701185,7.24
9865765,1529583,866,303100,1832683,19.82
9865766,9978171,3390,1186500,11164671,11.89
9865767,9955374,5813,2034550,11989924,20.44
9865768,9948635,3379,1182650,11131285,11.89
9865769,2287475,1102,385700,2673175,16.86
9865770,4443866,2841,994350,5438216,22.38
9865771,9933439,3044,1065400,10998839,10.73
9865772,9405904,7004,2451400,11857304,26.06
9865773,2138159,1736,607600,2745759,28.42
9865774,5059345,2789,976150,6035495,19.29
9865775,9924490,2361,826350,10750840,8.33
9865776,9936176,5754,2013900,11950076,20.27
9865777,9923490,1138,398300,10321790,4.01
9865778,1224897,66,23100,1247997,1.89
9865779,9910471,4626,1619100,11529571,16.34
9865780,3992430,3286,1150100,5142530,28.81
9865781,9901439,1060,371000,10272439,3.75
9865782,9911078,1613,564550,10475628,5.70
9865783,9913418,3312,1159200,11072618,11.69
9865784,284198,221,77350,361548,27.22
9865785,9643080,2898,1014300,10657380,10.52
9865786,9906584,6098,2134300,12040884,21.54
9865787,9897094,1000,350000,10247094,3.54
9865788,9904059,3164,1107400,11011459,11.18
9865789,9916592,2894,1012900,10929492,10.21
9865790,1354298,534,186900,1541198,13.80
9865791,9875700,5186,1815100,11690800,18.38
9865792,9891998,795,278250,10170248,2.81
9865793,9913955,3465,1212750,11126705,12.23
9865794,846026,330,115500,961526,13.65
9865795,9913214,4562,1596700,11509914,16.11
9865796,9920463,1098,384300,10304763,3.87
9865797,9925981,4154,1453900,11379881,14.65
9865798,662403,535,187250,849653,28.27
9865799,9914766,1648,576800,10491566,5.82
9865800,9919416,1382,483700,10403116,4.88
9865801,9921363,865,302750,10224113,3.05
9865802,9923644,1265,442750,10366394,4.46
9865803,9931628,4061,1421350,11352978,14.31
9865804,9934596,5921,2072350,12006946,20.86
9865805,9944018,4287,1500450,11444468,15.09
9865806,9930545,3568,1248800,11179345,12.58
9865807,9943653,4740,1659000,11602653,16.68
9865808,1416686,942,329700,1746386,23.27
9865809,9910556,5130,1795500,11706056,18.12
9865810,9932132,1797,628950,10561082,6.33
9865811,9944076,3935,1377250,11321326,13.85
9865813,9932215,1982,693700,10625915,6.98
9865814,1519925,2680,938000,2457925,61.71
9865815,9877972,3820,1337000,11214972,13.54
9865816,9891035,3384,1184400,11075435,11.97
9865817,9900804,1647,576450,10477254,5.82
9865818,9919470,2968,1038800,10958270,10.47
9865819,9921914,5119,1791650,11713564,18.06
9865820,9922626,5660,1981000,11903626,19.96
9865821,9923607,3096,1083600,11007207,10.92
9865822,9918665,2142,749700,10668365,7.56
9865823,9903174,3466,1213100,11116274,12.25
9865824,9906952,3632,1271200,11178152,12.83
9865825,9920109,4706,1647100,11567209,16.60
9865826,1344202,1358,475300,1819502,35.36
9865827,9909949,6427,2249450,12159399,22.70
9865828,9912779,4749,1662150,11574929,16.77
9865829,9912670,2935,1027250,10939920,10.36
9865830,9932698,5967,2088450,12021148,21.03
9865832,9942608,5675,1986250,11928858,19.98
9865833,9944042,2359,825650,10769692,8.30
9865834,865794,483,169050,1034844,19.53
9865835,9936924,3250,1137500,11074424,11.45
9865836,9915478,4248,1486800,11402278,14.99
9865837,9930663,2740,959000,10889663,9.66
9865838,9717149,4895,1713250,11430399,17.63
9865839,9929886,3171,1109850,11039736,11.18
9865840,100972,51,17850,118822,17.68
9865841,767651,574,200900,968551,26.17
9865842,9922602,5655,1979250,11901852,19.95
9865843,9930880,4819,1686650,11617530,16.98
9865844,9924793,6022,2107700,12032493,21.24
9865845,9936258,3392,1187200,11123458,11.95
9865846,3634262,2296,803600,4437862,22.11
9865847,9958385,5097,1783950,11742335,17.91
9865848,9973845,2290,801500,10775345,8.04
9865849,9981588,5149,1802150,11783738,18.05
9865850,863750,570,199500,1063250,23.10
9865851,9974521,3914,1369900,11344421,13.73
9865852,9988751,3432,1201200,11189951,12.03
9865853,9980786,1042,364700,10345486,3.65
9865854,9984484,3467,1213450,11197934,12.15
9865855,9965826,2954,1033900,10999726,10.37
9865856,9981066,4654,1628900,11609966,16.32
9865857,9985438,3077,1076950,11062388,10.79
9865859,9990125,3194,1117900,11108025,11.19
9865860,9899738,3841,1344350,11244088,13.58
9865861,9982873,4231,1480850,11463723,14.83
9865862,9877634,375,131250,10008884,1.33
9865863,91081,26,9100,100181,9.99
9865864,893808,1167,408450,1302258,45.70
9865865,9974042,3234,1131900,11105942,11.35
9865866,9985771,4630,1620500,11606271,16.23
9865867,9978914,2235,782250,10761164,7.84
9865869,1053892,525,183750,1237642,17.44
9865870,9963465,4343,1520050,11483515,15.26
9865871,9974390,1812,634200,10608590,6.36
9865872,1663777,888,310800,1974577,18.68
9865873,9977350,3551,1242850,11220200,12.46
9865874,641415,376,131600,773015,20.52
9865875,9914342,3756,1314600,11228942,13.26
9865876,9969502,2880,1008000,10977502,10.11
9865877,9804211,4408,1542800,11347011,15.74
9865878,9993895,5584,1954400,11948295,19.56
9865879,1904739,1127,394450,2299189,20.71
9865880,9994720,5767,2018450,12013170,20.20
9865881,5283141,2041,714350,5997491,13.52
9865882,9982620,4850,1697500,11680120,17.00
9865883,1547076,434,151900,1698976,9.82
9865884,7457324,5226,1829100,9286424,24.53
9865885,9976016,3660,1281000,11257016,12.84
9865886,1005083,473,165550,1170633,16.47
9865887,9966662,2336,817600,10784262,8.20
9865888,9969198,4300,1505000,11474198,15.10
9865889,3277227,1738,608300,3885527,18.56
9865890,9853832,4668,1633800,11487632,16.58
9865891,1557735,597,208950,1766685,13.41
9865892,9979134,6045,2115750,12094884,21.20
9865893,9992489,4054,1418900,11411389,14.20
9865894,9970704,2712,949200,10919904,9.52
9865895,1159910,861,301350,1461260,25.98
9865896,7316106,3203,1121050,8437156,15.32
9865897,1923234,1052,368200,2291434,19.14
9865898,9945003,2455,859250,10804253,8.64
9865899,9957619,3105,1086750,11044369,10.91
9865900,9974939,2253,788550,10763489,7.91
9865901,9976282,2319,811650,10787932,8.14
9865903,9958082,3167,1108450,11066532,11.13
9865904,9951052,3635,1272250,11223302,12.79
9865905,956501,1704,596400,1552901,62.35
9865906,305103,109,38150,343253,12.50
9865907,9937444,4380,1533000,11470444,15.43
9865908,2216452,724,253400,2469852,11.43
9865909,9936555,4291,1501850,11438405,15.11
9865910,5316271,3955,1384250,6700521,26.04
9865911,9950369,3570,1249500,11199869,12.56
9865912,9943846,1523,533050,10476896,5.36
9865913,99449,61,21350,120799,21.47
9865914,9937948,2982,1043700,10981648,10.50
9865915,9929259,1035,362250,10291509,3.65
9865916,9938100,5192,1817200,11755300,18.29
9865917,9928853,4568,1598800,11527653,16.10
9865918,2716956,284,99400,2816356,3.66
9865919,9918554,5825,2038750,11957304,20.55
9865920,9927582,5409,1893150,11820732,19.07
9865921,9923953,1324,463400,10387353,4.67
9865922,9929658,2360,826000,10755658,8.32
9865923,9926392,4221,1477350,11403742,14.88
9865924,9932883,2688,940800,10873683,9.47
9865925,9934702,589,206150,10140852,2.08
9865926,9939414,1338,468300,10407714,4.71
9865927,9776895,3059,1070650,10847545,10.95
9865928,9950677,4324,1513400,11464077,15.21
9865929,9959518,2146,751100,10710618,7.54
9865930,918628,803,281050,1199678,30.59
9865931,9957415,5918,2071300,12028715,20.80
9865932,9976025,2755,964250,10940275,9.67
9865933,9970686,6368,2228800,12199486,22.35
9865934,9987153,1426,499100,10486253,5.00
9865935,6224116,2535,887250,7111366,14.26
9865936,9965382,4598,1609300,11574682,16.15
9865937,9966886,5698,1994300,11961186,20.01
9865938,9989157,2896,1013600,11002757,10.15
9865940,9975433,979,342650,10318083,3.43
9865941,9985347,5109,1788150,11773497,17.91
9865942,614596,216,75600,690196,12.30
9865943,1507845,569,199150,1706995,13.21
9865944,9997356,4120,1442000,11439356,14.42
9865945,9997969,1150,402500,10400469,4.03
9865946,9996367,1882,658700,10655067,6.59
9865947,9988704,4024,1408400,11397104,14.10
9865948,312957,40,14000,326957,4.47
9865949,9987793,5205,1821750,11809543,18.24
9865950,9982464,6178,2162300,12144764,21.66
9865951,9983117,7854,2748900,12732017,27.54
9865952,9974021,1914,669900,10643921,6.72
9865953,5857252,4485,1569750,7427002,26.80
9865954,9995384,4275,1496250,11491634,14.97
9865955,9974150,4283,1499050,11473200,15.03
9865956,9970314,2854,998900,10969214,10.02
9865958,9999903,5036,1762600,11762503,17.63
9865959,9974410,2158,755300,10729710,7.57
9865960,9982227,5149,1802150,11784377,18.05
9865961,9981035,3560,1246000,11227035,12.48
9865962,9994642,4132,1446200,11440842,14.47
9865963,9989109,3432,1201200,11190309,12.03
9865964,9995181,6724,2353400,12348581,23.55
9865965,9994215,3081,1078350,11072565,10.79
9865966,2880620,1863,652050,3532670,22.64
9865967,2511192,796,278600,2789792,11.09
9865968,9996573,5502,1925700,11922273,19.26
9865969,9983237,3625,1268750,11251987,12.71
9865970,9975612,5154,1803900,11779512,18.08
9865972,9972586,5237,1832950,11805536,18.38
9865973,9977756,5013,1754550,11732306,17.58
9865974,9969943,2909,1018150,10988093,10.21
9865975,9973147,4007,1402450,11375597,14.06
9865976,9986788,5737,2007950,11994738,20.11
9865977,8166307,1650,577500,8743807,7.07
9865978,9971811,4198,1469300,11441111,14.73
9865980,9968622,2766,968100,10936722,9.71
9865981,9945191,2854,998900,10944091,10.04
9865982,527245,119,41650,568895,7.90
9865983,9952511,2158,755300,10707811,7.59
9865984,9906161,4394,1537900,11444061,15.52
9865985,9980642,2727,954450,10935092,9.56
9865986,9977510,3985,1394750,11372260,13.98
9865987,9980492,3015,1055250,11035742,10.57
9865988,9997239,3621,1267350,11264589,12.68
9865989,9979590,3699,1294650,11274240,12.97
9865990,7613163,1091,381850,7995013,5.02
9865991,8668926,3068,1073800,9742726,12.39
9865992,9992235,2777,971950,10964185,9.73
9865993,82418,42,14700,97118,17.84
9865994,9956244,2607,912450,10868694,9.16
9865995,9988209,4369,1529150,11517359,15.31
9865996,9975445,4893,1712550,11687995,17.17
9865997,9970903,4264,1492400,11463303,14.97
9865998,9977335,1320,462000,10439335,4.63
9865999,9989241,2365,827750,10816991,8.29
9866000,9985905,1274,445900,10431805,4.47
9866001,9991984,3466,1213100,11205084,12.14
9866002,458313,302,105700,564013,23.06
9866003,9976256,5571,1949850,11926106,19.54
9866004,4207915,948,331800,4539715,7.89
9866005,2570312,2279,797650,3367962,31.03
9866006,9956714,5260,1841000,11797714,18.49
9866007,9958805,2453,858550,10817355,8.62
9866009,9979845,2780,973000,10952845,9.75
9866010,9983951,4048,1416800,11400751,14.19
9866011,8389068,4079,1427650,9816718,17.02
9866012,9964297,4867,1703450,11667747,17.10
9866013,1321222,410,143500,1464722,10.86
9866014,9984334,2368,828800,10813134,8.30
9866015,9973492,973,340550,10314042,3.41
9866016,9575402,1680,588000,10163402,6.14
9866017,9981057,3569,1249150,11230207,12.52
9866018,9982664,2737,957950,10940614,9.60
9866019,9978465,6108,2137800,12116265,21.42
9866020,9988283,3397,1188950,11177233,11.90
9866021,9981283,3590,1256500,11237783,12.59
9866022,1795312,970,339500,2134812,18.91
9866023,553676,437,152950,706626,27.62
9866024,9980478,4464,1562400,11542878,15.65
9866025,9948730,4392,1537200,11485930,15.45
9866026,7868605,5558,1945300,9813905,24.72
9866027,9972856,5667,1983450,11956306,19.89
9866028,9962105,1646,576100,10538205,5.78
9866029,9939350,6684,2339400,12278750,23.54
9866030,9970574,3936,1377600,11348174,13.82
9866031,9898708,3949,1382150,11280858,13.96
9866032,3493061,1993,697550,4190611,19.97
9866033,9973036,4790,1676500,11649536,16.81
9866034,9977978,4717,1650950,11628928,16.55
9866035,9999176,6483,2269050,12268226,22.69
9866036,9979971,2819,986650,10966621,9.89
9866037,9972367,3192,1117200,11089567,11.20
9866038,9972425,6276,2196600,12169025,22.03
9866039,9970552,4349,1522150,11492702,15.27
9866040,9999271,2999,1049650,11048921,10.50
9866041,9990175,3761,1316350,11306525,13.18
9866042,9971385,6166,2158100,12129485,21.64
9866043,72273,19,6650,78923,9.20
9866044,9988765,5345,1870750,11859515,18.73
9866045,9982268,2613,914550,10896818,9.16
9866046,9983769,2904,1016400,11000169,10.18
9866047,1124772,742,259700,1384472,23.09
9866048,9949096,4622,1617700,11566796,16.26
9866050,9946777,2024,708400,10655177,7.12
9866051,9958896,3326,1164100,11122996,11.69
9866052,9962026,4130,1445500,11407526,14.51
9866053,9972524,1199,419650,10392174,4.21
9866054,9979235,3412,1194200,11173435,11.97
9866055,9990584,4590,1606500,11597084,16.08
9866056,9984862,1756,614600,10599462,6.16
9866057,968091,619,216650,1184741,22.38
9866058,8914070,3734,1306900,10220970,14.66
9866059,9992433,5700,1995000,11987433,19.97
9866060,217592,245,85750,303342,39.41
9866061,9981538,4310,1508500,11490038,15.11
9866062,9967292,2016,705600,10672892,7.08
9866063,9988384,2433,851550,10839934,8.53
9866064,9974046,1608,562800,10536846,5.64
9866065,9979841,1684,589400,10569241,5.91
9866066,302517,130,45500,348017,15.04
9866067,9971830,1227,429450,10401280,4.31
9866068,1512759,597,208950,1721709,13.81
9866070,988057,1084,379400,1367457,38.40
9866071,9972006,3356,1174600,11146606,11.78
9866072,9967559,1464,512400,10479959,5.14
9866073,5546067,2910,1018500,6564567,18.36
9866074,9968233,4480,1568000,11536233,15.73
9866075,9989759,2957,1034950,11024709,10.36
9866077,9972758,2123,743050,10715808,7.45
9866078,9984732,6011,2103850,12088582,21.07
9866079,9996964,1483,519050,10516014,5.19
9866080,9987294,4372,1530200,11517494,15.32
9866081,9979584,2068,723800,10703384,7.25
9866083,9995000,3312,1159200,11154200,11.60
9866084,1851273,19,6650,1857923,0.36
9866085,9434646,4248,1486800,10921446,15.76
9866086,9967549,6164,2157400,12124949,21.64
9866087,9972841,3024,1058400,11031241,10.61
9866088,9988033,3627,1269450,11257483,12.71
9866089,9775366,1798,629300,10404666,6.44
9866090,5777979,2614,914900,6692879,15.83
9866091,9984484,2397,838950,10823434,8.40
9866092,191470,61,21350,212820,11.15
9866093,9979501,1922,672700,10652201,6.74
9866094,9992184,2958,1035300,11027484,10.36
9866095,9989033,4643,1625050,11614083,16.27
9866096,9969220,4739,1658650,11627870,16.64
9866097,9988249,2744,960400,10948649,9.62
9866098,195258,75,26250,221508,13.44
9866099,9976766,4428,1549800,11526566,15.53
9866100,631570,303,106050,737620,16.79
9866101,1201677,497,173950,1375627,14.48
9866102,9968856,5757,2014950,11983806,20.21
9866103,4412138,989,346150,4758288,7.85
9866104,63278,62,21700,84978,34.29
9866105,9968376,1653,578550,10546926,5.80
9866106,9981227,4798,1679300,11660527,16.82
9866107,4870437,4076,1426600,6297037,29.29
9866108,9980653,4596,1608600,11589253,16.12
9866109,9996293,4719,1651650,11647943,16.52
9866110,9993165,4408,1542800,11535965,15.44
9866111,9997789,1978,692300,10690089,6.92
9866112,9980911,2467,863450,10844361,8.65
9866113,9972007,2351,822850,10794857,8.25
9866114,9969145,2881,1008350,10977495,10.11
9866115,9988373,3337,1167950,11156323,11.69
9866116,9970192,2105,736750,10706942,7.39
9866117,9982549,3340,1169000,11151549,11.71
9866118,9979763,3693,1292550,11272313,12.95
9866119,3753536,2047,716450,4469986,19.09
9866120,9979025,4865,1702750,11681775,17.06
9866121,9975518,5073,1775550,11751068,17.80
9866122,9998330,2635,922250,10920580,9.22
9866123,9989624,1687,590450,10580074,5.91
9866124,9984727,958,335300,10320027,3.36
9866125,9993717,5425,1898750,11892467,19.00
9866126,9974758,2969,1039150,11013908,10.42
9866127,9989678,3388,1185800,11175478,11.87
9866128,9985811,2431,850850,10836661,8.52
9866129,9979575,3472,1215200,11194775,12.18
9866130,1869448,1001,350350,2219798,18.74
9866131,9991087,1903,666050,10657137,6.67
9866133,9974890,3800,1330000,11304890,13.33
9866134,9997988,4188,1465800,11463788,14.66
9866135,1285761,217,75950,1361711,5.91
9866136,4558621,2276,796600,5355221,17.47
9866137,9994766,3077,1076950,11071716,10.78
9866138,9971363,3891,1361850,11333213,13.66
9866139,9965155,4953,1733550,11698705,17.40
9866140,9977084,3847,1346450,11323534,13.50
9866141,9972233,2767,968450,10940683,9.71
9866142,9975530,3200,1120000,11095530,11.23
9866143,9958116,3915,1370250,11328366,13.76
9866144,9959962,4028,1409800,11369762,14.15
9866145,5580344,3212,1124200,6704544,20.15
9866146,9943008,2558,895300,10838308,9.00
9866147,9237804,5165,1807750,11045554,19.57
9866148,9941515,5023,1758050,11699565,17.68
9866149,9951227,5146,1801100,11752327,18.10
9866150,9941159,3646,1276100,11217259,12.84
9866151,9965900,1651,577850,10543750,5.80
9866152,9954083,1453,508550,10462633,5.11
9866153,9942081,1773,620550,10562631,6.24
9866154,9954838,2293,802550,10757388,8.06
9866155,94307,33,11550,105857,12.25
9866156,1743347,741,259350,2002697,14.88
9866157,9979993,3881,1358350,11338343,13.61
9866158,9954552,3168,1108800,11063352,11.14
9866159,9967418,2104,736400,10703818,7.39
9866160,9982034,2134,746900,10728934,7.48
9866161,9971628,3553,1243550,11215178,12.47
9866162,2410984,1420,497000,2907984,20.61
9866163,9986746,3375,1181250,11167996,11.83
9866164,9986581,3682,1288700,11275281,12.90
9866165,9980697,4876,1706600,11687297,17.10
9866166,9992350,3405,1191750,11184100,11.93
9866167,9989271,3712,1299200,11288471,13.01
9866168,3234507,1699,594650,3829157,18.38
9866169,9998637,7339,2568650,12567287,25.69
9866170,9979600,4864,1702400,11682000,17.06
9866171,9978260,1729,605150,10583410,6.06
9866172,9839132,2282,798700,10637832,8.12
9866173,9948057,2847,996450,10944507,10.02
9866174,1919950,1251,437850,2357800,22.81
9866175,6141789,3265,1142750,7284539,18.61
9866176,9956107,5090,1781500,11737607,17.89
9866177,9952297,5102,1785700,11737997,17.94
9866178,678571,90,31500,710071,4.64
9866179,3550548,1527,534450,4084998,15.05
9866180,9966113,4236,1482600,11448713,14.88
9866181,7026988,1468,513800,7540788,7.31
9866182,9993045,1589,556150,10549195,5.57
9866183,9970198,5365,1877750,11847948,18.83
9866184,9979550,2634,921900,10901450,9.24
9866185,9985028,4561,1596350,11581378,15.99
9866186,9983302,3123,1093050,11076352,10.95
9866187,9982321,2378,832300,10814621,8.34
9866188,1438535,1280,448000,1886535,31.14
9866189,9976152,4339,1518650,11494802,15.22
9866190,402967,168,58800,461767,14.59
9866191,9976616,2428,849800,10826416,8.52
9866192,9986158,2832,991200,10977358,9.93
9866193,177352,93,32550,209902,18.35
9866194,9985319,4537,1587950,11573269,15.90
9866195,1210856,658,230300,1441156,19.02
9866196,718739,481,168350,887089,23.42
9866197,2005620,1393,487550,2493170,24.31
9866198,9977925,5816,2035600,12013525,20.40
9866199,9968828,1731,605850,10574678,6.08
9866200,9975712,4975,1741250,11716962,17.45
9866201,275532,138,48300,323832,17.53
9866203,9982313,1632,571200,10553513,5.72
9866204,68209,42,14700,82909,21.55
9866205,9983226,3383,1184050,11167276,11.86
9866206,9988049,3224,1128400,11116449,11.30
9866207,9932777,4227,1479450,11412227,14.89
9866208,9982959,1941,679350,10662309,6.81
9866209,9994642,1086,380100,10374742,3.80
9866210,9996927,4516,1580600,11577527,15.81
9866211,9981963,1598,559300,10541263,5.60
9866212,9993758,1278,447300,10441058,4.48
9866213,9990788,3434,1201900,11192688,12.03
9866214,9975878,1794,627900,10603778,6.29
9866215,9982620,3157,1104950,11087570,11.07
9866216,9997629,4228,1479800,11477429,14.80
9866217,9996912,3426,1199100,11196012,11.99
9866218,9985230,2577,901950,10887180,9.03
9866219,9965921,5583,1954050,11919971,19.61
9866220,5395459,3046,1066100,6461559,19.76
9866221,9974514,3861,1351350,11325864,13.55
9866222,9988832,3273,1145550,11134382,11.47
9866223,9903712,4358,1525300,11429012,15.40
9866224,9979219,4428,1549800,11529019,15.53
9866225,3393468,833,291550,3685018,8.59
9866226,9973658,3588,1255800,11229458,12.59
9866227,2985571,2232,781200,3766771,26.17
9866228,9949932,3545,1240750,11190682,12.47
9866229,451591,598,209300,660891,46.35
9866230,9957427,2469,864150,10821577,8.68
9866231,9957541,3466,1213100,11170641,12.18
9866232,9971513,4953,1733550,11705063,17.39
9866233,9971168,3471,1214850,11186018,12.18
9866234,9972752,1400,490000,10462752,4.91
9866235,9969760,1526,534100,10503860,5.36
9866236,9973741,3629,1270150,11243891,12.73
9866237,9978061,4405,1541750,11519811,15.45
9866238,9991024,1868,653800,10644824,6.54
9866239,9974103,1931,675850,10649953,6.78
9866240,9995010,1941,679350,10674360,6.80
9866241,9966996,2733,956550,10923546,9.60
9866242,9971835,3160,1106000,11077835,11.09
9866243,9983822,3804,1331400,11315222,13.34
9866244,9980511,5455,1909250,11889761,19.13
9866246,9984958,2455,859250,10844208,8.61
9866247,8850651,2664,932400,9783051,10.53
9866248,9982746,3038,1063300,11046046,10.65
9866249,9985584,3441,1204350,11189934,12.06
9866250,3152652,2020,707000,3859652,22.43
9866251,9913412,2229,780150,10693562,7.87
9866252,194371,42,14700,209071,7.56
9866253,9962564,2745,960750,10923314,9.64
9866254,9961172,4493,1572550,11533722,15.79
9866255,9966222,1845,645750,10611972,6.48
9866256,9968853,1704,596400,10565253,5.98
9866257,532405,790,276500,808905,51.93
9866259,9956004,4497,1573950,11529954,15.81
9866260,450034,49,17150,467184,3.81
9866261,9944083,2940,1029000,10973083,10.35
9866262,9956728,1652,578200,10534928,5.81
9866263,9975187,2110,738500,10713687,7.40
9866264,2196285,156,54600,2250885,2.49
9866265,9984521,4630,1620500,11605021,16.23
9866266,9968342,1802,630700,10599042,6.33
9866267,9988192,1382,483700,10471892,4.84
9866268,9988581,2589,906150,10894731,9.07
9866269,9983521,2020,707000,10690521,7.08
9866270,9983900,2830,990500,10974400,9.92
9866271,9988718,1745,610750,10599468,6.11
9866272,9979251,3228,1129800,11109051,11.32
9866273,9986789,973,340550,10327339,3.41
9866274,9974261,1169,409150,10383411,4.10
9866275,9994967,2635,922250,10917217,9.23
9866276,9982921,3381,1183350,11166271,11.85
9866277,9969769,1912,669200,10638969,6.71
9866278,9964545,3037,1062950,11027495,10.67
9866279,9980376,3913,1369550,11349926,13.72
9866280,9992573,1825,638750,10631323,6.39
9866281,9994546,2276,796600,10791146,7.97
9866282,9987766,2423,848050,10835816,8.49
9866283,9976984,1583,554050,10531034,5.55
9866284,2850776,2550,892500,3743276,31.31
9866285,462104,303,106050,568154,22.95
9866286,9982656,3835,1342250,11324906,13.45
9866287,9997495,2890,1011500,11008995,10.12
9866288,9978567,890,311500,10290067,3.12
9866289,9988543,2488,870800,10859343,8.72
9866290,900458,350,122500,1022958,13.60
9866291,9988980,4401,1540350,11529330,15.42
9866292,9992698,6097,2133950,12126648,21.36
9866293,9997312,1942,679700,10677012,6.80
9866295,9979144,2917,1020950,11000094,10.23
9866296,9968231,3018,1056300,11024531,10.60
9866297,2139767,1936,677600,2817367,31.67
9866298,9961080,4339,1518650,11479730,15.25
9866299,4991473,1642,574700,5566173,11.51
9866300,1522564,1092,382200,1904764,25.10
9866301,9980860,4632,1621200,11602060,16.24
9866302,9985322,4272,1495200,11480522,14.97
9866303,2204676,1381,483350,2688026,21.92
9866304,9959812,2597,908950,10868762,9.13
9866305,9987851,2125,743750,10731601,7.45
9866306,9994474,3624,1268400,11262874,12.69
9866307,9993116,3971,1389850,11382966,13.91
9866308,9991999,1017,355950,10347949,3.56
9866309,9975555,3631,1270850,11246405,12.74
9866310,9731443,5295,1853250,11584693,19.04
9866311,9976272,3388,1185800,11162072,11.89
9866312,9978305,2748,961800,10940105,9.64
9866313,9996935,2069,724150,10721085,7.24
9866314,9981583,1651,577850,10559433,5.79
9866315,9950860,6237,2182950,12133810,21.94
9866316,9993915,3153,1103550,11097465,11.04
9866317,9980636,5148,1801800,11782436,18.05
9866318,9893606,3786,1325100,11218706,13.39
9866319,9965777,1580,553000,10518777,5.55
9866320,1659688,642,224700,1884388,13.54
9866321,9981991,5204,1821400,11803391,18.25
9866322,9970200,4113,1439550,11409750,14.44
9866323,1304685,376,131600,1436285,10.09
9866324,9965178,4386,1535100,11500278,15.40
9866325,119721,42,14700,134421,12.28
9866326,9947095,2277,796950,10744045,8.01
9866327,214380,142,49700,264080,23.18
9866328,1801690,2894,1012900,2814590,56.22
9866329,688364,328,114800,803164,16.68
9866330,1309790,599,209650,1519440,16.01
9866331,1053409,1091,381850,1435259,36.25
9866332,9904385,1141,399350,10303735,4.03
9866333,9908572,5732,2006200,11914772,20.25
9866334,9902673,2786,975100,10877773,9.85
9866335,9926967,4992,1747200,11674167,17.60
9866336,9923537,4895,1713250,11636787,17.26
9866337,9920945,4489,1571150,11492095,15.84
9866338,9923581,4249,1487150,11410731,14.99
9866339,9926963,1400,490000,10416963,4.94
9866340,9931549,5944,2080400,12011949,20.95
9866341,9922839,5719,2001650,11924489,20.17
9866342,9919328,3377,1181950,11101278,11.92
9866343,9935081,4420,1547000,11482081,15.57
9866344,5614491,3162,1106700,6721191,19.71
9866345,9938462,6282,2198700,12137162,22.12
9866346,3003167,1992,697200,3700367,23.22
9866347,9964277,3359,1175650,11139927,11.80
9866348,9964785,4317,1510950,11475735,15.16
9866349,9967812,3381,1183350,11151162,11.87
9866350,9968526,955,334250,10302776,3.35
9866351,71000,18,6300,77300,8.87
9866352,9988038,4185,1464750,11452788,14.67
9866353,9984088,1420,497000,10481088,4.98
9866354,9998294,2122,742700,10740994,7.43
9866355,9987771,1593,557550,10545321,5.58
9866356,9983663,3149,1102150,11085813,11.04
9866357,9970364,5109,1788150,11758514,17.93
9866358,9994546,1835,642250,10636796,6.43
9866359,9996602,2952,1033200,11029802,10.34
9866360,9988628,4087,1430450,11419078,14.32
9866361,9961382,4783,1674050,11635432,16.81
9866362,9984617,5109,1788150,11772767,17.91
9866363,9985866,3076,1076600,11062466,10.78
9866364,9984225,2950,1032500,11016725,10.34
9866365,9984142,3605,1261750,11245892,12.64
9866366,9976933,1554,543900,10520833,5.45
9866367,9991605,1573,550550,10542155,5.51
9866368,9980738,4895,1713250,11693988,17.17
9866369,9999693,2055,719250,10718943,7.19
9866370,9999131,2903,1016050,11015181,10.16
9866371,8884334,2244,785400,9669734,8.84
9866372,9993020,4659,1630650,11623670,16.32
9866373,9996429,1478,517300,10513729,5.17
9866374,1789410,2601,910350,2699760,50.87
9866375,9975070,4525,1583750,11558820,15.88
9866376,9988139,4179,1462650,11450789,14.64
9866377,4755201,3966,1388100,6143301,29.19
9866378,9973557,4850,1697500,11671057,17.02
9866379,9984170,1148,401800,10385970,4.02
9866380,9999747,2050,717500,10717247,7.18
9866381,9995522,2406,842100,10837622,8.42
9866382,9971488,2852,998200,10969688,10.01
9866383,9995164,1543,540050,10535214,5.40
9866384,9999974,3161,1106350,11106324,11.06
9866385,2678034,1691,591850,3269884,22.10
9866386,9983753,3876,1356600,11340353,13.59
9866387,9962205,1015,355250,10317455,3.57
9866388,9977759,2546,891100,10868859,8.93
9866389,9971836,661,231350,10203186,2.32
9866390,9981468,1825,638750,10620218,6.40
9866391,9994114,1510,528500,10522614,5.29
9866393,2886457,2310,808500,3694957,28.01
9866394,9989262,5462,1911700,11900962,19.14
9866396,9967066,3392,1187200,11154266,11.91
9866397,9978625,4725,1653750,11632375,16.57
9866398,6636102,4341,1519350,8155452,22.90
9866399,9961882,4167,1458450,11420332,14.64
9866400,9968515,1074,375900,10344415,3.77
9866401,9988703,2251,787850,10776553,7.89
9866402,509878,117,40950,550828,8.03
9866403,9950411,1568,548800,10499211,5.52
9866404,9968823,3384,1184400,11153223,11.88
9866405,9980284,600,210000,10190284,2.10
9866406,9982864,794,277900,10260764,2.78
9866407,9993052,2788,975800,10968852,9.76
9866408,9970711,2396,838600,10809311,8.41
9866410,9981518,4508,1577800,11559318,15.81
9866411,9996608,1923,673050,10669658,6.73
9866412,9983579,2832,991200,10974779,9.93
9866413,9974088,2816,985600,10959688,9.88
9866414,9723748,4517,1580950,11304698,16.26
9866415,9983453,1604,561400,10544853,5.62
9866416,9800146,2901,1015350,10815496,10.36
9866417,633421,383,134050,767471,21.16
9866418,9976405,3286,1150100,11126505,11.53
9866419,9980935,3475,1216250,11197185,12.19
9866420,1107322,576,201600,1308922,18.21
9866421,9981788,4610,1613500,11595288,16.16
9866422,9967860,3162,1106700,11074560,11.10
9866423,9976399,5601,1960350,11936749,19.65
9866424,9981645,3833,1341550,11323195,13.44
9866425,9984548,3402,1190700,11175248,11.93
9866426,1919346,862,301700,2221046,15.72
9866427,942929,288,100800,1043729,10.69
9866428,9980504,5370,1879500,11860004,18.83
9866429,9978798,4501,1575350,11554148,15.79
9866430,9991018,3397,1188950,11179968,11.90
9866431,9983269,3506,1227100,11210369,12.29
9866432,538621,118,41300,579921,7.67
9866433,9993669,2819,986650,10980319,9.87
9866434,9993405,4421,1547350,11540755,15.48
9866435,537490,142,49700,587190,9.25
9866436,5903036,1103,386050,6289086,6.54
9866437,9977299,4014,1404900,11382199,14.08
9866438,9975988,6146,2151100,12127088,21.56
9866439,9980366,1854,648900,10629266,6.50
9866440,9987273,3612,1264200,11251473,12.66
9866441,9989363,4203,1471050,11460413,14.73
9866442,9999156,3225,1128750,11127906,11.29
9866443,2174602,1174,410900,2585502,18.90
9866444,9980181,4477,1566950,11547131,15.70
9866445,9977838,4375,1531250,11509088,15.35
9866446,9983707,7546,2641100,12624807,26.45
9866447,605512,386,135100,740612,22.31
9866448,1996074,1596,558600,2554674,27.98
9866449,9964121,5344,1870400,11834521,18.77
9866450,9973242,6125,2143750,12116992,21.50
9866452,1498202,1360,476000,1974202,31.77
9866453,9923797,6241,2184350,12108147,22.01
9866454,9947172,5357,1874950,11822122,18.85
9866455,9955488,3926,1374100,11329588,13.80
9866456,9975139,4305,1506750,11481889,15.11
9866457,9962422,4896,1713600,11676022,17.20
9866458,9985096,4571,1599850,11584946,16.02
9866459,9979176,3473,1215550,11194726,12.18
9866460,9996549,5295,1853250,11849799,18.54
9866461,9962097,3856,1349600,11311697,13.55
9866462,9980586,4322,1512700,11493286,15.16
9866463,410051,97,33950,444001,8.28
9866464,9991715,3489,1221150,11212865,12.22
9866466,7940279,4727,1654450,9594729,20.84
9866467,9969531,3798,1329300,11298831,13.33
9866468,9987733,2537,887950,10875683,8.89
9866469,9982760,3166,1108100,11090860,11.10
9866470,9988169,3205,1121750,11109919,11.23
9866471,9980385,6859,2400650,12381035,24.05
9866472,8976705,1458,510300,9487005,5.68
9866473,931355,494,172900,1104255,18.56
9866474,9972707,4375,1531250,11503957,15.35
9866475,2197484,525,183750,2381234,8.36
9866476,9956336,4154,1453900,11410236,14.60
9866477,9949519,1989,696150,10645669,7.00
9866478,9964302,2233,781550,10745852,7.84
9866479,9970748,5692,1992200,11962948,19.98
9866480,9967640,4923,1723050,11690690,17.29
9866481,249680,245,85750,335430,34.34
9866482,1616250,1306,457100,2073350,28.28
9866483,9961113,5931,2075850,12036963,20.84
9866484,9964070,1743,610050,10574120,6.12
9866485,9971552,4318,1511300,11482852,15.16
9866486,165218,64,22400,187618,13.56
9866487,9985199,2843,995050,10980249,9.97
9866488,9996697,3495,1223250,11219947,12.24
9866489,9985829,5961,2086350,12072179,20.89
9866490,9989582,4055,1419250,11408832,14.21
9866491,206851,64,22400,229251,10.83
9866492,9980481,738,258300,10238781,2.59
9866493,9967770,1735,607250,10575020,6.09
9866494,5437080,2820,987000,6424080,18.15
9866495,9951650,2801,980350,10932000,9.85
9866496,9945983,2504,876400,10822383,8.81
9866497,9925832,2930,1025500,10951332,10.33
9866498,9939912,4849,1697150,11637062,17.07
9866499,9954268,4378,1532300,11486568,15.39
9866500,9944411,4957,1734950,11679361,17.45
9866501,9943491,3550,1242500,11185991,12.50
9866502,9936013,5020,1757000,11693013,17.68
9866503,9948370,4707,1647450,11595820,16.56
9866504,9961680,4607,1612450,11574130,16.19
9866505,9939594,2066,723100,10662694,7.27
9866506,9927972,1765,617750,10545722,6.22
9866507,9042512,1688,590800,9633312,6.53
9866508,9921478,4065,1422750,11344228,14.34
9866509,385902,81,28350,414252,7.35
9866510,9901108,2132,746200,10647308,7.54
9866511,9885321,4461,1561350,11446671,15.79
9866512,2032045,332,116200,2148245,5.72
9866513,9533547,3286,1150100,10683647,12.06
9866514,9904321,7502,2625700,12530021,26.51
9866516,1839471,668,233800,2073271,12.71
9866517,9879426,5130,1795500,11674926,18.17
9866518,9885064,5510,1928500,11813564,19.51
9866519,9852365,1770,619500,10471865,6.29
9866520,9877292,4601,1610350,11487642,16.30
9866521,7761133,2434,851900,8613033,10.98
9866522,9883120,6065,2122750,12005870,21.48
9866523,9887165,1267,443450,10330615,4.49
9866524,9910551,4076,1426600,11337151,14.39
9866525,9894176,2778,972300,10866476,9.83
9866526,72273,19,6650,78923,9.20
9866527,9883446,4764,1667400,11550846,16.87
9866528,348627,286,100100,448727,28.71
9866529,2799083,2771,969850,3768933,34.65
9866530,9909284,3535,1237250,11146534,12.49
9866531,9909261,3278,1147300,11056561,11.58
9866532,9924587,2132,746200,10670787,7.52
9866533,9921304,3091,1081850,11003154,10.90
9866534,9918232,1276,446600,10364832,4.50
9866535,9922743,3497,1223950,11146693,12.33
9866536,9935802,3280,1148000,11083802,11.55
9866537,9943909,204,71400,10015309,0.72
9866538,9946345,3157,1104950,11051295,11.11
9866539,6954529,2178,762300,7716829,10.96
9866540,9952219,2748,961800,10914019,9.66
9866541,9957326,1101,385350,10342676,3.87
9866542,1152008,331,115850,1267858,10.06
9866543,7487248,4605,1611750,9098998,21.53
9866544,9964303,3602,1260700,11225003,12.65
9866545,3836960,1645,575750,4412710,15.01
9866546,802829,643,225050,1027879,28.03
9866547,9979195,2883,1009050,10988245,10.11
9866548,9983937,5156,1804600,11788537,18.08
9866549,9964850,3239,1133650,11098500,11.38
9866550,9979951,4422,1547700,11527651,15.51
9866551,1100375,519,181650,1282025,16.51
9866552,9963332,5426,1899100,11862432,19.06
9866553,9958518,3631,1270850,11229368,12.76
9866554,9947744,2479,867650,10815394,8.72
9866555,9960932,2880,1008000,10968932,10.12
9866556,9962376,4916,1720600,11682976,17.27
9866557,9970076,1650,577500,10547576,5.79
9866558,1721324,475,166250,1887574,9.66
9866559,9970101,2474,865900,10836001,8.68
9866560,9992976,4026,1409100,11402076,14.10
9866561,9996144,4243,1485050,11481194,14.86
9866562,8980905,3760,1316000,10296905,14.65
9866563,9982540,3270,1144500,11127040,11.47
9866564,5474613,1658,580300,6054913,10.60
9866565,9977936,3171,1109850,11087786,11.12
9866566,9981327,2211,773850,10755177,7.75
9866567,5069239,671,234850,5304089,4.63
9866568,9696994,5917,2070950,11767944,21.36
9866569,9994113,2135,747250,10741363,7.48
9866570,9981983,687,240450,10222433,2.41
9866571,9990743,4692,1642200,11632943,16.44
9866572,9985997,6190,2166500,12152497,21.70
9866573,9984820,5251,1837850,11822670,18.41
9866575,9981806,1693,592550,10574356,5.94
9866576,9982099,5517,1930950,11913049,19.34
9866577,9977720,1781,623350,10601070,6.25
9866578,9977644,3182,1113700,11091344,11.16
9866579,9974770,5408,1892800,11867570,18.98
9866580,9989788,2579,902650,10892438,9.04
9866581,9979912,2178,762300,10742212,7.64
9866582,9975984,3872,1355200,11331184,13.58
9866583,9972270,2995,1048250,11020520,10.51
9866585,428285,242,84700,512985,19.78
9866586,9972092,4748,1661800,11633892,16.66
9866587,9972224,3173,1110550,11082774,11.14
9866588,1415563,544,190400,1605963,13.45
9866589,9926774,5675,1986250,11913024,20.01
9866590,9957593,2272,795200,10752793,7.99
9866591,9968213,3045,1065750,11033963,10.69
9866592,1515874,485,169750,1685624,11.20
9866593,9740716,4781,1673350,11414066,17.18
9866594,333856,224,78400,412256,23.48
9866595,9989102,3155,1104250,11093352,11.05
9866596,9979640,1949,682150,10661790,6.84
9866597,9988753,1797,628950,10617703,6.30
9866598,623674,212,74200,697874,11.90
9866599,9981286,3720,1302000,11283286,13.04
9866600,9975030,2803,981050,10956080,9.84
9866601,1870778,968,338800,2209578,18.11
9866602,9998012,5304,1856400,11854412,18.57
9866603,9980891,3332,1166200,11147091,11.68
9866605,9978519,3276,1146600,11125119,11.49
9866606,9984307,4236,1482600,11466907,14.85
9866607,9894024,3894,1362900,11256924,13.77
9866608,9994992,4769,1669150,11664142,16.70
9866609,2974769,1279,447650,3422419,15.05
9866610,9966685,5833,2041550,12008235,20.48
9866611,9956557,5106,1787100,11743657,17.95
9866612,9958860,4935,1727250,11686110,17.34
9866613,9974903,5079,1777650,11752553,17.82
9866614,9973825,4326,1514100,11487925,15.18
9866615,9987758,3922,1372700,11360458,13.74
9866616,6332701,3617,1265950,7598651,19.99
9866617,9963128,333,116550,10079678,1.17
9866618,9987312,5400,1890000,11877312,18.92
9866619,52256,13,4550,56806,8.71
9866620,9983856,5796,2028600,12012456,20.32
9866621,9993708,3786,1325100,11318808,13.26
9866622,3146281,2030,710500,3856781,22.58
9866623,9972352,4306,1507100,11479452,15.11
9866624,9981174,5744,2010400,11991574,20.14
9866625,9984773,2548,891800,10876573,8.93
9866626,9998506,1714,599900,10598406,6.00
9866627,9986909,5882,2058700,12045609,20.61
9866628,9994438,3064,1072400,11066838,10.73
9866629,201050,232,81200,282250,40.39
9866630,9971472,2031,710850,10682322,7.13
9866631,9966805,5884,2059400,12026205,20.66
9866632,9976597,3317,1160950,11137547,11.64
9866633,9998707,3106,1087100,11085807,10.87
9866634,9985587,1595,558250,10543837,5.59
9866635,9990643,2078,727300,10717943,7.28
9866636,9987394,4635,1622250,11609644,16.24
9866637,9987857,2739,958650,10946507,9.60
9866638,6678570,354,123900,6802470,1.86
9866639,9854838,3939,1378650,11233488,13.99
9866640,9971207,4467,1563450,11534657,15.68
9866641,9961828,2690,941500,10903328,9.45
9866642,7400754,2057,719950,8120704,9.73
9866644,9942188,4488,1570800,11512988,15.80
9866645,9939566,3879,1357650,11297216,13.66
9866646,9936572,2295,803250,10739822,8.08
9866647,660566,328,114800,775366,17.38
9866648,9942390,3155,1104250,11046640,11.11
9866649,9950843,2191,766850,10717693,7.71
9866650,4746244,3486,1220100,5966344,25.71
9866651,9959262,2121,742350,10701612,7.45
9866652,1140607,627,219450,1360057,19.24
9866653,9874627,4884,1709400,11584027,17.31
9866654,9960702,3671,1284850,11245552,12.90
9866655,9962291,2628,919800,10882091,9.23
9866656,1985558,686,240100,2225658,12.09
9866657,9959336,3672,1285200,11244536,12.90
9866658,9952609,3844,1345400,11298009,13.52
9866659,9977571,2700,945000,10922571,9.47
9866661,9994281,2038,713300,10707581,7.14
9866662,9949238,2361,826350,10775588,8.31
9866664,9976699,3811,1333850,11310549,13.37
9866665,9979320,3127,1094450,11073770,10.97
9866666,9991755,1438,503300,10495055,5.04
9866667,9967360,3789,1326150,11293510,13.30
9866668,89209,42,14700,103909,16.48
9866669,9958844,4151,1452850,11411694,14.59
9866670,1553040,593,207550,1760590,13.36
9866671,4118832,1612,564200,4683032,13.70
9866672,8947710,1938,678300,9626010,7.58
9866673,9953809,3409,1193150,11146959,11.99
9866674,9911235,5977,2091950,12003185,21.11
9866675,5480332,1870,654500,6134832,11.94
9866677,9895365,4219,1476650,11372015,14.92
9866678,9921188,5383,1884050,11805238,18.99
9866679,9922929,927,324450,10247379,3.27
9866680,9938978,4301,1505350,11444328,15.15
9866681,9928964,4059,1420650,11349614,14.31
9866682,9948827,4866,1703100,11651927,17.12
9866683,4693586,2465,862750,5556336,18.38
9866684,9952244,4979,1742650,11694894,17.51
9866685,9980518,4911,1718850,11699368,17.22
9866686,9976783,5398,1889300,11866083,18.94
9866687,9992222,5503,1926050,11918272,19.28
9866688,9982748,1679,587650,10570398,5.89
9866689,383142,468,163800,546942,42.75
9866690,1341990,1232,431200,1773190,32.13
9866691,9974466,4426,1549100,11523566,15.53
9866692,9985298,4306,1507100,11492398,15.09
9866693,9975398,3078,1077300,11052698,10.80
9866694,9960366,5232,1831200,11791566,18.38
9866695,9975593,3271,1144850,11120443,11.48
9866696,9977629,4388,1535800,11513429,15.39
9866697,9977524,2158,755300,10732824,7.57
9866698,9967702,4093,1432550,11400252,14.37
9866699,9991278,2487,870450,10861728,8.71
9866700,6036268,1659,580650,6616918,9.62
9866701,9981716,5684,1989400,11971116,19.93
9866702,9975277,4600,1610000,11585277,16.14
9866703,3493421,1109,388150,3881571,11.11
9866704,1254866,648,226800,1481666,18.07
9866705,9974214,3798,1329300,11303514,13.33
9866706,9994318,3287,1150450,11144768,11.51
9866707,9986173,6870,2404500,12390673,24.08
9866708,9982373,1166,408100,10390473,4.09
9866709,9994259,4740,1659000,11653259,16.60
9866710,2232710,892,312200,2544910,13.98
9866711,9972990,3242,1134700,11107690,11.38
9866712,9974463,5309,1858150,11832613,18.63
9866713,9984566,3501,1225350,11209916,12.27
9866714,9874363,2279,797650,10672013,8.08
9866715,9980174,3161,1106350,11086524,11.09
9866716,9974497,3329,1165150,11139647,11.68
9866717,9979139,5253,1838550,11817689,18.42
9866718,9977606,2663,932050,10909656,9.34
9866719,9999578,4542,1589700,11589278,15.90
9866720,819040,233,81550,900590,9.96
9866721,9969108,3941,1379350,11348458,13.84
9866722,9951063,2414,844900,10795963,8.49
9866723,5540593,3720,1302000,6842593,23.50
9866724,9970528,3986,1395100,11365628,13.99
9866726,5877163,4285,1499750,7376913,25.52
9866727,366302,174,60900,427202,16.63
9866728,8237298,2360,826000,9063298,10.03
9866729,9945800,4858,1700300,11646100,17.10
9866730,873939,569,199150,1073089,22.79
9866731,9932691,4164,1457400,11390091,14.67
9866732,9944035,2011,703850,10647885,7.08
9866733,9950166,821,287350,10237516,2.89
9866734,9950568,6039,2113650,12064218,21.24
9866735,529456,286,100100,629556,18.91
9866736,9967868,1171,409850,10377718,4.11
9866737,9974227,993,347550,10321777,3.48
9866738,9980035,1621,567350,10547385,5.68
9866739,9984090,3405,1191750,11175840,11.94
9866740,9987136,1109,388150,10375286,3.89
9866741,9977694,2401,840350,10818044,8.42
9866742,9982113,4323,1513050,11495163,15.16
9866743,9984768,3720,1302000,11286768,13.04
9866744,9994519,5713,1999550,11994069,20.01
9866745,9990914,2317,810950,10801864,8.12
9866746,9994141,3782,1323700,11317841,13.24
9866747,9971288,3285,1149750,11121038,11.53
9866748,9965186,2942,1029700,10994886,10.33
9866749,9982313,4001,1400350,11382663,14.03
9866750,9986977,1756,614600,10601577,6.15
9866751,444472,319,111650,556122,25.12
9866752,9965799,2032,711200,10676999,7.14
9866753,9968153,2061,721350,10689503,7.24
9866754,9971502,1944,680400,10651902,6.82
9866755,9977177,4377,1531950,11509127,15.35
9866756,142871,114,39900,182771,27.93
9866757,9976970,841,294350,10271320,2.95
9866758,610164,99,34650,644814,5.68
9866759,9969463,2585,904750,10874213,9.08
9866760,9957642,1848,646800,10604442,6.50
9866761,9963220,3663,1282050,11245270,12.87
9866762,9966338,4892,1712200,11678538,17.18
9866763,9956404,1081,378350,10334754,3.80
9866764,9969605,3253,1138550,11108155,11.42
9866765,9985288,1968,688800,10674088,6.90
9866767,2587160,1785,624750,3211910,24.15
9866768,9657685,5369,1879150,11536835,19.46
9866769,7446361,2012,704200,8150561,9.46
9866770,9977341,1502,525700,10503041,5.27
9866771,1520145,1371,479850,1999995,31.57
9866772,411629,139,48650,460279,11.82
9866773,6376490,2868,1003800,7380290,15.74
9866774,9924042,2482,868700,10792742,8.75
9866775,9951449,1477,516950,10468399,5.19
9866776,9960373,1523,533050,10493423,5.35
9866777,9964822,2249,787150,10751972,7.90
9866778,9974246,3750,1312500,11286746,13.16
9866779,9972376,4535,1587250,11559626,15.92
9866780,9956660,2026,709100,10665760,7.12
9866781,9951657,1436,502600,10454257,5.05
9866782,9928064,1810,633500,10561564,6.38
9866783,4253424,2286,800100,5053524,18.81
9866784,9952489,4705,1646750,11599239,16.55
9866785,9900617,2694,942900,10843517,9.52
9866786,88989,25,8750,97739,9.83
9866787,843608,369,129150,972758,15.31
9866788,5617543,4015,1405250,7022793,25.02
9866789,9975478,3543,1240050,11215528,12.43
9866790,432370,590,206500,638870,47.76
9866791,9952143,5222,1827700,11779843,18.36
9866792,9957812,2334,816900,10774712,8.20
9866793,8936053,5410,1893500,10829553,21.19
9866794,95600,61,21350,116950,22.33
9866795,9941663,3289,1151150,11092813,11.58
9866796,9956118,4047,1416450,11372568,14.23
9866797,9946146,5114,1789900,11736046,18.00
9866798,38647,18,6300,44947,16.30
9866799,9978478,6275,2196250,12174728,22.01
9866800,9973351,5854,2048900,12022251,20.54
9866801,809805,384,134400,944205,16.60
9866802,9933334,4583,1604050,11537384,16.15
9866803,2052780,1020,357000,2409780,17.39
9866804,9964845,2037,712950,10677795,7.15
9866805,9977988,3317,1160950,11138938,11.64
9866806,9993995,3017,1055950,11049945,10.57
9866807,9984561,3131,1095850,11080411,10.98
9866808,9997866,1087,380450,10378316,3.81
9866810,9972531,3640,1274000,11246531,12.78
9866811,9976154,3779,1322650,11298804,13.26
9866812,9978276,1753,613550,10591826,6.15
9866813,9987257,4622,1617700,11604957,16.20
9866814,9982228,1705,596750,10578978,5.98
9866815,1259448,866,303100,1562548,24.07
9866816,9974578,4199,1469650,11444228,14.73
9866817,9984463,2595,908250,10892713,9.10
9866818,9996518,5858,2050300,12046818,20.51
9866819,9980240,3319,1161650,11141890,11.64
9866820,99579,66,23100,122679,23.20
9866821,599469,238,83300,682769,13.90
9866822,9892508,4938,1728300,11620808,17.47
9866823,1231302,1079,377650,1608952,30.67
9866824,9977661,4495,1573250,11550911,15.77
9866825,9989180,5004,1751400,11740580,17.53
9866826,9982195,4021,1407350,11389545,14.10
9866827,423646,433,151550,575196,35.77
9866828,9980857,4251,1487850,11468707,14.91
9866830,9960941,2900,1015000,10975941,10.19
9866831,9961968,1725,603750,10565718,6.06
9866832,9978023,2219,776650,10754673,7.78
9866833,9992625,4103,1436050,11428675,14.37
9866835,9954453,1110,388500,10342953,3.90
9866836,1897965,1149,402150,2300115,21.19
9866837,9990151,2748,961800,10951951,9.63
9866838,9995092,1102,385700,10380792,3.86
9866839,9978727,3013,1054550,11033277,10.57
9866840,9987796,6382,2233700,12221496,22.36
9866841,9995539,3881,1358350,11353889,13.59
9866842,9975207,3734,1306900,11282107,13.10
9866843,9982698,2074,725900,10708598,7.27
9866844,9986725,2198,769300,10756025,7.70
9866845,1974450,341,119350,2093800,6.04
9866846,5883086,1157,404950,6288036,6.88
9866847,9985258,4976,1741600,11726858,17.44
9866848,447541,591,206850,654391,46.22
9866849,9973408,2814,984900,10958308,9.88
9866850,9958752,2946,1031100,10989852,10.35
9866851,9980065,2779,972650,10952715,9.75
9866852,1994417,217,75950,2070367,3.81
9866853,9996983,3764,1317400,11314383,13.18
9866854,9981826,829,290150,10271976,2.91
9866855,2126690,1023,358050,2484740,16.84
9866856,9987269,1645,575750,10563019,5.76
9866857,1207468,123,43050,1250518,3.57
9866858,9975113,3722,1302700,11277813,13.06
9866859,9990889,3784,1324400,11315289,13.26
9866860,9993714,1925,673750,10667464,6.74
9866861,103100,33,11550,114650,11.20
9866862,9974363,3338,1168300,11142663,11.71
9866863,9977823,5741,2009350,11987173,20.14
9866864,1163158,298,104300,1267458,8.97
9866865,9988607,2973,1040550,11029157,10.42
9866866,31256,13,4550,35806,14.56
9866867,9989841,5311,1858850,11848691,18.61
9866869,9960486,6197,2168950,12129436,21.78
9866870,9942014,4379,1532650,11474664,15.42
9866871,263717,329,115150,378867,43.66
9866872,9947525,2679,937650,10885175,9.43
9866873,229194,103,36050,265244,15.73
9866874,9949952,4784,1674400,11624352,16.83
9866875,9940470,4083,1429050,11369520,14.38
9866876,3168800,878,307300,3476100,9.70
9866877,9947251,4957,1734950,11682201,17.44
9866878,9959047,3486,1220100,11179147,12.25
9866879,9961903,2737,957950,10919853,9.62
9866880,7042862,3071,1074850,8117712,15.26
9866881,9952042,4547,1591450,11543492,15.99
9866882,9960296,2483,869050,10829346,8.73
9866883,4225040,1824,638400,4863440,15.11
9866884,4592410,2897,1013950,5606360,22.08
9866885,5641980,1596,558600,6200580,9.90
9866886,9985988,4909,1718150,11704138,17.21
9866887,9989560,4276,1496600,11486160,14.98
9866888,9982980,3110,1088500,11071480,10.90
9866889,1584256,1072,375200,1959456,23.68
9866890,9982195,2282,798700,10780895,8.00
9866891,9955561,2401,840350,10795911,8.44
9866892,7298555,3781,1323350,8621905,18.13
9866893,9946965,4109,1438150,11385115,14.46
9866894,50000,18,6300,56300,12.60
9866895,9947896,4529,1585150,11533046,15.93
9866896,9944556,5381,1883350,11827906,18.94
9866897,9937019,4585,1604750,11541769,16.15
9866898,934630,1151,402850,1337480,43.10
9866899,9924781,5993,2097550,12022331,21.13
9866900,9938065,1107,387450,10325515,3.90
9866901,9945588,183,64050,10009638,0.64
9866902,9944805,3335,1167250,11112055,11.74
9866903,9951446,2814,984900,10936346,9.90
9866904,1661029,1101,385350,2046379,23.20
9866905,9949341,6481,2268350,12217691,22.80
9866906,9954450,5257,1839950,11794400,18.48
9866907,9966867,5056,1769600,11736467,17.75
9866908,9963856,4543,1590050,11553906,15.96
9866909,603673,454,158900,762573,26.32
9866910,9965717,4201,1470350,11436067,14.75
9866911,9977539,3779,1322650,11300189,13.26
9866912,9981108,1382,483700,10464808,4.85
9866913,9994780,3937,1377950,11372730,13.79
9866914,9986128,2688,940800,10926928,9.42
9866915,9957928,2373,830550,10788478,8.34
9866916,9989792,3464,1212400,11202192,12.14
9866917,9974662,4589,1606150,11580812,16.10
9866918,1799526,1350,472500,2272026,26.26
9866919,9973579,2749,962150,10935729,9.65
9866920,9984686,3793,1327550,11312236,13.30
9866921,98653,39,13650,112303,13.84
9866922,586428,494,172900,759328,29.48
9866923,3126946,940,329000,3455946,10.52
9866924,9928739,5094,1782900,11711639,17.96
9866925,1398312,608,212800,1611112,15.22
9866927,1287454,726,254100,1541554,19.74
9866928,9929220,3645,1275750,11204970,12.85
9866929,9950305,2037,712950,10663255,7.17
9866930,9963214,2171,759850,10723064,7.63
9866931,9952531,3609,1263150,11215681,12.69
9866932,9967633,2521,882350,10849983,8.85
9866933,9967900,1272,445200,10413100,4.47
9866934,9977657,2048,716800,10694457,7.18
9866935,9966872,3133,1096550,11063422,11.00
9866936,9985915,2994,1047900,11033815,10.49
9866937,7836763,2674,935900,8772663,11.94
9866938,9977730,2937,1027950,11005680,10.30
9866939,1090211,357,124950,1215161,11.46
9866940,2115270,645,225750,2341020,10.67
9866941,9988166,4804,1681400,11669566,16.83
9866942,9986952,2509,878150,10865102,8.79
9866943,9996272,5076,1776600,11772872,17.77
9866944,9768907,4924,1723400,11492307,17.64
9866945,9981392,2231,780850,10762242,7.82
9866946,1056551,812,284200,1340751,26.90
9866947,9992837,3105,1086750,11079587,10.88
9866948,9973367,2734,956900,10930267,9.59
9866949,9979210,5251,1837850,11817060,18.42
9866950,9969590,4146,1451100,11420690,14.56
9866951,9976495,4180,1463000,11439495,14.66
9866952,9958515,2344,820400,10778915,8.24
9866953,1396273,1365,477750,1874023,34.22
9866954,9978060,1921,672350,10650410,6.74
9866955,9978498,4757,1664950,11643448,16.69
9866957,1536201,308,107800,1644001,7.02
9866958,9958308,1566,548100,10506408,5.50
9866959,9573352,1430,500500,10073852,5.23
9866960,9957219,2354,823900,10781119,8.27
9866962,9960673,2860,1001000,10961673,10.05
9866963,266155,89,31150,297305,11.70
9866964,9939582,1589,556150,10495732,5.60
9866965,9935003,3643,1275050,11210053,12.83
9866966,1236775,687,240450,1477225,19.44
9866968,9934760,2888,1010800,10945560,10.17
9866969,9899007,1870,654500,10553507,6.61
9866970,2216049,375,131250,2347299,5.92
9866971,9883405,2309,808150,10691555,8.18
9866972,9839721,3585,1254750,11094471,12.75
9866973,9908763,1568,548800,10457563,5.54
9866974,9899243,4234,1481900,11381143,14.97
9866976,9912930,1571,549850,10462780,5.55
9866977,9918463,3722,1302700,11221163,13.13
9866978,9905285,3930,1375500,11280785,13.89
9866979,9914406,2822,987700,10902106,9.96
9866980,9918322,4783,1674050,11592372,16.88
9866981,220832,60,21000,241832,9.51
9866982,9911270,4650,1627500,11538770,16.42
9866983,9919319,3791,1326850,11246169,13.38
9866984,211468,77,26950,238418,12.74
9866985,9901740,3045,1065750,10967490,10.76
9866986,9876191,3956,1384600,11260791,14.02
9866987,9887368,2612,914200,10801568,9.25
9866988,9876311,3648,1276800,11153111,12.93
9866989,9884755,2119,741650,10626405,7.50
9866990,2786021,707,247450,3033471,8.88
9866991,9896595,3766,1318100,11214695,13.32
9866992,9908651,2695,943250,10851901,9.52
9866993,9900482,1664,582400,10482882,5.88
9866994,9917520,2101,735350,10652870,7.41
9866995,9912036,1427,499450,10411486,5.04
9866996,9912913,1416,495600,10408513,5.00
9866997,9909437,2495,873250,10782687,8.81
9866999,9938989,3045,1065750,11004739,10.72
9867000,9945758,1278,447300,10393058,4.50
9867001,9763012,375,131250,9894262,1.34
9867002,9940467,2268,793800,10734267,7.99
9867003,9962451,1643,575050,10537501,5.77
9867004,9960373,1782,623700,10584073,6.26
9867005,9958076,4152,1453200,11411276,14.59
9867006,9968029,3266,1143100,11111129,11.47
9867008,3110053,1239,433650,3543703,13.94
9867009,9958937,1430,500500,10459437,5.03
9867010,9960395,3516,1230600,11190995,12.35
9867011,9960705,4899,1714650,11675355,17.21
9867012,8061361,719,251650,8313011,3.12
9867013,9939179,3493,1222550,11161729,12.30
9867014,9854235,2999,1049650,10903885,10.65
9867015,9950284,2517,880950,10831234,8.85
9867016,9957248,4755,1664250,11621498,16.71
9867017,655415,306,107100,762515,16.34
9867018,9964820,2881,1008350,10973170,10.12
9867019,52256,13,4550,56806,8.71
9867020,9927632,2419,846650,10774282,8.53
9867021,9937034,3584,1254400,11191434,12.62
9867022,9915735,2990,1046500,10962235,10.55
9867023,9925806,1400,490000,10415806,4.94
9867024,9906524,2207,772450,10678974,7.80
9867026,9930259,3271,1144850,11075109,11.53
9867027,9945921,2488,870800,10816721,8.76
9867029,9947949,3263,1142050,11089999,11.48
9867030,9948270,3469,1214150,11162420,12.20
9867031,9928105,1034,361900,10290005,3.65
9867032,9946762,4752,1663200,11609962,16.72
9867033,9932446,3113,1089550,11021996,10.97
9867034,9957331,3624,1268400,11225731,12.74
9867035,9964146,4247,1486450,11450596,14.92
9867036,9965478,2677,936950,10902428,9.40
9867037,8679711,3575,1251250,9930961,14.42
9867038,9737760,4623,1618050,11355810,16.62
9867039,243748,131,45850,289598,18.81
9867040,9976276,1794,627900,10604176,6.29
9867041,9974790,5089,1781150,11755940,17.86
9867042,9996198,2990,1046500,11042698,10.47
9867043,9983751,2100,735000,10718751,7.36
9867044,218709,93,32550,251259,14.88
9867045,9956438,5090,1781500,11737938,17.89
9867046,9547339,2784,974400,10521739,10.21
9867047,9953164,2702,945700,10898864,9.50
9867048,9948190,3116,1090600,11038790,10.96
9867049,9972290,2201,770350,10742640,7.72
9867050,9981637,350,122500,10104137,1.23
9867051,9975369,4058,1420300,11395669,14.24
9867052,3645801,2386,835100,4480901,22.91
9867053,6210763,2575,901250,7112013,14.51
9867054,9976756,2346,821100,10797856,8.23
9867055,9985026,2564,897400,10882426,8.99
9867056,9996637,3944,1380400,11377037,13.81
9867057,898085,295,103250,1001335,11.50
9867058,9983597,4391,1536850,11520447,15.39
9867059,9979621,2840,994000,10973621,9.96
9867060,9985146,1387,485450,10470596,4.86
9867061,9957796,1651,577850,10535646,5.80
9867062,9971072,3015,1055250,11026322,10.58
9867064,9966364,3548,1241800,11208164,12.46
9867065,9839230,6328,2214800,12054030,22.51
9867066,1918081,790,276500,2194581,14.42
9867067,9996208,3575,1251250,11247458,12.52
9867068,9986002,2779,972650,10958652,9.74
9867069,9982386,3144,1100400,11082786,11.02
9867070,9975776,3028,1059800,11035576,10.62
9867071,6808088,3598,1259300,8067388,18.50
9867072,9983073,4287,1500450,11483523,15.03
9867073,9987436,2209,773150,10760586,7.74
9867074,9982948,3586,1255100,11238048,12.57
9867075,9987947,3431,1200850,11188797,12.02
9867077,9972592,3701,1295350,11267942,12.99
9867078,9985343,4047,1416450,11401793,14.19
9867079,4018608,2744,960400,4979008,23.90
9867080,9998770,5856,2049600,12048370,20.50
9867081,6003516,2286,800100,6803616,13.33
9867082,9979556,5212,1824200,11803756,18.28
9867083,9973800,3430,1200500,11174300,12.04
9867084,9992797,4215,1475250,11468047,14.76
9867085,9933629,3550,1242500,11176129,12.51
9867086,9964352,3102,1085700,11050052,10.90
9867087,9981330,3466,1213100,11194430,12.15
9867088,355193,296,103600,458793,29.17
9867089,9709932,1800,630000,10339932,6.49
9867090,381972,89,31150,413122,8.16
9867091,9740282,2072,725200,10465482,7.45
9867092,9935570,2321,812350,10747920,8.18
9867093,9951718,5655,1979250,11930968,19.89
9867094,9952166,2419,846650,10798816,8.51
9867095,9970714,3787,1325450,11296164,13.29
9867096,9969488,2910,1018500,10987988,10.22
9867097,9988422,2878,1007300,10995722,10.08
9867098,9637479,2648,926800,10564279,9.62
9867099,483109,330,115500,598609,23.91
9867100,9971154,3162,1106700,11077854,11.10
9867101,4169475,700,245000,4414475,5.88
9867102,9965807,1211,423850,10389657,4.25
9867103,9961649,3220,1127000,11088649,11.31
9867104,9959531,5014,1754900,11714431,17.62
9867106,9955507,3992,1397200,11352707,14.03
9867107,9962768,2869,1004150,10966918,10.08
9867108,9974040,1522,532700,10506740,5.34
9867109,9984653,1001,350350,10335003,3.51
9867110,9995842,1164,407400,10403242,4.08
9867111,9994667,3080,1078000,11072667,10.79
9867112,9997541,3487,1220450,11217991,12.21
9867113,411848,211,73850,485698,17.93
9867114,9984400,1467,513450,10497850,5.14
9867115,9972437,3356,1174600,11147037,11.78
9867116,6635359,2518,881300,7516659,13.28
9867117,9959387,3989,1396150,11355537,14.02
9867118,9970873,2965,1037750,11008623,10.41
9867119,73691,49,17150,90841,23.27
9867120,238965,84,29400,268365,12.30
9867121,9967626,5577,1951950,11919576,19.58
9867122,9969736,2553,893550,10863286,8.96
9867123,9973855,3337,1167950,11141805,11.71
9867124,9976795,4760,1666000,11642795,16.70
9867125,1849866,364,127400,1977266,6.89
9867126,351772,231,80850,432622,22.98
9867127,9961039,4122,1442700,11403739,14.48
9867128,56197,42,14700,70897,26.16
9867129,9950669,3953,1383550,11334219,13.90
9867130,9959634,1561,546350,10505984,5.49
9867131,9957202,1415,495250,10452452,4.97
9867132,9899982,1801,630350,10530332,6.37
9867133,9964197,3604,1261400,11225597,12.66
9867134,9967529,3474,1215900,11183429,12.20
9867135,9987913,3300,1155000,11142913,11.56
9867136,9967731,4892,1712200,11679931,17.18
9867137,9985770,4395,1538250,11524020,15.40
9867138,9993613,3091,1081850,11075463,10.83
9867139,9996071,3749,1312150,11308221,13.13
9867140,9976418,1700,595000,10571418,5.96
9867141,9976633,5530,1935500,11912133,19.40
9867142,9967727,4947,1731450,11699177,17.37
9867143,9962200,5030,1760500,11722700,17.67
9867144,9973125,4422,1547700,11520825,15.52
9867145,9969388,2890,1011500,10980888,10.15
9867146,827594,530,185500,1013094,22.41
9867147,366131,437,152950,519081,41.77
9867148,9960078,3917,1370950,11331028,13.76
9867149,9951794,3978,1392300,11344094,13.99
9867150,9786217,4982,1743700,11529917,17.82
9867151,9804718,1387,485450,10290168,4.95
9867152,9944620,3193,1117550,11062170,11.24
9867153,9965001,3715,1300250,11265251,13.05
9867154,9962817,2337,817950,10780767,8.21
9867155,9955277,4692,1642200,11597477,16.50
9867156,9943448,3925,1373750,11317198,13.82
9867157,9050218,3088,1080800,10131018,11.94
9867158,9943501,4443,1555050,11498551,15.64
9867161,9925527,3687,1290450,11215977,13.00
9867162,9938572,2391,836850,10775422,8.42
9867163,6607089,3476,1216600,7823689,18.41
9867164,9922451,4453,1558550,11481001,15.71
9867165,9927377,4276,1496600,11423977,15.08
9867166,9924255,4191,1466850,11391105,14.78
9867167,9918067,3113,1089550,11007617,10.99
9867168,9926480,5348,1871800,11798280,18.86
9867169,9913383,2132,746200,10659583,7.53
9867170,9917217,4959,1735650,11652867,17.50
9867171,1313080,271,94850,1407930,7.22
9867172,9901862,3954,1383900,11285762,13.98
9867173,2668733,727,254450,2923183,9.53
9867174,9914073,3355,1174250,11088323,11.84
9867175,9905024,4652,1628200,11533224,16.44
9867176,9879665,4185,1464750,11344415,14.83
9867178,9889645,5298,1854300,11743945,18.75
9867179,9892127,3317,1160950,11053077,11.74
9867180,1519444,924,323400,1842844,21.28
9867181,9918830,3901,1365350,11284180,13.77
9867182,708301,523,183050,891351,25.84
9867183,166904,128,44800,211704,26.84
9867184,8177549,2518,881300,9058849,10.78
9867185,9884200,4158,1455300,11339500,14.72
9867186,9895949,4894,1712900,11608849,17.31
9867187,9894792,4304,1506400,11401192,15.22
9867188,305251,178,62300,367551,20.41
9867189,9884477,3191,1116850,11001327,11.30
9867190,9341724,2854,998900,10340624,10.69
9867191,1463059,456,159600,1622659,10.91
9867192,4103559,2503,876050,4979609,21.35
9867193,9863689,2559,895650,10759339,9.08
9867194,9875472,6084,2129400,12004872,21.56
9867195,9872203,5162,1806700,11678903,18.30
9867196,9889212,1343,470050,10359262,4.75
9867197,9888928,5668,1983800,11872728,20.06
9867198,9871427,2885,1009750,10881177,10.23
9867199,9890811,3237,1132950,11023761,11.45
9867200,9910404,2246,786100,10696504,7.93
9867201,9905602,3865,1352750,11258352,13.66
9867202,9915585,4433,1551550,11467135,15.65
9867203,9913361,2983,1044050,10957411,10.53
9867204,9919594,4355,1524250,11443844,15.37
9867206,9901386,4905,1716750,11618136,17.34
9867207,9905813,2884,1009400,10915213,10.19
9867208,9926962,3297,1153950,11080912,11.62
9867209,9924675,3003,1051050,10975725,10.59
9867210,9932611,2608,912800,10845411,9.19
9867211,9945985,5200,1820000,11765985,18.30
9867212,9919453,4689,1641150,11560603,16.54
9867213,3605610,1087,380450,3986060,10.55
9867214,9934166,3880,1358000,11292166,13.67
9867215,9928765,3327,1164450,11093215,11.73
9867216,9926703,3401,1190350,11117053,11.99
9867217,9933802,3928,1374800,11308602,13.84
9867218,9944574,3211,1123850,11068424,11.30
9867219,9936068,2099,734650,10670718,7.39
9867220,9957626,2393,837550,10795176,8.41
9867221,9946011,2783,974050,10920061,9.79
9867222,9951118,3209,1123150,11074268,11.29
9867223,9958884,5918,2071300,12030184,20.80
9867224,9970316,3788,1325800,11296116,13.30
9867225,9977422,4868,1703800,11681222,17.08
9867226,9976781,3805,1331750,11308531,13.35
9867227,9974486,4630,1620500,11594986,16.25
9867228,9967379,4749,1662150,11629529,16.68
9867229,9973434,4990,1746500,11719934,17.51
9867230,9952202,5859,2050650,12002852,20.60
9867231,9983424,3528,1234800,11218224,12.37
9867232,356446,42,14700,371146,4.12
9867233,2117971,792,277200,2395171,13.09
9867234,9984139,4027,1409450,11393589,14.12
9867235,9984128,2864,1002400,10986528,10.04
9867236,163057,76,26600,189657,16.31
9867237,1447528,1012,354200,1801728,24.47
9867238,722020,257,89950,811970,12.46
9867239,9977344,3095,1083250,11060594,10.86
9867240,1550838,482,168700,1719538,10.88
9867241,9973802,3204,1121400,11095202,11.24
9867242,769936,177,61950,831886,8.05
9867243,9984137,4441,1554350,11538487,15.57
9867245,9978850,2548,891800,10870650,8.94
9867246,900425,425,148750,1049175,16.52
9867247,9971353,4149,1452150,11423503,14.56
9867248,9966565,2514,879900,10846465,8.83
9867249,9967859,3107,1087450,11055309,10.91
9867250,9945682,3308,1157800,11103482,11.64
9867251,9963925,4915,1720250,11684175,17.26
9867252,9956463,4549,1592150,11548613,15.99
9867253,9972452,6813,2384550,12357002,23.91
9867255,9978795,5012,1754200,11732995,17.58
9867256,9996885,3610,1263500,11260385,12.64
9867257,9974184,3204,1121400,11095584,11.24
9867258,2235025,426,149100,2384125,6.67
9867259,81432,62,21700,103132,26.65
9867260,9978777,3715,1300250,11279027,13.03
9867261,9989078,2862,1001700,10990778,10.03
9867262,9983937,3666,1283100,11267037,12.85
9867263,1473825,229,80150,1553975,5.44
9867264,9962836,3486,1220100,11182936,12.25
9867265,9976957,2543,890050,10867007,8.92
9867266,9975421,4500,1575000,11550421,15.79
9867267,9964119,3892,1362200,11326319,13.67
9867268,9983448,2551,892850,10876298,8.94
9867269,9969536,3224,1128400,11097936,11.32
9867270,9983447,3872,1355200,11338647,13.57
9867271,9984515,3704,1296400,11280915,12.98
9867272,9990921,6470,2264500,12255421,22.67
9867273,9983236,3640,1274000,11257236,12.76
9867274,285558,85,29750,315308,10.42
9867276,9974937,3812,1334200,11309137,13.38
9867277,9984123,2672,935200,10919323,9.37
9867278,9977953,3038,1063300,11041253,10.66
9867279,9984430,5040,1764000,11748430,17.67
9867280,2209963,763,267050,2477013,12.08
9867281,2870848,1957,684950,3555798,23.86
9867282,9985854,5404,1891400,11877254,18.94
9867283,9988936,2384,834400,10823336,8.35
9867285,9988863,4449,1557150,11546013,15.59
9867286,9988597,3360,1176000,11164597,11.77
9867287,9944922,4561,1596350,11541272,16.05
9867288,9977008,3622,1267700,11244708,12.71
9867289,9980092,5087,1780450,11760542,17.84
9867290,200486,146,51100,251586,25.49
9867291,9977905,4665,1632750,11610655,16.36
9867292,9974687,3679,1287650,11262337,12.91
9867293,9980012,3744,1310400,11290412,13.13
9867294,7193205,3184,1114400,8307605,15.49
9867295,9981191,4503,1576050,11557241,15.79
9867296,935999,211,73850,1009849,7.89
9867297,9997030,4396,1538600,11535630,15.39
9867298,9983894,5860,2051000,12034894,20.54
9867299,695277,239,83650,778927,12.03
9867300,9961869,4605,1611750,11573619,16.18
9867301,9973965,2987,1045450,11019415,10.48
9867302,9977716,2703,946050,10923766,9.48
9867303,704474,368,128800,833274,18.28
9867304,988760,545,190750,1179510,19.29
9867305,1306302,1482,518700,1825002,39.71
9867306,559393,448,156800,716193,28.03
9867307,9962906,4438,1553300,11516206,15.59
9867308,9968284,3570,1249500,11217784,12.53
9867309,9966679,4707,1647450,11614129,16.53
9867310,9983841,3169,1109150,11092991,11.11
9867311,9978517,4534,1586900,11565417,15.90
9867312,9980020,2648,926800,10906820,9.29
9867313,684355,443,155050,839405,22.66
9867314,9972995,4127,1444450,11417445,14.48
9867315,9977841,4334,1516900,11494741,15.20
9867317,9972803,3323,1163050,11135853,11.66
9867318,8976703,4050,1417500,10394203,15.79
9867320,9971554,4522,1582700,11554254,15.87
9867321,301768,194,67900,369668,22.50
9867322,1841616,316,110600,1952216,6.01
9867323,1897221,1041,364350,2261571,19.20
9867324,2138491,1909,668150,2806641,31.24
9867325,1670833,853,298550,1969383,17.87
9867326,9937100,3877,1356950,11294050,13.66
9867327,9953635,4776,1671600,11625235,16.79
9867328,9957467,4796,1678600,11636067,16.86
9867329,9951644,1954,683900,10635544,6.87
9867330,9949203,6293,2202550,12151753,22.14
9867331,9956155,4476,1566600,11522755,15.73
9867332,8607763,3927,1374450,9982213,15.97
9867333,9873397,6938,2428300,12301697,24.59
9867334,9965634,6486,2270100,12235734,22.78
9867335,9972709,5218,1826300,11799009,18.31
9867336,9960709,4142,1449700,11410409,14.55
9867337,9966342,4572,1600200,11566542,16.06
9867338,9985203,3914,1369900,11355103,13.72
9867339,9979062,2386,835100,10814162,8.37
9867340,9997017,2978,1042300,11039317,10.43
9867341,9987361,4929,1725150,11712511,17.27
9867342,9991354,2149,752150,10743504,7.53
9867343,9985432,4528,1584800,11570232,15.87
9867344,9999401,5347,1871450,11870851,18.72
9867345,9984397,2678,937300,10921697,9.39
9867346,171004,89,31150,202154,18.22
9867347,9988516,5078,1777300,11765816,17.79
9867348,9993875,4200,1470000,11463875,14.71
9867349,9993927,3890,1361500,11355427,13.62
9867350,9979211,3571,1249850,11229061,12.52
9867351,9998418,4107,1437450,11435868,14.38
9867352,9953154,6193,2167550,12120704,21.78
9867353,9978922,3091,1081850,11060772,10.84
9867354,9987202,5663,1982050,11969252,19.85
9867355,9986725,2791,976850,10963575,9.78
9867356,9980249,3725,1303750,11283999,13.06
9867357,9985097,3639,1273650,11258747,12.76
9867358,9984128,5716,2000600,11984728,20.04
9867359,9992926,1502,525700,10518626,5.26
9867360,434382,85,29750,464132,6.85
9867361,9991486,5615,1965250,11956736,19.67
9867362,9995315,1814,634900,10630215,6.35
9867363,9982408,4600,1610000,11592408,16.13
9867364,9991907,4027,1409450,11401357,14.11
9867365,9983750,3806,1332100,11315850,13.34
9867366,1241466,916,320600,1562066,25.82
9867367,1086915,332,116200,1203115,10.69
9867368,9967056,5338,1868300,11835356,18.74
9867369,9975697,3247,1136450,11112147,11.39
9867370,7100918,2656,929600,8030518,13.09
9867371,9967600,1985,694750,10662350,6.97
9867372,9983506,4804,1681400,11664906,16.84
9867373,7581120,2707,947450,8528570,12.50
9867374,588267,459,160650,748917,27.31
9867375,9967033,3379,1182650,11149683,11.87
9867376,2880228,2313,809550,3689778,28.11
9867377,142856,69,24150,167006,16.91
9867378,3402283,1957,684950,4087233,20.13
9867379,9971380,3881,1358350,11329730,13.62
9867380,9970586,4411,1543850,11514436,15.48
9867381,9979985,1359,475650,10455635,4.77
9867382,9984245,5805,2031750,12015995,20.35
9867383,9986265,6616,2315600,12301865,23.19
9867384,2017817,711,248850,2266667,12.33
9867385,9973430,4077,1426950,11400380,14.31
9867386,9989552,5874,2055900,12045452,20.58
9867387,5789469,609,213150,6002619,3.68
9867388,9954848,3072,1075200,11030048,10.80
9867389,9488161,3292,1152200,10640361,12.14
9867391,9961379,2168,758800,10720179,7.62
9867392,2034622,1044,365400,2400022,17.96
9867393,9956853,3964,1387400,11344253,13.93
9867395,9947152,4669,1634150,11581302,16.43
9867396,9943544,3133,1096550,11040094,11.03
9867397,9959414,2096,733600,10693014,7.37
9867398,278950,167,58450,337400,20.95
9867399,9942084,3211,1123850,11065934,11.30
9867400,1650645,791,276850,1927495,16.77
9867401,1479805,648,226800,1706605,15.33
9867402,5251163,2325,813750,6064913,15.50
9867403,9923554,4847,1696450,11620004,17.10
9867404,9933386,1830,640500,10573886,6.45
9867405,551209,42,14700,565909,2.67
9867406,174639,42,14700,189339,8.42
9867407,9934136,2068,723800,10657936,7.29
9867408,9927437,3390,1186500,11113937,11.95
9867409,9930871,1648,576800,10507671,5.81
9867410,2244090,646,226100,2470190,10.08
9867411,9940656,2890,1011500,10952156,10.18
9867412,9943779,3823,1338050,11281829,13.46
9867413,4639595,2472,865200,5504795,18.65
9867414,9969172,4717,1650950,11620122,16.56
9867415,5760822,1638,573300,6334122,9.95
9867416,9975261,5965,2087750,12063011,20.93
9867418,9981720,3755,1314250,11295970,13.17
9867419,9998488,1864,652400,10650888,6.52
9867420,9978825,3163,1107050,11085875,11.09
9867421,9985924,4041,1414350,11400274,14.16
9867422,9987246,3336,1167600,11154846,11.69
9867423,9732255,4654,1628900,11361155,16.74
9867424,9982902,7387,2585450,12568352,25.90
9867425,9734655,3667,1283450,11018105,13.18
9867426,9977935,5053,1768550,11746485,17.72
9867427,9984635,2456,859600,10844235,8.61
9867428,9985050,2949,1032150,11017200,10.34
9867429,9982093,3781,1323350,11305443,13.26
9867430,9983738,4048,1416800,11400538,14.19
9867431,5638950,2005,701750,6340700,12.44
9867432,9982275,2652,928200,10910475,9.30
9867433,9970257,3417,1195950,11166207,12.00
9867434,3737826,1903,666050,4403876,17.82
9867435,9965161,3757,1314950,11280111,13.20
9867436,9989543,2109,738150,10727693,7.39
9867437,6168582,2415,845250,7013832,13.70
9867438,9979762,3481,1218350,11198112,12.21
9867439,9990085,3003,1051050,11041135,10.52
9867440,9980796,4727,1654450,11635246,16.58
9867441,9971068,3668,1283800,11254868,12.88
9867442,7627715,3569,1249150,8876865,16.38
9867443,9964687,3476,1216600,11181287,12.21
9867444,2120868,1135,397250,2518118,18.73
9867445,9961754,3562,1246700,11208454,12.51
9867446,3460469,1167,408450,3868919,11.80
9867447,9963428,4547,1591450,11554878,15.97
9867448,3727303,1050,367500,4094803,9.86
9867450,9936910,3633,1271550,11208460,12.80
9867451,9954309,3471,1214850,11169159,12.20
9867452,9975246,3568,1248800,11224046,12.52
9867453,1285328,487,170450,1455778,13.26
9867454,9976122,2985,1044750,11020872,10.47
9867456,9961401,4951,1732850,11694251,17.40
9867457,5640821,1926,674100,6314921,11.95
9867458,9988934,3172,1110200,11099134,11.11
9867459,9980341,3790,1326500,11306841,13.29
9867460,1246139,619,216650,1462789,17.39
9867461,3169620,1033,361550,3531170,11.41
9867462,9966565,2976,1041600,11008165,10.45
9867463,9977877,5928,2074800,12052677,20.79
9867464,9977994,3070,1074500,11052494,10.77
9867465,9980753,3328,1164800,11145553,11.67
9867466,9981110,3144,1100400,11081510,11.02
9867467,9986883,4286,1500100,11486983,15.02
9867469,9975086,3574,1250900,11225986,12.54
9867470,9983324,4414,1544900,11528224,15.47
9867471,9982745,2329,815150,10797895,8.17
9867472,9987346,2845,995750,10983096,9.97
9867473,5766289,2765,967750,6734039,16.78
9867474,9984394,3216,1125600,11109994,11.27
9867475,9984188,4195,1468250,11452438,14.71
9867476,9970605,3672,1285200,11255805,12.89
9867477,1027307,250,87500,1114807,8.52
9867479,3446868,1512,529200,3976068,15.35
9867480,9990416,4034,1411900,11402316,14.13
9867481,9988704,2482,868700,10857404,8.70
9867482,2503134,946,331100,2834234,13.23
9867483,9983304,2624,918400,10901704,9.20
9867484,9992662,1449,507150,10499812,5.08
9867485,9997047,3846,1346100,11343147,13.46
9867486,9986467,2568,898800,10885267,9.00
9867487,251021,42,14700,265721,5.86
9867488,5284810,1202,420700,5705510,7.96
9867489,9981782,3249,1137150,11118932,11.39
9867490,3164142,1123,393050,3557192,12.42
9867491,9957445,3897,1363950,11321395,13.70
9867492,1827500,571,199850,2027350,10.94
9867493,9953314,1836,642600,10595914,6.46
9867494,9960864,4144,1450400,11411264,14.56
9867495,1157730,507,177450,1335180,15.33
9867496,9975988,5215,1825250,11801238,18.30
9867497,9987006,4701,1645350,11632356,16.47
9867498,9990419,3230,1130500,11120919,11.32
9867499,9967499,2282,798700,10766199,8.01
9867500,9975839,2903,1016050,10991889,10.19
9867501,1435780,703,246050,1681830,17.14
9867502,9978526,3317,1160950,11139476,11.63
9867503,9980612,5123,1793050,11773662,17.97
9867504,9989218,2558,895300,10884518,8.96
9867505,9973472,1317,460950,10434422,4.62
9867506,9978419,3441,1204350,11182769,12.07
9867507,9979616,3722,1302700,11282316,13.05
9867508,9961211,3346,1171100,11132311,11.76
9867509,9974704,2114,739900,10714604,7.42
9867510,9993107,3539,1238650,11231757,12.40
9867511,9981155,3236,1132600,11113755,11.35
9867512,9990879,4296,1503600,11494479,15.05
9867513,2960480,1909,668150,3628630,22.57
9867514,9966101,1921,672350,10638451,6.75
9867515,9954070,3833,1341550,11295620,13.48
9867516,9958656,3507,1227450,11186106,12.33
9867517,9973322,4511,1578850,11552172,15.83
9867518,9957682,3977,1391950,11349632,13.98
9867519,9975065,2673,935550,10910615,9.38
9867520,9960052,2732,956200,10916252,9.60
9867521,9974173,3139,1098650,11072823,11.01
9867522,9973854,2048,716800,10690654,7.19
9867523,9978468,3645,1275750,11254218,12.79
9867525,9970201,3264,1142400,11112601,11.46
9867526,57273,19,6650,63923,11.61
9867527,9973563,2397,838950,10812513,8.41
9867528,9959179,4680,1638000,11597179,16.45
9867529,9748387,2363,827050,10575437,8.48
9867530,135313,71,24850,160163,18.36
9867531,9935897,3053,1068550,11004447,10.75
9867532,9940214,1922,672700,10612914,6.77
9867533,9922539,2315,810250,10732789,8.17
9867534,9951910,3095,1083250,11035160,10.88
9867535,9953390,2751,962850,10916240,9.67
9867536,9935684,4142,1449700,11385384,14.59
9867538,9946673,2032,711200,10657873,7.15
9867539,9940391,950,332500,10272891,3.34
9867540,9956823,2733,956550,10913373,9.61
9867541,9967182,3342,1169700,11136882,11.74
9867542,9978752,1526,534100,10512852,5.35
9867543,9969454,4327,1514450,11483904,15.19
9867544,9973822,2802,980700,10954522,9.83
9867545,9982199,2656,929600,10911799,9.31
9867546,9999239,2759,965650,10964889,9.66
9867547,9990820,3089,1081150,11071970,10.82
9867548,9994110,2631,920850,10914960,9.21
9867549,9985576,3168,1108800,11094376,11.10
9867550,9971722,3499,1224650,11196372,12.28
9867551,9997625,3862,1351700,11349325,13.52
9867552,9986378,2654,928900,10915278,9.30
9867553,9989430,5920,2072000,12061430,20.74
9867554,9935522,2567,898450,10833972,9.04
9867555,9967821,3197,1118950,11086771,11.23
9867556,9957023,2091,731850,10688873,7.35
9867557,9974716,2706,947100,10921816,9.50
9867558,4870934,1324,463400,5334334,9.51
9867559,9975564,2066,723100,10698664,7.25
9867560,9961626,4809,1683150,11644776,16.90
9867561,9972093,4084,1429400,11401493,14.33
9867562,590711,247,86450,677161,14.63
9867563,9902182,3643,1275050,11177232,12.88
9867564,9969414,3754,1313900,11283314,13.18
9867565,749483,310,108500,857983,14.48
9867566,9985270,4034,1411900,11397170,14.14
9867567,9950691,2778,972300,10922991,9.77
9867568,9992659,3356,1174600,11167259,11.75
9867569,9992000,3505,1226750,11218750,12.28
9867570,9978650,6153,2153550,12132200,21.58
9867571,9979685,4823,1688050,11667735,16.91
9867572,9982839,2393,837550,10820389,8.39
9867573,9981495,1648,576800,10558295,5.78
9867574,9978961,3279,1147650,11126611,11.50
9867575,9991579,4910,1718500,11710079,17.20
9867576,9976661,3653,1278550,11255211,12.82
9867577,9993691,1986,695100,10688791,6.96
9867578,9979545,3750,1312500,11292045,13.15
9867579,9998304,2548,891800,10890104,8.92
9867580,9984500,5539,1938650,11923150,19.42
9867581,9968392,3412,1194200,11162592,11.98
9867582,9975981,1811,633850,10609831,6.35
9867583,9975430,4514,1579900,11555330,15.84
9867584,9980768,4421,1547350,11528118,15.50
9867585,9979690,2586,905100,10884790,9.07
9867586,9946252,4655,1629250,11575502,16.38
9867587,9568678,3234,1131900,10700578,11.83
9867588,9963880,3694,1292900,11256780,12.98
9867589,9969301,1963,687050,10656351,6.89
9867590,9970835,3855,1349250,11320085,13.53
9867591,9969919,3218,1126300,11096219,11.30
9867592,9974739,3825,1338750,11313489,13.42
9867593,9986603,2741,959350,10945953,9.61
9867594,9970162,3215,1125250,11095412,11.29
9867595,9987821,2297,803950,10791771,8.05
9867596,9989099,3048,1066800,11055899,10.68
9867597,2181238,661,231350,2412588,10.61
9867598,9964339,5717,2000950,11965289,20.08
9867599,9973053,258,90300,10063353,0.91
9867600,9969616,4883,1709050,11678666,17.14
9867601,9966981,1296,453600,10420581,4.55
9867602,9956661,2713,949550,10906211,9.54
9867603,9967916,1960,686000,10653916,6.88
9867604,9984635,3702,1295700,11280335,12.98
9867605,9981883,2011,703850,10685733,7.05
9867606,9967953,3925,1373750,11341703,13.78
9867607,1566770,1702,595700,2162470,38.02
9867608,9965884,3040,1064000,11029884,10.68
9867609,2861738,1472,515200,3376938,18.00
9867610,969099,399,139650,1108749,14.41
9867611,9936362,2968,1038800,10975162,10.45
9867612,9962915,3601,1260350,11223265,12.65
9867613,9940487,2815,985250,10925737,9.91
9867614,9962547,2838,993300,10955847,9.97
9867615,9958716,2750,962500,10921216,9.66
9867616,9957628,3788,1325800,11283428,13.31
9867617,9968317,2742,959700,10928017,9.63
9867618,9965600,2725,953750,10919350,9.57
9867619,9940438,5255,1839250,11779688,18.50
9867620,9991572,3309,1158150,11149722,11.59
9867621,9981384,2696,943600,10924984,9.45
9867622,9998749,1803,631050,10629799,6.31
9867623,9976362,2198,769300,10745662,7.71
9867624,9992572,4738,1658300,11650872,16.60
9867625,994605,389,136150,1130755,13.69
9867626,9981658,3539,1238650,11220308,12.41
9867627,9974564,3111,1088850,11063414,10.92
9867628,9988174,1767,618450,10606624,6.19
9867629,9972780,3133,1096550,11069330,11.00
9867630,8570469,2358,825300,9395769,9.63
9867631,4841524,2754,963900,5805424,19.91
9867632,9997217,3078,1077300,11074517,10.78
9867633,9969278,2996,1048600,11017878,10.52
9867634,2835797,1920,672000,3507797,23.70
9867635,1428639,551,192850,1621489,13.50
9867636,9985301,5636,1972600,11957901,19.76
9867637,9995373,3884,1359400,11354773,13.60
9867638,9978145,2876,1006600,10984745,10.09
9867639,9990763,2680,938000,10928763,9.39
9867640,1559513,546,191100,1750613,12.25
9867641,9972261,4097,1433950,11406211,14.38
9867642,336654,231,80850,417504,24.02
9867643,9960650,2485,869750,10830400,8.73
9867644,9976143,3073,1075550,11051693,10.78
9867645,9985718,2351,822850,10808568,8.24
9867646,5906611,2591,906850,6813461,15.35
9867647,9975931,4458,1560300,11536231,15.64
9867648,9966822,2075,726250,10693072,7.29
9867649,9978850,3112,1089200,11068050,10.92
9867650,253907,90,31500,285407,12.41
9867651,9972574,5285,1849750,11822324,18.55
9867652,9946190,2333,816550,10762740,8.21
9867653,9956442,3410,1193500,11149942,11.99
9867654,6491102,1621,567350,7058452,8.74
9867655,1785843,858,300300,2086143,16.82
9867656,4012108,1474,515900,4528008,12.86
9867657,9991850,2629,920150,10912000,9.21
9867658,9991646,3268,1143800,11135446,11.45
9867659,9983868,5031,1760850,11744718,17.64
9867660,8764204,2534,886900,9651104,10.12
9867661,9967412,4316,1510600,11478012,15.16
9867662,9987560,3245,1135750,11123310,11.37
9867663,9996634,1726,604100,10600734,6.04
9867664,9990207,3611,1263850,11254057,12.65
9867665,9995210,3880,1358000,11353210,13.59
9867666,3243701,1210,423500,3667201,13.06
9867667,1192835,661,231350,1424185,19.39
9867668,9955254,3385,1184750,11140004,11.90
9867669,9991834,4028,1409800,11401634,14.11
9867670,9991126,2458,860300,10851426,8.61
9867671,9989935,4937,1727950,11717885,17.30
9867672,9984401,5572,1950200,11934601,19.53
9867673,9973810,3549,1242150,11215960,12.45
9867674,9968829,2273,795550,10764379,7.98
9867675,9984165,4536,1587600,11571765,15.90
9867676,9993912,1734,606900,10600812,6.07
9867677,9981488,3291,1151850,11133338,11.54
9867678,9992009,2394,837900,10829909,8.39
9867679,9987178,1846,646100,10633278,6.47
9867680,9987981,3295,1153250,11141231,11.55
9867682,837907,199,69650,907557,8.31
9867683,9975214,2951,1032850,11008064,10.35
9867684,1203419,223,78050,1281469,6.49
9867685,9988241,1809,633150,10621391,6.34
9867687,9987105,2533,886550,10873655,8.88
9867688,9796737,2183,764050,10560787,7.80
9867689,9974990,3599,1259650,11234640,12.63
9867690,9972744,3795,1328250,11300994,13.32
9867691,9961145,1479,517650,10478795,5.20
9867692,9984736,2820,987000,10971736,9.89
9867693,9970240,4466,1563100,11533340,15.68
9867694,9977836,2474,865900,10843736,8.68
9867695,9979062,2815,985250,10964312,9.87
9867696,9998009,3943,1380050,11378059,13.80
9867697,9988387,2889,1011150,10999537,10.12
9867698,9985817,3672,1285200,11271017,12.87
9867699,2386234,735,257250,2643484,10.78
9867700,9957329,2141,749350,10706679,7.53
9867701,9974041,3954,1383900,11357941,13.88
9867702,9966421,3285,1149750,11116171,11.54
9867703,9975008,4086,1430100,11405108,14.34
9867704,3828135,1812,634200,4462335,16.57
9867705,9976636,2331,815850,10792486,8.18
9867706,5847134,1794,627900,6475034,10.74
9867707,9966062,3940,1379000,11345062,13.84
9867708,9974864,2675,936250,10911114,9.39
9867709,9959701,3105,1086750,11046451,10.91
9867710,9947321,3322,1162700,11110021,11.69
9867712,4987671,1167,408450,5396121,8.19
9867713,9976069,2690,941500,10917569,9.44
9867714,9976862,3355,1174250,11151112,11.77
9867715,9980813,3113,1089550,11070363,10.92
9867716,9974448,2923,1023050,10997498,10.26
9867717,9992904,2840,994000,10986904,9.95
9867718,9987979,2146,751100,10739079,7.52
9867719,9985052,4338,1518300,11503352,15.21
9867720,9980717,4183,1464050,11444767,14.67
9867721,9990385,6961,2436350,12426735,24.39
9867722,9980610,2291,801850,10782460,8.03
9867723,9986747,2889,1011150,10997897,10.12
9867724,9985676,3931,1375850,11361526,13.78
9867725,9959995,2781,973350,10933345,9.77
9867726,9991436,2650,927500,10918936,9.28
9867727,4347357,1401,490350,4837707,11.28
9867728,9985567,3428,1199800,11185367,12.02
9867729,4781258,1769,619150,5400408,12.95
9867730,9981561,4037,1412950,11394511,14.16
9867731,9986394,3749,1312150,11298544,13.14
9867732,9966970,1343,470050,10437020,4.72
9867733,9984910,3374,1180900,11165810,11.83
9867734,9999381,3498,1224300,11223681,12.24
9867735,9977185,3264,1142400,11119585,11.45
9867736,9983977,1659,580650,10564627,5.82
9867737,9989926,2528,884800,10874726,8.86
9867738,9971900,4944,1730400,11702300,17.35
9867739,9980898,7005,2451750,12432648,24.56
9867741,9987318,3066,1073100,11060418,10.74
9867742,9976814,4386,1535100,11511914,15.39
9867743,9988981,4272,1495200,11484181,14.97
9867744,9988865,2198,769300,10758165,7.70
9867745,9977062,4575,1601250,11578312,16.05
9867746,2833587,1544,540400,3373987,19.07
9867747,9969687,3062,1071700,11041387,10.75
9867748,9980556,4173,1460550,11441106,14.63
9867749,5834436,1480,518000,6352436,8.88
9867750,9983921,3236,1132600,11116521,11.34
9867751,9984024,3817,1335950,11319974,13.38
9867752,9962882,2359,825650,10788532,8.29
9867753,3571081,469,164150,3735231,4.60
9867755,9973842,2360,826000,10799842,8.28
9867756,9967106,3680,1288000,11255106,12.92
9867757,9952881,1937,677950,10630831,6.81
9867758,9974420,3366,1178100,11152520,11.81
9867759,9975082,3324,1163400,11138482,11.66
9867760,9993665,3164,1107400,11101065,11.08
9867761,9982757,2285,799750,10782507,8.01
9867762,9985972,4519,1581650,11567622,15.84
9867763,3152520,1355,474250,3626770,15.04
9867764,9976492,3027,1059450,11035942,10.62
9867765,861429,371,129850,991279,15.07
9867766,9956634,2790,976500,10933134,9.81
9867767,2040534,1106,387100,2427634,18.97
9867768,9954344,3327,1164450,11118794,11.70
9867769,9471643,3713,1299550,10771193,13.72
9867770,9945792,2750,962500,10908292,9.68
9867771,9989098,3852,1348200,11337298,13.50
9867772,3868523,2447,856450,4724973,22.14
9867773,9955415,1703,596050,10551465,5.99
9867774,9963647,2760,966000,10929647,9.70
9867775,9981105,3293,1152550,11133655,11.55
9867776,9984835,4878,1707300,11692135,17.10
9867777,9987840,3167,1108450,11096290,11.10
9867778,9977388,4102,1435700,11413088,14.39
9867779,9789085,2989,1046150,10835235,10.69
9867780,9983140,1967,688450,10671590,6.90
9867781,9963253,4789,1676150,11639403,16.82
9867782,9987050,2991,1046850,11033900,10.48
9867783,9974622,2950,1032500,11007122,10.35
9867784,9963028,2154,753900,10716928,7.57
9867785,9966624,4071,1424850,11391474,14.30
9867786,9970927,4610,1613500,11584427,16.18
9867787,9981085,1128,394800,10375885,3.96
9867788,9987949,2020,707000,10694949,7.08
9867789,9997577,4812,1684200,11681777,16.85
9867790,9994052,3672,1285200,11279252,12.86
9867791,9981446,5672,1985200,11966646,19.89
9867792,9979494,2937,1027950,11007444,10.30
9867793,9981978,2518,881300,10863278,8.83
9867794,9986039,4044,1415400,11401439,14.17
9867795,9981331,2288,800800,10782131,8.02
9867796,9973592,3529,1235150,11208742,12.38
9867798,9967730,4000,1400000,11367730,14.05
9867799,9981969,2708,947800,10929769,9.50
9867800,9975091,4548,1591800,11566891,15.96
9867801,9970434,3256,1139600,11110034,11.43
9867802,3699953,1626,569100,4269053,15.38
9867803,9969095,3495,1223250,11192345,12.27
9867804,2755910,706,247100,3003010,8.97
9867805,9989064,3861,1351350,11340414,13.53
9867806,9989800,4665,1632750,11622550,16.34
9867807,9984305,3053,1068550,11052855,10.70
9867808,9968221,2766,968100,10936321,9.71
9867809,9981745,1312,459200,10440945,4.60
9867810,9990111,4841,1694350,11684461,16.96
9867811,9993008,2339,818650,10811658,8.19
9867812,9986881,3795,1328250,11315131,13.30
9867813,9975249,2994,1047900,11023149,10.51
9867814,9991806,4393,1537550,11529356,15.39
9867815,9995592,2684,939400,10934992,9.40
9867816,9989153,3879,1357650,11346803,13.59
9867817,9970905,2401,840350,10811255,8.43
9867818,9970360,3679,1287650,11258010,12.91
9867819,2644763,1110,388500,3033263,14.69
9867820,5042245,1024,358400,5400645,7.11
9867821,9956157,3844,1345400,11301557,13.51
9867822,9958214,2792,977200,10935414,9.81
9867823,9970999,2373,830550,10801549,8.33
9867824,9980235,2691,941850,10922085,9.44
9867825,9976020,5203,1821050,11797070,18.25
9867826,9982819,2877,1006950,10989769,10.09
9867827,9974760,3202,1120700,11095460,11.24
9867828,9986703,4157,1454950,11441653,14.57
9867829,9981803,2217,775950,10757753,7.77
9867830,9984529,1569,549150,10533679,5.50
9867831,9298664,2549,892150,10190814,9.59
9867832,2091093,2508,877800,2968893,41.98
9867833,3949699,1414,494900,4444599,12.53
9867834,9967633,2523,883050,10850683,8.86
9867835,9960260,3573,1250550,11210810,12.56
9867836,9970066,3803,1331050,11301116,13.35
9867837,7820722,2683,939050,8759772,12.01
9867838,9973950,5011,1753850,11727800,17.58
9867839,9958011,3483,1219050,11177061,12.24
9867840,9955190,3054,1068900,11024090,10.74
9867841,9943358,2722,952700,10896058,9.58
9867842,936483,342,119700,1056183,12.78
9867843,9947515,3732,1306200,11253715,13.13
9867844,9961913,3569,1249150,11211063,12.54
9867845,9963824,4582,1603700,11567524,16.10
9867846,9953425,2382,833700,10787125,8.38
9867847,9965850,3620,1267000,11232850,12.71
9867848,2942666,708,247800,3190466,8.42
9867849,9949101,3553,1243550,11192651,12.50
9867850,9953354,4260,1491000,11444354,14.98
9867851,9946573,4138,1448300,11394873,14.56
9867852,9936976,2178,762300,10699276,7.67
9867853,9928712,2244,785400,10714112,7.91
9867854,9944325,2327,814450,10758775,8.19
9867855,9933086,2723,953050,10886136,9.59
9867856,9947735,1970,689500,10637235,6.93
9867859,9766988,2140,749000,10515988,7.67
9867860,9936474,2810,983500,10919974,9.90
9867861,743634,606,212100,955734,28.52
9867862,9915565,3015,1055250,10970815,10.64
9867863,9906242,4652,1628200,11534442,16.44
9867864,9913698,3432,1201200,11114898,12.12
9867865,9898829,3560,1246000,11144829,12.59
9867866,1140223,237,82950,1223173,7.27
9867867,9906568,1767,618450,10525018,6.24
9867868,8524741,2896,1013600,9538341,11.89
9867869,9893690,5242,1834700,11728390,18.54
9867870,3149256,2212,774200,3923456,24.58
9867871,9913668,3020,1057000,10970668,10.66
9867872,9919603,3112,1089200,11008803,10.98
9867873,296200,145,50750,346950,17.13
9867874,9892791,2465,862750,10755541,8.72
9867875,2451512,570,199500,2651012,8.14
9867876,9897022,4318,1511300,11408322,15.27
9867877,9893776,3290,1151500,11045276,11.64
9867878,9896459,3248,1136800,11033259,11.49
9867879,9923099,4474,1565900,11488999,15.78
9867880,9918485,2272,795200,10713685,8.02
9867881,9933806,2578,902300,10836106,9.08
9867882,9942216,4974,1740900,11683116,17.51
9867883,9947560,4998,1749300,11696860,17.59
9867884,9947926,3672,1285200,11233126,12.92
9867885,9946212,3035,1062250,11008462,10.68
9867887,9937217,3118,1091300,11028517,10.98
9867888,7523146,3477,1216950,8740096,16.18
9867889,9932732,2555,894250,10826982,9.00
9867890,9952457,4438,1553300,11505757,15.61
9867891,9907533,147,51450,9958983,0.52
9867892,9952017,3847,1346450,11298467,13.53
9867893,9528102,2699,944650,10472752,9.91
9867894,9945159,1754,613900,10559059,6.17
9867895,9965252,3554,1243900,11209152,12.48
9867896,9973293,2628,919800,10893093,9.22
9867897,9972129,5743,2010050,11982179,20.16
9867898,9972859,855,299250,10272109,3.00
9867899,3409232,820,287000,3696232,8.42
9867900,9968450,2713,949550,10918000,9.53
9867901,9967053,2359,825650,10792703,8.28
9867902,9980011,2614,914900,10894911,9.17
9867903,9981335,2478,867300,10848635,8.69
9867904,9922682,54,18900,9941582,0.19
9867905,9985112,4745,1660750,11645862,16.63
9867906,9992797,3661,1281350,11274147,12.82
9867907,9981545,2979,1042650,11024195,10.45
9867908,9983047,2576,901600,10884647,9.03
9867909,9978727,4381,1533350,11512077,15.37
9867910,9989286,2242,784700,10773986,7.86
9867911,9974114,2073,725550,10699664,7.27
9867912,9902271,3617,1265950,11168221,12.78
9867913,9982407,2827,989450,10971857,9.91
9867914,9973448,2789,976150,10949598,9.79
9867915,1250357,316,110600,1360957,8.85
9867916,9961566,2776,971600,10933166,9.75
9867917,1245896,531,185850,1431746,14.92
9867918,9939035,3795,1328250,11267285,13.36
9867919,9919169,2264,792400,10711569,7.99
9867920,9918512,1718,601300,10519812,6.06
9867921,9924362,2386,835100,10759462,8.41
9867922,9908268,3540,1239000,11147268,12.50
9867923,9908937,3772,1320200,11229137,13.32
9867924,4112749,882,308700,4421449,7.51
9867925,9935349,2360,826000,10761349,8.31
9867926,9936909,2545,890750,10827659,8.96
9867927,3064726,1052,368200,3432926,12.01
9867928,6851087,2026,709100,7560187,10.35
9867929,9937073,2353,823550,10760623,8.29
9867930,9929124,1930,675500,10604624,6.80
9867931,9949218,2212,774200,10723418,7.78
9867932,9929626,3930,1375500,11305126,13.85
9867933,9925439,1979,692650,10618089,6.98
9867934,9939808,3757,1314950,11254758,13.23
9867935,8931446,3140,1099000,10030446,12.30
9867936,9947043,3079,1077650,11024693,10.83
9867937,5816181,1699,594650,6410831,10.22
9867938,9968875,4589,1606150,11575025,16.11
9867939,9965075,2092,732200,10697275,7.35
9867940,9991788,2766,968100,10959888,9.69
9867941,9985556,3540,1239000,11224556,12.41
9867942,9971092,3191,1116850,11087942,11.20
9867943,9974974,3567,1248450,11223424,12.52
9867944,9975339,2895,1013250,10988589,10.16
9867945,9959178,3505,1226750,11185928,12.32
9867947,9976232,3242,1134700,11110932,11.37
9867948,9981180,4196,1468600,11449780,14.71
9867949,9974003,1132,396200,10370203,3.97
9867950,9986727,143,50050,10036777,0.50
9867951,9991790,2304,806400,10798190,8.07
9867952,3279111,1944,680400,3959511,20.75
9867953,9958435,1781,623350,10581785,6.26
9867954,9964713,2697,943950,10908663,9.47
9867955,9968050,2632,921200,10889250,9.24
9867956,9978300,2332,816200,10794500,8.18
9867957,9861724,4372,1530200,11391924,15.52
9867958,9971675,2051,717850,10689525,7.20
9867959,9969466,2695,943250,10912716,9.46
9867960,4915578,899,314650,5230228,6.40
9867961,9991676,3037,1062950,11054626,10.64
9867962,9990715,3253,1138550,11129265,11.40
9867963,9990758,2009,703150,10693908,7.04
9867964,9985158,3602,1260700,11245858,12.63
9867965,9983789,3708,1297800,11281589,13.00
9867966,9985171,3090,1081500,11066671,10.83
9867967,2789835,1183,414050,3203885,14.84
9867968,9965393,3047,1066450,11031843,10.70
9867969,2389872,867,303450,2693322,12.70
9867970,9976996,2952,1033200,11010196,10.36
9867971,9972737,3072,1075200,11047937,10.78
9867972,9965487,3383,1184050,11149537,11.88
9867973,9914381,2097,733950,10648331,7.40
9867974,9984931,4459,1560650,11545581,15.63
9867975,9985394,2771,969850,10955244,9.71
9867976,9961808,3347,1171450,11133258,11.76
9867977,9973762,3309,1158150,11131912,11.61
9867978,9990895,3495,1223250,11214145,12.24
9867979,9986671,3337,1167950,11154621,11.70
9867980,9979025,5568,1948800,11927825,19.53
9867981,9976682,3517,1230950,11207632,12.34
9867982,1076136,151,52850,1128986,4.91
9867983,9994882,5465,1912750,11907632,19.14
9867984,9981977,2912,1019200,11001177,10.21
9867985,9978175,1957,684950,10663125,6.86
9867986,9994557,3446,1206100,11200657,12.07
9867987,1051200,259,90650,1141850,8.62
9867988,9979873,3714,1299900,11279773,13.03
9867989,9975890,6236,2182600,12158490,21.88
9867990,9980984,2529,885150,10866134,8.87
9867991,9980435,2480,868000,10848435,8.70
9867992,9989388,3525,1233750,11223138,12.35
9867993,9982546,7880,2758000,12740546,27.63
9867994,9982467,5195,1818250,11800717,18.21
9867995,609853,267,93450,703303,15.32
9867996,9976277,4268,1493800,11470077,14.97
9867997,4436725,2681,938350,5375075,21.15
9867998,9977753,3116,1090600,11068353,10.93
9867999,9968119,4757,1664950,11633069,16.70
9868000,9964503,1844,645400,10609903,6.48
9868001,4553734,2589,906150,5459884,19.90
9868002,9962923,3552,1243200,11206123,12.48
9868003,9950572,2264,792400,10742972,7.96
9868004,9964891,5439,1903650,11868541,19.10
9868005,9970024,3767,1318450,11288474,13.22
9868006,9986915,2355,824250,10811165,8.25
9868007,9956985,3333,1166550,11123535,11.72
9868008,9973163,3542,1239700,11212863,12.43
9868009,9988483,2302,805700,10794183,8.07
9868010,9986293,2576,901600,10887893,9.03
9868011,9983456,3516,1230600,11214056,12.33
9868012,2646038,612,214200,2860238,8.10
9868013,9937366,2316,810600,10747966,8.16
9868014,9979357,3366,1178100,11157457,11.81
9868015,9924491,2831,990850,10915341,9.98
9868016,9942438,1822,637700,10580138,6.41
9868017,7474152,2080,728000,8202152,9.74
9868018,9981884,3760,1316000,11297884,13.18
9868019,9983002,3084,1079400,11062402,10.81
9868020,9999429,2851,997850,10997279,9.98
9868021,9989831,2426,849100,10838931,8.50
9868022,9992636,2954,1033900,11026536,10.35
9868023,9984406,2830,990500,10974906,9.92
9868024,9984289,2217,775950,10760239,7.77
9868026,9971549,4951,1732850,11704399,17.38
9868027,9985505,3145,1100750,11086255,11.02
9868028,9181830,4377,1531950,10713780,16.68
9868029,9991745,4296,1503600,11495345,15.05
9868030,475654,473,165550,641204,34.80
9868031,9938596,2803,981050,10919646,9.87
9868032,9965102,2340,819000,10784102,8.22
9868033,9974496,4635,1622250,11596746,16.26
9868034,9982015,3198,1119300,11101315,11.21
9868035,9989489,1140,399000,10388489,3.99
9868036,9979363,5342,1869700,11849063,18.74
9868037,9987862,2035,712250,10700112,7.13
9868038,9997012,2864,1002400,10999412,10.03
9868039,4071088,1034,361900,4432988,8.89
9868040,9907524,2365,827750,10735274,8.35
9868041,9971031,3444,1205400,11176431,12.09
9868042,9935838,3724,1303400,11239238,13.12
9868043,9975591,4192,1467200,11442791,14.71
9868044,9983322,2024,708400,10691722,7.10
9868045,9988831,2995,1048250,11037081,10.49
9868046,9988826,1611,563850,10552676,5.64
9868047,9987553,3625,1268750,11256303,12.70
9868048,9998552,5019,1756650,11755202,17.57
9868049,274235,121,42350,316585,15.44
9868050,9984243,3194,1117900,11102143,11.20
9868051,9999862,2193,767550,10767412,7.68
9868052,9985370,3830,1340500,11325870,13.42
9868054,9973979,1740,609000,10582979,6.11
9868055,9959924,3335,1167250,11127174,11.72
9868056,9994508,4471,1564850,11559358,15.66
9868057,9986091,2352,823200,10809291,8.24
9868058,9979503,2698,944300,10923803,9.46
9868060,9981118,2923,1023050,11004168,10.25
9868061,9975792,3891,1361850,11337642,13.65
9868062,9980817,2736,957600,10938417,9.59
9868063,9983480,4262,1491700,11475180,14.94
9868064,9974139,1761,616350,10590489,6.18
9868065,9965489,1795,628250,10593739,6.30
9868066,9989261,3584,1254400,11243661,12.56
9868067,752587,93,32550,785137,4.33
9868068,9976512,2529,885150,10861662,8.87
9868070,7385176,2421,847350,8232526,11.47
9868071,9987851,3577,1251950,11239801,12.53
9868072,9982812,3060,1071000,11053812,10.73
9868073,9992253,2511,878850,10871103,8.80
9868074,9985561,3772,1320200,11305761,13.22
9868075,9900514,3749,1312150,11212664,13.25
9868076,9969844,3567,1248450,11218294,12.52
9868077,9978152,1239,433650,10411802,4.35
9868078,3682234,982,343700,4025934,9.33
9868079,9977646,3688,1290800,11268446,12.94
9868080,9888372,1096,383600,10271972,3.88
9868081,9975282,4383,1534050,11509332,15.38
9868082,9954256,1778,622300,10576556,6.25
9868083,9982381,3298,1154300,11136681,11.56
9868084,9594115,805,281750,9875865,2.94
9868085,9975003,380,133000,10108003,1.33
9868086,9375472,771,269850,9645322,2.88
9868087,9965308,550,192500,10157808,1.93
9868088,9978389,411,143850,10122239,1.44
9868089,9971799,917,320950,10292749,3.22
9868090,9986734,1331,465850,10452584,4.66
9868091,9982801,1492,522200,10505001,5.23
9868092,8994635,823,288050,9282685,3.20
9868094,9974165,1264,442400,10416565,4.44
9868095,9971382,2284,799400,10770782,8.02
9868096,9974640,1960,686000,10660640,6.88
9868098,9946702,2020,707000,10653702,7.11
9868099,9975480,3581,1253350,11228830,12.56
9868100,1756375,585,204750,1961125,11.66
9868101,9974239,2835,992250,10966489,9.95
9868102,9976006,3727,1304450,11280456,13.08
9868103,1643214,508,177800,1821014,10.82
9868104,9999544,3637,1272950,11272494,12.73
9868105,9974462,4224,1478400,11452862,14.82
9868106,9986245,3434,1201900,11188145,12.04
9868107,9988887,3792,1327200,11316087,13.29
9868108,868054,200,70000,938054,8.06
9868109,9987663,2096,733600,10721263,7.35
9868110,9982013,1611,563850,10545863,5.65
9868111,3111137,1528,534800,3645937,17.19
9868112,9965711,2719,951650,10917361,9.55
9868113,9951296,3223,1128050,11079346,11.34
9868114,9980083,2702,945700,10925783,9.48
9868115,7713515,1539,538650,8252165,6.98
9868116,9964843,2429,850150,10814993,8.53
9868117,9975675,2295,803250,10778925,8.05
9868118,9981440,3838,1343300,11324740,13.46
9868119,9980050,4089,1431150,11411200,14.34
9868120,9975180,2905,1016750,10991930,10.19
9868121,9967496,5013,1754550,11722046,17.60
9868122,9969925,4655,1629250,11599175,16.34
9868123,9966431,3575,1251250,11217681,12.55
9868124,9963137,3084,1079400,11042537,10.83
9868125,9948297,2276,796600,10744897,8.01
9868126,911643,469,164150,1075793,18.01
9868127,2750706,1555,544250,3294956,19.79
9868128,4872280,1637,572950,5445230,11.76
9868129,9953097,2795,978250,10931347,9.83
9868130,9963897,4298,1504300,11468197,15.10
9868131,9963671,1737,607950,10571621,6.10
9868132,9973262,2351,822850,10796112,8.25
9868133,8905035,2965,1037750,9942785,11.65
9868134,9964640,3474,1215900,11180540,12.20
9868135,9979425,5047,1766450,11745875,17.70
9868136,9982590,3935,1377250,11359840,13.80
9868137,9980621,2287,800450,10781071,8.02
9868138,9994436,2177,761950,10756386,7.62
9868139,9962147,3718,1301300,11263447,13.06
9868140,9994108,2835,992250,10986358,9.93
9868141,9982992,2742,959700,10942692,9.61
9868142,9986471,3067,1073450,11059921,10.75
9868143,9982397,2809,983150,10965547,9.85
9868144,9982744,3828,1339800,11322544,13.42
9868145,9903385,6280,2198000,12101385,22.19
9868146,9989257,2934,1026900,11016157,10.28
9868147,9979860,2305,806750,10786610,8.08
9868148,9978026,3963,1387050,11365076,13.90
9868149,9984272,4912,1719200,11703472,17.22
9868150,9991391,3752,1313200,11304591,13.14
9868151,9876614,2691,941850,10818464,9.54
9868152,9990452,1432,501200,10491652,5.02
9868153,9976836,4442,1554700,11531536,15.58
9868154,9984525,1611,563850,10548375,5.65
9868155,9985029,1658,580300,10565329,5.81
9868156,9998228,2745,960750,10958978,9.61
9868157,9972829,4767,1668450,11641279,16.73
9868158,9958293,2013,704550,10662843,7.08
9868159,9975959,2936,1027600,11003559,10.30
9868160,9980346,2598,909300,10889646,9.11
9868161,8063542,2397,838950,8902492,10.40
9868162,9971482,2611,913850,10885332,9.16
9868163,8975018,4009,1403150,10378168,15.63
9868164,9986614,3791,1326850,11313464,13.29
9868165,9983580,3814,1334900,11318480,13.37
9868166,9982187,2020,707000,10689187,7.08
9868167,9999024,2654,928900,10927924,9.29
9868168,9979543,3263,1142050,11121593,11.44
9868169,9655442,1625,568750,10224192,5.89
9868170,675975,505,176750,852725,26.15
9868171,9971268,3056,1069600,11040868,10.73
9868172,9984139,2240,784000,10768139,7.85
9868173,9979153,1018,356300,10335453,3.57
9868174,9984294,3106,1087100,11071394,10.89
9868175,9987740,3062,1071700,11059440,10.73
9868176,9981559,2292,802200,10783759,8.04
9868177,9994093,3730,1305500,11299593,13.06
9868178,9969890,3032,1061200,11031090,10.64
9868179,9944715,6138,2148300,12093015,21.60
9868180,6752051,4326,1514100,8266151,22.42
9868181,9958773,2677,936950,10895723,9.41
9868182,9975574,5188,1815800,11791374,18.20
9868183,9980357,5214,1824900,11805257,18.28
9868184,9987419,3946,1381100,11368519,13.83
9868185,9976971,2964,1037400,11014371,10.40
9868186,9993623,2187,765450,10759073,7.66
9868187,9976628,3733,1306550,11283178,13.10
9868188,9993901,2923,1023050,11016951,10.24
9868189,9985500,6249,2187150,12172650,21.90
9868190,9988441,1589,556150,10544591,5.57
9868191,9990105,3469,1214150,11204255,12.15
9868192,9964166,3984,1394400,11358566,13.99
9868193,9968126,3689,1291150,11259276,12.95
9868194,9976189,4133,1446550,11422739,14.50
9868195,9988473,3076,1076600,11065073,10.78
9868196,9904996,2875,1006250,10911246,10.16
9868197,9989061,2899,1014650,11003711,10.16
9868198,9960301,2086,730100,10690401,7.33
9868199,9959904,3615,1265250,11225154,12.70
9868200,3218437,2704,946400,4164837,29.41
9868201,9967899,3944,1380400,11348299,13.85
9868202,9516411,4641,1624350,11140761,17.07
9868203,9943680,3770,1319500,11263180,13.27
9868204,6701418,2573,900550,7601968,13.44
9868205,9937784,5279,1847650,11785434,18.59
9868206,9964433,2078,727300,10691733,7.30
9868207,9949615,3629,1270150,11219765,12.77
9868208,9956664,3649,1277150,11233814,12.83
9868209,9956812,4262,1491700,11448512,14.98
9868210,9966333,3859,1350650,11316983,13.55
9868211,9970500,993,347550,10318050,3.49
9868213,9945008,2003,701050,10646058,7.05
9868214,9942228,1592,557200,10499428,5.60
9868215,9964633,4136,1447600,11412233,14.53
9868216,2666419,1072,375200,3041619,14.07
9868217,9954740,4182,1463700,11418440,14.70
9868218,9976432,3802,1330700,11307132,13.34
9868219,9977792,2876,1006600,10984392,10.09
9868220,9121276,2620,917000,10038276,10.05
9868221,1445052,1461,511350,1956402,35.39
9868222,9999916,2478,867300,10867216,8.67
9868223,3802607,1031,360850,4163457,9.49
9868225,9996157,2771,969850,10966007,9.70
9868226,9982449,3546,1241100,11223549,12.43
9868227,9980408,2477,866950,10847358,8.69
9868228,9988090,2333,816550,10804640,8.18
9868229,9990093,2694,942900,10932993,9.44
9868230,9999017,2575,901250,10900267,9.01
9868231,9981445,1628,569800,10551245,5.71
9868232,9981735,3326,1164100,11145835,11.66
9868233,9996645,2405,841750,10838395,8.42
9868234,9978674,2745,960750,10939424,9.63
9868235,9992271,1866,653100,10645371,6.54
9868236,8182003,2534,886900,9068903,10.84
9868237,9981858,2102,735700,10717558,7.37
9868238,9995676,3970,1389500,11385176,13.90
9868239,9975585,1725,603750,10579335,6.05
9868240,9959860,4678,1637300,11597160,16.44
9868241,9976536,4356,1524600,11501136,15.28
9868242,9985713,2662,931700,10917413,9.33
9868244,8915916,3385,1184750,10100666,13.29
9868245,9983552,6797,2378950,12362502,23.83
9868246,9992132,1442,504700,10496832,5.05
9868247,9968750,3722,1302700,11271450,13.07
9868248,9977144,6019,2106650,12083794,21.11
9868249,9978629,1724,603400,10582029,6.05
9868250,9968268,2409,843150,10811418,8.46
9868251,6587306,747,261450,6848756,3.97
9868252,7586664,1185,414750,8001414,5.47
9868253,9971872,739,258650,10230522,2.59
9868254,9945852,1305,456750,10402602,4.59
9868255,9968076,1260,441000,10409076,4.42
9868256,9984336,1515,530250,10514586,5.31
9868257,9985580,1877,656950,10642530,6.58
9868258,9998181,2828,989800,10987981,9.90
9868259,9987849,4076,1426600,11414449,14.28
9868260,9994313,3111,1088850,11083163,10.89
9868261,9982124,4957,1734950,11717074,17.38
9868262,9986128,5061,1771350,11757478,17.74
9868264,9980489,3878,1357300,11337789,13.60
9868265,9963763,3404,1191400,11155163,11.96
9868266,9978479,5525,1933750,11912229,19.38
9868267,9986033,4395,1538250,11524283,15.40
9868268,9988185,3175,1111250,11099435,11.13
9868269,9990488,2642,924700,10915188,9.26
9868270,9981260,2130,745500,10726760,7.47
9868271,9979324,3350,1172500,11151824,11.75
9868272,9966053,2536,887600,10853653,8.91
9868273,9965669,2551,892850,10858519,8.96
9868275,9961263,4933,1726550,11687813,17.33
9868276,9951351,3520,1232000,11183351,12.38
9868277,9934007,3972,1390200,11324207,13.99
9868278,9947649,3260,1141000,11088649,11.47
9868279,9952082,3345,1170750,11122832,11.76
9868280,1466629,541,189350,1655979,12.91
9868281,9943092,2456,859600,10802692,8.65
9868282,9965024,1149,402150,10367174,4.04
9868283,9967561,4565,1597750,11565311,16.03
9868284,9955532,4265,1492750,11448282,14.99
9868285,9975837,3824,1338400,11314237,13.42
9868286,9965531,2831,990850,10956381,9.94
9868287,9978198,1924,673400,10651598,6.75
9868288,9772076,3952,1383200,11155276,14.15
9868289,9986886,3216,1125600,11112486,11.27
9868290,9993215,2512,879200,10872415,8.80
9868291,9972480,4761,1666350,11638830,16.71
9868292,9984420,2651,927850,10912270,9.29
9868293,9994554,5066,1773100,11767654,17.74
9868294,9997350,2653,928550,10925900,9.29
9868295,9985789,2199,769650,10755439,7.71
9868296,9982152,1685,589750,10571902,5.91
9868297,9956423,4337,1517950,11474373,15.25
9868298,9995112,3802,1330700,11325812,13.31
9868299,9987245,3984,1394400,11381645,13.96
9868300,9991189,3093,1082550,11073739,10.84
9868301,9977286,4799,1679650,11656936,16.83
9868302,9979695,3357,1174950,11154645,11.77
9868303,9978103,2227,779450,10757553,7.81
9868304,9981586,3900,1365000,11346586,13.68
9868305,9972940,1553,543550,10516490,5.45
9868306,9985718,3600,1260000,11245718,12.62
9868307,9999980,2569,899150,10899130,8.99
9868308,9969853,2652,928200,10898053,9.31
9868309,9983895,3016,1055600,11039495,10.57
9868311,9974106,3547,1241450,11215556,12.45
9868312,9982661,2166,758100,10740761,7.59
9868313,9976814,2452,858200,10835014,8.60
9868314,9986801,3923,1373050,11359851,13.75
9868315,9987869,3649,1277150,11265019,12.79
9868316,9987348,2673,935550,10922898,9.37
9868319,3021352,1288,450800,3472152,14.92
9868320,9954151,4533,1586550,11540701,15.94
9868321,9970060,4212,1474200,11444260,14.79
9868322,9982200,3718,1301300,11283500,13.04
9868323,9984837,3383,1184050,11168887,11.86
9868324,9969387,4597,1608950,11578337,16.14
9868325,9677888,2701,945350,10623238,9.77
9868326,9977891,2079,727650,10705541,7.29
9868327,9981863,3589,1256150,11238013,12.58
9868328,9873044,1499,524650,10397694,5.31
9868329,9981467,4697,1643950,11625417,16.47
9868330,9997441,3696,1293600,11291041,12.94
9868331,9985933,1561,546350,10532283,5.47
9868332,9994797,3091,1081850,11076647,10.82
9868333,9976331,3345,1170750,11147081,11.74
9868334,9977459,2535,887250,10864709,8.89
9868335,9986134,4416,1545600,11531734,15.48
9868336,9989076,1717,600950,10590026,6.02
9868337,8912950,1202,420700,9333650,4.72
9868338,7767490,2825,988750,8756240,12.73
9868339,9969587,3821,1337350,11306937,13.41
9868340,9963126,2390,836500,10799626,8.40
9868341,1587435,807,282450,1869885,17.79
9868342,9963680,3824,1338400,11302080,13.43
9868343,9961556,3002,1050700,11012256,10.55
9868344,9954906,4190,1466500,11421406,14.73
9868345,9984063,4236,1482600,11466663,14.85
9868346,9984932,4041,1414350,11399282,14.16
9868347,9982339,805,281750,10264089,2.82
9868348,9989897,2741,959350,10949247,9.60
9868349,9929258,2964,1037400,10966658,10.45
9868350,9970849,3847,1346450,11317299,13.50
9868352,9749715,2966,1038100,10787815,10.65
9868353,9972424,4475,1566250,11538674,15.71
9868354,9971909,4390,1536500,11508409,15.41
9868355,9980273,2629,920150,10900423,9.22
9868356,990122,372,130200,1120322,13.15
9868357,9968281,281,98350,10066631,0.99
9868358,9980788,3372,1180200,11160988,11.82
9868359,9988857,3704,1296400,11285257,12.98
9868360,9995832,1903,666050,10661882,6.66
9868361,9982632,3401,1190350,11172982,11.92
9868362,9974564,3399,1189650,11164214,11.93
9868363,9991700,4010,1403500,11395200,14.05
9868364,4918256,1495,523250,5441506,10.64
9868365,9971585,2724,953400,10924985,9.56
9868366,6362166,1707,597450,6959616,9.39
9868367,9944897,3293,1152550,11097447,11.59
9868368,9950068,4699,1644650,11594718,16.53
9868369,9944530,2325,813750,10758280,8.18
9868370,9948191,3835,1342250,11290441,13.49
9868371,6297133,1733,606550,6903683,9.63
9868372,9961713,4961,1736350,11698063,17.43
9868373,9947077,1302,455700,10402777,4.58
9868374,9938170,3081,1078350,11016520,10.85
9868375,1423115,359,125650,1548765,8.83
9868376,4258032,1040,364000,4622032,8.55
9868377,9966782,2603,911050,10877832,9.14
9868378,9989347,2065,722750,10712097,7.24
9868379,9995608,2546,891100,10886708,8.91
9868380,9985978,1600,560000,10545978,5.61
9868381,9975723,1825,638750,10614473,6.40
9868382,9982722,2911,1018850,11001572,10.21
9868383,9986043,3777,1321950,11307993,13.24
9868384,9994905,2783,974050,10968955,9.75
9868385,9999707,453,158550,10158257,1.59
9868386,9988037,2537,887950,10875987,8.89
9868387,9990799,4943,1730050,11720849,17.32
9868388,9997222,3876,1356600,11353822,13.57
9868389,9998561,2726,954100,10952661,9.54
9868390,9972673,2112,739200,10711873,7.41
9868391,9961175,420,147000,10108175,1.48
9868392,9973733,4038,1413300,11387033,14.17
9868393,9984915,5563,1947050,11931965,19.50
9868394,9990698,2310,808500,10799198,8.09
9868395,9982531,5859,2050650,12033181,20.54
9868396,9382465,4318,1511300,10893765,16.11
9868397,9973787,2798,979300,10953087,9.82
9868398,1316363,582,203700,1520063,15.47
9868399,9988585,773,270550,10259135,2.71
9868400,9964903,1810,633500,10598403,6.36
9868401,9251048,5907,2067450,11318498,22.35
9868402,9645662,3573,1250550,10896212,12.96
9868403,9973712,3423,1198050,11171762,12.01
9868404,9989750,1898,664300,10654050,6.65
9868405,2562990,1969,689150,3252140,26.89
9868406,9966900,1258,440300,10407200,4.42
9868407,1932264,898,314300,2246564,16.27
9868408,9964328,3622,1267700,11232028,12.72
9868409,9964380,4763,1667050,11631430,16.73
9868410,9986948,3495,1223250,11210198,12.25
9868411,9978508,3762,1316700,11295208,13.20
9868412,9976551,3416,1195600,11172151,11.98
9868413,9960180,921,322350,10282530,3.24
9868414,9979793,4029,1410150,11389943,14.13
9868415,9964657,3696,1293600,11258257,12.98
9868416,9970289,3627,1269450,11239739,12.73
9868417,9970392,2066,723100,10693492,7.25
9868418,9969027,4751,1662850,11631877,16.68
9868419,4350180,2731,955850,5306030,21.97
9868420,1014404,362,126700,1141104,12.49
9868421,9945088,4748,1661800,11606888,16.71
9868422,9929516,3153,1103550,11033066,11.11
9868423,9918879,2574,900900,10819779,9.08
9868424,2385654,3635,1272250,3657904,53.33
9868425,9917487,4131,1445850,11363337,14.58
9868426,9904916,4468,1563800,11468716,15.79
9868427,9910439,1707,597450,10507889,6.03
9868428,9919024,5503,1926050,11845074,19.42
9868429,9911836,3000,1050000,10961836,10.59
9868430,9926057,2590,906500,10832557,9.13
9868431,9934294,1439,503650,10437944,5.07
9868432,3140804,657,229950,3370754,7.32
9868433,9962479,3998,1399300,11361779,14.05
9868434,9952281,2338,818300,10770581,8.22
9868435,9961478,3050,1067500,11028978,10.72
9868436,9942935,5069,1774150,11717085,17.84
9868437,9924238,2356,824600,10748838,8.31
9868438,9976534,3564,1247400,11223934,12.50
9868439,9189107,3232,1131200,10320307,12.31
9868440,9980659,4112,1439200,11419859,14.42
9868441,9961533,3805,1331750,11293283,13.37
9868442,9968544,4062,1421700,11390244,14.26
9868443,9976901,2139,748650,10725551,7.50
9868444,9997706,5305,1856750,11854456,18.57
9868445,5490700,3660,1281000,6771700,23.33
9868447,777951,388,135800,913751,17.46
9868448,9979299,1849,647150,10626449,6.48
9868449,9968013,4382,1533700,11501713,15.39
9868450,8711696,4028,1409800,10121496,16.18
9868451,9994137,5444,1905400,11899537,19.07
9868452,9986761,4054,1418900,11405661,14.21
9868453,9988141,3534,1236900,11225041,12.38
9868454,9938503,3544,1240400,11178903,12.48
9868455,9991114,1722,602700,10593814,6.03
9868456,9995831,4131,1445850,11441681,14.46
9868457,9985813,4971,1739850,11725663,17.42
9868458,6574575,1657,579950,7154525,8.82
9868459,9990101,1657,579950,10570051,5.81
9868460,9981509,1784,624400,10605909,6.26
9868461,9996905,1665,582750,10579655,5.83
9868462,9967927,3461,1211350,11179277,12.15
9868463,9983341,6070,2124500,12107841,21.28
9868464,9999940,2704,946400,10946340,9.46
9868465,9983025,1715,600250,10583275,6.01
9868466,9978593,2017,705950,10684543,7.07
9868467,9991090,3617,1265950,11257040,12.67
9868468,1876683,607,212450,2089133,11.32
9868469,6882990,3354,1173900,8056890,17.06
9868470,9988253,3589,1256150,11244403,12.58
9868471,4471163,1300,455000,4926163,10.18
9868472,9971095,2902,1015700,10986795,10.19
9868473,9981368,2849,997150,10978518,9.99
9868474,9985234,3585,1254750,11239984,12.57
9868475,7012859,2687,940450,7953309,13.41
9868477,9972365,2264,792400,10764765,7.95
9868478,9975167,2926,1024100,10999267,10.27
9868479,9991131,3592,1257200,11248331,12.58
9868480,9988325,3019,1056650,11044975,10.58
9868481,1336602,323,113050,1449652,8.46
9868482,9969506,3111,1088850,11058356,10.92
9868483,3401610,4351,1522850,4924460,44.77
9868484,9975405,1852,648200,10623605,6.50
9868485,6077887,2461,861350,6939237,14.17
9868486,9945704,3238,1133300,11079004,11.39
9868487,9950747,4618,1616300,11567047,16.24
9868488,9977508,4192,1467200,11444708,14.71
9868489,9961813,5246,1836100,11797913,18.43
9868490,9776897,2698,944300,10721197,9.66
9868491,9984104,3953,1383550,11367654,13.86
9868492,9631078,3787,1325450,10956528,13.76
9868493,9980608,1516,530600,10511208,5.32
9868494,9971373,3256,1139600,11110973,11.43
9868495,9992871,4126,1444100,11436971,14.45
9868496,1948640,671,234850,2183490,12.05
9868497,9970350,2392,837200,10807550,8.40
9868498,9983128,3071,1074850,11057978,10.77
9868499,9985533,1603,561050,10546583,5.62
9868500,9974719,1960,686000,10660719,6.88
9868501,9985502,4110,1438500,11424002,14.41
9868502,9964530,2906,1017100,10981630,10.21
9868504,9964759,2862,1001700,10966459,10.05
9868505,9980342,4543,1590050,11570392,15.93
9868506,9982756,4863,1702050,11684806,17.05
9868507,9994066,4010,1403500,11397566,14.04
9868508,9988087,2048,716800,10704887,7.18
9868509,9992180,4086,1430100,11422280,14.31
9868510,9971833,2650,927500,10899333,9.30
9868511,9976041,4811,1683850,11659891,16.88
9868513,9974108,2844,995400,10969508,9.98
9868514,9974045,2883,1009050,10983095,10.12
9868515,9988165,3519,1231650,11219815,12.33
9868516,9988057,1722,602700,10590757,6.03
9868517,9993200,3623,1268050,11261250,12.69
9868518,9969542,3882,1358700,11328242,13.63
9868519,9964201,2591,906850,10871051,9.10
9868520,5309807,1812,634200,5944007,11.94
9868521,9801948,3860,1351000,11152948,13.78
9868522,9949125,4884,1709400,11658525,17.18
9868523,9938705,1716,600600,10539305,6.04
9868524,9955737,2197,768950,10724687,7.72
9868525,9943048,3285,1149750,11092798,11.56
9868526,9937812,3809,1333150,11270962,13.41
9868527,3993596,1357,474950,4468546,11.89
9868528,9943621,5507,1927450,11871071,19.38
9868529,9935586,3440,1204000,11139586,12.12
9868531,9899533,1936,677600,10577133,6.84
9868532,9935129,3309,1158150,11093279,11.66
9868533,9934398,4175,1461250,11395648,14.71
9868534,9959642,3065,1072750,11032392,10.77
9868535,9947650,2874,1005900,10953550,10.11
9868536,9933474,3303,1156050,11089524,11.64
9868537,9953974,2209,773150,10727124,7.77
9868538,9955902,3347,1171450,11127352,11.77
9868539,9910968,1706,597100,10508068,6.02
9868540,9942667,3072,1075200,11017867,10.81
9868541,9965097,4599,1609650,11574747,16.15
9868543,9948594,4846,1696100,11644694,17.05
9868544,9942434,5623,1968050,11910484,19.79
9868545,3602359,1108,387800,3990159,10.77
9868546,9937731,3353,1173550,11111281,11.81
9868547,1794125,523,183050,1977175,10.20
9868548,9915879,2913,1019550,10935429,10.28
9868549,9903515,2494,872900,10776415,8.81
9868550,4192182,1509,528150,4720332,12.60
9868551,9902049,4492,1572200,11474249,15.88
9868552,9906658,1446,506100,10412758,5.11
9868553,780155,517,180950,961105,23.19
9868554,1398313,454,158900,1557213,11.36
9868555,9902948,3555,1244250,11147198,12.56
9868556,9921082,2618,916300,10837382,9.24
9868557,9900715,3645,1275750,11176465,12.89
9868558,9906691,2038,713300,10619991,7.20
9868559,9893442,2759,965650,10859092,9.76
9868560,9896809,4094,1432900,11329709,14.48
9868561,2675426,1245,435750,3111176,16.29
9868562,9920942,2638,923300,10844242,9.31
9868563,9916288,5294,1852900,11769188,18.69
9868564,9924368,3449,1207150,11131518,12.16
9868565,1478302,1073,375550,1853852,25.40
9868566,9909289,2480,868000,10777289,8.76
9868567,9909975,3673,1285550,11195525,12.97
9868568,9895333,4676,1636600,11531933,16.54
9868569,9901658,3416,1195600,11097258,12.07
9868570,9682396,3431,1200850,10883246,12.40
9868571,9916178,2685,939750,10855928,9.48
9868572,9927947,3178,1112300,11040247,11.20
9868573,9942701,2647,926450,10869151,9.32
9868574,9937728,3883,1359050,11296778,13.68
9868575,9946180,2527,884450,10830630,8.89
9868576,9953235,3577,1251950,11205185,12.58
9868577,9956625,5285,1849750,11806375,18.58
9868578,9957194,3142,1099700,11056894,11.04
9868579,9941200,2763,967050,10908250,9.73
9868580,9943569,3239,1133650,11077219,11.40
9868581,9949130,3873,1355550,11304680,13.62
9868582,9929121,4851,1697850,11626971,17.10
9868583,9944759,3330,1165500,11110259,11.72
9868584,9933202,6188,2165800,12099002,21.80
9868585,9931217,277,96950,10028167,0.98
9868586,1946020,1142,399700,2345720,20.54
9868587,9934931,3345,1170750,11105681,11.78
9868588,9935674,2144,750400,10686074,7.55
9868589,9875957,3694,1292900,11168857,13.09
9868590,9879022,4127,1444450,11323472,14.62
9868591,9975176,4019,1406650,11381826,14.10
9868592,9964262,3002,1050700,11014962,10.54
9868593,9952009,1844,645400,10597409,6.49
9868595,9969310,3736,1307600,11276910,13.12
9868596,9965036,4892,1712200,11677236,17.18
9868597,9963150,3019,1056650,11019800,10.61
9868598,9961513,3568,1248800,11210313,12.54
9868599,1219962,846,296100,1516062,24.27
9868600,1615532,571,199850,1815382,12.37
9868601,9976233,3583,1254050,11230283,12.57
9868602,9993648,4021,1407350,11400998,14.08
9868603,9990224,4198,1469300,11459524,14.71
9868604,9984018,2609,913150,10897168,9.15
9868605,9949780,6053,2118550,12068330,21.29
9868606,9980214,3267,1143450,11123664,11.46
9868607,9993374,1764,617400,10610774,6.18
9868608,9988667,1932,676200,10664867,6.77
9868609,582402,169,59150,641552,10.16
9868610,5098805,374,130900,5229705,2.57
9868611,9977034,3387,1185450,11162484,11.88
9868612,9975147,4081,1428350,11403497,14.32
9868613,9995887,2694,942900,10938787,9.43
9868614,9999523,3256,1139600,11139123,11.40
9868615,9986527,3271,1144850,11131377,11.46
9868616,9996424,3118,1091300,11087724,10.92
9868618,5859910,893,312550,6172460,5.33
9868619,9997033,3743,1310050,11307083,13.10
9868620,9987463,1883,659050,10646513,6.60
9868621,9972473,2093,732550,10705023,7.35
9868622,9966626,3031,1060850,11027476,10.64
9868623,9960294,3017,1055950,11016244,10.60
9868624,9965008,6948,2431800,12396808,24.40
9868625,9979458,1942,679700,10659158,6.81
9868626,9974073,1898,664300,10638373,6.66
9868627,9973814,1392,487200,10461014,4.88
9868628,9974051,3124,1093400,11067451,10.96
9868629,9967610,3314,1159900,11127510,11.64
9868630,9986455,3801,1330350,11316805,13.32
9868631,9982997,3256,1139600,11122597,11.42
9868632,4896555,1211,423850,5320405,8.66
9868633,3084764,1122,392700,3477464,12.73
9868634,9969214,1696,593600,10562814,5.95
9868635,9938994,2953,1033550,10972544,10.40
9868636,9977216,2702,945700,10922916,9.48
9868637,9973800,2767,968450,10942250,9.71
9868638,9953442,3673,1285550,11238992,12.92
9868639,3369454,1058,370300,3739754,10.99
9868640,2982938,1232,431200,3414138,14.46
9868641,9994303,2529,885150,10879453,8.86
9868642,9985216,3129,1095150,11080366,10.97
9868643,9972664,3383,1184050,11156714,11.87
9868644,9777568,1946,681100,10458668,6.97
9868645,9989124,2464,862400,10851524,8.63
9868646,5690842,1569,549150,6239992,9.65
9868647,9999990,1227,429450,10429440,4.29
9868648,9981182,3705,1296750,11277932,12.99
9868650,9965095,1422,497700,10462795,4.99
9868651,8980042,4473,1565550,10545592,17.43
9868652,9980575,1551,542850,10523425,5.44
9868653,9972726,5048,1766800,11739526,17.72
9868654,9993124,3463,1212050,11205174,12.13
9868657,9979477,2772,970200,10949677,9.72
9868658,9985159,3570,1249500,11234659,12.51
9868659,9981583,2907,1017450,10999033,10.19
9868660,9977334,2013,704550,10681884,7.06
9868661,9985280,4417,1545950,11531230,15.48
9868662,9970319,1661,581350,10551669,5.83
9868663,5353980,2065,722750,6076730,13.50
9868664,3938205,2063,722050,4660255,18.33
9868665,9980265,2976,1041600,11021865,10.44
9868666,9973430,3994,1397900,11371330,14.02
9868667,9979208,3602,1260700,11239908,12.63
9868668,9989477,3007,1052450,11041927,10.54
9868669,9987019,3380,1183000,11170019,11.85
9868670,9986154,3467,1213450,11199604,12.15
9868671,9986679,5125,1793750,11780429,17.96
9868672,763453,163,57050,820503,7.47
9868673,9964331,3346,1171100,11135431,11.75
9868674,9950430,2823,988050,10938480,9.93
9868675,9956857,3514,1229900,11186757,12.35
9868676,8241367,1630,570500,8811867,6.92
9868677,9974107,4302,1505700,11479807,15.10
9868678,9980301,3546,1241100,11221401,12.44
9868679,9989806,3709,1298150,11287956,12.99
9868680,4489195,1199,419650,4908845,9.35
9868681,9967015,2522,882700,10849715,8.86
9868682,9969178,770,269500,10238678,2.70
9868683,9972103,1187,415450,10387553,4.17
9868684,9953446,1290,451500,10404946,4.54
9868685,9899305,4804,1681400,11580705,16.99
9868686,9978114,2343,820050,10798164,8.22
9868687,9980098,3143,1100050,11080148,11.02
9868688,9970605,1400,490000,10460605,4.91
9868689,9908392,4750,1662500,11570892,16.78
9868690,9983359,2624,918400,10901759,9.20
9868691,9975839,1880,658000,10633839,6.60
9868692,9990826,2809,983150,10973976,9.84
9868693,9964537,2130,745500,10710037,7.48
9868694,9972329,3426,1199100,11171429,12.02
9868695,2410045,2236,782600,3192645,32.47
9868696,1095643,383,134050,1229693,12.23
9868697,9959441,3064,1072400,11031841,10.77
9868698,9963422,2439,853650,10817072,8.57
9868699,9967442,2270,794500,10761942,7.97
9868700,9978498,2872,1005200,10983698,10.07
9868701,180615,42,14700,195315,8.14
9868702,808878,180,63000,871878,7.79
9868704,9919986,3699,1294650,11214636,13.05
9868705,9955290,1562,546700,10501990,5.49
9868706,4967729,1607,562450,5530179,11.32
9868707,4556639,1802,630700,5187339,13.84
9868708,9942464,1785,624750,10567214,6.28
9868709,9933780,2569,899150,10832930,9.05
9868710,9933559,1615,565250,10498809,5.69
9868711,9884047,1386,485100,10369147,4.91
9868712,9933139,2260,791000,10724139,7.96
9868713,7775271,1494,522900,8298171,6.73
9868714,9899537,1736,607600,10507137,6.14
9868715,9119980,3091,1081850,10201830,11.86
9868716,9943052,3214,1124900,11067952,11.31
9868717,9919411,3337,1167950,11087361,11.77
9868718,9896719,3082,1078700,10975419,10.90
9868719,9924634,1778,622300,10546934,6.27
9868720,9948507,2729,955150,10903657,9.60
9868721,9899125,3459,1210650,11109775,12.23
9868722,9933247,2919,1021650,10954897,10.29
9868723,623385,278,97300,720685,15.61
9868724,3898211,1222,427700,4325911,10.97
9868725,6799960,2230,780500,7580460,11.48
9868726,4693266,1490,521500,5214766,11.11
9868727,9927808,3985,1394750,11322558,14.05
9868728,9944745,1546,541100,10485845,5.44
9868729,1251746,469,164150,1415896,13.11
9868730,9954090,2208,772800,10726890,7.76
9868731,9944156,1323,463050,10407206,4.66
9868732,9946464,3796,1328600,11275064,13.36
9868733,9961971,2090,731500,10693471,7.34
9868734,9898465,2320,812000,10710465,8.20
9868735,1631456,1059,370650,2002106,22.72
9868736,9969444,3428,1199800,11169244,12.03
9868737,702001,354,123900,825901,17.65
9868738,9956747,1840,644000,10600747,6.47
9868739,9978754,3998,1399300,11378054,14.02
9868740,9939156,2125,743750,10682906,7.48
9868741,9959734,1888,660800,10620534,6.63
9868742,9951426,3031,1060850,11012276,10.66
9868743,9970631,4230,1480500,11451131,14.85
9868744,9968068,4092,1432200,11400268,14.37
9868745,9979446,3543,1240050,11219496,12.43
9868746,9979094,1836,642600,10621694,6.44
9868747,9995441,1562,546700,10542141,5.47
9868748,9985664,2898,1014300,10999964,10.16
9868749,186483,97,33950,220433,18.21
9868750,9970675,4906,1717100,11687775,17.22
9868751,9982413,3303,1156050,11138463,11.58
9868752,9949689,4634,1621900,11571589,16.30
9868753,9976888,3565,1247750,11224638,12.51
9868754,9964368,2996,1048600,11012968,10.52
9868755,9890400,4147,1451450,11341850,14.68
9868756,9957278,3650,1277500,11234778,12.83
9868757,9931801,3032,1061200,10993001,10.68
9868758,642173,212,74200,716373,11.55
9868759,9969151,5026,1759100,11728251,17.65
9868760,9986959,1703,596050,10583009,5.97
9868761,604755,414,144900,749655,23.96
9868762,9960043,1669,584150,10544193,5.86
9868763,9957860,2517,880950,10838810,8.85
9868764,9958936,2600,910000,10868936,9.14
9868765,9973368,2296,803600,10776968,8.06
9868766,9982634,2880,1008000,10990634,10.10
9868767,9981801,2563,897050,10878851,8.99
9868768,9983934,2929,1025150,11009084,10.27
9868769,9980415,1320,462000,10442415,4.63
9868770,9984526,2946,1031100,11015626,10.33
9868771,9971366,2829,990150,10961516,9.93
9868772,9976580,2375,831250,10807830,8.33
9868773,9962984,3735,1307250,11270234,13.12
9868774,9983128,1395,488250,10471378,4.89
9868775,9975659,2595,908250,10883909,9.10
9868776,9981684,2623,918050,10899734,9.20
9868777,9988985,3394,1187900,11176885,11.89
9868778,9982008,2477,866950,10848958,8.69
9868779,9980156,2327,814450,10794606,8.16
9868780,9993735,2870,1004500,10998235,10.05
9868781,9987193,2476,866600,10853793,8.68
9868782,9987328,2531,885850,10873178,8.87
9868783,9991380,3101,1085350,11076730,10.86
9868784,9984863,3800,1330000,11314863,13.32
9868785,9970573,3444,1205400,11175973,12.09
9868786,9987116,2392,837200,10824316,8.38
9868787,9960161,3465,1212750,11172911,12.18
9868788,9974899,2425,848750,10823649,8.51
9868789,9971462,3642,1274700,11246162,12.78
9868790,9985218,2375,831250,10816468,8.32
9868791,9994635,1313,459550,10454185,4.60
9868792,9980731,4252,1488200,11468931,14.91
9868793,9974542,1505,526750,10501292,5.28
9868794,9974173,3452,1208200,11182373,12.11
9868795,9986799,3840,1344000,11330799,13.46
9868796,9993886,2737,957950,10951836,9.59
9868797,9973487,2870,1004500,10977987,10.07
9868798,9981289,4532,1586200,11567489,15.89
9868799,8906101,3823,1338050,10244151,15.02
9868800,9990153,2640,924000,10914153,9.25
9868801,9985661,2372,830200,10815861,8.31
9868802,8793122,3399,1189650,9982772,13.53
9868803,9983656,1909,668150,10651806,6.69
9868804,9983795,4420,1547000,11530795,15.50
9868805,9972622,1292,452200,10424822,4.53
9868806,5654453,1952,683200,6337653,12.08
9868807,9966267,2990,1046500,11012767,10.50
9868808,9977086,1855,649250,10626336,6.51
9868809,9989823,3066,1073100,11062923,10.74
9868811,9972955,4007,1402450,11375405,14.06
9868812,9997776,3774,1320900,11318676,13.21
9868813,9999132,2197,768950,10768082,7.69
9868814,9992068,1136,397600,10389668,3.98
9868815,9987670,3581,1253350,11241020,12.55
9868816,9995771,1405,491750,10487521,4.92
9868817,9748947,4424,1548400,11297347,15.88
9868818,9993091,3773,1320550,11313641,13.21
9868819,9992445,1337,467950,10460395,4.68
9868820,9986206,2734,956900,10943106,9.58
9868821,9986611,4523,1583050,11569661,15.85
9868822,9977028,3609,1263150,11240178,12.66
9868823,4386987,1052,368200,4755187,8.39
9868824,9914614,4188,1465800,11380414,14.78
9868825,9986349,2706,947100,10933449,9.48
9868826,9995718,4212,1474200,11469918,14.75
9868827,9985538,1890,661500,10647038,6.62
9868828,9995154,2876,1006600,11001754,10.07
9868829,9998177,2731,955850,10954027,9.56
9868830,9976361,3093,1082550,11058911,10.85
9868831,9960202,807,282450,10242652,2.84
9868832,9975869,2640,924000,10899869,9.26
9868833,9979356,3326,1164100,11143456,11.67
9868834,9984510,4046,1416100,11400610,14.18
9868835,9987176,2530,885500,10872676,8.87
9868836,9888576,3866,1353100,11241676,13.68
9868837,9983915,2153,753550,10737465,7.55
9868838,9979119,2178,762300,10741419,7.64
9868839,9982331,2328,814800,10797131,8.16
9868840,9997906,4592,1607200,11605106,16.08
9868841,9684865,1881,658350,10343215,6.80
9868842,9982673,3853,1348550,11331223,13.51
9868844,9976426,2171,759850,10736276,7.62
9868845,9958889,2861,1001350,10960239,10.05
9868846,9976733,3959,1385650,11362383,13.89
9868847,9949699,2541,889350,10839049,8.94
9868848,9988696,2882,1008700,10997396,10.10
9868849,8251095,3019,1056650,9307745,12.81
9868850,9998720,2498,874300,10873020,8.74
9868851,9979316,3439,1203650,11182966,12.06
9868852,9985634,900,315000,10300634,3.15
9868853,9966133,3093,1082550,11048683,10.86
9868854,9981953,2249,787150,10769103,7.89
9868855,9976095,2211,773850,10749945,7.76
9868856,9970500,1275,446250,10416750,4.48
9868857,9979401,2910,1018500,10997901,10.21
9868858,9968630,3740,1309000,11277630,13.13
9868859,9994363,2544,890400,10884763,8.91
9868860,9980065,3651,1277850,11257915,12.80
9868861,7061964,2902,1015700,8077664,14.38
9868862,9990300,3040,1064000,11054300,10.65
9868863,9970398,3801,1330350,11300748,13.34
9868864,9981147,4812,1684200,11665347,16.87
9868865,9971230,3433,1201550,11172780,12.05
9868866,9993391,3996,1398600,11391991,14.00
9868867,9994746,5937,2077950,12072696,20.79
9868868,9999865,3833,1341550,11341415,13.42
9868869,9983235,3453,1208550,11191785,12.11
9868870,9962269,2500,875000,10837269,8.78
9868871,5406955,2970,1039500,6446455,19.23
9868872,3045932,3866,1353100,4399032,44.42
9868873,9935951,3984,1394400,11330351,14.03
9868874,9939984,2644,925400,10865384,9.31
9868875,2271624,529,185150,2456774,8.15
9868876,9948436,3449,1207150,11155586,12.13
9868877,9954434,3478,1217300,11171734,12.23
9868878,9960526,2209,773150,10733676,7.76
9868879,9976274,3621,1267350,11243624,12.70
9868880,9974624,2587,905450,10880074,9.08
9868881,9974881,1255,439250,10414131,4.40
9868882,9958759,1705,596750,10555509,5.99
9868883,8814010,1168,408800,9222810,4.64
9868885,9978559,2764,967400,10945959,9.69
9868886,9970520,2484,869400,10839920,8.72
9868887,9963773,3752,1313200,11276973,13.18
9868888,9958143,2679,937650,10895793,9.42
9868889,9982622,3038,1063300,11045922,10.65
9868890,9984291,3137,1097950,11082241,11.00
9868892,9478121,2432,851200,10329321,8.98
9868893,9979123,4508,1577800,11556923,15.81
9868894,9992314,1171,409850,10402164,4.10
9868895,9998270,2270,794500,10792770,7.95
9868896,9981231,1965,687750,10668981,6.89
9868897,9961645,3387,1185450,11147095,11.90
9868898,397728,101,35350,433078,8.89
9868899,5339884,1697,593950,5933834,11.12
9868900,9975185,3189,1116150,11091335,11.19
9868901,9972718,3125,1093750,11066468,10.97
9868902,3573117,1248,436800,4009917,12.22
9868903,9941614,1784,624400,10566014,6.28
9868904,9949679,3590,1256500,11206179,12.63
9868905,9993392,2640,924000,10917392,9.25
9868906,9974248,3492,1222200,11196448,12.25
9868907,9976285,3538,1238300,11214585,12.41
9868909,2355204,871,304850,2660054,12.94
9868910,9978602,3253,1138550,11117152,11.41
9868911,9928173,3265,1142750,11070923,11.51
9868912,9996983,1772,620200,10617183,6.20
9868913,9987763,3396,1188600,11176363,11.90
9868914,9988428,3387,1185450,11173878,11.87
9868915,9979240,2626,919100,10898340,9.21
9868916,9983811,3478,1217300,11201111,12.19
9868917,9978566,2024,708400,10686966,7.10
9868918,9971506,4371,1529850,11501356,15.34
9868919,9948330,3770,1319500,11267830,13.26
9868921,9951640,4689,1641150,11592790,16.49
9868922,9935401,3586,1255100,11190501,12.63
9868923,9962037,1733,606550,10568587,6.09
9868924,4764636,1148,401800,5166436,8.43
9868925,9963762,3903,1366050,11329812,13.71
9868926,9951564,3437,1202950,11154514,12.09
9868927,9964409,5535,1937250,11901659,19.44
9868928,9966137,4330,1515500,11481637,15.21
9868929,673149,257,89950,763099,13.36
9868930,4828296,1399,489650,5317946,10.14
9868931,3862886,1057,369950,4232836,9.58
9868932,9935153,1949,682150,10617303,6.87
9868933,6356136,1210,423500,6779636,6.66
9868934,9962714,2760,966000,10928714,9.70
9868935,9961552,3341,1169350,11130902,11.74
9868936,2238691,584,204400,2443091,9.13
9868937,9955684,1474,515900,10471584,5.18
9868938,8732573,3627,1269450,10002023,14.54
9868939,9969475,3678,1287300,11256775,12.91
9868940,6427250,1464,512400,6939650,7.97
9868941,9969845,2766,968100,10937945,9.71
9868942,9978644,2652,928200,10906844,9.30
9868943,9985540,4237,1482950,11468490,14.85
9868944,1798992,505,176750,1975742,9.82
9868945,9968348,4270,1494500,11462848,14.99
9868946,7008176,2738,958300,7966476,13.67
9868947,7296425,3326,1164100,8460525,15.95
9868948,9970821,2566,898100,10868921,9.01
9868950,1473661,969,339150,1812811,23.01
9868951,9989637,3227,1129450,11119087,11.31
9868952,9993679,2543,890050,10883729,8.91
9868953,9984501,2257,789950,10774451,7.91
9868954,9998267,839,293650,10291917,2.94
9868955,9971961,2986,1045100,11017061,10.48
9868956,9977121,2655,929250,10906371,9.31
9868957,9984217,2682,938700,10922917,9.40
9868958,6782160,1841,644350,7426510,9.50
9868959,9975266,3872,1355200,11330466,13.59
9868960,9989033,984,344400,10333433,3.45
9868961,9971770,2727,954450,10926220,9.57
9868962,9955789,3237,1132950,11088739,11.38
9868963,9969910,4314,1509900,11479810,15.14
9868964,9983948,2767,968450,10952398,9.70
9868965,9973987,249,87150,10061137,0.87
9868966,9959741,4015,1405250,11364991,14.11
9868968,9935051,2387,835450,10770501,8.41
9868969,9923648,3271,1144850,11068498,11.54
9868970,9947052,1617,565950,10513002,5.69
9868971,9949138,3701,1295350,11244488,13.02
9868973,8950224,2793,977550,9927774,10.92
9868974,9950007,3830,1340500,11290507,13.47
9868975,9950062,5389,1886150,11836212,18.96
9868977,9951547,5150,1802500,11754047,18.11
9868978,1470119,381,133350,1603469,9.07
9868979,9959940,2897,1013950,10973890,10.18
9868980,9973694,2446,856100,10829794,8.58
9868981,9975661,3930,1375500,11351161,13.79
9868982,9968333,3611,1263850,11232183,12.68
9868983,9984808,4427,1549450,11534258,15.52
9868984,9992294,4777,1671950,11664244,16.73
9868985,9973719,1358,475300,10449019,4.77
9868986,9980346,2340,819000,10799346,8.21
9868987,9981330,995,348250,10329580,3.49
9868988,8426969,6153,2153550,10580519,25.56
9868989,3189449,535,187250,3376699,5.87
9868990,8583159,3008,1052800,9635959,12.27
9868991,8022854,1627,569450,8592304,7.10
9868992,9924452,3895,1363250,11287702,13.74
9868993,9987706,2938,1028300,11016006,10.30
9868994,9978101,1597,558950,10537051,5.60
9868995,9968955,817,285950,10254905,2.87
9868996,9995089,1555,544250,10539339,5.45
9868997,9876192,5403,1891050,11767242,19.15
9868998,9992094,4140,1449000,11441094,14.50
9868999,9949093,3341,1169350,11118443,11.75
9869000,9965683,2882,1008700,10974383,10.12
9869001,9980164,5023,1758050,11738214,17.62
9869002,9972503,3548,1241800,11214303,12.45
9869003,9991620,2598,909300,10900920,9.10
9869004,9979689,2280,798000,10777689,8.00
9869005,3089907,1001,350350,3440257,11.34
9869006,9966053,3475,1216250,11182303,12.20
9869007,5864016,2008,702800,6566816,11.98
9869008,9954066,3513,1229550,11183616,12.35
9869009,9949863,4287,1500450,11450313,15.08
9869010,3630578,1219,426650,4057228,11.75
9869011,9971079,3913,1369550,11340629,13.74
9869012,1368278,456,159600,1527878,11.66
9869013,9954056,2841,994350,10948406,9.99
9869014,1196518,656,229600,1426118,19.19
9869015,9965090,2912,1019200,10984290,10.23
9869016,9969625,2454,858900,10828525,8.62
9869017,9980758,2538,888300,10869058,8.90
9869018,1726581,483,169050,1895631,9.79
9869019,9972528,3973,1390550,11363078,13.94
9869020,9989178,3209,1123150,11112328,11.24
9869021,9980663,1912,669200,10649863,6.70
9869022,9995653,3609,1263150,11258803,12.64
9869023,242400,113,39550,281950,16.32
9869024,9968692,2396,838600,10807292,8.41
9869025,9965307,3414,1194900,11160207,11.99
9869026,9979731,2883,1009050,10988781,10.11
9869027,9994291,4116,1440600,11434891,14.41
9869028,9992498,3088,1080800,11073298,10.82
9869029,9961097,2387,835450,10796547,8.39
9869030,9962300,4534,1586900,11549200,15.93
9869031,3702989,625,218750,3921739,5.91
9869032,9998111,3819,1336650,11334761,13.37
9869033,9999308,2895,1013250,11012558,10.13
9869034,9986590,5423,1898050,11884640,19.01
9869035,9989065,3208,1122800,11111865,11.24
9869036,2251200,830,290500,2541700,12.90
9869038,2527823,1753,613550,3141373,24.27
9869039,9974034,3746,1311100,11285134,13.15
9869040,9978541,4145,1450750,11429291,14.54
9869041,9985370,3429,1200150,11185520,12.02
9869042,9988389,440,154000,10142389,1.54
9869043,9985130,3734,1306900,11292030,13.09
9869044,9962137,2432,851200,10813337,8.54
9869045,9975706,3518,1231300,11207006,12.34
9869046,9987798,1625,568750,10556548,5.69
9869047,9989156,2716,950600,10939756,9.52
9869048,9989609,2778,972300,10961909,9.73
9869049,9987116,3532,1236200,11223316,12.38
9869050,3011443,967,338450,3349893,11.24
9869051,9973641,2084,729400,10703041,7.31
9869052,9979497,4048,1416800,11396297,14.20
9869053,9950082,4755,1664250,11614332,16.73
9869054,9964045,2981,1043350,11007395,10.47
9869055,1558536,926,324100,1882636,20.80
9869056,9944045,3138,1098300,11042345,11.04
9869057,9943509,6232,2181200,12124709,21.94
9869058,2191640,1082,378700,2570340,17.28
9869059,9905696,2375,831250,10736946,8.39
9869061,9022071,2577,901950,9924021,10.00
9869062,9951971,8255,2889250,12841221,29.03
9869063,1043641,222,77700,1121341,7.45
9869064,9961022,4419,1546650,11507672,15.53
9869065,602075,408,142800,744875,23.72
9869066,709200,291,101850,811050,14.36
9869067,9964150,2462,861700,10825850,8.65
9869068,9965089,3196,1118600,11083689,11.23
9869069,9963723,3660,1281000,11244723,12.86
9869070,9896864,3618,1266300,11163164,12.79
9869071,9979616,3721,1302350,11281966,13.05
9869072,9982405,1271,444850,10427255,4.46
9869073,9973048,4243,1485050,11458098,14.89
9869074,9972926,2094,732900,10705826,7.35
9869075,9964675,1728,604800,10569475,6.07
9869076,9964607,4512,1579200,11543807,15.85
9869077,9974858,3505,1226750,11201608,12.30
9869078,9950293,4363,1527050,11477343,15.35
9869079,9972658,2835,992250,10964908,9.95
9869080,9776849,954,333900,10110749,3.42
9869081,9995287,3651,1277850,11273137,12.78
9869083,9899569,1943,680050,10579619,6.87
9869084,9971329,3469,1214150,11185479,12.18
9869086,5727459,1873,655550,6383009,11.45
9869087,9974040,2749,962150,10936190,9.65
9869088,9961749,3098,1084300,11046049,10.88
9869089,9959191,4187,1465450,11424641,14.71
9869090,9965838,1463,512050,10477888,5.14
9869091,9954659,3375,1181250,11135909,11.87
9869092,9977480,4377,1531950,11509430,15.35
9869093,9975517,4651,1627850,11603367,16.32
9869094,9980743,3011,1053850,11034593,10.56
9869095,9983594,4879,1707650,11691244,17.10
9869096,9977844,2515,880250,10858094,8.82
9869097,2783692,854,298900,3082592,10.74
9869098,9970699,4360,1526000,11496699,15.30
9869099,9993514,1749,612150,10605664,6.13
9869100,9986111,1523,533050,10519161,5.34
9869101,9997758,4021,1407350,11405108,14.08
9869102,9981375,4069,1424150,11405525,14.27
9869103,9987423,2530,885500,10872923,8.87
9869104,9937569,2199,769650,10707219,7.74
9869106,9944981,3490,1221500,11166481,12.28
9869107,9957152,3491,1221850,11179002,12.27
9869108,9957149,3410,1193500,11150649,11.99
9869109,9955354,3722,1302700,11258054,13.09
9869110,9951493,3518,1231300,11182793,12.37
9869111,9970225,2589,906150,10876375,9.09
9869112,7520597,3298,1154300,8674897,15.35
9869113,9979026,2197,768950,10747976,7.71
9869114,9986928,4125,1443750,11430678,14.46
9869115,9969284,2769,969150,10938434,9.72
9869116,9986308,3036,1062600,11048908,10.64
9869117,9947576,5842,2044700,11992276,20.55
9869118,9963862,2180,763000,10726862,7.66
9869119,9973709,3916,1370600,11344309,13.74
9869120,9985841,4090,1431500,11417341,14.34
9869121,9994865,3404,1191400,11186265,11.92
9869122,9979295,3299,1154650,11133945,11.57
9869123,9996276,4022,1407700,11403976,14.08
9869124,9988501,4484,1569400,11557901,15.71
9869125,9981990,4313,1509550,11491540,15.12
9869127,9989927,2499,874650,10864577,8.76
9869128,9978173,3740,1309000,11287173,13.12
9869129,9974772,3167,1108450,11083222,11.11
9869130,9416074,1778,622300,10038374,6.61
9869131,9983489,4412,1544200,11527689,15.47
9869132,9992735,2941,1029350,11022085,10.30
9869133,9984540,3835,1342250,11326790,13.44
9869134,9983442,2820,987000,10970442,9.89
9869135,9992789,3930,1375500,11368289,13.76
9869136,9976251,4418,1546300,11522551,15.50
9869137,9975702,3063,1072050,11047752,10.75
9869139,9974311,3882,1358700,11333011,13.62
9869140,9957793,3139,1098650,11056443,11.03
9869141,9970531,4954,1733900,11704431,17.39
9869142,9946085,2073,725550,10671635,7.29
9869143,9962232,2500,875000,10837232,8.78
9869144,9804932,1154,403900,10208832,4.12
9869145,9987321,3612,1264200,11251521,12.66
9869146,9993732,3393,1187550,11181282,11.88
9869147,9988038,3377,1181950,11169988,11.83
9869148,9986740,3098,1084300,11071040,10.86
9869149,9980859,2396,838600,10819459,8.40
9869150,9975194,1743,610050,10585244,6.12
9869151,9958892,6275,2196250,12155142,22.05
9869152,9959495,1879,657650,10617145,6.60
9869153,9932767,2651,927850,10860617,9.34
9869154,9957670,2634,921900,10879570,9.26
9869155,9950526,4407,1542450,11492976,15.50
9869156,9961599,2143,750050,10711649,7.53
9869157,9970635,2973,1040550,11011185,10.44
9869158,9965225,2849,997150,10962375,10.01
9869159,9979128,4077,1426950,11406078,14.30
9869160,9988571,6003,2101050,12089621,21.03
9869161,9983126,2536,887600,10870726,8.89
9869162,9983116,3643,1275050,11258166,12.77
9869163,9973611,3121,1092350,11065961,10.95
9869164,9986289,2244,785400,10771689,7.86
9869165,9994724,4333,1516550,11511274,15.17
9869166,9981697,2366,828100,10809797,8.30
9869168,9964906,1198,419300,10384206,4.21
9869169,9983471,2855,999250,10982721,10.01
9869170,9955266,2870,1004500,10959766,10.09
9869171,9938786,2482,868700,10807486,8.74
9869172,9972296,2548,891800,10864096,8.94
9869173,9978591,2769,969150,10947741,9.71
9869174,9992384,3633,1271550,11263934,12.73
9869175,9979472,1825,638750,10618222,6.40
9869176,9970322,4245,1485750,11456072,14.90
9869177,9981831,3096,1083600,11065431,10.86
9869178,9984317,2244,785400,10769717,7.87
9869179,9981448,1046,366100,10347548,3.67
9869180,9977446,3371,1179850,11157296,11.83
9869181,9969579,1313,459550,10429129,4.61
9869182,9717184,2477,866950,10584134,8.92
9869183,9980998,4210,1473500,11454498,14.76
9869184,9991508,4931,1725850,11717358,17.27
9869186,9986152,2342,819700,10805852,8.21
9869187,3282963,492,172200,3455163,5.25
9869188,9985880,4660,1631000,11616880,16.33
9869189,9836652,3898,1364300,11200952,13.87
9869190,9981426,2532,886200,10867626,8.88
9869191,3755457,1586,555100,4310557,14.78
9869192,9964242,3766,1318100,11282342,13.23
9869193,9598682,3053,1068550,10667232,11.13
9869194,9957958,3313,1159550,11117508,11.64
9869195,9971432,3785,1324750,11296182,13.29
9869196,9974046,2355,824250,10798296,8.26
9869197,9984751,1087,380450,10365201,3.81
9869198,9993323,3645,1275750,11269073,12.77
9869199,9981911,4315,1510250,11492161,15.13
9869200,9974999,3307,1157450,11132449,11.60
9869201,9968336,3543,1240050,11208386,12.44
9869203,9969381,4298,1504300,11473681,15.09
9869204,9979332,3330,1165500,11144832,11.68
9869205,9923469,2457,859950,10783419,8.67
9869206,9993506,3649,1277150,11270656,12.78
9869207,9986039,4594,1607900,11593939,16.10
9869209,9969746,5494,1922900,11892646,19.29
9869210,9965491,2331,815850,10781341,8.19
9869211,9973673,2052,718200,10691873,7.20
9869212,9984788,2747,961450,10946238,9.63
9869214,9983497,1631,570850,10554347,5.72
9869215,9960640,3669,1284150,11244790,12.89
9869216,9959620,2207,772450,10732070,7.76
9869217,9964983,2976,1041600,11006583,10.45
9869218,9985823,4326,1514100,11499923,15.16
9869219,9994028,3464,1212400,11206428,12.13
9869220,9993172,1657,579950,10573122,5.80
9869221,9978048,2385,834750,10812798,8.37
9869222,9983765,4679,1637650,11621415,16.40
9869223,2044099,661,231350,2275449,11.32
9869224,9475942,3946,1381100,10857042,14.57
9869225,9969144,2980,1043000,11012144,10.46
9869226,9881589,3333,1166550,11048139,11.81
9869227,9980421,1439,503650,10484071,5.05
9869228,9985495,3641,1274350,11259845,12.76
9869229,4840003,1288,450800,5290803,9.31
9869230,9966755,2724,953400,10920155,9.57
9869231,9958668,3308,1157800,11116468,11.63
9869232,9948867,2000,700000,10648867,7.04
9869233,9946548,2859,1000650,10947198,10.06
9869234,8526709,1648,576800,9103509,6.76
9869235,198765,106,37100,235865,18.67
9869236,9957098,2972,1040200,10997298,10.45
9869237,9939184,2703,946050,10885234,9.52
9869238,9961376,2450,857500,10818876,8.61
9869239,9958101,3636,1272600,11230701,12.78
9869240,9949983,1893,662550,10612533,6.66
9869241,9953034,2856,999600,10952634,10.04
9869242,9969918,3469,1214150,11184068,12.18
9869243,9944144,5017,1755950,11700094,17.66
9869244,770490,151,52850,823340,6.86
9869245,9960278,2122,742700,10702978,7.46
9869246,9972723,3046,1066100,11038823,10.69
9869247,9976554,2745,960750,10937304,9.63
9869248,9959443,2204,771400,10730843,7.75
9869249,2085175,785,274750,2359925,13.18
9869250,9935390,3318,1161300,11096690,11.69
9869251,8809801,1605,561750,9371551,6.38
9869252,9922674,2308,807800,10730474,8.14
9869253,9942648,2646,926100,10868748,9.31
9869254,9947304,3370,1179500,11126804,11.86
9869255,2331759,1241,434350,2766109,18.63
9869256,9720348,2551,892850,10613198,9.19
9869257,9965241,3606,1262100,11227341,12.67
9869258,9953025,924,323400,10276425,3.25
9869259,9977166,2232,781200,10758366,7.83
9869260,9982005,1886,660100,10642105,6.61
9869261,9994029,4229,1480150,11474179,14.81
9869262,8381235,1642,574700,8955935,6.86
9869263,9994481,2348,821800,10816281,8.22
9869264,9985008,3305,1156750,11141758,11.58
9869265,9984933,6302,2205700,12190633,22.09
9869266,9981667,2090,731500,10713167,7.33
9869267,9993374,3358,1175300,11168674,11.76
9869268,9972803,2960,1036000,11008803,10.39
9869269,9972115,2183,764050,10736165,7.66
9869270,9962452,3931,1375850,11338302,13.81
9869271,9979381,880,308000,10287381,3.09
9869272,9981037,3127,1094450,11075487,10.97
9869273,9977882,4640,1624000,11601882,16.28
9869274,9999809,2191,766850,10766659,7.67
9869275,9994814,3060,1071000,11065814,10.72
9869276,9995531,1972,690200,10685731,6.91
9869277,9972943,1024,358400,10331343,3.59
9869278,9976697,1513,529550,10506247,5.31
9869279,9989128,4099,1434650,11423778,14.36
9869280,9970586,2535,887250,10857836,8.90
9869281,9996856,3551,1242850,11239706,12.43
9869282,9976652,2452,858200,10834852,8.60
9869283,9978609,1328,464800,10443409,4.66
9869284,9987390,2478,867300,10854690,8.68
9869285,9981048,3342,1169700,11150748,11.72
9869286,9992101,4971,1739850,11731951,17.41
9869287,9988383,2914,1019900,11008283,10.21
9869288,9981202,3252,1138200,11119402,11.40
9869289,9994417,4298,1504300,11498717,15.05
9869290,9989822,2407,842450,10832272,8.43
9869291,9972571,2608,912800,10885371,9.15
9869292,9990514,2482,868700,10859214,8.70
9869293,9980961,3724,1303400,11284361,13.06
9869294,1642435,197,68950,1711385,4.20
9869295,9983596,2632,921200,10904796,9.23
9869296,6887388,1685,589750,7477138,8.56
9869297,9995635,3964,1387400,11383035,13.88
9869298,9995447,1783,624050,10619497,6.24
9869299,9980365,2687,940450,10920815,9.42
9869300,9994010,3121,1092350,11086360,10.93
9869301,9989226,2088,730800,10720026,7.32
9869302,9966218,3064,1072400,11038618,10.76
9869303,8151090,2983,1044050,9195140,12.81
9869304,9989026,3614,1264900,11253926,12.66
9869305,9973069,3870,1354500,11327569,13.58
9869307,9959759,1172,410200,10369959,4.12
9869308,9966266,2586,905100,10871366,9.08
9869309,9957939,3835,1342250,11300189,13.48
9869310,2457599,1938,678300,3135899,27.60
9869311,9969277,3473,1215550,11184827,12.19
9869312,9969862,3119,1091650,11061512,10.95
9869313,9974335,2354,823900,10798235,8.26
9869314,1952451,414,144900,2097351,7.42
9869316,9956013,2755,964250,10920263,9.69
9869317,9974160,2265,792750,10766910,7.95
9869318,9983738,3225,1128750,11112488,11.31
9869319,9988041,1965,687750,10675791,6.89
9869320,9998532,1578,552300,10550832,5.52
9869321,9995877,1776,621600,10617477,6.22
9869322,9980442,2689,941150,10921592,9.43
9869323,9983197,1358,475300,10458497,4.76
9869324,9976033,2371,829850,10805883,8.32
9869325,9982389,2705,946750,10929139,9.48
9869326,9899301,2881,1008350,10907651,10.19
9869327,9999542,2694,942900,10942442,9.43
9869328,9971290,1933,676550,10647840,6.78
9869329,9981414,5110,1788500,11769914,17.92
9869330,9965682,3932,1376200,11341882,13.81
9869331,9983040,2961,1036350,11019390,10.38
9869332,9979759,5930,2075500,12055259,20.80
9869333,9993330,5204,1821400,11814730,18.23
9869334,9982106,4422,1547700,11529806,15.50
9869335,9974373,5036,1762600,11736973,17.67
9869336,9981924,4640,1624000,11605924,16.27
9869338,2905221,1118,391300,3296521,13.47
9869339,9984669,3252,1138200,11122869,11.40
9869340,9979401,3366,1178100,11157501,11.81
9869341,9791852,4344,1520400,11312252,15.53
9869342,9803707,5751,2012850,11816557,20.53
9869343,9973675,3612,1264200,11237875,12.68
9869344,9990408,5604,1961400,11951808,19.63
9869345,9787114,2148,751800,10538914,7.68
9869346,9988142,2439,853650,10841792,8.55
9869347,9992700,5871,2054850,12047550,20.56
9869348,9987197,3602,1260700,11247897,12.62
9869349,9981395,3822,1337700,11319095,13.40
9869350,9971069,4636,1622600,11593669,16.27
9869351,9982910,4947,1731450,11714360,17.34
9869352,9996358,4405,1541750,11538108,15.42
9869353,9977042,4184,1464400,11441442,14.68
9869354,9980575,6525,2283750,12264325,22.88
9869355,9976936,4452,1558200,11535136,15.62
9869356,9982396,3802,1330700,11313096,13.33
9869357,9933399,2690,941500,10874899,9.48
9869358,5619877,2077,726950,6346827,12.94
9869359,9988603,1509,528150,10516753,5.29
9869360,9977938,2737,957950,10935888,9.60
9869361,9993600,4972,1740200,11733800,17.41
9869362,9973629,2652,928200,10901829,9.31
9869363,9802434,2536,887600,10690034,9.05
9869364,9971012,2527,884450,10855462,8.87
9869365,9985088,3064,1072400,11057488,10.74
9869366,9483924,2568,898800,10382724,9.48
9869368,9990290,3493,1222550,11212840,12.24
9869369,9977945,2577,901950,10879895,9.04
9869370,9970581,1880,658000,10628581,6.60
9869371,9974194,3650,1277500,11251694,12.81
9869372,9986845,3888,1360800,11347645,13.63
9869373,9989893,2515,880250,10870143,8.81
9869374,9983217,4647,1626450,11609667,16.29
9869375,9990694,4151,1452850,11443544,14.54
9869376,9977679,4384,1534400,11512079,15.38
9869377,9961274,3473,1215550,11176824,12.20
9869378,9973226,2105,736750,10709976,7.39
9869379,9977113,4333,1516550,11493663,15.20
9869380,9964953,3155,1104250,11069203,11.08
9869381,9958508,3843,1345050,11303558,13.51
9869382,9974745,3547,1241450,11216195,12.45
9869383,9953130,2633,921550,10874680,9.26
9869384,9961361,3195,1118250,11079611,11.23
9869385,9984936,3158,1105300,11090236,11.07
9869386,9989355,2975,1041250,11030605,10.42
9869387,9983199,2252,788200,10771399,7.90
9869388,9993630,2033,711550,10705180,7.12
9869389,2916359,1151,402850,3319209,13.81
9869390,9976432,3598,1259300,11235732,12.62
9869391,2280651,448,156800,2437451,6.88
9869392,9971004,2125,743750,10714754,7.46
9869393,9969902,3487,1220450,11190352,12.24
9869394,9993295,3150,1102500,11095795,11.03
9869395,639017,414,144900,783917,22.68
9869396,9754872,2226,779100,10533972,7.99
9869397,9976561,3021,1057350,11033911,10.60
9869398,9991729,2711,948850,10940579,9.50
9869399,9974902,1955,684250,10659152,6.86
9869400,593065,312,109200,702265,18.41
9869401,9949306,3006,1052100,11001406,10.57
9869402,9957508,2762,966700,10924208,9.71
9869403,9953688,3039,1063650,11017338,10.69
9869404,9677321,3509,1228150,10905471,12.69
9869405,9970357,2183,764050,10734407,7.66
9869406,2609642,575,201250,2810892,7.71
9869407,9964878,4963,1737050,11701928,17.43
9869408,9963374,2360,826000,10789374,8.29
9869409,9955152,3475,1216250,11171402,12.22
9869410,9947273,2360,826000,10773273,8.30
9869412,1269902,615,215250,1485152,16.95
9869413,9909504,1808,632800,10542304,6.39
9869414,9879851,3581,1253350,11133201,12.69
9869415,2759919,953,333550,3093469,12.09
9869416,9955785,2225,778750,10734535,7.82
9869417,9955791,2320,812000,10767791,8.16
9869418,9955548,2283,799050,10754598,8.03
9869419,9960413,3549,1242150,11202563,12.47
9869420,9954916,1965,687750,10642666,6.91
9869421,9966486,2858,1000300,10966786,10.04
9869422,9960703,4112,1439200,11399903,14.45
9869423,9974295,2595,908250,10882545,9.11
9869424,9979245,2841,994350,10973595,9.96
9869425,9967558,2276,796600,10764158,7.99
9869426,9998144,3367,1178450,11176594,11.79
9869427,9981586,3153,1103550,11085136,11.06
9869428,9981813,3545,1240750,11222563,12.43
9869429,9983804,3062,1071700,11055504,10.73
9869430,9989442,5337,1867950,11857392,18.70
9869431,9978929,3611,1263850,11242779,12.67
9869432,9978613,2853,998550,10977163,10.01
9869433,9989314,5078,1777300,11766614,17.79
9869434,9983762,2489,871150,10854912,8.73
9869435,9975059,3333,1166550,11141609,11.69
9869436,9983459,5071,1774850,11758309,17.78
9869437,7960066,3138,1098300,9058366,13.80
9869439,9964822,2814,984900,10949722,9.88
9869440,9963899,3467,1213450,11177349,12.18
9869441,9974515,2737,957950,10932465,9.60
9869442,9989885,3727,1304450,11294335,13.06
9869443,9991313,4062,1421700,11413013,14.23
9869444,9699485,5488,1920800,11620285,19.80
9869445,9971688,6981,2443350,12415038,24.50
9869446,9991354,3044,1065400,11056754,10.66
9869447,9984766,5350,1872500,11857266,18.75
9869448,9987260,2759,965650,10952910,9.67
9869449,9968282,2867,1003450,10971732,10.07
9869450,9955300,2604,911400,10866700,9.15
9869451,9956364,3617,1265950,11222314,12.71
9869452,9945016,4735,1657250,11602266,16.66
9869453,9947581,2961,1036350,10983931,10.42
9869454,9930316,2953,1033550,10963866,10.41
9869455,9937294,4870,1704500,11641794,17.15
9869456,1720372,511,178850,1899222,10.40
9869457,78709,12,4200,82909,5.34
9869458,9949048,2816,985600,10934648,9.91
9869459,9934924,1686,590100,10525024,5.94
9869460,9941000,1667,583450,10524450,5.87
9869462,9939897,4729,1655150,11595047,16.65
9869463,9950408,1845,645750,10596158,6.49
9869464,9935533,3277,1146950,11082483,11.54
9869465,9935619,2694,942900,10878519,9.49
9869466,9941995,2640,924000,10865995,9.29
9869467,9955197,4843,1695050,11650247,17.03
9869468,2446409,609,213150,2659559,8.71
9869470,9941089,3470,1214500,11155589,12.22
9869472,4408091,1088,380800,4788891,8.64
9869473,9955773,1959,685650,10641423,6.89
9869474,6763425,987,345450,7108875,5.11
9869475,9953628,398,139300,10092928,1.40
9869476,9960674,3659,1280650,11241324,12.86
9869477,5748747,2573,900550,6649297,15.67
9869478,9959626,2905,1016750,10976376,10.21
9869479,9950400,4548,1591800,11542200,16.00
9869480,9935675,5768,2018800,11954475,20.32
9869481,9925084,3486,1220100,11145184,12.29
9869482,8926070,3010,1053500,9979570,11.80
9869484,9859284,4058,1420300,11279584,14.41
9869485,9922592,3279,1147650,11070242,11.57
9869486,1057310,281,98350,1155660,9.30
9869487,9924348,2940,1029000,10953348,10.37
9869488,9926213,4055,1419250,11345463,14.30
9869489,9922934,4407,1542450,11465384,15.54
9869490,9933117,3138,1098300,11031417,11.06
9869491,9946614,2539,888650,10835264,8.93
9869492,9959861,2786,975100,10934961,9.79
9869493,9970816,3642,1274700,11245516,12.78
9869494,2592871,2395,838250,3431121,32.33
9869495,9959577,2426,849100,10808677,8.53
9869496,9977553,2565,897750,10875303,9.00
9869497,9980057,1646,576100,10556157,5.77
9869498,9963398,3760,1316000,11279398,13.21
9869499,9978730,3627,1269450,11248180,12.72
9869500,9985103,2888,1010800,10995903,10.12
9869501,9960594,1367,478450,10439044,4.80
9869502,9967726,1355,474250,10441976,4.76
9869503,9987031,2461,861350,10848381,8.62
9869504,9994945,2998,1049300,11044245,10.50
9869505,9984074,3516,1230600,11214674,12.33
9869506,9967625,4653,1628550,11596175,16.34
9869507,9994815,4309,1508150,11502965,15.09
9869508,9995187,1383,484050,10479237,4.84
9869509,9970234,3020,1057000,11027234,10.60
9869510,9981928,2884,1009400,10991328,10.11
9869511,9991315,2395,838250,10829565,8.39
9869512,9995816,3792,1327200,11323016,13.28
9869513,9974858,1831,640850,10615708,6.42
9869514,9968990,2920,1022000,10990990,10.25
9869515,9967545,3258,1140300,11107845,11.44
9869516,9976431,3241,1134350,11110781,11.37
9869517,9978600,3367,1178450,11157050,11.81
9869518,7658410,1773,620550,8278960,8.10
9869519,9981478,4028,1409800,11391278,14.12
9869520,9992083,1523,533050,10525133,5.33
9869521,9929235,1788,625800,10555035,6.30
9869522,9983858,2108,737800,10721658,7.39
9869523,9986939,2610,913500,10900439,9.15
9869524,5390318,1335,467250,5857568,8.67
9869525,9997567,3640,1274000,11271567,12.74
9869526,5419958,464,162400,5582358,3.00
9869527,9967288,1845,645750,10613038,6.48
9869528,9978744,1966,688100,10666844,6.90
9869529,9978795,3724,1303400,11282195,13.06
9869530,9992368,2136,747600,10739968,7.48
9869531,9988733,5550,1942500,11931233,19.45
9869532,9971082,2853,998550,10969632,10.01
9869535,9976370,2614,914900,10891270,9.17
9869536,9973298,3760,1316000,11289298,13.20
9869537,9972144,3682,1288700,11260844,12.92
9869538,9982316,3065,1072750,11055066,10.75
9869539,9981840,3078,1077300,11059140,10.79
9869540,9983978,4450,1557500,11541478,15.60
9869541,1109356,73,25550,1134906,2.30
9869542,9993906,2182,763700,10757606,7.64
9869544,9986473,2692,942200,10928673,9.43
9869545,9992497,1470,514500,10506997,5.15
9869546,9982388,1642,574700,10557088,5.76
9869547,8207228,2031,710850,8918078,8.66
9869548,9985788,3008,1052800,11038588,10.54
9869549,9986279,4624,1618400,11604679,16.21
9869550,9976545,3118,1091300,11067845,10.94
9869551,9977227,1737,607950,10585177,6.09
9869552,9970649,2553,893550,10864199,8.96
9869553,9985714,3294,1152900,11138614,11.55
9869554,9976352,3365,1177750,11154102,11.81
9869555,9956226,2258,790300,10746526,7.94
9869556,9965096,1774,620900,10585996,6.23
9869557,9973019,2599,909650,10882669,9.12
9869558,9962410,220,77000,10039410,0.77
9869559,9968187,1257,439950,10408137,4.41
9869560,9991163,2454,858900,10850063,8.60
9869561,9980267,1413,494550,10474817,4.96
9869562,9987271,2213,774550,10761821,7.76
9869563,9972006,3121,1092350,11064356,10.95
9869564,9967800,1996,698600,10666400,7.01
9869565,9956284,3110,1088500,11044784,10.93
9869566,9985393,2323,813050,10798443,8.14
9869567,9971971,2543,890050,10862021,8.93
9869568,9939478,3198,1119300,11058778,11.26
9869569,9973823,3536,1237600,11211423,12.41
9869570,9970206,1321,462350,10432556,4.64
9869571,9975471,3992,1397200,11372671,14.01
9869572,9989806,4524,1583400,11573206,15.85
9869573,9994625,2551,892850,10887475,8.93
9869574,9971063,5509,1928150,11899213,19.34
9869575,9971993,3189,1116150,11088143,11.19
9869576,9936749,2283,799050,10735799,8.04
9869577,9965708,1264,442400,10408108,4.44
9869578,9952868,2285,799750,10752618,8.04
9869579,9967569,3933,1376550,11344119,13.81
9869580,9975321,3348,1171800,11147121,11.75
9869581,9978287,2235,782250,10760537,7.84
9869582,9978279,2934,1026900,11005179,10.29
9869583,9968842,3205,1121750,11090592,11.25
9869584,9987247,4998,1749300,11736547,17.52
9869585,9980919,3178,1112300,11093219,11.14
9869586,9974655,1887,660450,10635105,6.62
9869587,9987189,3136,1097600,11084789,10.99
9869588,4945945,1487,520450,5466395,10.52
9869590,9992783,1976,691600,10684383,6.92
9869592,9970048,2859,1000650,10970698,10.04
9869593,9977418,1741,609350,10586768,6.11
9869594,1770803,405,141750,1912553,8.00
9869595,9970561,2669,934150,10904711,9.37
9869596,9830661,2906,1017100,10847761,10.35
9869597,9910598,3597,1258950,11169548,12.70
9869598,9511220,566,198100,9709320,2.08
9869599,9968089,318,111300,10079389,1.12
9869600,9974446,1715,600250,10574696,6.02
9869601,9965797,2241,784350,10750147,7.87
9869602,9970044,1466,513100,10483144,5.15
9869603,9982373,1403,491050,10473423,4.92
9869604,9993908,3543,1240050,11233958,12.41
9869605,9988009,2250,787500,10775509,7.88
9869606,9994241,2015,705250,10699491,7.06
9869607,9993911,2238,783300,10777211,7.84
9869608,9987745,3365,1177750,11165495,11.79
9869609,9987045,1849,647150,10634195,6.48
9869610,7483701,2555,894250,8377951,11.95
9869611,9979648,2617,915950,10895598,9.18
9869612,9982374,3723,1303050,11285424,13.05
9869613,9972119,3287,1150450,11122569,11.54
9869614,9982037,2105,736750,10718787,7.38
9869615,9992618,2048,716800,10709418,7.17
9869617,9951536,2611,913850,10865386,9.18
9869618,9975804,2493,872550,10848354,8.75
9869619,8145795,3615,1265250,9411045,15.53
9869620,9982257,2643,925050,10907307,9.27
9869621,9992268,2178,762300,10754568,7.63
9869622,9985433,2627,919450,10904883,9.21
9869623,8953398,2987,1045450,9998848,11.68
9869624,9970683,2824,988400,10959083,9.91
9869625,9975760,4217,1475950,11451710,14.80
9869626,9961958,2069,724150,10686108,7.27
9869627,8828626,4648,1626800,10455426,18.43
9869628,9070300,2969,1039150,10109450,11.46
9869629,9936345,4218,1476300,11412645,14.86
9869630,9952383,3476,1216600,11168983,12.22
9869631,9937747,4930,1725500,11663247,17.36
9869632,9942454,5437,1902950,11845404,19.14
9869633,9929081,2660,931000,10860081,9.38
9869634,9923854,4574,1600900,11524754,16.13
9869635,3566097,1242,434700,4000797,12.19
9869636,9952979,1743,610050,10563029,6.13
9869637,9942903,294,102900,10045803,1.03
9869638,9938732,3406,1192100,11130832,11.99
9869640,9958496,4115,1440250,11398746,14.46
9869641,294745,124,43400,338145,14.72
9869642,9963549,1689,591150,10554699,5.93
9869643,9941647,4427,1549450,11491097,15.59
9869644,2270342,629,220150,2490492,9.70
9869645,9940379,2443,855050,10795429,8.60
9869647,9936302,4671,1634850,11571152,16.45
9869649,9908419,3555,1244250,11152669,12.56
9869650,9299656,2415,845250,10144906,9.09
9869651,9926081,1918,671300,10597381,6.76
9869652,9946404,4126,1444100,11390504,14.52
9869653,9932403,7717,2700950,12633353,27.19
9869654,9096160,2681,938350,10034510,10.32
9869655,9728554,3621,1267350,10995904,13.03
9869656,9932909,3583,1254050,11186959,12.63
9869657,9948468,2624,918400,10866868,9.23
9869658,9922757,4274,1495900,11418657,15.08
9869660,9917933,2534,886900,10804833,8.94
9869661,9924120,3723,1303050,11227170,13.13
9869662,9930875,4506,1577100,11507975,15.88
9869663,9953975,3868,1353800,11307775,13.60
9869664,9958660,3729,1305150,11263810,13.11
9869665,9965186,2636,922600,10887786,9.26
9869666,9975614,3913,1369550,11345164,13.73
9869667,9986241,1973,690550,10676791,6.92
9869668,9975768,4723,1653050,11628818,16.57
9869669,9981848,2542,889700,10871548,8.91
9869670,9985199,2887,1010450,10995649,10.12
9869672,9984108,2633,921550,10905658,9.23
9869673,9988351,2820,987000,10975351,9.88
9869674,9988879,3487,1220450,11209329,12.22
9869675,9972956,1899,664650,10637606,6.66
9869676,9969801,2745,960750,10930551,9.64
9869677,9977443,3208,1122800,11100243,11.25
9869678,9985921,4489,1571150,11557071,15.73
9869679,9960790,1189,416150,10376940,4.18
9869680,9975278,4627,1619450,11594728,16.23
9869681,9381547,2493,872550,10254097,9.30
9869682,7017930,2842,994700,8012630,14.17
9869683,9977712,2052,718200,10695912,7.20
9869684,8965306,1930,675500,9640806,7.53
9869685,5485844,1860,651000,6136844,11.87
9869686,9983401,2491,871850,10855251,8.73
9869687,9984920,4122,1442700,11427620,14.45
9869688,6941193,3301,1155350,8096543,16.64
9869689,9987206,3829,1340150,11327356,13.42
9869690,9970133,3017,1055950,11026083,10.59
9869691,3860343,1602,560700,4421043,14.52
9869692,9987369,4281,1498350,11485719,15.00
9869693,3097139,1034,361900,3459039,11.68
9869694,9960757,2032,711200,10671957,7.14
9869695,9976868,2074,725900,10702768,7.28
9869696,9974263,3335,1167250,11141513,11.70
9869697,9973169,3223,1128050,11101219,11.31
9869698,9978262,3292,1152200,11130462,11.55
9869699,9991637,5086,1780100,11771737,17.82
9869700,4868405,1586,555100,5423505,11.40
9869701,9975028,2761,966350,10941378,9.69
9869702,9979896,2787,975450,10955346,9.77
9869703,9994763,1828,639800,10634563,6.40
9869704,9972673,1261,441350,10414023,4.43
9869705,9967436,1642,574700,10542136,5.77
9869706,9980655,4799,1679650,11660305,16.83
9869707,9965888,2308,807800,10773688,8.11
9869708,9979398,2850,997500,10976898,10.00
9869709,9976476,1371,479850,10456326,4.81
9869711,9947717,2586,905100,10852817,9.10
9869712,2124600,878,307300,2431900,14.46
9869713,9943109,2879,1007650,10950759,10.13
9869714,9953823,1257,439950,10393773,4.42
9869715,9944380,3083,1079050,11023430,10.85
9869716,2692099,1328,464800,3156899,17.27
9869717,9950367,1942,679700,10630067,6.83
9869718,1429197,1067,373450,1802647,26.13
9869719,9952460,908,317800,10270260,3.19
9869720,9897846,2176,761600,10659446,7.69
9869721,2180988,1719,601650,2782638,27.59
9869722,9926133,3233,1131550,11057683,11.40
9869723,6718527,1563,547050,7265577,8.14
9869724,9931499,1356,474600,10406099,4.78
9869726,9940182,1376,481600,10421782,4.84
9869727,9951240,1290,451500,10402740,4.54
9869728,9952701,2859,1000650,10953351,10.05
9869729,1525632,562,196700,1722332,12.89
9869730,4100205,1253,438550,4538755,10.70
9869731,9954406,3751,1312850,11267256,13.19
9869732,51359,35,12250,63609,23.85
9869733,9928347,4268,1493800,11422147,15.05
9869734,9970528,5005,1751750,11722278,17.57
9869735,2464363,1402,490700,2955063,19.91
9869736,9955198,2164,757400,10712598,7.61
9869737,9963048,4314,1509900,11472948,15.16
9869738,9955958,4159,1455650,11411608,14.62
9869739,9949916,3171,1109850,11059766,11.15
9869740,9984635,2298,804300,10788935,8.06
9869741,3566289,1499,524650,4090939,14.71
9869742,4634694,535,187250,4821944,4.04
9869743,9989984,3175,1111250,11101234,11.12
9869744,9982189,3183,1114050,11096239,11.16
9869745,9968087,4478,1567300,11535387,15.72
9869746,5900167,1315,460250,6360417,7.80
9869747,9963552,1637,572950,10536502,5.75
9869748,9961651,863,302050,10263701,3.03
9869749,9970283,2327,814450,10784733,8.17
9869750,9949696,4624,1618400,11568096,16.27
9869751,9950018,3460,1211000,11161018,12.17
9869752,9975112,2859,1000650,10975762,10.03
9869753,9998245,2836,992600,10990845,9.93
9869754,451283,179,62650,513933,13.88
9869755,9978859,3099,1084650,11063509,10.87
9869756,9971256,4340,1519000,11490256,15.23
9869757,9981433,3055,1069250,11050683,10.71
9869758,9466979,4868,1703800,11170779,18.00
9869759,9972137,2738,958300,10930437,9.61
9869760,9969270,2335,817250,10786520,8.20
9869761,9964549,3201,1120350,11084899,11.24
9869762,9948925,5410,1893500,11842425,19.03
9869763,9981859,2623,918050,10899909,9.20
9869764,9987540,2287,800450,10787990,8.01
9869765,9988083,1668,583800,10571883,5.84
9869766,9970630,4072,1425200,11395830,14.29
9869767,9974172,3333,1166550,11140722,11.70
9869768,9995183,2834,991900,10987083,9.92
9869769,9987892,3267,1143450,11131342,11.45
9869770,9974535,4854,1698900,11673435,17.03
9869771,9979614,2206,772100,10751714,7.74
9869773,9984571,3269,1144150,11128721,11.46
9869774,9997359,3290,1151500,11148859,11.52
9869775,9971162,2740,959000,10930162,9.62
9869776,9977261,4062,1421700,11398961,14.25
9869778,897029,206,72100,969129,8.04
9869779,9990905,4019,1406650,11397555,14.08
9869780,9984240,4182,1463700,11447940,14.66
9869781,9975102,2281,798350,10773452,8.00
9869782,9483670,2003,701050,10184720,7.39
9869783,9983077,4982,1743700,11726777,17.47
9869784,9938466,2700,945000,10883466,9.51
9869785,9983436,3171,1109850,11093286,11.12
9869786,9986337,4013,1404550,11390887,14.06
9869787,4704552,2052,718200,5422752,15.27
9869788,9978049,4905,1716750,11694799,17.21
9869789,1358162,685,239750,1597912,17.65
9869790,9980697,4390,1536500,11517197,15.39
9869791,9988504,3197,1118950,11107454,11.20
9869792,9970566,2823,988050,10958616,9.91
9869793,9966832,5615,1965250,11932082,19.72
9869794,9956803,1168,408800,10365603,4.11
9869795,9947696,4741,1659350,11607046,16.68
9869796,9972273,4475,1566250,11538523,15.71
9869797,9970190,2386,835100,10805290,8.38
9869798,7417381,1474,515900,7933281,6.96
9869799,9982349,4760,1666000,11648349,16.69
9869800,9975723,4131,1445850,11421573,14.49
9869801,9955594,2122,742700,10698294,7.46
9869802,9962462,4894,1712900,11675362,17.19
9869803,9987218,3982,1393700,11380918,13.95
9869804,9985546,2613,914550,10900096,9.16
9869805,9983663,2666,933100,10916763,9.35
9869806,9973263,2346,821100,10794363,8.23
9869807,9960052,4381,1533350,11493402,15.39
9869808,9945889,4097,1433950,11379839,14.42
9869809,9950149,4372,1530200,11480349,15.38
9869810,9951854,2870,1004500,10956354,10.09
9869811,9943429,6499,2274650,12218079,22.88
9869812,754950,475,166250,921200,22.02
9869813,9965474,2485,869750,10835224,8.73
9869814,9976505,1390,486500,10463005,4.88
9869815,9969563,1112,389200,10358763,3.90
9869816,646506,187,65450,711956,10.12
9869817,9967761,1452,508200,10475961,5.10
9869818,9982065,2489,871150,10853215,8.73
9869819,9982454,1672,585200,10567654,5.86
9869820,9993024,3319,1161650,11154674,11.62
9869821,9993296,3129,1095150,11088446,10.96
9869822,9984897,1854,648900,10633797,6.50
9869823,9988558,2086,730100,10718658,7.31
9869824,9967474,5204,1821400,11788874,18.27
9869825,9978829,2815,985250,10964079,9.87
9869826,9728857,5451,1907850,11636707,19.61
9869828,9974548,3840,1344000,11318548,13.47
9869829,9987288,3328,1164800,11152088,11.66
9869830,8520494,2736,957600,9478094,11.24
9869831,9947346,3077,1076950,11024296,10.83
9869832,9996393,2731,955850,10952243,9.56
9869833,9984988,4357,1524950,11509938,15.27
9869835,9981789,3458,1210300,11192089,12.13
9869836,9986752,4364,1527400,11514152,15.29
9869837,3709226,1166,408100,4117326,11.00
9869838,9991951,4095,1433250,11425201,14.34
9869839,9993334,2247,786450,10779784,7.87
9869840,1195685,902,315700,1511385,26.40
9869841,57931,25,8750,66681,15.10
9869842,9962914,3001,1050350,11013264,10.54
9869843,9951958,4845,1695750,11647708,17.04
9869844,9972939,1580,553000,10525939,5.55
9869845,9983984,1609,563150,10547134,5.64
9869846,9963422,4406,1542100,11505522,15.48
9869847,9966839,1980,693000,10659839,6.95
9869848,8981007,3573,1250550,10231557,13.92
9869849,3179070,1824,638400,3817470,20.08
9869850,9978198,1888,660800,10638998,6.62
9869851,9999553,3300,1155000,11154553,11.55
9869852,9982570,3765,1317750,11300320,13.20
9869853,9978988,2579,902650,10881638,9.05
9869854,9970502,2885,1009750,10980252,10.13
9869855,9970014,5007,1752450,11722464,17.58
9869856,9986763,3745,1310750,11297513,13.12
9869857,9990425,3396,1188600,11179025,11.90
9869858,9976147,2614,914900,10891047,9.17
9869859,9988760,2107,737450,10726210,7.38
9869860,9996263,5873,2055550,12051813,20.56
9869861,1684801,1023,358050,2042851,21.25
9869862,6343852,2195,768250,7112102,12.11
9869863,9986994,4398,1539300,11526294,15.41
9869864,9962880,2261,791350,10754230,7.94
9869865,9951255,3377,1181950,11133205,11.88
9869867,5925395,1845,645750,6571145,10.90
9869868,9948985,3049,1067150,11016135,10.73
9869869,8905098,2440,854000,9759098,9.59
9869870,8947552,1807,632450,9580002,7.07
9869871,5599093,2170,759500,6358593,13.56
9869872,9946442,3587,1255450,11201892,12.62
9869873,9951405,2273,795550,10746955,7.99
9869874,9974682,4064,1422400,11397082,14.26
9869875,9962878,4029,1410150,11373028,14.15
9869876,9978650,2228,779800,10758450,7.81
9869877,9991573,5746,2011100,12002673,20.13
9869878,3985215,2199,769650,4754865,19.31
9869879,9975549,2488,870800,10846349,8.73
9869880,959221,1140,399000,1358221,41.60
9869881,9961373,3317,1160950,11122323,11.65
9869882,9959646,2883,1009050,10968696,10.13
9869883,9959767,2336,817600,10777367,8.21
9869884,9847973,3592,1257200,11105173,12.77
9869885,9981497,3067,1073450,11054947,10.75
9869886,9980198,2052,718200,10698398,7.20
9869887,9974372,3896,1363600,11337972,13.67
9869888,9987564,2650,927500,10915064,9.29
9869889,9973887,1149,402150,10376037,4.03
9869890,9973558,2862,1001700,10975258,10.04
9869891,9983545,3080,1078000,11061545,10.80
9869892,9418414,3598,1259300,10677714,13.37
9869893,9989889,2430,850500,10840389,8.51
9869894,9975079,5597,1958950,11934029,19.64
9869895,9974935,2784,974400,10949335,9.77
9869896,9989476,4121,1442350,11431826,14.44
9869897,9989722,3385,1184750,11174472,11.86
9869898,9990104,3378,1182300,11172404,11.83
9869899,9988536,2979,1042650,11031186,10.44
9869900,9988599,3373,1180550,11169149,11.82
9869901,9975296,2908,1017800,10993096,10.20
9869902,9988052,3561,1246350,11234402,12.48
9869903,9978349,2122,742700,10721049,7.44
9869904,6848107,2132,746200,7594307,10.90
9869905,9256808,4740,1659000,10915808,17.92
9869906,9963738,2051,717850,10681588,7.20
9869907,9951606,5785,2024750,11976356,20.35
9869908,9950477,4336,1517600,11468077,15.25
9869909,1031931,87,30450,1062381,2.95
9869910,9954489,3067,1073450,11027939,10.78
9869911,9952923,5172,1810200,11763123,18.19
9869912,9858999,2060,721000,10579999,7.31
9869913,9951979,5853,2048550,12000529,20.58
9869914,9947953,3617,1265950,11213903,12.73
9869915,9969864,2231,780850,10750714,7.83
9869916,9978243,2589,906150,10884393,9.08
9869918,9962313,2174,760900,10723213,7.64
9869920,9928503,4048,1416800,11345303,14.27
9869921,9937105,5461,1911350,11848455,19.23
9869922,9943701,2922,1022700,10966401,10.28
9869923,9939965,2856,999600,10939565,10.06
9869924,9949612,1948,681800,10631412,6.85
9869925,9943720,2748,961800,10905520,9.67
9869926,9934365,3439,1203650,11138015,12.12
9869927,9951440,2955,1034250,10985690,10.39
9869928,9959237,3806,1332100,11291337,13.38
9869929,9962098,3281,1148350,11110448,11.53
9869930,9961826,2351,822850,10784676,8.26
9869931,9968325,2970,1039500,11007825,10.43
9869932,9982759,2477,866950,10849709,8.68
9869933,9979384,1781,623350,10602734,6.25
9869934,9980772,3630,1270500,11251272,12.73
9869935,8989913,2112,739200,9729113,8.22
9869936,9983035,4982,1743700,11726735,17.47
9869937,9988408,2622,917700,10906108,9.19
9869938,9997997,3205,1121750,11119747,11.22
9869939,9987334,7029,2460150,12447484,24.63
9869940,9980921,4450,1557500,11538421,15.60
9869941,1727282,1376,481600,2208882,27.88
9869943,9973783,2950,1032500,11006283,10.35
9869944,72204,27,9450,81654,13.09
9869945,9987336,3298,1154300,11141636,11.56
9869946,6581162,3067,1073450,7654612,16.31
9869948,9961667,4050,1417500,11379167,14.23
9869949,9971208,3410,1193500,11164708,11.97
9869950,9978981,4228,1479800,11458781,14.83
9869951,9985997,3628,1269800,11255797,12.72
9869952,9994529,3628,1269800,11264329,12.70
9869953,9748203,2471,864850,10613053,8.87
9869954,9984864,1765,617750,10602614,6.19
9869955,9975294,1931,675850,10651144,6.78
9869956,9973114,5474,1915900,11889014,19.21
9869957,9972094,3349,1172150,11144244,11.75
9869958,9978899,3738,1308300,11287199,13.11
9869959,9981223,1756,614600,10595823,6.16
9869960,9989347,4455,1559250,11548597,15.61
9869961,9977459,1276,446600,10424059,4.48
9869962,9986923,2118,741300,10728223,7.42
9869963,9995242,2931,1025850,11021092,10.26
9869964,9982481,2620,917000,10899481,9.19
9869965,9994835,3862,1351700,11346535,13.52
9869966,9649600,3097,1083950,10733550,11.23
9869967,9983971,4252,1488200,11472171,14.91
9869968,9999641,1868,653800,10653441,6.54
9869969,9977483,3052,1068200,11045683,10.71
9869970,9992065,3843,1345050,11337115,13.46
9869971,9981993,4137,1447950,11429943,14.51
9869972,9483813,3414,1194900,10678713,12.60
9869973,9969842,3996,1398600,11368442,14.03
9869974,9979338,2975,1041250,11020588,10.43
9869975,2664397,1246,436100,3100497,16.37
9869976,9993075,4472,1565200,11558275,15.66
9869977,9978719,2152,753200,10731919,7.55
9869978,9990570,1871,654850,10645420,6.55
9869979,9980936,1418,496300,10477236,4.97
9869980,9979886,1463,512050,10491936,5.13
9869981,9994233,1359,475650,10469883,4.76
9869982,9999289,1963,687050,10686339,6.87
9869983,9999827,2008,702800,10702627,7.03
9869984,9998653,6412,2244200,12242853,22.45
9869985,9999076,3781,1323350,11322426,13.23
9869986,9987776,2118,741300,10729076,7.42
9869987,9990916,3373,1180550,11171466,11.82
9869988,9981350,3271,1144850,11126200,11.47
9869989,9999130,2320,812000,10811130,8.12
9869990,9980502,3898,1364300,11344802,13.67
9869991,9135712,3547,1241450,10377162,13.59
9869992,9989930,3064,1072400,11062330,10.73
9869993,5608795,827,289450,5898245,5.16
9869994,9973807,3420,1197000,11170807,12.00
9869995,9976060,4397,1538950,11515010,15.43
9869996,9986439,4145,1450750,11437189,14.53
9869997,8897645,2970,1039500,9937145,11.68
9869998,9989299,4656,1629600,11618899,16.31
9869999,9981965,3317,1160950,11142915,11.63
9870000,9974299,2184,764400,10738699,7.66
9870001,9980683,2062,721700,10702383,7.23
9870002,5225059,1458,510300,5735359,9.77
9870003,1345380,578,202300,1547680,15.04
9870004,9986743,5270,1844500,11831243,18.47
9870005,9992646,4506,1577100,11569746,15.78
9870006,9990665,5929,2075150,12065815,20.77
9870007,9988353,2195,768250,10756603,7.69
9870008,9989988,3275,1146250,11136238,11.47
9870009,2278893,365,127750,2406643,5.61
9870010,9987683,4192,1467200,11454883,14.69
9870011,9995350,2703,946050,10941400,9.46
9870012,9973602,1992,697200,10670802,6.99
9870013,9993230,2311,808850,10802080,8.09
9870014,9980000,1671,584850,10564850,5.86
9870015,9962582,4606,1612100,11574682,16.18
9870016,9968303,2289,801150,10769453,8.04
9870017,9955449,3307,1157450,11112899,11.63
9870018,9918845,1867,653450,10572295,6.59
9870019,9955516,3430,1200500,11156016,12.06
9870020,9949212,5802,2030700,11979912,20.41
9870021,9961234,2819,986650,10947884,9.90
9870022,9944834,2693,942550,10887384,9.48
9870023,9958521,3075,1076250,11034771,10.81
9870024,9935349,1627,569450,10504799,5.73
9870025,1259595,62,21700,1281295,1.72
9870026,9959399,2099,734650,10694049,7.38
9870027,9957357,1248,436800,10394157,4.39
9870029,9967675,3142,1099700,11067375,11.03
9870030,9964836,2164,757400,10722236,7.60
9870031,9957456,4500,1575000,11532456,15.82
9870032,9938312,1971,689850,10628162,6.94
9870033,9960368,2657,929950,10890318,9.34
9870034,9969076,4640,1624000,11593076,16.29
9870035,9963477,2077,726950,10690427,7.30
9870036,9984246,2793,977550,10961796,9.79
9870037,9993298,1996,698600,10691898,6.99
9870038,9983728,4063,1422050,11405778,14.24
9870039,9981557,2990,1046500,11028057,10.48
9870041,9959880,5332,1866200,11826080,18.74
9870042,9988509,2060,721000,10709509,7.22
9870043,9994930,3523,1233050,11227980,12.34
9870044,4940310,3335,1167250,6107560,23.63
9870045,9977426,4068,1423800,11401226,14.27
9870046,9968397,2798,979300,10947697,9.82
9870047,9990466,3417,1195950,11186416,11.97
9870048,9997418,4221,1477350,11474768,14.78
9870049,9984351,3440,1204000,11188351,12.06
9870050,9961134,4169,1459150,11420284,14.65
9870051,9948094,2027,709450,10657544,7.13
9870052,9964257,2530,885500,10849757,8.89
9870054,9947201,1645,575750,10522951,5.79
9870055,9954893,3977,1391950,11346843,13.98
9870056,3952263,1371,479850,4432113,12.14
9870057,9989003,3092,1082200,11071203,10.83
9870058,9994719,1235,432250,10426969,4.32
9870059,9997054,2137,747950,10745004,7.48
9870060,9999191,2817,985950,10985141,9.86
9870061,9978701,2367,828450,10807151,8.30
9870062,9987074,3073,1075550,11062624,10.77
9870063,9981006,3374,1180900,11161906,11.83
9870064,9982107,1711,598850,10580957,6.00
9870065,9992689,1296,453600,10446289,4.54
9870066,9983770,837,292950,10276720,2.93
9870067,9983209,3391,1186850,11170059,11.89
9870068,9988201,5040,1764000,11752201,17.66
9870069,9982910,3454,1208900,11191810,12.11
9870070,9983023,2499,874650,10857673,8.76
9870071,9988406,1266,443100,10431506,4.44
9870072,9972059,3978,1392300,11364359,13.96
9870073,9954439,4436,1552600,11507039,15.60
9870074,9930082,4099,1434650,11364732,14.45
9870075,9962053,4672,1635200,11597253,16.41
9870076,9955638,2936,1027600,10983238,10.32
9870077,9966369,3576,1251600,11217969,12.56
9870078,9966971,2504,876400,10843371,8.79
9870079,9973301,3927,1374450,11347751,13.78
9870080,9977379,4919,1721650,11699029,17.26
9870081,9954280,2876,1006600,10960880,10.11
9870083,9973633,4049,1417150,11390783,14.21
9870084,805838,414,144900,950738,17.98
9870085,3324992,797,278950,3603942,8.39
9870086,9970081,2021,707350,10677431,7.09
9870087,9982896,1923,673050,10655946,6.74
9870088,9983629,2474,865900,10849529,8.67
9870089,9987121,2775,971250,10958371,9.73
9870090,1188223,238,83300,1271523,7.01
9870091,9254063,3637,1272950,10527013,13.76
9870093,9980725,2491,871850,10852575,8.74
9870094,9973844,2867,1003450,10977294,10.06
9870095,9988267,3638,1273300,11261567,12.75
9870096,9974067,2593,907550,10881617,9.10
9870097,9893295,4350,1522500,11415795,15.39
9870098,9983303,2511,878850,10862153,8.80
9870099,242571,180,63000,305571,25.97
9870100,9978976,3791,1326850,11305826,13.30
9870101,9967561,3163,1107050,11074611,11.11
9870102,9973750,3192,1117200,11090950,11.20
9870103,9989338,2533,886550,10875888,8.87
9870104,9967819,4137,1447950,11415769,14.53
9870105,9986905,2925,1023750,11010655,10.25
9870106,9987372,2179,762650,10750022,7.64
9870107,9979420,3145,1100750,11080170,11.03
9870108,9977475,2710,948500,10925975,9.51
9870109,9970550,4668,1633800,11604350,16.39
9870110,9979477,3222,1127700,11107177,11.30
9870111,9983783,1770,619500,10603283,6.21
9870112,6606475,2223,778050,7384525,11.78
9870113,9979005,4695,1643250,11622255,16.47
9870114,9987537,3552,1243200,11230737,12.45
9870115,3604889,2010,703500,4308389,19.52
9870116,9979337,3528,1234800,11214137,12.37
9870117,9985664,2975,1041250,11026914,10.43
9870118,5619581,1664,582400,6201981,10.36
9870119,9989640,2678,937300,10926940,9.38
9870120,9993891,2323,813050,10806941,8.14
9870121,6203716,2160,756000,6959716,12.19
9870122,9988546,3228,1129800,11118346,11.31
9870123,9993619,4315,1510250,11503869,15.11
9870124,9981746,3551,1242850,11224596,12.45
9870125,9978004,3091,1081850,11059854,10.84
9870126,9987341,2955,1034250,11021591,10.36
9870127,9993450,2864,1002400,10995850,10.03
9870128,9900599,3106,1087100,10987699,10.98
9870129,9997983,3906,1367100,11365083,13.67
9870130,8996150,2068,723800,9719950,8.05
9870131,9983320,5019,1756650,11739970,17.60
9870132,6779079,1745,610750,7389829,9.01
9870134,1774297,588,205800,1980097,11.60
9870135,1517737,236,82600,1600337,5.44
9870136,9961527,3983,1394050,11355577,13.99
9870137,9963292,3274,1145900,11109192,11.50
9870138,9961008,3236,1132600,11093608,11.37
9870139,9971740,3652,1278200,11249940,12.82
9870140,9959570,3951,1382850,11342420,13.88
9870141,9951169,3457,1209950,11161119,12.16
9870143,9952352,3791,1326850,11279202,13.33
9870144,9950863,3034,1061900,11012763,10.67
9870145,9934393,1719,601650,10536043,6.06
9870146,9773115,2981,1043350,10816465,10.68
9870147,9935020,2415,845250,10780270,8.51
9870148,9916279,2712,949200,10865479,9.57
9870149,9930816,3065,1072750,11003566,10.80
9870150,9942674,2800,980000,10922674,9.86
9870151,9930649,4843,1695050,11625699,17.07
9870152,8800415,3346,1171100,9971515,13.31
9870153,1537468,511,178850,1716318,11.63
9870154,9932082,3399,1189650,11121732,11.98
9870155,5952637,1765,617750,6570387,10.38
9870156,9962036,3101,1085350,11047386,10.89
9870157,9983226,2270,794500,10777726,7.96
9870158,9985418,3253,1138550,11123968,11.40
9870159,9982472,3082,1078700,11061172,10.81
9870160,9996856,2161,756350,10753206,7.57
9870161,9973948,4398,1539300,11513248,15.43
9870162,9988358,3097,1083950,11072308,10.85
9870163,9973980,3352,1173200,11147180,11.76
9870164,9984540,1893,662550,10647090,6.64
9870165,9968563,2258,790300,10758863,7.93
9870166,9993595,2544,890400,10883995,8.91
9870167,5964300,1448,506800,6471100,8.50
9870168,9971201,3345,1170750,11141951,11.74
9870169,9985032,2307,807450,10792482,8.09
9870170,9978620,2863,1002050,10980670,10.04
9870171,9970884,2487,870450,10841334,8.73
9870172,9964282,2256,789600,10753882,7.92
9870173,9955100,3198,1119300,11074400,11.24
9870174,9825464,2286,800100,10625564,8.14
9870175,9986332,2304,806400,10792732,8.08
9870176,9993118,4188,1465800,11458918,14.67
9870177,9990070,2231,780850,10770920,7.82
9870178,9984006,4686,1640100,11624106,16.43
9870179,9995357,5183,1814050,11809407,18.15
9870180,9979637,2815,985250,10964887,9.87
9870181,9995076,2140,749000,10744076,7.49
9870182,9985096,1711,598850,10583946,6.00
9870183,9985905,2958,1035300,11021205,10.37
9870184,9988441,3287,1150450,11138891,11.52
9870185,9983728,2413,844550,10828278,8.46
9870186,9987605,2764,967400,10955005,9.69
9870187,9994942,3364,1177400,11172342,11.78
9870188,9983018,2325,813750,10796768,8.15
9870189,9979871,4363,1527050,11506921,15.30
9870190,9976052,4469,1564150,11540202,15.68
9870191,9957417,4208,1472800,11430217,14.79
9870192,9960190,4548,1591800,11551990,15.98
9870193,9955466,4242,1484700,11440166,14.91
9870194,9944193,3177,1111950,11056143,11.18
9870195,7245099,4655,1629250,8874349,22.49
9870196,9978826,3831,1340850,11319676,13.44
9870197,1087802,491,171850,1259652,15.80
9870199,9872682,4417,1545950,11418632,15.66
9870200,9933450,1696,593600,10527050,5.98
9870201,9917994,2614,914900,10832894,9.22
9870202,9922307,3452,1208200,11130507,12.18
9870203,6557653,1229,430150,6987803,6.56
9870204,9917223,3091,1081850,10999073,10.91
9870205,9908702,4806,1682100,11590802,16.98
9870207,9919730,5098,1784300,11704030,17.99
9870208,9930545,5168,1808800,11739345,18.21
9870209,9923957,3069,1074150,10998107,10.82
9870210,6698083,2128,744800,7442883,11.12
9870211,9945829,3638,1273300,11219129,12.80
9870213,9923868,2942,1029700,10953568,10.38
9870214,9930378,3653,1278550,11208928,12.88
9870215,9949031,2480,868000,10817031,8.72
9870216,9954392,2814,984900,10939292,9.89
9870217,9954008,3270,1144500,11098508,11.50
9870218,9966455,4013,1404550,11371005,14.09
9870219,9978421,4480,1568000,11546421,15.71
9870220,9981079,1679,587650,10568729,5.89
9870221,9989356,3212,1124200,11113556,11.25
9870222,9980738,4592,1607200,11587938,16.10
9870223,9996176,3080,1078000,11074176,10.78
9870224,561783,392,137200,698983,24.42
9870225,9963149,3297,1153950,11117099,11.58
9870226,582030,601,210350,792380,36.14
9870227,9944093,3561,1246350,11190443,12.53
9870228,9950608,3216,1125600,11076208,11.31
9870229,3886096,1720,602000,4488096,15.49
9870230,9958670,3864,1352400,11311070,13.58
9870231,2572618,1374,480900,3053518,18.69
9870232,9953168,4596,1608600,11561768,16.16
9870233,9955688,2621,917350,10873038,9.21
9870234,9963399,3706,1297100,11260499,13.02
9870235,9958538,2451,857850,10816388,8.61
9870236,9981525,5280,1848000,11829525,18.51
9870237,9978892,4659,1630650,11609542,16.34
9870238,9993888,3445,1205750,11199638,12.06
9870239,9972739,4580,1603000,11575739,16.07
9870240,9978578,1955,684250,10662828,6.86
9870241,9977124,3157,1104950,11082074,11.07
9870242,9969359,3915,1370250,11339609,13.74
9870244,9971199,2717,950950,10922149,9.54
9870245,9956368,2885,1009750,10966118,10.14
9870246,9959891,2737,957950,10917841,9.62
9870247,9973801,2488,870800,10844601,8.73
9870248,6295426,771,269850,6565276,4.29
9870249,9971604,3511,1228850,11200454,12.32
9870250,9972249,6265,2192750,12164999,21.99
9870251,5576888,2433,851550,6428438,15.27
9870252,9956930,2715,950250,10907180,9.54
9870253,9952027,3759,1315650,11267677,13.22
9870254,9975718,4452,1558200,11533918,15.62
9870255,9966394,3791,1326850,11293244,13.31
9870256,5354524,3216,1125600,6480124,21.02
9870257,9967620,3606,1262100,11229720,12.66
9870258,9971242,2824,988400,10959642,9.91
9870259,9974030,3459,1210650,11184680,12.14
9870260,9969389,3345,1170750,11140139,11.74
9870261,9986029,2787,975450,10961479,9.77
9870262,9985409,3620,1267000,11252409,12.69
9870263,9979818,4362,1526700,11506518,15.30
9870264,4498407,1690,591500,5089907,13.15
9870265,9986593,2764,967400,10953993,9.69
9870266,9963529,2599,909650,10873179,9.13
9870267,409939,218,76300,486239,18.61
9870268,9959487,3614,1264900,11224387,12.70
9870269,9967180,3219,1126650,11093830,11.30
9870270,7188767,1944,680400,7869167,9.46
9870271,9966340,4079,1427650,11393990,14.32
9870272,9967658,3299,1154650,11122308,11.58
9870273,9973686,3601,1260350,11234036,12.64
9870274,9998997,2756,964600,10963597,9.65
9870275,9986088,3556,1244600,11230688,12.46
9870276,9980928,3294,1152900,11133828,11.55
9870277,9981334,2178,762300,10743634,7.64
9870278,9985195,4881,1708350,11693545,17.11
9870279,6025296,3475,1216250,7241546,20.19
9870280,9973993,2538,888300,10862293,8.91
9870281,9989717,2166,758100,10747817,7.59
9870282,9937431,2869,1004150,10941581,10.10
9870283,9989656,2415,845250,10834906,8.46
9870284,9973029,3720,1302000,11275029,13.06
9870285,9963684,3564,1247400,11211084,12.52
9870286,9976865,4714,1649900,11626765,16.54
9870287,423731,67,23450,447181,5.53
9870288,9985077,3167,1108450,11093527,11.10
9870289,9978223,1935,677250,10655473,6.79
9870290,9995487,2522,882700,10878187,8.83
9870291,9692060,2832,991200,10683260,10.23
9870292,2122064,522,182700,2304764,8.61
9870293,9980844,4079,1427650,11408494,14.30
9870294,9993122,1268,443800,10436922,4.44
9870295,9999302,4552,1593200,11592502,15.93
9870296,9999428,5297,1853950,11853378,18.54
9870297,9995579,2371,829850,10825429,8.30
9870298,9982580,2974,1040900,11023480,10.43
9870299,9978430,3174,1110900,11089330,11.13
9870300,9980428,3455,1209250,11189678,12.12
9870301,9965839,2962,1036700,11002539,10.40
9870302,9961311,4686,1640100,11601411,16.46
9870303,9945580,4978,1742300,11687880,17.52
9870304,9975504,3446,1206100,11181604,12.09
9870305,9969230,2909,1018150,10987380,10.21
9870306,365816,97,33950,399766,9.28
9870307,9955254,2986,1045100,11000354,10.50
9870308,9957048,2441,854350,10811398,8.58
9870309,9874567,6169,2159150,12033717,21.87
9870310,9955456,3665,1282750,11238206,12.88
9870311,9956187,2196,768600,10724787,7.72
9870312,9961439,4790,1676500,11637939,16.83
9870313,9947946,5367,1878450,11826396,18.88
9870315,1251656,166,58100,1309756,4.64
9870316,9938885,5008,1752800,11691685,17.64
9870317,9957933,4234,1481900,11439833,14.88
9870318,9963152,3622,1267700,11230852,12.72
9870319,9970179,2649,927150,10897329,9.30
9870320,9951079,3416,1195600,11146679,12.01
9870321,9463427,3009,1053150,10516577,11.13
9870322,9968618,3996,1398600,11367218,14.03
9870323,9977956,2289,801150,10779106,8.03
9870324,9997830,5657,1979950,11977780,19.80
9870325,9973260,4459,1560650,11533910,15.65
9870326,9482347,4564,1597400,11079747,16.85
9870327,9981219,2996,1048600,11029819,10.51
9870328,4684727,704,246400,4931127,5.26
9870329,3769207,1989,696150,4465357,18.47
9870330,625796,384,134400,760196,21.48
9870331,9962789,5848,2046800,12009589,20.54
9870332,9440380,2490,871500,10311880,9.23
9870333,9964084,2493,872550,10836634,8.76
9870334,9967213,4730,1655500,11622713,16.61
9870335,9954593,2679,937650,10892243,9.42
9870336,6903083,1270,444500,7347583,6.44
9870337,9955653,2809,983150,10938803,9.88
9870338,3107421,723,253050,3360471,8.14
9870339,9958745,3416,1195600,11154345,12.01
9870340,9974838,2250,787500,10762338,7.89
9870341,9974606,4896,1713600,11688206,17.18
9870342,9987522,2716,950600,10938122,9.52
9870343,9986877,2238,783300,10770177,7.84
9870344,9842805,2762,966700,10809505,9.82
9870345,9983691,2957,1034950,11018641,10.37
9870346,9980266,5061,1771350,11751616,17.75
9870347,9988985,4455,1559250,11548235,15.61
9870348,9962751,3394,1187900,11150651,11.92
9870349,9961297,5633,1971550,11932847,19.79
9870350,9959054,4800,1680000,11639054,16.87
9870351,9966849,4401,1540350,11507199,15.45
9870353,9959865,2912,1019200,10979065,10.23
9870354,9966616,3780,1323000,11289616,13.27
9870355,9980392,3674,1285900,11266292,12.88
9870356,9966131,4152,1453200,11419331,14.58
9870357,9967316,2744,960400,10927716,9.64
9870358,9150248,3447,1206450,10356698,13.18
9870359,9981832,4906,1717100,11698932,17.20
9870360,9980212,2683,939050,10919262,9.41
9870361,9975959,3922,1372700,11348659,13.76
9870362,9992153,5272,1845200,11837353,18.47
9870363,9996530,3240,1134000,11130530,11.34
9870364,9990874,3635,1272250,11263124,12.73
9870365,9973557,5937,2077950,12051507,20.83
9870366,9975800,3775,1321250,11297050,13.24
9870367,9715633,4289,1501150,11216783,15.45
9870368,1767625,860,301000,2068625,17.03
9870369,9620740,3470,1214500,10835240,12.62
9870370,9970833,4026,1409100,11379933,14.13
9870371,9958523,3418,1196300,11154823,12.01
9870372,9957304,2593,907550,10864854,9.11
9870373,9965407,2039,713650,10679057,7.16
9870374,9970267,5117,1790950,11761217,17.96
9870375,2880047,586,205100,3085147,7.12
9870376,9962602,1639,573650,10536252,5.76
9870377,9979183,4136,1447600,11426783,14.51
9870378,9968482,3026,1059100,11027582,10.62
9870379,9960884,1987,695450,10656334,6.98
9870380,9965674,3582,1253700,11219374,12.58
9870381,9971122,3798,1329300,11300422,13.33
9870382,9982723,3559,1245650,11228373,12.48
9870383,9994321,4345,1520750,11515071,15.22
9870384,9981212,2894,1012900,10994112,10.15
9870385,9977129,5762,2016700,11993829,20.21
9870386,598915,207,72450,671365,12.10
9870387,9956445,4941,1729350,11685795,17.37
9870388,8978872,1799,629650,9608522,7.01
9870389,9966990,976,341600,10308590,3.43
9870390,9974246,2409,843150,10817396,8.45
9870391,9976655,1715,600250,10576905,6.02
9870392,9987969,3100,1085000,11072969,10.86
9870393,9979350,2286,800100,10779450,8.02
9870394,9977066,3798,1329300,11306366,13.32
9870395,9970399,2102,735700,10706099,7.38
9870396,9987034,3685,1289750,11276784,12.91
9870398,9977325,2993,1047550,11024875,10.50
9870399,337783,190,66500,404283,19.69
9870400,9980503,4070,1424500,11405003,14.27
9870401,8990293,2322,812700,9802993,9.04
9870403,9969665,2669,934150,10903815,9.37
9870404,9964642,1944,680400,10645042,6.83
9870405,9984564,2429,850150,10834714,8.51
9870406,9985041,2354,823900,10808941,8.25
9870407,9992110,5132,1796200,11788310,17.98
9870408,9979163,4492,1572200,11551363,15.75
9870409,9992866,3671,1284850,11277716,12.86
9870411,4768655,2084,729400,5498055,15.30
9870412,9983201,6096,2133600,12116801,21.37
9870413,9976808,1229,430150,10406958,4.31
9870414,9996687,3216,1125600,11122287,11.26
9870415,3519450,1069,374150,3893600,10.63
9870416,9981643,3402,1190700,11172343,11.93
9870417,9946226,2584,904400,10850626,9.09
9870418,9972993,2798,979300,10952293,9.82
9870419,9978401,4352,1523200,11501601,15.26
9870421,9987517,3676,1286600,11274117,12.88
9870422,9996502,3854,1348900,11345402,13.49
9870423,9970902,3249,1137150,11108052,11.40
9870424,9988963,3682,1288700,11277663,12.90
9870425,9989556,1687,590450,10580006,5.91
9870426,9986104,2249,787150,10773254,7.88
9870427,9982956,4013,1404550,11387506,14.07
9870428,512310,318,111300,623610,21.73
9870429,9976920,2962,1036700,11013620,10.39
9870430,9984302,2658,930300,10914602,9.32
9870431,9988622,3039,1063650,11052272,10.65
9870432,4454400,2135,747250,5201650,16.78
9870433,9972989,4296,1503600,11476589,15.08
9870434,9982111,1880,658000,10640111,6.59
9870435,9980242,2719,951650,10931892,9.54
9870436,9996743,3965,1387750,11384493,13.88
9870437,9977058,239,83650,10060708,0.84
9870438,9981715,3392,1187200,11168915,11.89
9870439,2297827,1135,397250,2695077,17.29
9870440,8339292,2598,909300,9248592,10.90
9870441,9991808,3342,1169700,11161508,11.71
9870442,9997421,5365,1877750,11875171,18.78
9870443,9988323,3532,1236200,11224523,12.38
9870444,9974072,2011,703850,10677922,7.06
9870445,9952157,2086,730100,10682257,7.34
9870446,9986860,2339,818650,10805510,8.20
9870447,9979094,3610,1263500,11242594,12.66
9870448,9985251,2826,989100,10974351,9.91
9870449,9982032,3741,1309350,11291382,13.12
9870450,9982339,2449,857150,10839489,8.59
9870451,3618071,1237,432950,4051021,11.97
9870452,9970135,3457,1209950,11180085,12.14
9870453,9982498,2820,987000,10969498,9.89
9870454,9946501,575,201250,10147751,2.02
9870455,9935970,2005,701750,10637720,7.06
9870456,9977988,1425,498750,10476738,5.00
9870457,9995845,1943,680050,10675895,6.80
9870458,9994851,2143,750050,10744901,7.50
9870459,9992217,1561,546350,10538567,5.47
9870460,9989448,2748,961800,10951248,9.63
9870461,9987432,2355,824250,10811682,8.25
9870462,9980604,2220,777000,10757604,7.79
9870463,5367853,1142,399700,5767553,7.45
9870464,9969384,3312,1159200,11128584,11.63
9870465,9968607,3480,1218000,11186607,12.22
9870467,9962439,1015,355250,10317689,3.57
9870468,9985186,2318,811300,10796486,8.13
9870469,9981009,2580,903000,10884009,9.05
9870470,9993130,3894,1362900,11356030,13.64
9870471,9997345,2911,1018850,11016195,10.19
9870472,9990873,4039,1413650,11404523,14.15
9870473,9988678,2313,809550,10798228,8.10
9870474,9988068,2013,704550,10692618,7.05
9870475,9988058,1923,673050,10661108,6.74
9870476,9990708,1492,522200,10512908,5.23
9870477,8092542,1658,580300,8672842,7.17
9870478,9989723,2247,786450,10776173,7.87
9870479,9917683,2242,784700,10702383,7.91
9870480,9979918,2601,910350,10890268,9.12
9870481,9977058,4201,1470350,11447408,14.74
9870482,9985620,3430,1200500,11186120,12.02
9870483,9984321,1977,691950,10676271,6.93
9870484,9970280,1191,416850,10387130,4.18
9870485,9999407,3730,1305500,11304907,13.06
9870486,9982879,2527,884450,10867329,8.86
9870487,9984612,3968,1388800,11373412,13.91
9870488,9989361,2744,960400,10949761,9.61
9870489,9973451,3742,1309700,11283151,13.13
9870490,9955810,2100,735000,10690810,7.38
9870491,9961719,2551,892850,10854569,8.96
9870492,9973010,2267,793450,10766460,7.96
9870493,6195146,2160,756000,6951146,12.20
9870494,9980658,3423,1198050,11178708,12.00
9870495,2284485,1496,523600,2808085,22.92
9870496,9964731,2901,1015350,10980081,10.19
9870497,7420371,2030,710500,8130871,9.57
9870498,9970868,2139,748650,10719518,7.51
9870499,9980176,2835,992250,10972426,9.94
9870500,9975273,5672,1985200,11960473,19.90
9870501,9964601,3391,1186850,11151451,11.91
9870502,9973895,5436,1902600,11876495,19.08
9870503,9964175,3338,1168300,11132475,11.73
9870504,1392910,1278,447300,1840210,32.11
9870505,9943380,1930,675500,10618880,6.79
9870506,9971886,4805,1681750,11653636,16.86
9870507,9954678,3688,1290800,11245478,12.97
9870508,9982910,3741,1309350,11292260,13.12
9870509,9988988,5245,1835750,11824738,18.38
9870510,9975913,3760,1316000,11291913,13.19
9870511,9985966,3727,1304450,11290416,13.06
9870512,9988408,1844,645400,10633808,6.46
9870513,9994767,3067,1073450,11068217,10.74
9870514,9981265,2761,966350,10947615,9.68
9870515,9979250,3596,1258600,11237850,12.61
9870516,9981627,2870,1004500,10986127,10.06
9870517,9986006,4642,1624700,11610706,16.27
9870518,9986712,4492,1572200,11558912,15.74
9870519,9998307,4428,1549800,11548107,15.50
9870520,9983502,3513,1229550,11213052,12.32
9870521,9962485,6029,2110150,12072635,21.18
9870522,9964199,3853,1348550,11312749,13.53
9870524,9963086,2397,838950,10802036,8.42
9870525,9971590,5258,1840300,11811890,18.46
9870526,9973415,1977,691950,10665365,6.94
9870527,9976650,4169,1459150,11435800,14.63
9870528,9995682,4744,1660400,11656082,16.61
9870529,9989643,4439,1553650,11543293,15.55
9870530,9974814,2441,854350,10829164,8.57
9870531,9979978,3583,1254050,11234028,12.57
9870532,9953353,3716,1300600,11253953,13.07
9870533,9972785,2467,863450,10836235,8.66
9870534,9965649,3707,1297450,11263099,13.02
9870535,9981005,1649,577150,10558155,5.78
9870536,5815897,1846,646100,6461997,11.11
9870537,9976038,2597,908950,10884988,9.11
9870538,9993224,3073,1075550,11068774,10.76
9870539,9992592,3909,1368150,11360742,13.69
9870540,9959282,1821,637350,10596632,6.40
9870541,9980256,3281,1148350,11128606,11.51
9870542,9788506,4964,1737400,11525906,17.75
9870543,9980154,2745,960750,10940904,9.63
9870544,9972604,2216,775600,10748204,7.78
9870545,3080609,1575,551250,3631859,17.89
9870546,9978898,3342,1169700,11148598,11.72
9870547,1508833,250,87500,1596333,5.80
9870548,9956841,2276,796600,10753441,8.00
9870549,9968856,2797,978950,10947806,9.82
9870550,9975001,2787,975450,10950451,9.78
9870551,9986509,2673,935550,10922059,9.37
9870553,9983599,3742,1309700,11293299,13.12
9870554,9976820,2208,772800,10749620,7.75
9870555,9940259,3209,1123150,11063409,11.30
9870556,9976404,2521,882350,10858754,8.84
9870557,9970876,3295,1153250,11124126,11.57
9870558,9976336,3945,1380750,11357086,13.84
9870559,9960135,3687,1290450,11250585,12.96
9870560,9981500,4586,1605100,11586600,16.08
9870561,9981886,4917,1720950,11702836,17.24
9870562,9972028,2935,1027250,10999278,10.30
9870563,9987943,5235,1832250,11820193,18.34
9870565,9983188,4748,1661800,11644988,16.65
9870566,9986748,3543,1240050,11226798,12.42
9870567,9974358,4649,1627150,11601508,16.31
9870568,3846721,948,331800,4178521,8.63
9870569,9979730,3959,1385650,11365380,13.88
9870570,9977226,2496,873600,10850826,8.76
9870571,9988768,2677,936950,10925718,9.38
9870572,9987540,3209,1123150,11110690,11.25
9870573,9983612,3176,1111600,11095212,11.13
9870574,9994178,3517,1230950,11225128,12.32
9870575,9993043,1966,688100,10681143,6.89
9870576,9986845,2502,875700,10862545,8.77
9870577,5320292,1095,383250,5703542,7.20
9870578,9967428,4362,1526700,11494128,15.32
9870580,7517198,2584,904400,8421598,12.03
9870581,9944346,2966,1038100,10982446,10.44
9870582,9952779,4445,1555750,11508529,15.63
9870583,9954231,2284,799400,10753631,8.03
9870584,9959102,4482,1568700,11527802,15.75
9870586,9146159,2845,995750,10141909,10.89
9870587,9283811,3970,1389500,10673311,14.97
9870588,9986697,3571,1249850,11236547,12.52
9870589,9995162,2078,727300,10722462,7.28
9870590,1261910,344,120400,1382310,9.54
9870591,9978149,2858,1000300,10978449,10.02
9870592,9958047,4361,1526350,11484397,15.33
9870593,9964178,2293,802550,10766728,8.05
9870594,9969877,1973,690550,10660427,6.93
9870595,9963566,3085,1079750,11043316,10.84
9870596,9969282,3666,1283100,11252382,12.87
9870597,9964341,3123,1093050,11057391,10.97
9870598,9971704,626,219100,10190804,2.20
9870599,9976254,1227,429450,10405704,4.30
9870600,9959055,6448,2256800,12215855,22.66
9870601,9978974,2849,997150,10976124,9.99
9870602,9978482,3547,1241450,11219932,12.44
9870603,9976326,4366,1528100,11504426,15.32
9870604,9985362,4422,1547700,11533062,15.50
9870605,9970311,3947,1381450,11351761,13.86
9870606,9199592,5952,2083200,11282792,22.64
9870607,9730415,2382,833700,10564115,8.57
9870608,9207239,5103,1786050,10993289,19.40
9870609,9968316,4023,1408050,11376366,14.13
9870610,9969721,3398,1189300,11159021,11.93
9870611,9979777,3437,1202950,11182727,12.05
9870612,9970192,3370,1179500,11149692,11.83
9870613,9957380,3516,1230600,11187980,12.36
9870614,9989067,2884,1009400,10998467,10.11
9870615,9971207,2590,906500,10877707,9.09
9870616,9991992,3685,1289750,11281742,12.91
9870617,7807384,658,230300,8037684,2.95
9870618,9956928,3249,1137150,11094078,11.42
9870619,9990532,3032,1061200,11051732,10.62
9870620,9970655,3320,1162000,11132655,11.65
9870622,9974527,3246,1136100,11110627,11.39
9870623,9962033,4203,1471050,11433083,14.77
9870624,9977601,1987,695450,10673051,6.97
9870625,9962534,3401,1190350,11152884,11.95
9870626,9967178,2612,914200,10881378,9.17
9870627,9975332,3092,1082200,11057532,10.85
9870628,9955269,3734,1306900,11262169,13.13
9870629,9605100,2851,997850,10602950,10.39
9870630,9973554,4722,1652700,11626254,16.57
9870631,9973650,4601,1610350,11584000,16.15
9870632,9975924,3121,1092350,11068274,10.95
9870633,9981756,2368,828800,10810556,8.30
9870634,9981112,4263,1492050,11473162,14.95
9870635,9975319,3377,1181950,11157269,11.85
9870636,9979954,3304,1156400,11136354,11.59
9870637,6981624,1218,426300,7407924,6.11
9870638,9998040,4016,1405600,11403640,14.06
9870639,9980716,4633,1621550,11602266,16.25
9870640,9987454,2544,890400,10877854,8.92
9870641,9976605,3337,1167950,11144555,11.71
9870642,9974354,4670,1634500,11608854,16.39
9870643,9982055,3604,1261400,11243455,12.64
9870644,9979249,4249,1487150,11466399,14.90
9870645,9910046,4286,1500100,11410146,15.14
9870646,9990072,3802,1330700,11320772,13.32
9870647,791467,179,62650,854117,7.92
9870648,9984334,4805,1681750,11666084,16.84
9870649,3454406,772,270200,3724606,7.82
9870650,9966741,3078,1077300,11044041,10.81
9870651,9970804,2700,945000,10915804,9.48
9870652,9972700,2779,972650,10945350,9.75
9870653,9989747,2634,921900,10911647,9.23
9870654,2827365,1750,612500,3439865,21.66
9870655,9978464,4210,1473500,11451964,14.77
9870656,9920184,4632,1621200,11541384,16.34
9870657,9981787,4687,1640450,11622237,16.43
9870658,9998692,3744,1310400,11309092,13.11
9870659,9993196,3443,1205050,11198246,12.06
9870660,9987541,2408,842800,10830341,8.44
9870661,9979242,3110,1088500,11067742,10.91
9870662,9976757,3219,1126650,11103407,11.29
9870663,9963465,2422,847700,10811165,8.51
9870664,9953003,2604,911400,10864403,9.16
9870665,9941857,3589,1256150,11198007,12.63
9870666,9953027,2620,917000,10870027,9.21
9870668,9905099,3532,1236200,11141299,12.48
9870669,8814583,5238,1833300,10647883,20.80
9870670,9955807,2813,984550,10940357,9.89
9870671,9977504,4786,1675100,11652604,16.79
9870672,3632865,3242,1134700,4767565,31.23
9870673,9972884,4842,1694700,11667584,16.99
9870674,9955383,3849,1347150,11302533,13.53
9870675,9976270,2536,887600,10863870,8.90
9870676,9978098,2887,1010450,10988548,10.13
9870677,9982234,3699,1294650,11276884,12.97
9870678,9940581,4507,1577450,11518031,15.87
9870679,9979516,2881,1008350,10987866,10.10
9870680,9983928,5803,2031050,12014978,20.34
9870681,9974692,3776,1321600,11296292,13.25
9870682,9986710,2874,1005900,10992610,10.07
9870683,8692181,4292,1502200,10194381,17.28
9870684,9992292,3001,1050350,11042642,10.51
9870685,8963107,1978,692300,9655407,7.72
9870686,9974479,3790,1326500,11300979,13.30
9870687,9997309,4710,1648500,11645809,16.49
9870688,9982344,3317,1160950,11143294,11.63
9870689,9983025,3875,1356250,11339275,13.59
9870690,8837938,2851,997850,9835788,11.29
9870691,4752298,1070,374500,5126798,7.88
9870692,8960682,4316,1510600,10471282,16.86
9870693,9989260,4194,1467900,11457160,14.69
9870694,9980205,3661,1281350,11261555,12.84
9870695,9979803,3920,1372000,11351803,13.75
9870696,9978620,3099,1084650,11063270,10.87
9870697,9889688,4153,1453550,11343238,14.70
9870698,9986917,6052,2118200,12105117,21.21
9870699,9927046,1311,458850,10385896,4.62
9870700,9982422,4165,1457750,11440172,14.60
9870701,9980783,3834,1341900,11322683,13.44
9870702,9983184,3752,1313200,11296384,13.15
9870703,9980429,1862,651700,10632129,6.53
9870704,9984236,4128,1444800,11429036,14.47
9870705,9991840,5491,1921850,11913690,19.23
9870706,9988402,4348,1521800,11510202,15.24
9870707,9968187,3797,1328950,11297137,13.33
9870708,9981754,5265,1842750,11824504,18.46
9870709,9967243,2952,1033200,11000443,10.37
9870710,2910560,1508,527800,3438360,18.13
9870711,9982116,3226,1129100,11111216,11.31
9870712,3555184,1625,568750,4123934,16.00
9870713,9990561,2744,960400,10950961,9.61
9870714,9999355,3848,1346800,11346155,13.47
9870715,9994756,3696,1293600,11288356,12.94
9870716,9976037,5547,1941450,11917487,19.46
9870717,9790409,2103,736050,10526459,7.52
9870718,9956020,4107,1437450,11393470,14.44
9870719,9970028,3849,1347150,11317178,13.51
9870720,9969961,3085,1079750,11049711,10.83
9870721,9959802,1425,498750,10458552,5.01
9870722,9966959,3053,1068550,11035509,10.72
9870723,9976721,2374,830900,10807621,8.33
9870724,9968411,3221,1127350,11095761,11.31
9870725,9984174,3314,1159900,11144074,11.62
9870727,9968686,3734,1306900,11275586,13.11
9870728,9985169,2553,893550,10878719,8.95
9870729,9963870,3155,1104250,11068120,11.08
9870730,9968326,2408,842800,10811126,8.45
9870731,9994988,3772,1320200,11315188,13.21
9870732,9977139,3854,1348900,11326039,13.52
9870733,9877680,2604,911400,10789080,9.23
9870735,9956929,4865,1702750,11659679,17.10
9870736,9973596,3098,1084300,11057896,10.87
9870737,9977078,2674,935900,10912978,9.38
9870738,9982616,2747,961450,10944066,9.63
9870739,9987553,2135,747250,10734803,7.48
9870740,9916902,2715,950250,10867152,9.58
9870741,8992135,2456,859600,9851735,9.56
9870742,9981915,2708,947800,10929715,9.50
9870743,9988008,4094,1432900,11420908,14.35
9870744,9993246,3503,1226050,11219296,12.27
9870745,9994969,3314,1159900,11154869,11.60
9870746,9971344,3611,1263850,11235194,12.67
9870748,9992147,4000,1400000,11392147,14.01
9870749,9985611,3771,1319850,11305461,13.22
9870750,9996021,4376,1531600,11527621,15.32
9870751,9971324,4697,1643950,11615274,16.49
9870752,9979675,4011,1403850,11383525,14.07
9870753,3545183,889,311150,3856333,8.78
9870754,9983507,1929,675150,10658657,6.76
9870755,2628508,2699,944650,3573158,35.94
9870756,9996285,5169,1809150,11805435,18.10
9870757,3447924,797,278950,3726874,8.09
9870758,6239265,4670,1634500,7873765,26.20
9870759,9971365,4885,1709750,11681115,17.15
9870760,9957366,3621,1267350,11224716,12.73
9870761,4227262,1595,558250,4785512,13.21
9870762,9940098,2789,976150,10916248,9.82
9870763,3771207,3067,1073450,4844657,28.46
9870764,9920335,3163,1107050,11027385,11.16
9870765,9933984,3172,1110200,11044184,11.18
9870766,9943372,4001,1400350,11343722,14.08
9870768,9914179,2690,941500,10855679,9.50
9870769,8519366,3324,1163400,9682766,13.66
9870770,9894931,1168,408800,10303731,4.13
9870771,9911442,822,287700,10199142,2.90
9870772,9907731,4759,1665650,11573381,16.81
9870773,9911519,3353,1173550,11085069,11.84
9870774,8998110,2434,851900,9850010,9.47
9870775,9932429,4056,1419600,11352029,14.29
9870776,9914661,4591,1606850,11521511,16.21
9870777,2840711,1761,616350,3457061,21.70
9870778,9913796,2163,757050,10670846,7.64
9870779,9932064,2259,790650,10722714,7.96
9870780,2222627,846,296100,2518727,13.32
9870781,9926670,6027,2109450,12036120,21.25
9870782,9926614,2802,980700,10907314,9.88
9870783,9934390,3592,1257200,11191590,12.66
9870784,9958179,3163,1107050,11065229,11.12
9870785,9963450,4346,1521100,11484550,15.27
9870786,9972178,3369,1179150,11151328,11.82
9870787,8975057,4118,1441300,10416357,16.06
9870788,9993865,4683,1639050,11632915,16.40
9870789,9918847,2180,763000,10681847,7.69
9870790,9933181,4843,1695050,11628231,17.06
9870791,6547967,1592,557200,7105167,8.51
9870792,9984556,3305,1156750,11141306,11.59
9870793,9980164,4572,1600200,11580364,16.03
9870794,9992826,1954,683900,10676726,6.84
9870795,9981191,2666,933100,10914291,9.35
9870796,9992586,3495,1223250,11215836,12.24
9870798,9992811,2606,912100,10904911,9.13
9870799,9993587,4975,1741250,11734837,17.42
9870800,9994323,3534,1236900,11231223,12.38
9870801,9979514,3613,1264550,11244064,12.67
9870802,9985064,4778,1672300,11657364,16.75
9870803,9987004,3619,1266650,11253654,12.68
9870804,9982148,2754,963900,10946048,9.66
9870805,9371475,4232,1481200,10852675,15.81
9870806,9961822,2337,817950,10779772,8.21
9870807,9996717,4159,1455650,11452367,14.56
9870808,9972569,2742,959700,10932269,9.62
9870809,9965169,2631,920850,10886019,9.24
9870810,9976208,3101,1085350,11061558,10.88
9870811,9990270,2226,779100,10769370,7.80
9870812,9989642,2975,1041250,11030892,10.42
9870813,9988017,4171,1459850,11447867,14.62
9870814,9985100,4184,1464400,11449500,14.67
9870815,9988400,3892,1362200,11350600,13.64
9870816,9992371,3795,1328250,11320621,13.29
9870817,9995386,2855,999250,10994636,10.00
9870818,9970479,4750,1662500,11632979,16.67
9870819,9969733,2985,1044750,11014483,10.48
9870820,9953172,2566,898100,10851272,9.02
9870821,9969698,4347,1521450,11491148,15.26
9870822,9953487,2947,1031450,10984937,10.36
9870823,9947306,2446,856100,10803406,8.61
9870824,9880339,3542,1239700,11120039,12.55
9870825,9963368,4449,1557150,11520518,15.63
9870826,9978252,3565,1247750,11226002,12.50
9870827,9957951,3731,1305850,11263801,13.11
9870828,7465940,2730,955500,8421440,12.80
9870830,9989579,2357,824950,10814529,8.26
9870831,9989045,3897,1363950,11352995,13.65
9870832,9999648,3016,1055600,11055248,10.56
9870833,9991310,2624,918400,10909710,9.19
9870834,9986794,4499,1574650,11561444,15.77
9870835,9974425,2870,1004500,10978925,10.07
9870836,9967814,3091,1081850,11049664,10.85
9870837,9980224,4308,1507800,11488024,15.11
9870838,9979918,2646,926100,10906018,9.28
9870839,9959017,2895,1013250,10972267,10.17
9870840,9959656,2793,977550,10937206,9.82
9870841,9951349,2994,1047900,10999249,10.53
9870842,9959556,2424,848400,10807956,8.52
9870843,9975913,1873,655550,10631463,6.57
9870844,1983582,425,148750,2132332,7.50
9870845,9964923,7524,2633400,12598323,26.43
9870846,9975784,4152,1453200,11428984,14.57
9870847,9980174,2820,987000,10967174,9.89
9870848,9980934,2128,744800,10725734,7.46
9870849,9993784,3791,1326850,11320634,13.28
9870850,9964626,3400,1190000,11154626,11.94
9870851,9980077,3226,1129100,11109177,11.31
9870852,9994530,1892,662200,10656730,6.63
9870853,9984886,3499,1224650,11209536,12.27
9870855,9954236,3816,1335600,11289836,13.42
9870856,9961163,4094,1432900,11394063,14.38
9870857,9968723,3674,1285900,11254623,12.90
9870858,9984690,4428,1549800,11534490,15.52
9870859,9993293,2546,891100,10884393,8.92
9870860,9974999,3415,1195250,11170249,11.98
9870861,9990408,3265,1142750,11133158,11.44
9870862,9972962,2244,785400,10758362,7.88
9870863,9985234,3038,1063300,11048534,10.65
9870864,9977990,4672,1635200,11613190,16.39
9870865,9967197,3245,1135750,11102947,11.39
9870866,9956190,2104,736400,10692590,7.40
9870867,9958916,5695,1993250,11952166,20.01
9870868,9958217,3088,1080800,11039017,10.85
9870869,9944937,5994,2097900,12042837,21.10
9870870,9949571,2603,911050,10860621,9.16
9870871,9973946,3377,1181950,11155896,11.85
9870872,9979442,3990,1396500,11375942,13.99
9870873,9978833,3490,1221500,11200333,12.24
9870874,8999981,3139,1098650,10098631,12.21
9870875,9992097,3209,1123150,11115247,11.24
9870876,9986829,3081,1078350,11065179,10.80
9870877,9990413,3254,1138900,11129313,11.40
9870878,9998651,2672,935200,10933851,9.35
9870879,9983465,4045,1415750,11399215,14.18
9870880,9993541,1478,517300,10510841,5.18
9870881,9999397,2392,837200,10836597,8.37
9870882,9996942,4516,1580600,11577542,15.81
9870883,9992022,3433,1201550,11193572,12.03
9870884,9997699,2963,1037050,11034749,10.37
9870885,9898297,3596,1258600,11156897,12.72
9870886,9919459,3810,1333500,11252959,13.44
9870887,9981189,2474,865900,10847089,8.68
9870888,9992422,4915,1720250,11712672,17.22
9870890,9977200,2079,727650,10704850,7.29
9870891,9979031,4661,1631350,11610381,16.35
9870892,9956908,3301,1155350,11112258,11.60
9870893,9972322,2753,963550,10935872,9.66
9870894,9991308,3232,1131200,11122508,11.32
9870895,9931188,1762,616700,10547888,6.21
9870897,9957919,4040,1414000,11371919,14.20
9870898,9986674,2924,1023400,11010074,10.25
9870899,8664660,3152,1103200,9767860,12.73
9870900,9982567,3781,1323350,11305917,13.26
9870901,9963110,2842,994700,10957810,9.98
9870902,9977989,3075,1076250,11054239,10.79
9870903,9989952,2716,950600,10940552,9.52
9870904,9983649,5884,2059400,12043049,20.63
9870905,9980383,3545,1240750,11221133,12.43
9870906,9975148,2989,1046150,11021298,10.49
9870907,9988202,2771,969850,10958052,9.71
9870908,9972593,2559,895650,10868243,8.98
9870909,9986793,3904,1366400,11353193,13.68
9870910,9989175,3904,1366400,11355575,13.68
9870911,9969735,3955,1384250,11353985,13.88
9870912,9974822,3147,1101450,11076272,11.04
9870913,9966545,3619,1266650,11233195,12.71
9870914,6723194,1545,540750,7263944,8.04
9870915,9967203,5300,1855000,11822203,18.61
9870916,9965794,3219,1126650,11092444,11.31
9870917,9955551,4176,1461600,11417151,14.68
9870918,9975178,5698,1994300,11969478,19.99
9870919,9974083,1959,685650,10659733,6.87
9870920,9990981,3831,1340850,11331831,13.42
9870921,9974480,1827,639450,10613930,6.41
9870922,9979659,5344,1870400,11850059,18.74
9870923,9959945,3402,1190700,11150645,11.95
9870924,9977588,1649,577150,10554738,5.78
9870925,9967155,368,128800,10095955,1.29
9870926,9959871,3039,1063650,11023521,10.68
9870927,9965636,5237,1832950,11798586,18.39
9870928,9993715,3637,1272950,11266665,12.74
9870929,9971598,3065,1072750,11044348,10.76
9870930,9886738,3168,1108800,10995538,11.22
9870931,9991278,2980,1043000,11034278,10.44
9870932,9976927,4678,1637300,11614227,16.41
9870933,9001226,2687,940450,9941676,10.45
9870934,9990841,1873,655550,10646391,6.56
9870935,9922164,3811,1333850,11256014,13.44
9870936,9908579,3018,1056300,10964879,10.66
9870937,9981011,5490,1921500,11902511,19.25
9870938,9973359,3393,1187550,11160909,11.91
9870939,9990426,3934,1376900,11367326,13.78
9870941,9982696,3064,1072400,11055096,10.74
9870942,9981482,1526,534100,10515582,5.35
9870943,9981921,2601,910350,10892271,9.12
9870944,9985358,2429,850150,10835508,8.51
9870946,9965009,6097,2133950,12098959,21.41
9870947,9976275,3065,1072750,11049025,10.75
9870948,9994245,5819,2036650,12030895,20.38
9870949,9976785,3240,1134000,11110785,11.37
9870950,9981747,1510,528500,10510247,5.29
9870951,9984304,1116,390600,10374904,3.91
9870952,9972047,2362,826700,10798747,8.29
9870953,9988582,4652,1628200,11616782,16.30
9870954,9980455,4329,1515150,11495605,15.18
9870955,9983092,1910,668500,10651592,6.70
9870956,9997234,4096,1433600,11430834,14.34
9870957,9983278,3580,1253000,11236278,12.55
9870959,9954311,6148,2151800,12106111,21.62
9870960,7448893,2299,804650,8253543,10.80
9870961,9961330,3864,1352400,11313730,13.58
9870962,9974674,4487,1570450,11545124,15.74
9870963,9968817,4266,1493100,11461917,14.98
9870964,9981074,3368,1178800,11159874,11.81
9870965,2749160,987,345450,3094610,12.57
9870966,9972391,3342,1169700,11142091,11.73
9870967,9970354,4155,1454250,11424604,14.59
9870968,9989393,4260,1491000,11480393,14.93
9870969,9980820,4939,1728650,11709470,17.32
9870970,9997472,5196,1818600,11816072,18.19
9870971,9985495,4737,1657950,11643445,16.60
9870972,2303365,715,250250,2553615,10.86
9870973,9979400,3915,1370250,11349650,13.73
9870974,9980508,3681,1288350,11268858,12.91
9870975,9983757,4966,1738100,11721857,17.41
9870976,9989445,5550,1942500,11931945,19.45
9870977,9975964,5149,1802150,11778114,18.06
9870978,9971678,4485,1569750,11541428,15.74
9870979,9967855,2198,769300,10737155,7.72
9870980,9965138,3244,1135400,11100538,11.39
9870981,9964279,3425,1198750,11163029,12.03
9870982,9966820,3195,1118250,11085070,11.22
9870983,9983061,3251,1137850,11120911,11.40
9870984,3731882,1357,474950,4206832,12.73
9870985,9989193,5730,2005500,11994693,20.08
9870986,9482827,3790,1326500,10809327,13.99
9870987,9979153,4250,1487500,11466653,14.91
9870988,9370459,1956,684600,10055059,7.31
9870989,9980753,2458,860300,10841053,8.62
9870990,9995807,1658,580300,10576107,5.81
9870991,9988003,5517,1930950,11918953,19.33
9870992,9984843,2621,917350,10902193,9.19
9870993,9992425,1705,596750,10589175,5.97
9870994,9983523,2548,891800,10875323,8.93
9870995,9996296,2542,889700,10885996,8.90
9870996,9979103,4492,1572200,11551303,15.75
9870997,9990512,5061,1771350,11761862,17.73
9870998,9987778,4209,1473150,11460928,14.75
9870999,9989693,1387,485450,10475143,4.86
9871000,9974768,2912,1019200,10993968,10.22
9871001,9982427,3286,1150100,11132527,11.52
9871002,9979959,4517,1580950,11560909,15.84
9871003,9994414,4760,1666000,11660414,16.67
9871005,9902452,2142,749700,10652152,7.57
9871006,9986017,6538,2288300,12274317,22.92
9871007,9975566,4346,1521100,11496666,15.25
9871008,9984441,2944,1030400,11014841,10.32
9871009,9978608,3384,1184400,11163008,11.87
9871010,1577936,706,247100,1825036,15.66
9871011,9996104,4125,1443750,11439854,14.44
9871012,9990395,5630,1970500,11960895,19.72
9871013,9988003,3141,1099350,11087353,11.01
9871014,9972912,3388,1185800,11158712,11.89
9871015,9989509,3138,1098300,11087809,10.99
9871016,9996896,5368,1878800,11875696,18.79
9871017,9984044,3993,1397550,11381594,14.00
9871018,9996618,5430,1900500,11897118,19.01
9871019,9975356,489,171150,10146506,1.72
9871020,9961530,3681,1288350,11249880,12.93
9871021,9973876,6064,2122400,12096276,21.28
9871022,9973189,3818,1336300,11309489,13.40
9871023,9973221,3014,1054900,11028121,10.58
9871024,9971928,3853,1348550,11320478,13.52
9871025,9987443,3384,1184400,11171843,11.86
9871026,9917114,6231,2180850,12097964,21.99
9871028,9998982,3688,1290800,11289782,12.91
9871029,9992203,3741,1309350,11301553,13.10
9871030,9990047,4247,1486450,11476497,14.88
9871031,9991715,4890,1711500,11703215,17.13
9871032,9992116,3202,1120700,11112816,11.22
9871033,9988001,6100,2135000,12123001,21.38
9871034,9975113,2647,926450,10901563,9.29
9871035,9961841,3836,1342600,11304441,13.48
9871036,9965828,4324,1513400,11479228,15.19
9871037,9987897,4025,1408750,11396647,14.10
9871039,9950760,6855,2399250,12350010,24.11
9871040,9948199,6515,2280250,12228449,22.92
9871041,9962556,4160,1456000,11418556,14.61
9871042,9954147,6206,2172100,12126247,21.82
9871043,9941184,4940,1729000,11670184,17.39
9871045,9965012,4305,1506750,11471762,15.12
9871046,9959409,5298,1854300,11813709,18.62
9871047,9983822,1485,519750,10503572,5.21
9871048,9974693,2167,758450,10733143,7.60
9871049,9993021,1182,413700,10406721,4.14
9871050,9987049,1246,436100,10423149,4.37
9871051,9987689,3923,1373050,11360739,13.75
9871052,9989596,1928,674800,10664396,6.76
9871053,9983924,3518,1231300,11215224,12.33
9871054,9994587,3226,1129100,11123687,11.30
9871055,9976996,2608,912800,10889796,9.15
9871056,9966213,2684,939400,10905613,9.43
9871057,9948284,3555,1244250,11192534,12.51
9871058,9998719,2706,947100,10945819,9.47
9871059,9975923,2436,852600,10828523,8.55
9871060,9977037,4188,1465800,11442837,14.69
9871061,9995565,4026,1409100,11404665,14.10
9871062,9979360,5122,1792700,11772060,17.96
9871063,9988240,3904,1366400,11354640,13.68
9871064,9986842,3263,1142050,11128892,11.44
9871065,9988205,6126,2144100,12132305,21.47
9871066,9985387,5400,1890000,11875387,18.93
9871067,9987304,4305,1506750,11494054,15.09
9871068,9991068,5370,1879500,11870568,18.81
9871069,9983928,4151,1452850,11436778,14.55
9871070,9993310,5666,1983100,11976410,19.84
9871071,9986941,4533,1586550,11573491,15.89
9871072,9975098,4069,1424150,11399248,14.28
9871073,9992427,2473,865550,10857977,8.66
9871074,9997747,3860,1351000,11348747,13.51
9871075,9973662,4678,1637300,11610962,16.42
9871076,9976264,4310,1508500,11484764,15.12
9871077,9990337,5754,2013900,12004237,20.16
9871078,9977574,5561,1946350,11923924,19.51
9871079,9974087,3457,1209950,11184037,12.13
9871080,9965030,4847,1696450,11661480,17.02
9871081,9960054,5359,1875650,11835704,18.83
9871082,9950393,4254,1488900,11439293,14.96
9871083,9976895,2773,970550,10947445,9.73
9871084,9963208,4577,1601950,11565158,16.08
9871085,9970414,5086,1780100,11750514,17.85
9871086,9962392,5174,1810900,11773292,18.18
9871087,9969307,5337,1867950,11837257,18.74
9871088,2294654,708,247800,2542454,10.80
9871089,9960599,2635,922250,10882849,9.26
9871090,9957753,6183,2164050,12121803,21.73
9871091,9974281,3956,1384600,11358881,13.88
9871092,9967037,6142,2149700,12116737,21.57
9871093,9980393,5564,1947400,11927793,19.51
9871094,9968906,6109,2138150,12107056,21.45
9871095,9954528,3220,1127000,11081528,11.32
9871096,9957696,4409,1543150,11500846,15.50
9871097,9975176,2384,834400,10809576,8.36
9871098,9971047,6182,2163700,12134747,21.70
9871099,9884868,4128,1444800,11329668,14.62
9871100,9996645,3681,1288350,11284995,12.89
9871101,9980097,5847,2046450,12026547,20.51
9871102,9961174,5627,1969450,11930624,19.77
9871103,9996274,2435,852250,10848524,8.53
9871105,9907158,3822,1337700,11244858,13.50
9871106,9979409,5172,1810200,11789609,18.14
9871107,9979956,2956,1034600,11014556,10.37
9871108,9998401,4561,1596350,11594751,15.97
9871109,9976461,3199,1119650,11096111,11.22
9871110,9973960,3927,1374450,11348410,13.78
9871111,9964545,6145,2150750,12115295,21.58
9871112,9962196,2891,1011850,10974046,10.16
9871113,9967040,4021,1407350,11374390,14.12
9871114,9955824,2216,775600,10731424,7.79
9871115,9971808,3172,1110200,11082008,11.13
9871116,9964878,3158,1105300,11070178,11.09
9871117,9952424,4499,1574650,11527074,15.82
9871118,9950212,4779,1672650,11622862,16.81
9871119,9964890,3995,1398250,11363140,14.03
9871120,9969600,4438,1553300,11522900,15.58
9871122,9954802,6680,2338000,12292802,23.49
9871123,9971116,3838,1343300,11314416,13.47
9871124,9985450,1584,554400,10539850,5.55
9871125,9989071,5459,1910650,11899721,19.13
9871126,1895693,581,203350,2099043,10.73
9871127,9977075,2889,1011150,10988225,10.13
9871128,9972310,2293,802550,10774860,8.05
9871129,9969893,2233,781550,10751443,7.84
9871130,9968067,2448,856800,10824867,8.60
9871132,9992712,2629,920150,10912862,9.21
9871133,9985782,5292,1852200,11837982,18.55
9871134,9977433,4433,1551550,11528983,15.55
9871135,9989556,5554,1943900,11933456,19.46
9871136,9976616,5418,1896300,11872916,19.01
9871137,9985010,5710,1998500,11983510,20.02
9871139,9976266,5168,1808800,11785066,18.13
9871140,9982818,3556,1244600,11227418,12.47
9871141,9979334,3693,1292550,11271884,12.95
9871142,9984534,3424,1198400,11182934,12.00
9871143,9980576,2622,917700,10898276,9.19
9871144,9973923,3728,1304800,11278723,13.08
9871145,9965020,5208,1822800,11787820,18.29
9871146,9706973,5568,1948800,11655773,20.08
9871147,9972915,4795,1678250,11651165,16.83
9871148,9964461,3393,1187550,11152011,11.92
9871149,9973319,2328,814800,10788119,8.17
9871150,9981298,2802,980700,10961998,9.83
9871151,9780594,1647,576450,10357044,5.89
9871152,9971131,3968,1388800,11359931,13.93
9871153,9997510,5768,2018800,12016310,20.19
9871154,9981843,3101,1085350,11067193,10.87
9871155,9993208,3996,1398600,11391808,14.00
9871156,9988906,4130,1445500,11434406,14.47
9871157,9984593,4384,1534400,11518993,15.37
9871158,9988194,2028,709800,10697994,7.11
9871159,9974921,4723,1653050,11627971,16.57
9871160,9987648,2727,954450,10942098,9.56
9871161,9746431,3118,1091300,10837731,11.20
9871162,9966751,2437,852950,10819701,8.56
9871163,9984501,5024,1758400,11742901,17.61
9871164,9990901,5718,2001300,11992201,20.03
9871165,9984902,3562,1246700,11231602,12.49
9871166,9980603,5715,2000250,11980853,20.04
9871167,9994457,4545,1590750,11585207,15.92
9871168,9490918,4068,1423800,10914718,15.00
9871169,9971024,3649,1277150,11248174,12.81
9871170,9984497,2537,887950,10872447,8.89
9871171,3515874,1656,579600,4095474,16.49
9871172,9967889,4529,1585150,11553039,15.90
9871173,9970185,2702,945700,10915885,9.49
9871174,9955912,4751,1662850,11618762,16.70
9871175,9942717,4235,1482250,11424967,14.91
9871176,9950891,3717,1300950,11251841,13.07
9871177,9960224,3481,1218350,11178574,12.23
9871178,9970353,4292,1502200,11472553,15.07
9871179,9969726,4233,1481550,11451276,14.86
9871180,2287665,709,248150,2535815,10.85
9871181,9965492,3530,1235500,11200992,12.40
9871182,9970974,4623,1618050,11589024,16.23
9871183,9966533,2872,1005200,10971733,10.09
9871184,9968236,3417,1195950,11164186,12.00
9871185,9973502,4877,1706950,11680452,17.11
9871186,9993806,4975,1741250,11735056,17.42
9871187,9965697,2505,876750,10842447,8.80
9871188,9977489,4753,1663550,11641039,16.67
9871189,9950059,4555,1594250,11544309,16.02
9871190,9965984,3476,1216600,11182584,12.21
9871191,9984235,2854,998900,10983135,10.00
9871192,9978244,1847,646450,10624694,6.48
9871193,9960322,4997,1748950,11709272,17.56
9871194,9972294,5061,1771350,11743644,17.76
9871195,9988684,4810,1683500,11672184,16.85
9871196,9977299,3519,1231650,11208949,12.34
9871197,9972584,3239,1133650,11106234,11.37
9871198,9957271,4657,1629950,11587221,16.37
9871199,9976006,6264,2192400,12168406,21.98
9871200,9983139,6345,2220750,12203889,22.25
9871202,9952174,5709,1998150,11950324,20.08
9871203,9965013,3057,1069950,11034963,10.74
9871204,7967718,2025,708750,8676468,8.90
9871205,9977883,3516,1230600,11208483,12.33
9871206,9994001,2252,788200,10782201,7.89
9871207,9996749,2506,877100,10873849,8.77
9871208,9925311,4129,1445150,11370461,14.56
9871209,9987787,2201,770350,10758137,7.71
9871210,9946668,3087,1080450,11027118,10.86
9871211,9982643,3696,1293600,11276243,12.96
9871212,9981812,3989,1396150,11377962,13.99
9871213,9980837,4452,1558200,11539037,15.61
9871214,9982399,5316,1860600,11842999,18.64
9871215,9991552,2494,872900,10864452,8.74
9871216,9981923,6172,2160200,12142123,21.64
9871217,9974158,5514,1929900,11904058,19.35
9871218,9964673,3712,1299200,11263873,13.04
9871219,9968755,4773,1670550,11639305,16.76
9871220,9951738,2123,743050,10694788,7.47
9871221,4046809,1588,555800,4602609,13.73
9871222,9918958,3108,1087800,11006758,10.97
9871223,9335830,3327,1164450,10500280,12.47
9871224,9668649,4775,1671250,11339899,17.29
9871225,9962813,4569,1599150,11561963,16.05
9871226,9939574,4294,1502900,11442474,15.12
9871227,9935402,3829,1340150,11275552,13.49
9871228,9684436,1201,420350,10104786,4.34
9871229,9945880,2934,1026900,10972780,10.32
9871230,9937742,3460,1211000,11148742,12.19
9871231,2829920,1523,533050,3362970,18.84
9871232,9962637,3881,1358350,11320987,13.63
9871233,9984164,3100,1085000,11069164,10.87
9871234,9981195,3508,1227800,11208995,12.30
9871235,9985962,4423,1548050,11534012,15.50
9871236,9983308,3478,1217300,11200608,12.19
9871237,9987610,3735,1307250,11294860,13.09
9871238,9998536,3257,1139950,11138486,11.40
9871239,9991558,4181,1463350,11454908,14.65
9871240,9993455,3039,1063650,11057105,10.64
9871241,9982099,4016,1405600,11387699,14.08
9871242,9988340,2557,894950,10883290,8.96
9871243,9970237,4941,1729350,11699587,17.35
9871244,9194176,1540,539000,9733176,5.86
9871245,9988807,3466,1213100,11201907,12.14
9871246,9987970,4375,1531250,11519220,15.33
9871247,9976326,3380,1183000,11159326,11.86
9871249,9954948,5160,1806000,11760948,18.14
9871250,9897182,4252,1488200,11385382,15.04
9871251,9959923,5121,1792350,11752273,18.00
9871252,8834910,3501,1225350,10060260,13.87
9871253,9945055,4135,1447250,11392305,14.55
9871254,9969142,2686,940100,10909242,9.43
9871255,9909180,4088,1430800,11339980,14.44
9871256,9984288,5160,1806000,11790288,18.09
9871257,9978605,2941,1029350,11007955,10.32
9871258,9415097,2725,953750,10368847,10.13
9871259,9707618,4393,1537550,11245168,15.84
9871260,9710636,2926,1024100,10734736,10.55
9871261,9974398,3646,1276100,11250498,12.79
9871262,9974141,2440,854000,10828141,8.56
9871263,6247076,1675,586250,6833326,9.38
9871264,9939878,5695,1993250,11933128,20.05
9871265,9933887,3750,1312500,11246387,13.21
9871266,9939825,4123,1443050,11382875,14.52
9871267,6833225,2046,716100,7549325,10.48
9871268,9928433,2906,1017100,10945533,10.24
9871269,9902213,4737,1657950,11560163,16.74
9871270,9940784,3301,1155350,11096134,11.62
9871271,9967304,2326,814100,10781404,8.17
9871272,9960167,3704,1296400,11256567,13.02
9871273,9846742,6232,2181200,12027942,22.15
9871274,9971340,2821,987350,10958690,9.90
9871275,9976745,3216,1125600,11102345,11.28
9871276,9866470,2466,863100,10729570,8.75
9871277,9979597,3099,1084650,11064247,10.87
9871278,9981368,3999,1399650,11381018,14.02
9871280,9970235,4724,1653400,11623635,16.58
9871281,6485877,2445,855750,7341627,13.19
9871282,4086476,2630,920500,5006976,22.53
9871283,9980430,6313,2209550,12189980,22.14
9871284,9978877,2979,1042650,11021527,10.45
9871285,3572112,2020,707000,4279112,19.79
9871286,9955301,7254,2538900,12494201,25.50
9871288,9800427,4235,1482250,11282677,15.12
9871289,9973855,3310,1158500,11132355,11.62
9871290,9990389,4633,1621550,11611939,16.23
9871291,9992198,4012,1404200,11396398,14.05
9871292,9969691,5635,1972250,11941941,19.78
9871293,9978120,4671,1634850,11612970,16.38
9871294,9971558,3690,1291500,11263058,12.95
9871295,9969232,3183,1114050,11083282,11.17
9871296,9968363,4563,1597050,11565413,16.02
9871297,9969744,1960,686000,10655744,6.88
9871298,6346846,1832,641200,6988046,10.10
9871299,9994926,3538,1238300,11233226,12.39
9871302,9965112,2807,982450,10947562,9.86
9871303,9965304,2542,889700,10855004,8.93
9871304,9951919,2655,929250,10881169,9.34
9871305,9955751,3198,1119300,11075051,11.24
9871306,9971841,4127,1444450,11416291,14.49
9871307,9951751,4056,1419600,11371351,14.26
9871308,9947800,2443,855050,10802850,8.60
9871309,9952809,4584,1604400,11557209,16.12
9871310,9940140,2844,995400,10935540,10.01
9871311,5400322,2035,712250,6112572,13.19
9871312,9925406,2285,799750,10725156,8.06
9871313,9937300,4813,1684550,11621850,16.95
9871314,9948981,4658,1630300,11579281,16.39
9871315,9939024,4587,1605450,11544474,16.15
9871316,9941326,4661,1631350,11572676,16.41
9871317,9953147,4365,1527750,11480897,15.35
9871318,9962598,4141,1449350,11411948,14.55
9871319,9966410,2747,961450,10927860,9.65
9871320,1309998,361,126350,1436348,9.65
9871321,213672,182,63700,277372,29.81
9871322,9984622,3739,1308650,11293272,13.11
9871323,9975282,3653,1278550,11253832,12.82
9871324,9998025,2750,962500,10960525,9.63
9871325,9988069,2723,953050,10941119,9.54
9871326,9481691,5415,1895250,11376941,19.99
9871327,9625484,1816,635600,10261084,6.60
9871328,2731487,1662,581700,3313187,21.30
9871329,9969847,3639,1273650,11243497,12.78
9871330,9973932,4336,1517600,11491532,15.22
9871331,9961259,2441,854350,10815609,8.58
9871332,9970318,4365,1527750,11498068,15.32
9871334,9965026,4859,1700650,11665676,17.07
9871335,9484255,4117,1440950,10925205,15.19
9871336,9478752,2044,715400,10194152,7.55
9871337,9985246,4948,1731800,11717046,17.34
9871338,9967293,4513,1579550,11546843,15.85
9871339,9681119,3417,1195950,10877069,12.35
9871340,9114040,3301,1155350,10269390,12.68
9871341,9967445,4548,1591800,11559245,15.97
9871342,9964135,2553,893550,10857685,8.97
9871343,9989492,1986,695100,10684592,6.96
9871344,8679091,1537,537950,9217041,6.20
9871345,8970646,3208,1122800,10093446,12.52
9871346,652500,864,302400,954900,46.34
9871347,9970700,4395,1538250,11508950,15.43
9871348,9982046,4747,1661450,11643496,16.64
9871349,9975120,4582,1603700,11578820,16.08
9871350,9957554,2457,859950,10817504,8.64
9871351,9966103,2968,1038800,11004903,10.42
9871352,897914,413,144550,1042464,16.10
9871353,9969254,4905,1716750,11686004,17.22
9871354,9976226,4507,1577450,11553676,15.81
9871355,9978145,4144,1450400,11428545,14.54
9871356,2461625,746,261100,2722725,10.61
9871357,4395528,2419,846650,5242178,19.26
9871358,9955112,3803,1331050,11286162,13.37
9871359,9964150,4454,1558900,11523050,15.65
9871360,9982557,4961,1736350,11718907,17.39
9871361,9987601,3851,1347850,11335451,13.50
9871362,9984444,4191,1466850,11451294,14.69
9871363,7198950,4366,1528100,8727050,21.23
9871364,9978290,5678,1987300,11965590,19.92
9871365,9974390,3854,1348900,11323290,13.52
9871366,9966704,4757,1664950,11631654,16.71
9871367,9986339,4382,1533700,11520039,15.36
9871368,9989610,4599,1609650,11599260,16.11
9871369,820713,884,309400,1130113,37.70
9871370,9969496,3976,1391600,11361096,13.96
9871371,9975269,4282,1498700,11473969,15.02
9871372,9994561,3059,1070650,11065211,10.71
9871373,9989378,2288,800800,10790178,8.02
9871375,9976797,2056,719600,10696397,7.21
9871376,9980689,2189,766150,10746839,7.68
9871377,9986354,4578,1602300,11588654,16.04
9871378,9989555,6614,2314900,12304455,23.17
9871380,9896485,3103,1086050,10982535,10.97
9871381,9940536,3365,1177750,11118286,11.85
9871382,9980989,5163,1807050,11788039,18.10
9871383,3782457,864,302400,4084857,7.99
9871384,9973267,4813,1684550,11657817,16.89
9871385,9984447,5291,1851850,11836297,18.55
9871386,9965974,3913,1369550,11335524,13.74
9871387,9964856,3862,1351700,11316556,13.56
9871388,2216251,876,306600,2522851,13.83
9871389,9953374,3289,1151150,11104524,11.57
9871390,3463887,1437,502950,3966837,14.52
9871391,9941499,4387,1535450,11476949,15.44
9871392,9941624,4544,1590400,11532024,16.00
9871393,9947205,2733,956550,10903755,9.62
9871394,9937279,3029,1060150,10997429,10.67
9871395,9920852,4419,1546650,11467502,15.59
9871396,9919778,4239,1483650,11403428,14.96
9871397,9923647,2400,840000,10763647,8.46
9871398,9936957,3889,1361150,11298107,13.70
9871399,5848035,2841,994350,6842385,17.00
9871400,5216764,2273,795550,6012314,15.25
9871401,9948266,2595,908250,10856516,9.13
9871402,9939228,4201,1470350,11409578,14.79
9871403,1269351,465,162750,1432101,12.82
9871404,9915589,5950,2082500,11998089,21.00
9871405,2663078,833,291550,2954628,10.95
9871406,9912155,2651,927850,10840005,9.36
9871407,2381746,1568,548800,2930546,23.04
9871408,9942932,3545,1240750,11183682,12.48
9871409,9940627,2807,982450,10923077,9.88
9871410,9936209,3347,1171450,11107659,11.79
9871411,9945497,2862,1001700,10947197,10.07
9871412,9963221,4079,1427650,11390871,14.33
9871413,9951808,3050,1067500,11019308,10.73
9871414,2449674,1468,513800,2963474,20.97
9871415,9939802,3456,1209600,11149402,12.17
9871416,9882296,4970,1739500,11621796,17.60
9871417,9930414,3483,1219050,11149464,12.28
9871418,9945196,4290,1501500,11446696,15.10
9871419,9959785,3014,1054900,11014685,10.59
9871420,9970772,6128,2144800,12115572,21.51
9871421,3028545,2344,820400,3848945,27.09
9871422,9972898,4385,1534750,11507648,15.39
9871423,9673640,4589,1606150,11279790,16.60
9871424,3306133,715,250250,3556383,7.57
9871425,9959737,5213,1824550,11784287,18.32
9871426,9790947,4256,1489600,11280547,15.21
9871427,9948798,2723,953050,10901848,9.58
9871428,5251331,2340,819000,6070331,15.60
9871429,9963602,5465,1912750,11876352,19.20
9871430,6667139,2176,761600,7428739,11.42
9871431,9978997,2582,903700,10882697,9.06
9871432,9981955,3691,1291850,11273805,12.94
9871433,9982549,3779,1322650,11305199,13.25
9871434,9990143,5023,1758050,11748193,17.60
9871435,9983977,2253,788550,10772527,7.90
9871436,9981818,3878,1357300,11339118,13.60
9871437,9996874,4924,1723400,11720274,17.24
9871438,9980959,3921,1372350,11353309,13.75
9871439,9998230,6172,2160200,12158430,21.61
9871441,9983907,2325,813750,10797657,8.15
9871442,9981546,3935,1377250,11358796,13.80
9871443,9975936,1733,606550,10582486,6.08
9871444,4239845,5932,2076200,6316045,48.97
9871445,9986181,4661,1631350,11617531,16.34
9871446,9993441,4739,1658650,11652091,16.60
9871447,9988118,5085,1779750,11767868,17.82
9871448,6784800,3757,1314950,8099750,19.38
9871449,9977369,6763,2367050,12344419,23.72
9871450,9960091,4107,1437450,11397541,14.43
9871451,9977843,2302,805700,10783543,8.07
9871452,9970408,7402,2590700,12561108,25.98
9871453,9761089,4622,1617700,11378789,16.57
9871454,9594553,6547,2291450,11886003,23.88
9871455,9994854,1627,569450,10564304,5.70
9871456,9996502,4577,1601950,11598452,16.03
9871457,9982725,5871,2054850,12037575,20.58
9871458,9984007,3832,1341200,11325207,13.43
9871459,9979684,3053,1068550,11048234,10.71
9871460,9968299,2880,1008000,10976299,10.11
9871461,9970181,3393,1187550,11157731,11.91
9871462,9965675,4234,1481900,11447575,14.87
9871463,3187745,1896,663600,3851345,20.82
9871464,9981280,3544,1240400,11221680,12.43
9871465,9999162,3131,1095850,11095012,10.96
9871466,9995308,4046,1416100,11411408,14.17
9871467,9888272,4169,1459150,11347422,14.76
9871468,9976110,4410,1543500,11519610,15.47
9871469,9986884,4172,1460200,11447084,14.62
9871470,9998473,3215,1125250,11123723,11.25
9871471,9973663,4217,1475950,11449613,14.80
9871472,6362821,1667,583450,6946271,9.17
9871473,9989296,5957,2084950,12074246,20.87
9871474,9986165,2050,717500,10703665,7.18
9871475,3927526,2807,982450,4909976,25.01
9871476,9982184,3184,1114400,11096584,11.16
9871477,9119651,2107,737450,9857101,8.09
9871478,9970435,2322,812700,10783135,8.15
9871479,9897050,4600,1610000,11507050,16.27
9871480,9983708,2860,1001000,10984708,10.03
9871481,3973606,941,329350,4302956,8.29
9871482,9985112,4094,1432900,11418012,14.35
9871483,9970693,7408,2592800,12563493,26.00
9871484,9995557,3461,1211350,11206907,12.12
9871485,9968333,1719,601650,10569983,6.04
9871486,6154309,2798,979300,7133609,15.91
9871487,9987320,3631,1270850,11258170,12.72
9871488,4092233,2443,855050,4947283,20.89
9871489,9987646,5020,1757000,11744646,17.59
9871490,9985060,4873,1705550,11690610,17.08
9871491,9991488,2489,871150,10862638,8.72
9871492,9986310,3555,1244250,11230560,12.46
9871493,894498,346,121100,1015598,13.54
9871494,9962045,4208,1472800,11434845,14.78
9871495,9962295,4225,1478750,11441045,14.84
9871496,6383685,3087,1080450,7464135,16.93
9871497,9956858,4770,1669500,11626358,16.77
9871498,9962576,3741,1309350,11271926,13.14
9871499,9913978,4783,1674050,11588028,16.89
9871500,9976491,3752,1313200,11289691,13.16
9871501,9975218,3607,1262450,11237668,12.66
9871502,9983596,2863,1002050,10985646,10.04
9871503,9998552,5742,2009700,12008252,20.10
9871504,9907950,6103,2136050,12044000,21.56
9871505,9913608,3347,1171450,11085058,11.82
9871506,9983972,4153,1453550,11437522,14.56
9871507,9998140,3783,1324050,11322190,13.24
9871508,5578022,3528,1234800,6812822,22.14
9871509,9983359,6157,2154950,12138309,21.59
9871510,9982459,3727,1304450,11286909,13.07
9871511,9977553,2945,1030750,11008303,10.33
9871512,9987888,2920,1022000,11009888,10.23
9871514,9977319,3593,1257550,11234869,12.60
9871515,4955968,1093,382550,5338518,7.72
9871516,9953675,4501,1575350,11529025,15.83
9871517,9938796,3393,1187550,11126346,11.95
9871518,9962113,3545,1240750,11202863,12.45
9871519,9967151,4277,1496950,11464101,15.02
9871520,9947680,4250,1487500,11435180,14.95
9871521,9962486,2536,887600,10850086,8.91
9871522,9957355,6103,2136050,12093405,21.45
9871523,9968311,3354,1173900,11142211,11.78
9871524,9975418,2411,843850,10819268,8.46
9871525,9988916,3897,1363950,11352866,13.65
9871526,9983830,4012,1404200,11388030,14.06
9871527,9985124,3713,1299550,11284674,13.01
9871529,9956118,4156,1454600,11410718,14.61
9871530,1923189,626,219100,2142289,11.39
9871531,9874119,4439,1553650,11427769,15.73
9871532,9973846,2268,793800,10767646,7.96
9871533,9965882,7839,2743650,12709532,27.53
9871534,9968777,4051,1417850,11386627,14.22
9871535,1464442,722,252700,1717142,17.26
9871536,9963384,3086,1080100,11043484,10.84
9871537,9952447,2241,784350,10736797,7.88
9871538,9962817,3152,1103200,11066017,11.07
9871539,9858854,4591,1606850,11465704,16.30
9871540,9959479,3216,1125600,11085079,11.30
9871541,9967995,4209,1473150,11441145,14.78
9871542,9969599,4420,1547000,11516599,15.52
9871543,9963864,4560,1596000,11559864,16.02
9871544,9971209,2915,1020250,10991459,10.23
9871545,9991068,3720,1302000,11293068,13.03
9871546,9979141,4120,1442000,11421141,14.45
9871547,9993117,3727,1304450,11297567,13.05
9871548,9930034,3221,1127350,11057384,11.35
9871549,9997810,3343,1170050,11167860,11.70
9871550,9980337,3587,1255450,11235787,12.58
9871551,9975528,3437,1202950,11178478,12.06
9871552,9659981,2540,889000,10548981,9.20
9871553,9982180,5096,1783600,11765780,17.87
9871554,9979790,4481,1568350,11548140,15.72
9871555,9940378,3872,1355200,11295578,13.63
9871556,9981775,4452,1558200,11539975,15.61
9871557,9971537,4277,1496950,11468487,15.01
9871560,9953635,5085,1779750,11733385,17.88
9871561,6015389,2920,1022000,7037389,16.99
9871562,2043837,2121,742350,2786187,36.32
9871563,9968857,4626,1619100,11587957,16.24
9871564,9952772,5394,1887900,11840672,18.97
9871565,9964209,3429,1200150,11164359,12.04
9871566,9726514,5518,1931300,11657814,19.86
9871567,9986803,4205,1471750,11458553,14.74
9871568,9987657,3369,1179150,11166807,11.81
9871569,9983139,3447,1206450,11189589,12.08
9871570,9962538,3443,1205050,11167588,12.10
9871571,9959561,3410,1193500,11153061,11.98
9871572,9906118,3185,1114750,11020868,11.25
9871573,9992011,5058,1770300,11762311,17.72
9871574,9905575,3892,1362200,11267775,13.75
9871575,9986544,3119,1091650,11078194,10.93
9871576,9987222,3568,1248800,11236022,12.50
9871577,9887865,3796,1328600,11216465,13.44
9871578,9991048,4516,1580600,11571648,15.82
9871579,9981429,3531,1235850,11217279,12.38
9871580,7483554,2588,905800,8389354,12.10
9871581,9980940,4362,1526700,11507640,15.30
9871582,9991991,2314,809900,10801891,8.11
9871583,9986193,3893,1362550,11348743,13.64
9871584,9984873,3295,1153250,11138123,11.55
9871585,9982414,2200,770000,10752414,7.71
9871586,9959056,2975,1041250,11000306,10.46
9871587,5593958,1640,574000,6167958,10.26
9871588,9959200,4550,1592500,11551700,15.99
9871589,9983133,4398,1539300,11522433,15.42
9871590,9983422,5457,1909950,11893372,19.13
9871591,9948603,2314,809900,10758503,8.14
9871592,9976162,4333,1516550,11492712,15.20
9871593,9981767,3302,1155700,11137467,11.58
9871595,9979300,2287,800450,10779750,8.02
9871596,9991632,2881,1008350,10999982,10.09
9871597,9988972,3168,1108800,11097772,11.10
9871598,9992110,3685,1289750,11281860,12.91
9871599,9621772,3132,1096200,10717972,11.39
9871600,9979214,3867,1353450,11332664,13.56
9871601,9980643,4387,1535450,11516093,15.38
9871602,9982301,1573,550550,10532851,5.52
9871603,9998108,2198,769300,10767408,7.69
9871604,9969946,4414,1544900,11514846,15.50
9871605,9979958,3817,1335950,11315908,13.39
9871606,9985688,5044,1765400,11751088,17.68
9871607,9986638,3225,1128750,11115388,11.30
9871608,9967981,4452,1558200,11526181,15.63
9871609,9994113,4749,1662150,11656263,16.63
9871610,9975112,4056,1419600,11394712,14.23
9871612,9984977,1102,385700,10370677,3.86
9871613,9985796,4061,1421350,11407146,14.23
9871614,9977438,7361,2576350,12553788,25.82
9871615,9975060,4486,1570100,11545160,15.74
9871616,9007659,2379,832650,9840309,9.24
9871617,9984996,3409,1193150,11178146,11.95
9871618,9964623,4758,1665300,11629923,16.71
9871619,9971985,1572,550200,10522185,5.52
9871620,9986458,5118,1791300,11777758,17.94
9871621,8843749,1602,560700,9404449,6.34
9871622,9992558,2489,871150,10863708,8.72
9871623,9993194,3585,1254750,11247944,12.56
9871625,9993119,2362,826700,10819819,8.27
9871626,1353703,414,144900,1498603,10.70
9871627,9977854,4503,1576050,11553904,15.80
9871628,9981952,5588,1955800,11937752,19.59
9871629,9977372,2696,943600,10920972,9.46
9871630,9998858,4833,1691550,11690408,16.92
9871631,8622414,1316,460600,9083014,5.34
9871632,9977746,3978,1392300,11370046,13.95
9871633,9905664,6338,2218300,12123964,22.39
9871634,9957464,3029,1060150,11017614,10.65
9871635,9963881,2808,982800,10946681,9.86
9871636,9968481,3238,1133300,11101781,11.37
9871637,9974414,2749,962150,10936564,9.65
9871638,9975505,3651,1277850,11253355,12.81
9871639,7912977,5651,1977850,9890827,25.00
9871640,9985983,4515,1580250,11566233,15.82
9871641,9996584,2219,776650,10773234,7.77
9871642,9988939,1808,632800,10621739,6.34
9871643,9987140,3257,1139950,11127090,11.41
9871644,9994504,3798,1329300,11323804,13.30
9871645,3169265,2553,893550,4062815,28.19
9871646,9972373,4621,1617350,11589723,16.22
9871647,9998076,2709,948150,10946226,9.48
9871648,9988155,3755,1314250,11302405,13.16
9871649,9990535,3141,1099350,11089885,11.00
9871650,9970522,4028,1409800,11380322,14.14
9871651,9981710,4527,1584450,11566160,15.87
9871652,9979685,2010,703500,10683185,7.05
9871653,9999606,2124,743400,10743006,7.43
9871654,8999866,4587,1605450,10605316,17.84
9871655,9986984,3291,1151850,11138834,11.53
9871656,8524196,2031,710850,9235046,8.34
9871657,9984589,3049,1067150,11051739,10.69
9871659,9953175,4076,1426600,11379775,14.33
9871660,9958101,2536,887600,10845701,8.91
9871661,7258816,2275,796250,8055066,10.97
9871662,9974298,3254,1138900,11113198,11.42
9871663,9980297,7560,2646000,12626297,26.51
9871664,9647573,2895,1013250,10660823,10.50
9871665,9999368,2795,978250,10977618,9.78
9871666,758032,234,81900,839932,10.80
9871667,3568630,2359,825650,4394280,23.14
9871668,9973685,3785,1324750,11298435,13.28
9871669,9963373,4706,1647100,11610473,16.53
9871670,5427885,2426,849100,6276985,15.64
9871671,9977546,6384,2234400,12211946,22.39
9871672,9989892,4160,1456000,11445892,14.57
9871673,9977421,4161,1456350,11433771,14.60
9871674,9976076,3118,1091300,11067376,10.94
9871675,9983462,3445,1205750,11189212,12.08
9871676,9300955,1114,389900,9690855,4.19
9871677,9986543,1359,475650,10462193,4.76
9871678,9996854,1830,640500,10637354,6.41
9871679,9987593,4273,1495550,11483143,14.97
9871680,9962787,558,195300,10158087,1.96
9871681,9984753,1464,512400,10497153,5.13
9871682,9974688,2905,1016750,10991438,10.19
9871683,9965442,4693,1642550,11607992,16.48
9871684,9971513,5035,1762250,11733763,17.67
9871685,9974994,2556,894600,10869594,8.97
9871686,9979051,3244,1135400,11114451,11.38
9871687,9985705,6065,2122750,12108455,21.26
9871688,7801282,3164,1107400,8908682,14.20
9871689,7267339,2269,794150,8061489,10.93
9871690,9931682,4796,1678600,11610282,16.90
9871691,9970072,3290,1151500,11121572,11.55
9871692,9968865,3788,1325800,11294665,13.30
9871693,9966638,3741,1309350,11275988,13.14
9871694,9987794,2132,746200,10733994,7.47
9871695,9992615,3028,1059800,11052415,10.61
9871697,9989260,6336,2217600,12206860,22.20
9871698,9960395,2956,1034600,10994995,10.39
9871699,9987409,4707,1647450,11634859,16.50
9871700,3638247,1402,490700,4128947,13.49
9871701,9973984,1915,670250,10644234,6.72
9871702,4004835,611,213850,4218685,5.34
9871703,9974358,3784,1324400,11298758,13.28
9871704,9959839,3742,1309700,11269539,13.15
9871705,9981225,3474,1215900,11197125,12.18
9871706,9974102,1290,451500,10425602,4.53
9871707,1468437,437,152950,1621387,10.42
9871708,9960348,3091,1081850,11042198,10.86
9871709,9973696,3654,1278900,11252596,12.82
9871710,8585517,756,264600,8850117,3.08
9871711,9966077,4084,1429400,11395477,14.34
9871712,9965703,2200,770000,10735703,7.73
9871713,9981230,3326,1164100,11145330,11.66
9871714,9956298,3049,1067150,11023448,10.72
9871715,9958147,3302,1155700,11113847,11.61
9871716,9959388,3479,1217650,11177038,12.23
9871717,9954695,4290,1501500,11456195,15.08
9871718,9942054,3412,1194200,11136254,12.01
9871719,866074,414,144900,1010974,16.73
9871720,9955287,2440,854000,10809287,8.58
9871721,9955560,3682,1288700,11244260,12.94
9871722,9961957,1174,410900,10372857,4.12
9871723,9965763,6220,2177000,12142763,21.84
9871724,9973351,2965,1037750,11011101,10.41
9871725,9970350,3567,1248450,11218800,12.52
9871726,9781301,2373,830550,10611851,8.49
9871727,9986455,3613,1264550,11251005,12.66
9871728,5218502,1995,698250,5916752,13.38
9871729,9946305,1952,683200,10629505,6.87
9871730,9975524,2844,995400,10970924,9.98
9871731,9995859,5104,1786400,11782259,17.87
9871732,9948468,5776,2021600,11970068,20.32
9871733,9974439,1890,661500,10635939,6.63
9871734,4006254,1843,645050,4651304,16.10
9871735,9966444,3639,1273650,11240094,12.78
9871736,1511013,845,295750,1806763,19.57
9871737,9851613,5240,1834000,11685613,18.62
9871738,9875254,6001,2100350,11975604,21.27
9871739,9995303,3202,1120700,11116003,11.21
9871741,9972510,2726,954100,10926610,9.57
9871742,9982707,3573,1250550,11233257,12.53
9871743,9982201,3137,1097950,11080151,11.00
9871744,9991167,5289,1851150,11842317,18.53
9871745,9648928,2765,967750,10616678,10.03
9871746,9979539,4542,1589700,11569239,15.93
9871747,9966482,3384,1184400,11150882,11.88
9871748,9966829,3169,1109150,11075979,11.13
9871749,9961000,6050,2117500,12078500,21.26
9871750,9965617,3992,1397200,11362817,14.02
9871752,9961927,2039,713650,10675577,7.16
9871753,9950725,2774,970900,10921625,9.76
9871754,9958353,2047,716450,10674803,7.19
9871756,8946050,1473,515550,9461600,5.76
9871757,9959527,2164,757400,10716927,7.60
9871758,9949623,2883,1009050,10958673,10.14
9871759,9962733,4495,1573250,11535983,15.79
9871760,9954791,2795,978250,10933041,9.83
9871762,9932569,3351,1172850,11105419,11.81
9871763,9946601,5093,1782550,11729151,17.92
9871764,9953614,2044,715400,10669014,7.19
9871765,9965197,2900,1015000,10980197,10.19
9871766,9954962,5116,1790600,11745562,17.99
9871767,1295874,678,237300,1533174,18.31
9871768,9956539,3899,1364650,11321189,13.71
9871769,2097820,418,146300,2244120,6.97
9871770,9395677,4849,1697150,11092827,18.06
9871771,9945903,4874,1705900,11651803,17.15
9871772,9925350,3189,1116150,11041500,11.25
9871773,4434587,1715,600250,5034837,13.54
9871774,9954918,5483,1919050,11873968,19.28
9871775,9977369,3521,1232350,11209719,12.35
9871776,9889273,3713,1299550,11188823,13.14
9871777,9962156,1845,645750,10607906,6.48
9871778,9948502,4466,1563100,11511602,15.71
9871779,9986000,3512,1229200,11215200,12.31
9871780,9944376,5181,1813350,11757726,18.23
9871781,9994779,4914,1719900,11714679,17.21
9871782,9972781,1902,665700,10638481,6.68
9871783,9630282,1389,486150,10116432,5.05
9871784,9987516,2692,942200,10929716,9.43
9871785,9990790,5682,1988700,11979490,19.91
9871786,9987873,4347,1521450,11509323,15.23
9871787,9997740,2593,907550,10905290,9.08
9871788,9999373,3650,1277500,11276873,12.78
9871789,9996593,3097,1083950,11080543,10.84
9871790,9832014,3087,1080450,10912464,10.99
9871791,9975365,5670,1984500,11959865,19.89
9871792,9983446,2462,861700,10845146,8.63
9871793,9985462,3978,1392300,11377762,13.94
9871795,9976509,2029,710150,10686659,7.12
9871796,9524122,1699,594650,10118772,6.24
9871797,9970807,3081,1078350,11049157,10.82
9871798,9987118,4565,1597750,11584868,16.00
9871799,9984166,6239,2183650,12167816,21.87
9871800,9965333,4896,1713600,11678933,17.20
9871802,9958710,3810,1333500,11292210,13.39
9871803,9971701,2108,737800,10709501,7.40
9871804,9972341,4535,1587250,11559591,15.92
9871805,6512209,2006,702100,7214309,10.78
9871806,9987238,6409,2243150,12230388,22.46
9871807,9988831,4431,1550850,11539681,15.53
9871808,9975037,5182,1813700,11788737,18.18
9871809,9975087,3307,1157450,11132537,11.60
9871810,9972966,3493,1222550,11195516,12.26
9871811,9971745,2856,999600,10971345,10.02
9871812,9979171,3634,1271900,11251071,12.75
9871813,9974566,1958,685300,10659866,6.87
9871814,5091316,882,308700,5400016,6.06
9871815,9977455,5327,1864450,11841905,18.69
9871816,6981923,2168,758800,7740723,10.87
9871817,9991191,3692,1292200,11283391,12.93
9871818,9982535,3729,1305150,11287685,13.07
9871821,9985818,5117,1790950,11776768,17.93
9871822,9979007,4443,1555050,11534057,15.58
9871823,9998259,3022,1057700,11055959,10.58
9871824,9992047,4855,1699250,11691297,17.01
9871825,9971177,5580,1953000,11924177,19.59
9871826,9997192,2654,928900,10926092,9.29
9871827,9977908,4401,1540350,11518258,15.44
9871828,8149391,577,201950,8351341,2.48
9871829,9990103,2792,977200,10967303,9.78
9871830,9418462,4022,1407700,10826162,14.95
9871831,9493125,3029,1060150,10553275,11.17
9871832,9746216,2506,877100,10623316,9.00
9871833,9999648,3551,1242850,11242498,12.43
9871834,6758149,170,59500,6817649,0.88
9871835,9984744,3679,1287650,11272394,12.90
9871836,9899383,161,56350,9955733,0.57
9871837,9974672,4433,1551550,11526222,15.55
9871839,9974338,4939,1728650,11702988,17.33
9871840,9983235,5701,1995350,11978585,19.99
9871841,9975038,1106,387100,10362138,3.88
9871842,9969881,4692,1642200,11612081,16.47
9871843,9967253,1609,563150,10530403,5.65
9871844,9979081,4225,1478750,11457831,14.82
9871845,9989597,1543,540050,10529647,5.41
9871846,9999971,4572,1600200,11600171,16.00
9871847,9984335,3548,1241800,11226135,12.44
9871848,9989287,2275,796250,10785537,7.97
9871849,9987535,2880,1008000,10995535,10.09
9871850,9994633,1421,497350,10491983,4.98
9871852,9981111,3553,1243550,11224661,12.46
9871853,9985271,3216,1125600,11110871,11.27
9871854,8986552,2203,771050,9757602,8.58
9871855,9998982,2917,1020950,11019932,10.21
9871856,9977422,5183,1814050,11791472,18.18
9871857,4822458,866,303100,5125558,6.29
9871858,9967565,3795,1328250,11295815,13.33
9871859,9940498,4974,1740900,11681398,17.51
9871860,9958945,5320,1862000,11820945,18.70
9871861,9978228,4710,1648500,11626728,16.52
9871862,9966089,5506,1927100,11893189,19.34
9871863,9960759,1722,602700,10563459,6.05
9871864,9953710,1339,468650,10422360,4.71
9871865,9966335,2752,963200,10929535,9.66
9871866,9952820,4104,1436400,11389220,14.43
9871867,9155583,1957,684950,9840533,7.48
9871868,8674153,608,212800,8886953,2.45
9871869,9944144,2673,935550,10879694,9.41
9871870,9933936,3136,1097600,11031536,11.05
9871871,9956734,5303,1856050,11812784,18.64
9871872,9955164,3977,1391950,11347114,13.98
9871873,9925878,2800,980000,10905878,9.87
9871874,9936702,3448,1206800,11143502,12.14
9871875,9933368,2323,813050,10746418,8.19
9871876,3979940,573,200550,4180490,5.04
9871877,9946767,5081,1778350,11725117,17.88
9871878,1005348,132,46200,1051548,4.60
9871879,9929470,3322,1162700,11092170,11.71
9871880,9937641,4895,1713250,11650891,17.24
9871881,1691349,462,161700,1853049,9.56
9871882,9582032,4456,1559600,11141632,16.28
9871883,9943132,2459,860650,10803782,8.66
9871884,9954752,4025,1408750,11363502,14.15
9871885,9967023,5199,1819650,11786673,18.26
9871886,9897713,3660,1281000,11178713,12.94
9871887,9974251,4992,1747200,11721451,17.52
9871888,9978618,3804,1331400,11310018,13.34
9871889,9979001,4032,1411200,11390201,14.14
9871890,9998842,3692,1292200,11291042,12.92
9871891,9969226,4412,1544200,11513426,15.49
9871892,879372,761,266350,1145722,30.29
9871893,9965990,3980,1393000,11358990,13.98
9871894,9964642,3322,1162700,11127342,11.67
9871895,9963826,4289,1501150,11464976,15.07
9871896,554036,210,73500,627536,13.27
9871897,9991939,4669,1634150,11626089,16.35
9871898,9979388,2216,775600,10754988,7.77
9871899,843710,372,130200,973910,15.43
9871900,9992146,4325,1513750,11505896,15.15
9871901,9995250,1683,589050,10584300,5.89
9871902,9997912,2699,944650,10942562,9.45
9871903,9982337,3815,1335250,11317587,13.38
9871904,9986851,4834,1691900,11678751,16.94
9871905,9984165,6630,2320500,12304665,23.24
9871906,9980873,2895,1013250,10994123,10.15
9871907,9980389,1236,432600,10412989,4.33
9871908,9983094,4908,1717800,11700894,17.21
9871909,9992534,4428,1549800,11542334,15.51
9871910,5006654,494,172900,5179554,3.45
9871911,9980225,3474,1215900,11196125,12.18
9871912,9965841,2659,930650,10896491,9.34
9871913,1380756,1427,499450,1880206,36.17
9871914,9940252,4269,1494150,11434402,15.03
9871915,9954669,4881,1708350,11663019,17.16
9871916,9960024,3631,1270850,11230874,12.76
9871917,9973719,3656,1279600,11253319,12.83
9871918,9952224,3115,1090250,11042474,10.95
9871919,9400742,4578,1602300,11003042,17.04
9871920,6421524,1081,378350,6799874,5.89
9871921,9962031,1934,676900,10638931,6.79
9871922,9964318,2194,767900,10732218,7.71
9871923,9969742,4508,1577800,11547542,15.83
9871924,9985232,5337,1867950,11853182,18.71
9871925,9986987,3143,1100050,11087037,11.01
9871926,9996090,3266,1143100,11139190,11.44
9871927,1010339,647,226450,1236789,22.41
9871928,9620627,3166,1108100,10728727,11.52
9871929,9955972,4453,1558550,11514522,15.65
9871930,9470015,3198,1119300,10589315,11.82
9871931,9947701,3660,1281000,11228701,12.88
9871932,9959399,1858,650300,10609699,6.53
9871933,4036901,1047,366450,4403351,9.08
9871934,9951937,3538,1238300,11190237,12.44
9871935,9975258,3402,1190700,11165958,11.94
9871936,9974940,3768,1318800,11293740,13.22
9871937,9960032,2815,985250,10945282,9.89
9871938,9984388,4302,1505700,11490088,15.08
9871939,5725968,361,126350,5852318,2.21
9871940,9978608,4875,1706250,11684858,17.10
9871941,9987998,3089,1081150,11069148,10.82
9871942,9979679,5192,1817200,11796879,18.21
9871943,9743603,2363,827050,10570653,8.49
9871944,9985278,3825,1338750,11324028,13.41
9871945,9918996,3010,1053500,10972496,10.62
9871946,9987754,1133,396550,10384304,3.97
9871947,9979750,2647,926450,10906200,9.28
9871948,9980306,3026,1059100,11039406,10.61
9871949,9981454,5165,1807750,11789204,18.11
9871950,9989058,4660,1631000,11620058,16.33
9871951,9986636,3004,1051400,11038036,10.53
9871952,9982506,2199,769650,10752156,7.71
9871953,9998760,5934,2076900,12075660,20.77
9871954,4844215,1626,569100,5413315,11.75
9871955,9987094,6117,2140950,12128044,21.44
9871956,9989677,4097,1433950,11423627,14.35
9871957,9978525,3041,1064350,11042875,10.67
9871958,7282526,753,263550,7546076,3.62
9871959,9979944,3483,1219050,11198994,12.21
9871960,9982508,4895,1713250,11695758,17.16
9871961,9996632,4845,1695750,11692382,16.96
9871962,9987577,3848,1346800,11334377,13.48
9871963,9999106,3676,1286600,11285706,12.87
9871964,9981577,3960,1386000,11367577,13.89
9871965,9973701,7224,2528400,12502101,25.35
9871966,9968920,4696,1643600,11612520,16.49
9871967,9982947,4276,1496600,11479547,14.99
9871968,9975079,4076,1426600,11401679,14.30
9871969,9982055,4074,1425900,11407955,14.28
9871970,9987647,3356,1174600,11162247,11.76
9871971,8166896,1020,357000,8523896,4.37
9871972,8642884,294,102900,8745784,1.19
9871973,9879467,5561,1946350,11825817,19.70
9871974,2611294,584,204400,2815694,7.83
9871975,214782,76,26600,241382,12.38
9871976,9947351,4427,1549450,11496801,15.58
9871977,9966564,2931,1025850,10992414,10.29
9871978,9957594,2144,750400,10707994,7.54
9871979,9973119,5747,2011450,11984569,20.17
9871980,9987565,3161,1106350,11093915,11.08
9871981,9980234,2277,796950,10777184,7.99
9871982,9681209,3416,1195600,10876809,12.35
9871983,2469703,2377,831950,3301653,33.69
9871984,9868527,4164,1457400,11325927,14.77
9871985,2143820,850,297500,2441320,13.88
9871986,9963972,4836,1692600,11656572,16.99
9871987,9982397,2324,813400,10795797,8.15
9871988,9978517,5512,1929200,11907717,19.33
9871989,9448557,3137,1097950,10546507,11.62
9871990,9967453,3785,1324750,11292203,13.29
9871991,9962975,2191,766850,10729825,7.70
9871992,9861059,7794,2727900,12588959,27.66
9871993,945737,68,23800,969537,2.52
9871994,9977965,3025,1058750,11036715,10.61
9871995,9981005,4097,1433950,11414955,14.37
9871996,9974229,1794,627900,10602129,6.30
9871997,9970680,3568,1248800,11219480,12.52
9871998,9953896,3566,1248100,11201996,12.54
9871999,6811902,3294,1152900,7964802,16.92
9872000,5941140,2555,894250,6835390,15.05
9872001,9969852,2903,1016050,10985902,10.19
9872002,9972793,2121,742350,10715143,7.44
9872003,9979296,2381,833350,10812646,8.35
9872004,9973120,2977,1041950,11015070,10.45
9872005,9978847,3133,1096550,11075397,10.99
9872006,9990784,5629,1970150,11960934,19.72
9872007,9980966,3374,1180900,11161866,11.83
9872008,2989423,397,138950,3128373,4.65
9872009,9966464,2626,919100,10885564,9.22
9872010,9981918,5816,2035600,12017518,20.39
9872011,6181265,783,274050,6455315,4.43
9872012,9955234,4009,1403150,11358384,14.09
9872013,9960371,3162,1106700,11067071,11.11
9872014,9959592,4338,1518300,11477892,15.24
9872015,9956463,3861,1351350,11307813,13.57
9872016,9955539,3480,1218000,11173539,12.23
9872017,9974953,3622,1267700,11242653,12.71
9872018,9965871,2709,948150,10914021,9.51
9872019,9984684,3619,1266650,11251334,12.69
9872020,9973782,2260,791000,10764782,7.93
9872021,6647312,1964,687400,7334712,10.34
9872022,9955959,3969,1389150,11345109,13.95
9872023,9962589,5819,2036650,11999239,20.44
9872024,9964343,2649,927150,10891493,9.30
9872025,9937593,6231,2180850,12118443,21.95
9872026,9995367,2969,1039150,11034517,10.40
9872027,4658704,1432,501200,5159904,10.76
9872028,9981485,2456,859600,10841085,8.61
9872029,9995438,3314,1159900,11155338,11.60
9872030,9984667,4541,1589350,11574017,15.92
9872031,9988331,3143,1100050,11088381,11.01
9872032,9984657,2588,905800,10890457,9.07
9872033,9984112,2174,760900,10745012,7.62
9872035,9983402,4126,1444100,11427502,14.47
9872036,9982722,4596,1608600,11591322,16.11
9872037,9982769,3157,1104950,11087719,11.07
9872039,9984974,4641,1624350,11609324,16.27
9872040,9971658,4035,1412250,11383908,14.16
9872041,9968262,3131,1095850,11064112,10.99
9872042,9972867,3751,1312850,11285717,13.16
9872043,2010013,770,269500,2279513,13.41
9872044,9938802,4195,1468250,11407052,14.77
9872045,291227,154,53900,345127,18.51
9872046,9917253,3487,1220450,11137703,12.31
9872047,9933442,4315,1510250,11443692,15.20
9872048,9884030,4440,1554000,11438030,15.72
9872049,9943326,4771,1669850,11613176,16.79
9872050,9947022,3895,1363250,11310272,13.71
9872051,9959750,2153,753550,10713300,7.57
9872052,9966864,4365,1527750,11494614,15.33
9872053,9956140,4335,1517250,11473390,15.24
9872054,9977196,4719,1651650,11628846,16.55
9872056,9972944,4665,1632750,11605694,16.37
9872057,9960391,4400,1540000,11500391,15.46
9872058,9966083,5048,1766800,11732883,17.73
9872059,9973027,1515,530250,10503277,5.32
9872060,9985852,3308,1157800,11143652,11.59
9872061,9976681,4814,1684900,11661581,16.89
9872062,9990331,5560,1946000,11936331,19.48
9872063,9997039,4282,1498700,11495739,14.99
9872064,468522,292,102200,570722,21.81
9872065,9977144,3200,1120000,11097144,11.23
9872066,8982121,3478,1217300,10199421,13.55
9872067,9657827,1805,631750,10289577,6.54
9872069,9976703,2402,840700,10817403,8.43
9872070,9967601,3605,1261750,11229351,12.66
9872071,9705311,2745,960750,10666061,9.90
9872072,9992606,5692,1992200,11984806,19.94
9872073,3483303,1115,390250,3873553,11.20
9872074,9956503,1499,524650,10481153,5.27
9872075,9950752,3451,1207850,11158602,12.14
9872076,4468966,2392,837200,5306166,18.73
9872077,9984624,2596,908600,10893224,9.10
9872078,5742030,381,133350,5875380,2.32
9872079,9968529,4378,1532300,11500829,15.37
9872080,9983978,3111,1088850,11072828,10.91
9872081,9988835,2060,721000,10709835,7.22
9872082,9973707,5420,1897000,11870707,19.02
9872083,9990406,2771,969850,10960256,9.71
9872084,9974678,3418,1196300,11170978,11.99
9872085,9985109,2967,1038450,11023559,10.40
9872086,9999058,3375,1181250,11180308,11.81
9872087,8981754,2641,924350,9906104,10.29
9872088,3097059,1452,508200,3605259,16.41
9872089,9981312,3469,1214150,11195462,12.16
9872090,9967819,2694,942900,10910719,9.46
9872091,9979454,4349,1522150,11501604,15.25
9872092,9955135,390,136500,10091635,1.37
9872093,9958709,3604,1261400,11220109,12.67
9872094,975059,773,270550,1245609,27.75
9872095,9958718,1876,656600,10615318,6.59
9872097,161196,69,24150,185346,14.98
9872098,1203713,980,343000,1546713,28.50
9872099,9936233,2080,728000,10664233,7.33
9872100,9940535,3185,1114750,11055285,11.21
9872101,9941546,4107,1437450,11378996,14.46
9872102,9595711,5072,1775200,11370911,18.50
9872103,9943693,3444,1205400,11149093,12.12
9872104,9947811,3269,1144150,11091961,11.50
9872105,9956535,4718,1651300,11607835,16.59
9872106,9967623,2464,862400,10830023,8.65
9872107,9967406,4053,1418550,11385956,14.23
9872108,9967830,3406,1192100,11159930,11.96
9872109,9962664,2056,719600,10682264,7.22
9872110,9948470,4685,1639750,11588220,16.48
9872111,9967034,2184,764400,10731434,7.67
9872112,3295005,1619,566650,3861655,17.20
9872113,9971253,2927,1024450,10995703,10.27
9872114,9959545,2141,749350,10708895,7.52
9872115,9977282,2713,949550,10926832,9.52
9872116,9980375,3636,1272600,11252975,12.75
9872117,9981424,3612,1264200,11245624,12.67
9872118,9978304,4281,1498350,11476654,15.02
9872119,953722,272,95200,1048922,9.98
9872120,9975468,4106,1437100,11412568,14.41
9872121,9965529,3624,1268400,11233929,12.73
9872122,9988339,4414,1544900,11533239,15.47
9872123,9987862,5167,1808450,11796312,18.11
9872124,9972804,4271,1494850,11467654,14.99
9872125,9991452,3608,1262800,11254252,12.64
9872126,434846,330,115500,550346,26.56
9872127,9909591,3158,1105300,11014891,11.15
9872128,9996754,5325,1863750,11860504,18.64
9872129,9988525,4543,1590050,11578575,15.92
9872130,9974435,2872,1005200,10979635,10.08
9872131,9998674,3682,1288700,11287374,12.89
9872132,9804704,5015,1755250,11559954,17.90
9872133,2981340,1547,541450,3522790,18.16
9872134,9987861,4665,1632750,11620611,16.35
9872135,8981582,3445,1205750,10187332,13.42
9872136,975505,478,167300,1142805,17.15
9872137,9992933,3983,1394050,11386983,13.95
9872138,4194175,1156,404600,4598775,9.65
9872139,9989556,3946,1381100,11370656,13.83
9872140,426673,287,100450,527123,23.54
9872141,9974752,4461,1561350,11536102,15.65
9872142,9981246,4109,1438150,11419396,14.41
9872143,9966321,1960,686000,10652321,6.88
9872144,9965487,5222,1827700,11793187,18.34
9872145,9980418,2875,1006250,10986668,10.08
9872146,2111356,615,215250,2326606,10.19
9872147,9984693,252,88200,10072893,0.88
9872148,9999120,4990,1746500,11745620,17.47
9872149,9989118,5094,1782900,11772018,17.85
9872150,9988321,3352,1173200,11161521,11.75
9872151,9983458,4073,1425550,11409008,14.28
9872152,9987207,4579,1602650,11589857,16.05
9872153,9989556,4093,1432550,11422106,14.34
9872154,9995434,2334,816900,10812334,8.17
9872155,9982231,3112,1089200,11071431,10.91
9872156,1729287,681,238350,1967637,13.78
9872157,9980172,1917,670950,10651122,6.72
9872158,9784562,2007,702450,10487012,7.18
9872159,9996354,2961,1036350,11032704,10.37
9872160,9972304,2803,981050,10953354,9.84
9872161,2015006,828,289800,2304806,14.38
9872162,9979552,4727,1654450,11634002,16.58
9872163,578463,194,67900,646363,11.74
9872164,9997160,1970,689500,10686660,6.90
9872165,4653389,801,280350,4933739,6.02
9872166,9969213,4153,1453550,11422763,14.58
9872167,9971909,3784,1324400,11296309,13.28
9872168,9989917,2468,863800,10853717,8.65
9872169,9974929,4962,1736700,11711629,17.41
9872170,9979162,3548,1241800,11220962,12.44
9872171,9990217,5461,1911350,11901567,19.13
9872173,9972808,1358,475300,10448108,4.77
9872174,9619730,2991,1046850,10666580,10.88
9872175,9982541,3207,1122450,11104991,11.24
9872176,1192768,383,134050,1326818,11.24
9872177,9973567,4119,1441650,11415217,14.45
9872178,511494,108,37800,549294,7.39
9872179,9964218,5351,1872850,11837068,18.80
9872180,9942831,2650,927500,10870331,9.33
9872181,9952843,6552,2293200,12246043,23.04
9872182,9968227,4082,1428700,11396927,14.33
9872183,9981023,1334,466900,10447923,4.68
9872184,9962010,4739,1658650,11620660,16.65
9872185,9952987,3016,1055600,11008587,10.61
9872186,9962201,5127,1794450,11756651,18.01
9872187,9958892,5376,1881600,11840492,18.89
9872188,9967595,5524,1933400,11900995,19.40
9872189,2114562,572,200200,2314762,9.47
9872190,9981181,3994,1397900,11379081,14.01
9872191,9981095,3643,1275050,11256145,12.77
9872192,498933,80,28000,526933,5.61
9872193,9967602,3084,1079400,11047002,10.83
9872194,9983398,3528,1234800,11218198,12.37
9872195,9994942,2125,743750,10738692,7.44
9872196,9986648,5791,2026850,12013498,20.30
9872197,4896120,4021,1407350,6303470,28.74
9872198,9979839,5547,1941450,11921289,19.45
9872199,9958831,5181,1813350,11772181,18.21
9872200,9978489,4063,1422050,11400539,14.25
9872201,1200761,332,116200,1316961,9.68
9872202,9998664,2838,993300,10991964,9.93
9872203,9941876,2895,1013250,10955126,10.19
9872204,552206,233,81550,633756,14.77
9872205,9970481,3056,1069600,11040081,10.73
9872206,9970071,3780,1323000,11293071,13.27
9872207,2604199,1067,373450,2977649,14.34
9872208,9960025,5669,1984150,11944175,19.92
9872209,9971893,2406,842100,10813993,8.44
9872210,9968980,136,47600,10016580,0.48
9872211,9950171,3889,1361150,11311321,13.68
9872212,9935241,4274,1495900,11431141,15.06
9872213,9934611,6178,2162300,12096911,21.77
9872214,9952750,1785,624750,10577500,6.28
9872215,9969431,1250,437500,10406931,4.39
9872216,9972141,1750,612500,10584641,6.14
9872217,9970265,3837,1342950,11313215,13.47
9872218,1165223,845,295750,1460973,25.38
9872219,1471085,1095,383250,1854335,26.05
9872220,9942811,2387,835450,10778261,8.40
9872221,9953770,2196,768600,10722370,7.72
9872222,9954914,724,253400,10208314,2.55
9872223,9951887,1842,644700,10596587,6.48
9872224,8972860,4919,1721650,10694510,19.19
9872225,9932721,4918,1721300,11654021,17.33
9872226,9859935,3236,1132600,10992535,11.49
9872227,83185,42,14700,97885,17.67
9872228,9933768,3813,1334550,11268318,13.43
9872229,9942126,4493,1572550,11514676,15.82
9872230,9950142,2921,1022350,10972492,10.27
9872231,9943899,2099,734650,10678549,7.39
9872232,9948476,5387,1885450,11833926,18.95
9872233,9965840,3266,1143100,11108940,11.47
9872234,413445,174,60900,474345,14.73
9872235,921679,103,36050,957729,3.91
9872236,9954134,2197,768950,10723084,7.72
9872237,9952162,625,218750,10170912,2.20
9872238,9964379,2014,704900,10669279,7.07
9872239,9979797,676,236600,10216397,2.37
9872240,9973381,3414,1194900,11168281,11.98
9872241,9960611,5812,2034200,11994811,20.42
9872242,9956278,5133,1796550,11752828,18.04
9872243,1208470,267,93450,1301920,7.73
9872244,9970247,5177,1811950,11782197,18.17
9872245,3931570,257,89950,4021520,2.29
9872246,9962083,3866,1353100,11315183,13.58
9872247,9956075,1298,454300,10410375,4.56
9872248,9938394,3577,1251950,11190344,12.60
9872249,9949285,3357,1174950,11124235,11.81
9872250,9945456,3790,1326500,11271956,13.34
9872251,9968859,3962,1386700,11355559,13.91
9872252,9973034,4992,1747200,11720234,17.52
9872253,9974446,3183,1114050,11088496,11.17
9872254,9993656,4336,1517600,11511256,15.19
9872255,9993168,2116,740600,10733768,7.41
9872256,9978919,6079,2127650,12106569,21.32
9872257,9987238,3627,1269450,11256688,12.71
9872258,9987202,3496,1223600,11210802,12.25
9872259,9975455,2198,769300,10744755,7.71
9872260,9986191,4478,1567300,11553491,15.69
9872261,1223799,621,217350,1441149,17.76
9872262,1286076,959,335650,1621726,26.10
9872263,9965483,6632,2321200,12286683,23.29
9872264,9975506,3853,1348550,11324056,13.52
9872265,9970748,4303,1506050,11476798,15.10
9872267,9958655,4185,1464750,11423405,14.71
9872268,9973701,3995,1398250,11371951,14.02
9872269,6995976,3552,1243200,8239176,17.77
9872270,1822126,491,171850,1993976,9.43
9872271,9984833,5164,1807400,11792233,18.10
9872272,1657574,528,184800,1842374,11.15
9872273,9975593,7351,2572850,12548443,25.79
9872274,9967795,4614,1614900,11582695,16.20
9872275,9798634,5462,1911700,11710334,19.51
9872276,9990977,2698,944300,10935277,9.45
9872277,9981545,8340,2919000,12900545,29.24
9872278,9985487,5328,1864800,11850287,18.68
9872279,9976214,3463,1212050,11188264,12.15
9872280,9971151,4075,1426250,11397401,14.30
9872281,9967966,4783,1674050,11642016,16.79
9872282,9980479,3438,1203300,11183779,12.06
9872283,9998369,4010,1403500,11401869,14.04
9872284,9983418,2676,936600,10920018,9.38
9872285,9985848,1159,405650,10391498,4.06
9872286,265780,261,91350,357130,34.37
9872287,9983635,1113,389550,10373185,3.90
9872288,9995040,4644,1625400,11620440,16.26
9872289,5200572,792,277200,5477772,5.33
9872291,9977201,5434,1901900,11879101,19.06
9872292,9981497,5081,1778350,11759847,17.82
9872293,9985638,1545,540750,10526388,5.42
9872294,9985636,3397,1188950,11174586,11.91
9872295,9983491,4661,1631350,11614841,16.34
9872296,9993567,3465,1212750,11206317,12.14
9872297,325740,277,96950,422690,29.76
9872298,9961319,3279,1147650,11108969,11.52
9872299,4255420,1801,630350,4885770,14.81
9872300,5003925,2546,891100,5895025,17.81
9872301,181298,109,38150,219448,21.04
9872302,9948055,4516,1580600,11528655,15.89
9872303,2592841,859,300650,2893491,11.60
9872304,9951645,3924,1373400,11325045,13.80
9872305,9950665,954,333900,10284565,3.36
9872306,9950814,4269,1494150,11444964,15.02
9872309,9957098,4030,1410500,11367598,14.17
9872310,9976113,3791,1326850,11302963,13.30
9872312,1775584,1496,523600,2299184,29.49
9872313,9984895,5835,2042250,12027145,20.45
9872314,997415,336,117600,1115015,11.79
9872315,771851,605,211750,983601,27.43
9872316,9983381,3894,1362900,11346281,13.65
9872317,9995609,983,344050,10339659,3.44
9872318,746602,406,142100,888702,19.03
9872319,9961031,3810,1333500,11294531,13.39
9872320,9969039,3354,1173900,11142939,11.78
9872321,9981366,4823,1688050,11669416,16.91
9872322,9985911,2767,968450,10954361,9.70
9872323,9983883,544,190400,10174283,1.91
9872324,9985384,4430,1550500,11535884,15.53
9872325,9913435,2557,894950,10808385,9.03
9872326,9988486,367,128450,10116936,1.29
9872327,9989470,3187,1115450,11104920,11.17
9872328,9993820,4814,1684900,11678720,16.86
9872329,80285,103,36050,116335,44.90
9872330,9971167,6769,2369150,12340317,23.76
9872331,4582075,1183,414050,4996125,9.04
9872332,9986065,4415,1545250,11531315,15.47
9872333,9984133,2411,843850,10827983,8.45
9872335,1237594,536,187600,1425194,15.16
9872336,9971418,1621,567350,10538768,5.69
9872337,9980304,3208,1122800,11103104,11.25
9872338,9977734,4510,1578500,11556234,15.82
9872339,9996531,5956,2084600,12081131,20.85
9872340,9984560,3608,1262800,11247360,12.65
9872341,9973931,3564,1247400,11221331,12.51
9872342,9960365,5375,1881250,11841615,18.89
9872343,9958760,2626,919100,10877860,9.23
9872344,9957928,4233,1481550,11439478,14.88
9872345,9952953,472,165200,10118153,1.66
9872346,9962067,5057,1769950,11732017,17.77
9872348,9932328,4367,1528450,11460778,15.39
9872349,9762135,398,139300,9901435,1.43
9872350,601741,253,88550,690291,14.72
9872351,3745839,3610,1263500,5009339,33.73
9872352,9913537,4038,1413300,11326837,14.26
9872353,9935384,3867,1353450,11288834,13.62
9872354,2836602,1067,373450,3210052,13.17
9872355,1451598,527,184450,1636048,12.71
9872356,9921319,4626,1619100,11540419,16.32
9872357,9903595,725,253750,10157345,2.56
9872358,9898307,3732,1306200,11204507,13.20
9872359,9899751,2075,726250,10626001,7.34
9872360,9908556,2288,800800,10709356,8.08
9872361,7874338,2508,877800,8752138,11.15
9872363,9359980,3712,1299200,10659180,13.88
9872364,9937108,3301,1155350,11092458,11.63
9872365,8974409,2786,975100,9949509,10.87
9872366,9947699,3932,1376200,11323899,13.83
9872367,9954523,2310,808500,10763023,8.12
9872369,9978633,4120,1442000,11420633,14.45
9872370,9981768,3354,1173900,11155668,11.76
9872371,1078572,430,150500,1229072,13.95
9872372,5101250,1570,549500,5650750,10.77
9872373,9978199,4443,1555050,11533249,15.58
9872374,692902,48,16800,709702,2.42
9872375,9973832,4457,1559950,11533782,15.64
9872376,9944820,4067,1423450,11368270,14.31
9872377,9965318,3895,1363250,11328568,13.68
9872378,9960501,4603,1611050,11571551,16.17
9872379,9984157,5747,2011450,11995607,20.15
9872380,9994919,4317,1510950,11505869,15.12
9872381,9986460,1250,437500,10423960,4.38
9872382,9980513,1378,482300,10462813,4.83
9872383,9981395,4850,1697500,11678895,17.01
9872384,4379848,373,130550,4510398,2.98
9872385,3166081,1618,566300,3732381,17.89
9872386,9840146,5370,1879500,11719646,19.10
9872387,8740888,6385,2234750,10975638,25.57
9872388,9994194,2494,872900,10867094,8.73
9872389,2379101,830,290500,2669601,12.21
9872390,9992503,3486,1220100,11212603,12.21
9872391,9982133,4294,1502900,11485033,15.06
9872392,9985814,7630,2670500,12656314,26.74
9872393,9976140,4724,1653400,11629540,16.57
9872394,9989635,4252,1488200,11477835,14.90
9872395,9998935,3294,1152900,11151835,11.53
9872396,9983060,2945,1030750,11013810,10.32
9872397,9990399,4885,1709750,11700149,17.11
9872399,9974313,4382,1533700,11508013,15.38
9872400,9990240,4955,1734250,11724490,17.36
9872401,9980094,1654,578900,10558994,5.80
9872403,3523540,1169,409150,3932690,11.61
9872404,9978470,5980,2093000,12071470,20.98
9872405,9967749,5044,1765400,11733149,17.71
9872406,9974526,3402,1190700,11165226,11.94
9872407,1042027,555,194250,1236277,18.64
9872408,9959531,5093,1782550,11742081,17.90
9872409,9976689,5170,1809500,11786189,18.14
9872410,9989835,5539,1938650,11928485,19.41
9872411,9996250,4473,1565550,11561800,15.66
9872412,9970635,3211,1123850,11094485,11.27
9872413,9960091,3771,1319850,11279941,13.25
9872414,9980593,7722,2702700,12683293,27.08
9872415,9983249,3890,1361500,11344749,13.64
9872416,9994524,1823,638050,10632574,6.38
9872417,1756883,49,17150,1774033,0.98
9872418,1744407,595,208250,1952657,11.94
9872419,9954013,4505,1576750,11530763,15.84
9872420,9937108,2651,927850,10864958,9.34
9872421,9947442,4322,1512700,11460142,15.21
9872422,9956777,2185,764750,10721527,7.68
9872423,9966805,3605,1261750,11228555,12.66
9872424,9948501,2464,862400,10810901,8.67
9872425,9969952,1211,423850,10393802,4.25
9872426,9960506,1956,684600,10645106,6.87
9872427,5309111,1495,523250,5832361,9.86
9872428,9975706,2299,804650,10780356,8.07
9872429,9986628,1695,593250,10579878,5.94
9872430,5535955,1350,472500,6008455,8.54
9872431,9993462,3507,1227450,11220912,12.28
9872432,9973546,3322,1162700,11136246,11.66
9872433,6873618,3643,1275050,8148668,18.55
9872434,9988144,5350,1872500,11860644,18.75
9872435,9978904,2326,814100,10793004,8.16
9872436,9999578,719,251650,10251228,2.52
9872437,9971990,3974,1390900,11362890,13.95
9872438,9991995,1995,698250,10690245,6.99
9872439,9978043,3892,1362200,11340243,13.65
9872440,1912034,665,232750,2144784,12.17
9872441,9961145,4259,1490650,11451795,14.96
9872442,9949426,4153,1453550,11402976,14.61
9872443,9954410,4802,1680700,11635110,16.88
9872444,9959825,2655,929250,10889075,9.33
9872445,9946996,2749,962150,10909146,9.67
9872446,9590447,3571,1249850,10840297,13.03
9872447,9932300,2973,1040550,10972850,10.48
9872448,1013370,1153,403550,1416920,39.82
9872449,9926520,4580,1603000,11529520,16.15
9872450,9916076,4941,1729350,11645426,17.44
9872451,9656997,3446,1206100,10863097,12.49
9872452,9942128,3020,1057000,10999128,10.63
9872453,9946236,2991,1046850,10993086,10.53
9872454,9940270,4031,1410850,11351120,14.19
9872455,9933135,1616,565600,10498735,5.69
9872457,9926735,5391,1886850,11813585,19.01
9872458,1578231,54,18900,1597131,1.20
9872459,9913942,3711,1298850,11212792,13.10
9872460,9939383,4538,1588300,11527683,15.98
9872461,9935109,3767,1318450,11253559,13.27
9872462,4219516,2467,863450,5082966,20.46
9872463,9930139,4539,1588650,11518789,16.00
9872464,9927528,6187,2165450,12092978,21.81
9872465,9932573,5235,1832250,11764823,18.45
9872466,190149,31,10850,200999,5.71
9872467,9952274,3866,1353100,11305374,13.60
9872468,9954843,2681,938350,10893193,9.43
9872469,6389565,4017,1405950,7795515,22.00
9872470,9959396,3409,1193150,11152546,11.98
9872471,2093058,1075,376250,2469308,17.98
9872472,262114,114,39900,302014,15.22
9872473,9988463,4441,1554350,11542813,15.56
9872474,9987700,4414,1544900,11532600,15.47
9872475,9984407,4504,1576400,11560807,15.79
9872476,9980249,2556,894600,10874849,8.96
9872477,9979937,2483,869050,10848987,8.71
9872478,1271858,158,55300,1327158,4.35
9872479,9976720,4544,1590400,11567120,15.94
9872480,9983143,2032,711200,10694343,7.12
9872481,9994824,3963,1387050,11381874,13.88
9872482,9975513,3025,1058750,11034263,10.61
9872483,2585954,1531,535850,3121804,20.72
9872484,9979489,5343,1870050,11849539,18.74
9872485,9202904,2581,903350,10106254,9.82
9872486,9983200,3518,1231300,11214500,12.33
9872487,9993332,4020,1407000,11400332,14.08
9872488,9970488,2369,829150,10799638,8.32
9872489,9978371,1119,391650,10370021,3.92
9872490,9992243,2113,739550,10731793,7.40
9872491,9971743,4090,1431500,11403243,14.36
9872492,9975871,780,273000,10248871,2.74
9872493,9983912,1216,425600,10409512,4.26
9872494,9979918,2010,703500,10683418,7.05
9872495,9979808,2949,1032150,11011958,10.34
9872496,249770,145,50750,300520,20.32
9872497,9979779,3543,1240050,11219829,12.43
9872498,2040729,1055,369250,2409979,18.09
9872499,9945800,5755,2014250,11960050,20.25
9872500,9939166,2750,962500,10901666,9.68
9872501,9926928,3956,1384600,11311528,13.95
9872502,714650,414,144900,859550,20.28
9872503,9912953,3663,1282050,11195003,12.93
9872504,9904991,3325,1163750,11068741,11.75
9872505,9910829,4750,1662500,11573329,16.77
9872506,9923955,1884,659400,10583355,6.64
9872507,9935749,2400,840000,10775749,8.45
9872508,9918301,2281,798350,10716651,8.05
9872510,9911554,4021,1407350,11318904,14.20
9872511,9933059,2505,876750,10809809,8.83
9872512,8935693,3461,1211350,10147043,13.56
9872513,9954294,2434,851900,10806194,8.56
9872514,5153238,1831,640850,5794088,12.44
9872515,1308902,263,92050,1400952,7.03
9872516,9927681,3972,1390200,11317881,14.00
9872517,8323512,2796,978600,9302112,11.76
9872518,9908233,3222,1127700,11035933,11.38
9872519,9915220,3180,1113000,11028220,11.23
9872520,186926,76,26600,213526,14.23
9872521,9881413,276,96600,9978013,0.98
9872522,9892280,3725,1303750,11196030,13.18
9872523,163204,93,32550,195754,19.94
9872524,9922505,5155,1804250,11726755,18.18
9872525,9903386,1752,613200,10516586,6.19
9872526,9888766,4769,1669150,11557916,16.88
9872527,9911033,737,257950,10168983,2.60
9872528,9935610,1361,476350,10411960,4.79
9872529,9923706,4230,1480500,11404206,14.92
9872530,9935974,1199,419650,10355624,4.22
9872531,9929837,1534,536900,10466737,5.41
9872532,3186809,1383,484050,3670859,15.19
9872533,9898198,3677,1286950,11185148,13.00
9872534,9938745,5169,1809150,11747895,18.20
9872535,9923905,1717,600950,10524855,6.06
9872536,9928915,3547,1241450,11170365,12.50
9872537,9943761,2044,715400,10659161,7.19
9872538,9946893,3759,1315650,11262543,13.23
9872539,2191384,1133,396550,2587934,18.10
9872540,9934188,4706,1647100,11581288,16.58
9872541,286599,224,78400,364999,27.36
9872542,9939594,4345,1520750,11460344,15.30
9872543,9952864,5016,1755600,11708464,17.64
9872544,9962994,1456,509600,10472594,5.11
9872545,9968777,4667,1633450,11602227,16.39
9872546,9982935,2905,1016750,10999685,10.18
9872547,9974730,3921,1372350,11347080,13.76
9872548,9967031,1624,568400,10535431,5.70
9872550,9967926,3167,1108450,11076376,11.12
9872551,9971554,4708,1647800,11619354,16.53
9872552,9968471,3271,1144850,11113321,11.48
9872553,9964986,289,101150,10066136,1.02
9872554,9960609,2771,969850,10930459,9.74
9872555,9941834,3691,1291850,11233684,12.99
9872556,3449206,1649,577150,4026356,16.73
9872557,1911518,1564,547400,2458918,28.64
9872558,9906773,2886,1010100,10916873,10.20
9872559,9926396,1996,698600,10624996,7.04
9872560,9921192,4922,1722700,11643892,17.36
9872561,9945786,2559,895650,10841436,9.01
9872562,9949421,3298,1154300,11103721,11.60
9872563,9944389,4124,1443400,11387789,14.51
9872564,9945710,3686,1290100,11235810,12.97
9872565,9964430,3740,1309000,11273430,13.14
9872566,9970529,2298,804300,10774829,8.07
9872567,9986905,4558,1595300,11582205,15.97
9872568,9997922,5008,1752800,11750722,17.53
9872569,9993788,2736,957600,10951388,9.58
9872570,777411,158,55300,832711,7.11
9872571,9961174,6681,2338350,12299524,23.47
9872572,9979283,3834,1341900,11321183,13.45
9872573,9976347,469,164150,10140497,1.65
9872575,9973948,1843,645050,10618998,6.47
9872576,9963688,1794,627900,10591588,6.30
9872577,9980971,1710,598500,10579471,6.00
9872578,9984558,4331,1515850,11500408,15.18
9872579,9985767,1646,576100,10561867,5.77
9872580,9982417,660,231000,10213417,2.31
9872581,9966724,4547,1591450,11558174,15.97
9872582,9979818,2035,712250,10692068,7.14
9872583,970166,706,247100,1217266,25.47
9872584,9990520,2932,1026200,11016720,10.27
9872585,402062,113,39550,441612,9.84
9872586,9966726,1841,644350,10611076,6.47
9872587,9983120,5995,2098250,12081370,21.02
9872588,9983500,2239,783650,10767150,7.85
9872589,9978422,2900,1015000,10993422,10.17
9872590,9988566,2118,741300,10729866,7.42
9872591,9985294,1837,642950,10628244,6.44
9872592,9984689,1340,469000,10453689,4.70
9872593,9985908,3346,1171100,11157008,11.73
9872594,9969820,2279,797650,10767470,8.00
9872595,9954443,1788,625800,10580243,6.29
9872596,1625467,231,80850,1706317,4.97
9872597,9950951,4486,1570100,11521051,15.78
9872598,9945815,1701,595350,10541165,5.99
9872599,9962546,1702,595700,10558246,5.98
9872600,9968323,3239,1133650,11101973,11.37
9872601,9983746,2247,786450,10770196,7.88
9872602,9579993,1210,423500,10003493,4.42
9872603,9978342,3026,1059100,11037442,10.61
9872604,9996421,1165,407750,10404171,4.08
9872605,9982116,4006,1402100,11384216,14.05
9872606,9975484,2944,1030400,11005884,10.33
9872607,8886938,3725,1303750,10190688,14.67
9872608,9987190,2858,1000300,10987490,10.02
9872609,9980021,1903,666050,10646071,6.67
9872610,9905843,2042,714700,10620543,7.21
9872611,9990218,2540,889000,10879218,8.90
9872612,9978109,3430,1200500,11178609,12.03
9872614,9985177,3080,1078000,11063177,10.80
9872615,9816010,3778,1322300,11138310,13.47
9872616,9984588,6436,2252600,12237188,22.56
9872617,2882618,1210,423500,3306118,14.69
9872618,9987734,4811,1683850,11671584,16.86
9872619,9977515,3572,1250200,11227715,12.53
9872620,9981514,3785,1324750,11306264,13.27
9872621,9994677,5505,1926750,11921427,19.28
9872622,1567807,805,281750,1849557,17.97
9872623,9972955,5432,1901200,11874155,19.06
9872625,9973216,2895,1013250,10986466,10.16
9872626,9780229,3777,1321950,11102179,13.52
9872627,9935140,4965,1737750,11672890,17.49
9872628,9963085,1789,626150,10589235,6.28
9872629,9903169,4593,1607550,11510719,16.23
9872630,9982675,5185,1814750,11797425,18.18
9872631,9987183,1701,595350,10582533,5.96
9872632,9921497,4587,1605450,11526947,16.18
9872633,9988396,714,249900,10238296,2.50
9872634,9930915,4092,1432200,11363115,14.42
9872635,1287871,356,124600,1412471,9.67
9872636,2813052,1610,563500,3376552,20.03
9872637,9963546,3575,1251250,11214796,12.56
9872638,9964256,5718,2001300,11965556,20.08
9872639,9940605,5676,1986600,11927205,19.98
9872640,1511562,715,250250,1761812,16.56
9872641,9960550,5425,1898750,11859300,19.06
9872642,9964119,4725,1653750,11617869,16.60
9872643,9975038,2116,740600,10715638,7.42
9872644,9483368,1730,605500,10088868,6.38
9872645,9982725,4984,1744400,11727125,17.47
9872646,9993831,1381,483350,10477181,4.84
9872647,9881095,4017,1405950,11287045,14.23
9872648,9986952,886,310100,10297052,3.11
9872649,9998244,1271,444850,10443094,4.45
9872650,9971766,2103,736050,10707816,7.38
9872651,9972406,1551,542850,10515256,5.44
9872652,9964348,5631,1970850,11935198,19.78
9872653,9971360,950,332500,10303860,3.33
9872654,9975248,4650,1627500,11602748,16.32
9872655,9984995,960,336000,10320995,3.37
9872656,9983986,3849,1347150,11331136,13.49
9872657,9997881,947,331450,10329331,3.32
9872658,9983309,780,273000,10256309,2.73
9872660,1596010,882,308700,1904710,19.34
9872663,9986428,6184,2164400,12150828,21.67
9872665,9961446,3133,1096550,11057996,11.01
9872666,9984125,4267,1493450,11477575,14.96
9872667,9997053,6015,2105250,12102303,21.06
9872668,1161858,742,259700,1421558,22.35
9872669,766951,461,161350,928301,21.04
9872670,8370864,4347,1521450,9892314,18.18
9872671,9991287,4896,1713600,11704887,17.15
9872672,746152,372,130200,876352,17.45
9872673,142721,74,25900,168621,18.15
9872674,9964727,3762,1316700,11281427,13.21
9872675,9943171,2787,975450,10918621,9.81
9872676,3050815,1201,420350,3471165,13.78
9872677,2916198,884,309400,3225598,10.61
9872678,9506283,3889,1361150,10867433,14.32
9872679,8785870,1944,680400,9466270,7.74
9872680,9900251,3652,1278200,11178451,12.91
9872681,3121482,899,314650,3436132,10.08
9872682,9885568,3173,1110550,10996118,11.23
9872683,9906512,2012,704200,10610712,7.11
9872684,9909145,2696,943600,10852745,9.52
9872685,9917012,1516,530600,10447612,5.35
9872686,9905356,1461,511350,10416706,5.16
9872687,9891291,4962,1736700,11627991,17.56
9872688,9909821,1029,360150,10269971,3.63
9872689,9917364,5337,1867950,11785314,18.84
9872690,9914710,1848,646800,10561510,6.52
9872691,9932744,3548,1241800,11174544,12.50
9872692,9931419,3922,1372700,11304119,13.82
9872694,1731685,845,295750,2027435,17.08
9872695,9909901,3636,1272600,11182501,12.84
9872696,9897690,2916,1020600,10918290,10.31
9872697,9625551,3680,1288000,10913551,13.38
9872698,9897174,2791,976850,10874024,9.87
9872699,9920045,3570,1249500,11169545,12.60
9872700,1059360,351,122850,1182210,11.60
9872701,9890882,3734,1306900,11197782,13.21
9872702,9896082,3865,1352750,11248832,13.67
9872703,9898341,3827,1339450,11237791,13.53
9872704,9905854,3383,1184050,11089904,11.95
9872705,9896146,4135,1447250,11343396,14.62
9872706,9905424,1231,430850,10336274,4.35
9872707,9899498,3297,1153950,11053448,11.66
9872708,785752,213,74550,860302,9.49
9872709,9907774,5784,2024400,11932174,20.43
9872710,9902144,3578,1252300,11154444,12.65
9872711,9126974,3159,1105650,10232624,12.11
9872712,9909200,1176,411600,10320800,4.15
9872713,1329547,485,169750,1499297,12.77
9872714,9878773,4200,1470000,11348773,14.88
9872715,9885052,3125,1093750,10978802,11.06
9872716,9899583,3424,1198400,11097983,12.11
9872717,9896567,5600,1960000,11856567,19.80
9872718,1551299,406,142100,1693399,9.16
9872719,9885957,4803,1681050,11567007,17.00
9872720,9874161,1098,384300,10258461,3.89
9872721,9807293,3442,1204700,11011993,12.28
9872722,9892979,3242,1134700,11027679,11.47
9872723,9903072,4980,1743000,11646072,17.60
9872724,9910710,6592,2307200,12217910,23.28
9872725,9887975,5096,1783600,11671575,18.04
9872726,9881524,1984,694400,10575924,7.03
9872727,9383447,6785,2374750,11758197,25.31
9872728,9875474,1635,572250,10447724,5.79
9872729,9885595,6754,2363900,12249495,23.91
9872730,9879892,1165,407750,10287642,4.13
9872731,77209,42,14700,91909,19.04
9872732,9864791,3481,1218350,11083141,12.35
9872733,9882026,2246,786100,10668126,7.95
9872734,9892108,4502,1575700,11467808,15.93
9872735,9892222,5144,1800400,11692622,18.20
9872736,9887042,1105,386750,10273792,3.91
9872738,9885383,1299,454650,10340033,4.60
9872739,509729,252,88200,597929,17.30
9872740,9891220,5019,1756650,11647870,17.76
9872741,9895868,2593,907550,10803418,9.17
9872742,9906110,2635,922250,10828360,9.31
9872743,5197397,1213,424550,5621947,8.17
9872744,9881466,5335,1867250,11748716,18.90
9872745,9897573,5645,1975750,11873323,19.96
9872746,9905195,2279,797650,10702845,8.05
9872747,9897372,1342,469700,10367072,4.75
9872748,9893599,3118,1091300,10984899,11.03
9872749,9895944,2497,873950,10769894,8.83
9872750,9900180,3160,1106000,11006180,11.17
9872751,9903738,2335,817250,10720988,8.25
9872752,9934364,6111,2138850,12073214,21.53
9872753,9928725,1297,453950,10382675,4.57
9872754,638771,377,131950,770721,20.66
9872755,9660801,4237,1482950,11143751,15.35
9872756,9914980,3317,1160950,11075930,11.71
9872757,9918001,4088,1430800,11348801,14.43
9872758,1999670,805,281750,2281420,14.09
9872759,9944583,3927,1374450,11319033,13.82
9872760,1965987,694,242900,2208887,12.36
9872761,1624275,970,339500,1963775,20.90
9872762,9928810,6801,2380350,12309160,23.97
9872763,1260818,12,4200,1265018,0.33
9872764,9916268,4662,1631700,11547968,16.45
9872765,9928624,1999,699650,10628274,7.05
9872766,9941546,5013,1754550,11696096,17.65
9872767,9925227,1471,514850,10440077,5.19
9872769,9919719,274,95900,10015619,0.97
9872770,9896800,3576,1251600,11148400,12.65
9872771,9884573,4032,1411200,11295773,14.28
9872772,9892583,5226,1829100,11721683,18.49
9872774,9904700,4908,1717800,11622500,17.34
9872775,9915536,3769,1319150,11234686,13.30
9872776,9914551,1498,524300,10438851,5.29
9872777,9928939,2673,935550,10864489,9.42
9872778,9939514,4814,1684900,11624414,16.95
9872779,9931745,1542,539700,10471445,5.43
9872780,9942665,3621,1267350,11210015,12.75
9872781,9959357,1371,479850,10439207,4.82
9872782,9961197,3845,1345750,11306947,13.51
9872783,9885152,4187,1465450,11350602,14.82
9872784,9975786,6003,2101050,12076836,21.06
9872785,9981966,3968,1388800,11370766,13.91
9872786,9975340,4181,1463350,11438690,14.67
9872787,9915940,4291,1501850,11417790,15.15
9872788,9928348,2536,887600,10815948,8.94
9872789,9984064,2384,834400,10818464,8.36
9872790,9991255,4752,1663200,11654455,16.65
9872791,9985662,2690,941500,10927162,9.43
9872792,9990684,2307,807450,10798134,8.08
9872793,9986459,4780,1673000,11659459,16.75
9872794,9994589,6172,2160200,12154789,21.61
9872795,9982455,1725,603750,10586205,6.05
9872797,9979272,1563,547050,10526322,5.48
9872798,9970177,5611,1963850,11934027,19.70
9872799,9982616,2843,995050,10977666,9.97
9872800,9989676,3016,1055600,11045276,10.57
9872801,9961753,5344,1870400,11832153,18.78
9872802,9979706,2603,911050,10890756,9.13
9872803,9979623,3014,1054900,11034523,10.57
9872804,9989928,1914,669900,10659828,6.71
9872806,372993,82,28700,401693,7.69
9872807,9974445,3431,1200850,11175295,12.04
9872808,9974112,1258,440300,10414412,4.41
9872809,9976751,2675,936250,10913001,9.38
9872810,9984733,3787,1325450,11310183,13.27
9872811,9965731,1568,548800,10514531,5.51
9872812,9948924,4847,1696450,11645374,17.05
9872813,9968367,821,287350,10255717,2.88
9872814,9971817,3471,1214850,11186667,12.18
9872815,9521796,2193,767550,10289346,8.06
9872816,123546,19,6650,130196,5.38
9872817,9969048,3236,1132600,11101648,11.36
9872818,9985153,1899,664650,10649803,6.66
9872819,9976606,6047,2116450,12093056,21.21
9872820,72273,19,6650,78923,9.20
9872821,9949241,4937,1727950,11677191,17.37
9872822,9948434,5580,1953000,11901434,19.63
9872823,4231924,273,95550,4327474,2.26
9872824,9938719,4243,1485050,11423769,14.94
9872825,9934398,3336,1167600,11101998,11.75
9872826,9939024,4400,1540000,11479024,15.49
9872827,9944272,3574,1250900,11195172,12.58
9872828,9967779,1774,620900,10588679,6.23
9872829,9967603,1577,551950,10519553,5.54
9872830,9966356,2166,758100,10724456,7.61
9872832,9929239,1850,647500,10576739,6.52
9872833,9957056,3976,1391600,11348656,13.98
9872834,9957509,5646,1976100,11933609,19.85
9872835,9947464,5865,2052750,12000214,20.64
9872836,9949875,4345,1520750,11470625,15.28
9872837,9961792,4179,1462650,11424442,14.68
9872838,1886379,609,213150,2099529,11.30
9872839,9956956,7086,2480100,12437056,24.91
9872840,1401847,837,292950,1694797,20.90
9872841,8670371,819,286650,8957021,3.31
9872842,9953751,5842,2044700,11998451,20.54
9872843,9945883,1934,676900,10622783,6.81
9872845,1047774,324,113400,1161174,10.82
9872846,9964805,2489,871150,10835955,8.74
9872847,9950349,1430,500500,10450849,5.03
9872848,9960354,4135,1447250,11407604,14.53
9872850,9957887,3761,1316350,11274237,13.22
9872851,9960918,2522,882700,10843618,8.86
9872852,9961906,4968,1738800,11700706,17.45
9872853,9976026,2997,1048950,11024976,10.51
9872854,1246557,573,200550,1447107,16.09
9872855,9960687,5217,1825950,11786637,18.33
9872856,9968502,3022,1057700,11026202,10.61
9872857,895028,208,72800,967828,8.13
9872858,9972827,4466,1563100,11535927,15.67
9872859,9949139,1387,485450,10434589,4.88
9872860,5325681,2291,801850,6127531,15.06
9872861,9965334,2492,872200,10837534,8.75
9872862,9976452,3499,1224650,11201102,12.28
9872863,9979050,4564,1597400,11576450,16.01
9872864,9973625,6871,2404850,12378475,24.11
9872865,9981403,2728,954800,10936203,9.57
9872866,9987629,4331,1515850,11503479,15.18
9872867,9984273,2034,711900,10696173,7.13
9872868,1118344,531,185850,1304194,16.62
9872869,9973962,3906,1367100,11341062,13.71
9872870,9725442,1482,518700,10244142,5.33
9872871,9971999,2127,744450,10716449,7.47
9872872,1185181,488,170800,1355981,14.41
9872873,9978551,1895,663250,10641801,6.65
9872874,9992588,4327,1514450,11507038,15.16
9872875,9998189,2624,918400,10916589,9.19
9872876,9986118,5031,1760850,11746968,17.63
9872877,9975357,4184,1464400,11439757,14.68
9872878,9965478,1585,554750,10520228,5.57
9872879,9988537,3874,1355900,11344437,13.57
9872880,9985664,4384,1534400,11520064,15.37
9872881,2312388,508,177800,2490188,7.69
9872882,9981623,3654,1278900,11260523,12.81
9872883,9974977,4977,1741950,11716927,17.46
9872884,9982824,6145,2150750,12133574,21.54
9872885,9991946,4279,1497650,11489596,14.99
9872886,9984104,3456,1209600,11193704,12.12
9872887,9961855,3907,1367450,11329305,13.73
9872888,9967553,4903,1716050,11683603,17.22
9872889,5964804,1598,559300,6524104,9.38
9872890,9985695,4302,1505700,11491395,15.08
9872891,9995751,5186,1815100,11810851,18.16
9872892,9985563,5933,2076550,12062113,20.80
9872893,9987942,7253,2538550,12526492,25.42
9872894,9978846,3751,1312850,11291696,13.16
9872895,9978195,5951,2082850,12061045,20.87
9872896,771280,158,55300,826580,7.17
9872897,9952356,3765,1317750,11270106,13.24
9872898,9956240,5520,1932000,11888240,19.40
9872899,9957617,2375,831250,10788867,8.35
9872900,9974614,3943,1380050,11354664,13.84
9872901,9964628,6412,2244200,12208828,22.52
9872902,9953478,5149,1802150,11755628,18.11
9872903,9973999,5500,1925000,11898999,19.30
9872904,1800144,789,276150,2076294,15.34
9872905,9953569,6563,2297050,12250619,23.08
9872906,9977250,2174,760900,10738150,7.63
9872907,9992485,4667,1633450,11625935,16.35
9872908,9990635,6623,2318050,12308685,23.20
9872909,9942640,2865,1002750,10945390,10.09
9872910,9974321,3128,1094800,11069121,10.98
9872911,9970224,1216,425600,10395824,4.27
9872912,9985158,4075,1426250,11411408,14.28
9872913,9980480,2053,718550,10699030,7.20
9872914,9983791,2491,871850,10855641,8.73
9872915,9990485,3346,1171100,11161585,11.72
9872916,9981549,3797,1328950,11310499,13.31
9872917,9988083,5179,1812650,11800733,18.15
9872918,9994035,4660,1631000,11625035,16.32
9872919,1664134,607,212450,1876584,12.77
9872920,9970448,3255,1139250,11109698,11.43
9872921,2678388,957,334950,3013338,12.51
9872922,9971734,6693,2342550,12314284,23.49
9872923,9981879,3846,1346100,11327979,13.49
9872925,2189974,517,180950,2370924,8.26
9872927,9947922,2668,933800,10881722,9.39
9872928,7553547,4690,1641500,9195047,21.73
9872929,3810081,1243,435050,4245131,11.42
9872930,966885,669,234150,1201035,24.22
9872931,9935150,5001,1750350,11685500,17.62
9872932,9924303,6927,2424450,12348753,24.43
9872933,9931337,2743,960050,10891387,9.67
9872934,9925333,5592,1957200,11882533,19.72
9872935,9948107,5126,1794100,11742207,18.03
9872936,9942576,4555,1594250,11536826,16.03
9872937,9948884,2231,780850,10729734,7.85
9872938,9970095,2327,814450,10784545,8.17
9872939,9966029,1660,581000,10547029,5.83
9872940,3587109,1280,448000,4035109,12.49
9872941,7371443,3564,1247400,8618843,16.92
9872942,9982814,6021,2107350,12090164,21.11
9872943,1387130,633,221550,1608680,15.97
9872944,9984091,4019,1406650,11390741,14.09
9872945,9983266,2148,751800,10735066,7.53
9872946,9979310,4744,1660400,11639710,16.64
9872947,1345254,332,116200,1461454,8.64
9872948,9994725,6062,2121700,12116425,21.23
9872949,9973552,5837,2042950,12016502,20.48
9872950,9998721,5305,1856750,11855471,18.57
9872951,9986827,3677,1286950,11273777,12.89
9872952,9699360,4282,1498700,11198060,15.45
9872953,9963671,1492,522200,10485871,5.24
9872954,9959828,5522,1932700,11892528,19.40
9872955,9960019,4134,1446900,11406919,14.53
9872956,227884,82,28700,256584,12.59
9872957,9885508,2156,754600,10640108,7.63
9872958,9984539,3915,1370250,11354789,13.72
9872959,9970450,1766,618100,10588550,6.20
9872960,9963777,529,185150,10148927,1.86
9872961,9968804,1138,398300,10367104,4.00
9872962,9980024,2844,995400,10975424,9.97
9872963,1434580,601,210350,1644930,14.66
9872964,8986396,2966,1038100,10024496,11.55
9872965,8989931,4527,1584450,10574381,17.62
9872966,9968576,6502,2275700,12244276,22.83
9872967,4595362,2886,1010100,5605462,21.98
9872968,667799,502,175700,843499,26.31
9872969,4109526,3209,1123150,5232676,27.33
9872970,9969710,3526,1234100,11203810,12.38
9872971,163691,61,21350,185041,13.04
9872972,3029755,1932,676200,3705955,22.32
9872973,9981726,3326,1164100,11145826,11.66
9872974,6979316,2582,903700,7883016,12.95
9872975,1086232,524,183400,1269632,16.88
9872976,1472086,409,143150,1615236,9.72
9872977,9983401,4260,1491000,11474401,14.93
9872978,9985378,5578,1952300,11937678,19.55
9872979,9993871,4643,1625050,11618921,16.26
9872980,9989138,2278,797300,10786438,7.98
9872981,9986283,2969,1039150,11025433,10.41
9872982,9973743,3722,1302700,11276443,13.06
9872983,9973517,1260,441000,10414517,4.42
9872984,7017732,3047,1066450,8084182,15.20
9872985,9950869,5717,2000950,11951819,20.11
9872987,9967633,4993,1747550,11715183,17.53
9872988,9977714,2988,1045800,11023514,10.48
9872989,9975425,1002,350700,10326125,3.52
9872990,9984766,5570,1949500,11934266,19.52
9872991,9967941,4264,1492400,11460341,14.97
9872992,9987162,1383,484050,10471212,4.85
9872993,1646957,285,99750,1746707,6.06
9872994,9985864,4553,1593550,11579414,15.96
9872995,9939891,887,310450,10250341,3.12
9872996,2483301,837,292950,2776251,11.80
9872997,9974906,5786,2025100,12000006,20.30
9872998,9970404,2061,721350,10691754,7.23
9872999,9971027,819,286650,10257677,2.87
9873000,9963687,5831,2040850,12004537,20.48
9873001,9978121,4250,1487500,11465621,14.91
9873002,9981743,867,303450,10285193,3.04
9873003,9969384,1052,368200,10337584,3.69
9873004,9982739,2032,711200,10693939,7.12
9873005,9992874,4301,1505350,11498224,15.06
9873006,9979734,422,147700,10127434,1.48
9873007,9982864,4809,1683150,11666014,16.86
9873008,9983969,4092,1432200,11416169,14.34
9873009,1143017,375,131250,1274267,11.48
9873010,4756775,953,333550,5090325,7.01
9873012,8997375,2064,722400,9719775,8.03
9873013,9987776,277,96950,10084726,0.97
9873014,9974514,915,320250,10294764,3.21
9873015,3366076,827,289450,3655526,8.60
9873016,9965907,2690,941500,10907407,9.45
9873017,9987083,3009,1053150,11040233,10.55
9873018,9993780,1367,478450,10472230,4.79
9873019,9971666,1335,467250,10438916,4.69
9873020,9977929,1883,659050,10636979,6.61
9873021,1585307,630,220500,1805807,13.91
9873022,9973864,3614,1264900,11238764,12.68
9873023,9981010,2101,735350,10716360,7.37
9873024,407705,128,44800,452505,10.99
9873025,195737,71,24850,220587,12.70
9873026,9760030,1868,653800,10413830,6.70
9873027,9981839,1139,398650,10380489,3.99
9873029,9956357,4981,1743350,11699707,17.51
9873030,9967269,1732,606200,10573469,6.08
9873031,9973273,3133,1096550,11069823,10.99
9873032,681876,301,105350,787226,15.45
9873033,9972541,2652,928200,10900741,9.31
9873034,9962103,1000,350000,10312103,3.51
9873035,9995962,2181,763350,10759312,7.64
9873036,1561085,498,174300,1735385,11.17
9873037,9970054,468,163800,10133854,1.64
9873038,9991451,2498,874300,10865751,8.75
9873039,9985159,7029,2460150,12445309,24.64
9873040,9980014,1879,657650,10637664,6.59
9873041,9999562,4405,1541750,11541312,15.42
9873042,61146,29,10150,71296,16.60
9873043,9960271,2154,753900,10714171,7.57
9873044,9950838,2880,1008000,10958838,10.13
9873045,9966145,5165,1807750,11773895,18.14
9873046,9979040,2425,848750,10827790,8.51
9873047,839791,404,141400,981191,16.84
9873048,279178,84,29400,308578,10.53
9873049,9991943,3263,1142050,11133993,11.43
9873050,9972424,4088,1430800,11403224,14.35
9873051,9993692,622,217700,10211392,2.18
9873052,9979472,672,235200,10214672,2.36
9873053,9972627,1851,647850,10620477,6.50
9873055,727021,1176,411600,1138621,56.61
9873056,2920653,754,263900,3184553,9.04
9873057,9972177,3077,1076950,11049127,10.80
9873058,9985651,1839,643650,10629301,6.45
9873059,9982349,950,332500,10314849,3.33
9873060,9992955,1045,365750,10358705,3.66
9873061,9981814,3787,1325450,11307264,13.28
9873062,9988559,2783,974050,10962609,9.75
9873063,8990096,4896,1713600,10703696,19.06
9873064,447842,524,183400,631242,40.95
9873065,9969348,3528,1234800,11204148,12.39
9873066,9975020,3183,1114050,11089070,11.17
9873067,806690,395,138250,944940,17.14
9873068,9971813,3228,1129800,11101613,11.33
9873069,9985596,2387,835450,10821046,8.37
9873070,9982493,3813,1334550,11317043,13.37
9873071,9987916,1535,537250,10525166,5.38
9873072,9995415,3485,1219750,11215165,12.20
9873073,9982032,2384,834400,10816432,8.36
9873074,7052071,1413,494550,7546621,7.01
9873075,9960029,2558,895300,10855329,8.99
9873076,9982783,3914,1369900,11352683,13.72
9873077,9985930,3755,1314250,11300180,13.16
9873078,9990444,2672,935200,10925644,9.36
9873079,9951307,4804,1681400,11632707,16.90
9873080,9980047,2594,907900,10887947,9.10
9873081,9985275,2689,941150,10926425,9.43
9873082,9944686,3853,1348550,11293236,13.56
9873083,128458,61,21350,149808,16.62
9873084,9959350,3648,1276800,11236150,12.82
9873085,9888567,4095,1433250,11321817,14.49
9873086,9996534,4107,1437450,11433984,14.38
9873087,9980323,4044,1415400,11395723,14.18
9873088,9995020,397,138950,10133970,1.39
9873089,9989082,2039,713650,10702732,7.14
9873090,9977146,1432,501200,10478346,5.02
9873092,9990913,2412,844200,10835113,8.45
9873093,9986076,2615,915250,10901326,9.17
9873094,854295,159,55650,909945,6.51
9873095,9965883,962,336700,10302583,3.38
9873096,9625524,3758,1315300,10940824,13.66
9873097,9981088,4786,1675100,11656188,16.78
9873098,9723319,4100,1435000,11158319,14.76
9873099,9972240,5410,1893500,11865740,18.99
9873100,9969341,2503,876050,10845391,8.79
9873101,9883099,6340,2219000,12102099,22.45
9873102,9986209,2615,915250,10901459,9.17
9873103,2408794,745,260750,2669544,10.82
9873104,9979821,4450,1557500,11537321,15.61
9873105,1732363,658,230300,1962663,13.29
9873106,9978870,6234,2181900,12160770,21.87
9873108,9960624,4426,1549100,11509724,15.55
9873109,4190326,1613,564550,4754876,13.47
9873110,9950159,2103,736050,10686209,7.40
9873111,9970387,2008,702800,10673187,7.05
9873112,9975806,631,220850,10196656,2.21
9873113,9977740,4176,1461600,11439340,14.65
9873114,2735853,1565,547750,3283603,20.02
9873115,2147830,673,235550,2383380,10.97
9873116,1391735,619,216650,1608385,15.57
9873117,9936042,2143,750050,10686092,7.55
9873118,9933684,3317,1160950,11094634,11.69
9873119,9933685,5173,1810550,11744235,18.23
9873120,9939736,916,320600,10260336,3.23
9873121,9956112,5657,1979950,11936062,19.89
9873122,9967922,4304,1506400,11474322,15.11
9873123,7131414,3708,1297800,8429214,18.20
9873124,9963698,4408,1542800,11506498,15.48
9873125,9685875,2521,882350,10568225,9.11
9873126,9948988,3990,1396500,11345488,14.04
9873127,9936263,3519,1231650,11167913,12.40
9873128,9942843,4217,1475950,11418793,14.84
9873129,9940765,3505,1226750,11167515,12.34
9873130,9942189,1166,408100,10350289,4.10
9873131,9948309,2555,894250,10842559,8.99
9873132,9958199,1073,375550,10333749,3.77
9873133,9963948,2245,785750,10749698,7.89
9873134,9967603,2236,782600,10750203,7.85
9873135,9980693,965,337750,10318443,3.38
9873136,9976365,1908,667800,10644165,6.69
9873137,861293,414,144900,1006193,16.82
9873138,9983449,3417,1195950,11179399,11.98
9873139,9965617,975,341250,10306867,3.42
9873140,9962808,1355,474250,10437058,4.76
9873141,9975431,3615,1265250,11240681,12.68
9873142,9962373,1177,411950,10374323,4.14
9873143,9969027,4140,1449000,11418027,14.54
9873144,6308419,3384,1184400,7492819,18.77
9873145,9971246,3804,1331400,11302646,13.35
9873146,9972397,4237,1482950,11455347,14.87
9873147,1390141,1173,410550,1800691,29.53
9873148,9901964,6258,2190300,12092264,22.12
9873149,9972092,2559,895650,10867742,8.98
9873150,9990840,3505,1226750,11217590,12.28
9873151,9973586,5378,1882300,11855886,18.87
9873152,9955303,4096,1433600,11388903,14.40
9873153,9954413,1669,584150,10538563,5.87
9873154,9964486,2878,1007300,10971786,10.11
9873155,9946819,3237,1132950,11079769,11.39
9873156,9967657,1355,474250,10441907,4.76
9873157,9969040,1581,553350,10522390,5.55
9873158,9989435,1650,577500,10566935,5.78
9873159,9983284,1204,421400,10404684,4.22
9873160,9978175,2711,948850,10927025,9.51
9873161,9987721,4187,1465450,11453171,14.67
9873162,1280810,934,326900,1607710,25.52
9873163,9972543,3400,1190000,11162543,11.93
9873164,9990821,5165,1807750,11798571,18.09
9873165,9984556,3220,1127000,11111556,11.29
9873166,896418,589,206150,1102568,23.00
9873167,9976390,1717,600950,10577340,6.02
9873168,9967007,3078,1077300,11044307,10.81
9873170,1646498,1016,355600,2002098,21.60
9873171,9976191,1791,626850,10603041,6.28
9873172,9986247,3388,1185800,11172047,11.87
9873173,9936248,1256,439600,10375848,4.42
9873175,9978950,3427,1199450,11178400,12.02
9873176,9980768,1997,698950,10679718,7.00
9873177,9982538,3942,1379700,11362238,13.82
9873178,9982944,2722,952700,10935644,9.54
9873179,179748,58,20300,200048,11.29
9873180,674186,378,132300,806486,19.62
9873181,9971090,4971,1739850,11710940,17.45
9873182,9974853,3340,1169000,11143853,11.72
9873183,9677502,1513,529550,10207052,5.47
9873184,9969536,2043,715050,10684586,7.17
9873185,2051478,895,313250,2364728,15.27
9873187,9963477,3231,1130850,11094327,11.35
9873188,9968710,4541,1589350,11558060,15.94
9873189,568918,55,19250,588168,3.38
9873190,5329505,3160,1106000,6435505,20.75
9873191,9936931,5852,2048200,11985131,20.61
9873192,9940547,3785,1324750,11265297,13.33
9873193,8050520,3433,1201550,9252070,14.93
9873194,2094633,612,214200,2308833,10.23
9873195,9950976,5437,1902950,11853926,19.12
9873196,960251,106,37100,997351,3.86
9873197,501656,170,59500,561156,11.86
9873198,9954756,3629,1270150,11224906,12.76
9873199,4910175,2875,1006250,5916425,20.49
9873200,9938252,5274,1845900,11784152,18.57
9873201,9955282,6198,2169300,12124582,21.79
9873202,1590823,649,227150,1817973,14.28
9873203,9926687,2495,873250,10799937,8.80
9873204,3041751,629,220150,3261901,7.24
9873205,9947530,4076,1426600,11374130,14.34
9873206,8685136,4808,1682800,10367936,19.38
9873207,9932292,5014,1754900,11687192,17.67
9873208,9945893,3637,1272950,11218843,12.80
9873209,9933039,4120,1442000,11375039,14.52
9873210,9947309,4743,1660050,11607359,16.69
9873211,9961887,4414,1544900,11506787,15.51
9873212,9965074,4787,1675450,11640524,16.81
9873213,187364,137,47950,235314,25.59
9873214,9959895,2589,906150,10866045,9.10
9873215,9966574,3480,1218000,11184574,12.22
9873217,218029,99,34650,252679,15.89
9873218,3152606,1319,461650,3614256,14.64
9873219,9197041,5445,1905750,11102791,20.72
9873221,2303830,817,285950,2589780,12.41
9873222,9996463,3726,1304100,11300563,13.05
9873223,9988891,3869,1354150,11343041,13.56
9873224,9970083,3793,1327550,11297633,13.32
9873225,9966864,4153,1453550,11420414,14.58
9873226,8974153,3386,1185100,10159253,13.21
9873227,9964577,1066,373100,10337677,3.74
9873228,9964235,3617,1265950,11230185,12.70
9873229,9997965,3203,1121050,11119015,11.21
9873230,9983223,2063,722050,10705273,7.23
9873231,9962881,2810,983500,10946381,9.87
9873232,9980577,4877,1706950,11687527,17.10
9873233,656841,289,101150,757991,15.40
9873234,9974555,3792,1327200,11301755,13.31
9873235,9991995,3683,1289050,11281045,12.90
9873236,9976761,2078,727300,10704061,7.29
9873237,9985386,3821,1337350,11322736,13.39
9873238,9998020,4150,1452500,11450520,14.53
9873239,9991675,1023,358050,10349725,3.58
9873240,9980856,1736,607600,10588456,6.09
9873241,9993795,1318,461300,10455095,4.62
9873242,9980955,2938,1028300,11009255,10.30
9873243,9988011,5294,1852900,11840911,18.55
9873244,9996567,3187,1115450,11112017,11.16
9873245,9993786,5172,1810200,11803986,18.11
9873246,9979018,3886,1360100,11339118,13.63
9873248,3070104,683,239050,3309154,7.79
9873249,9984806,4727,1654450,11639256,16.57
9873250,4547019,1795,628250,5175269,13.82
9873251,3795141,1868,653800,4448941,17.23
9873252,9984542,4152,1453200,11437742,14.55
9873253,9984461,3831,1340850,11325311,13.43
9873254,9986867,2271,794850,10781717,7.96
9873255,229815,146,51100,280915,22.24
9873256,772206,880,308000,1080206,39.89
9873257,9984204,3892,1362200,11346404,13.64
9873258,9979478,2174,760900,10740378,7.62
9873259,9989509,4239,1483650,11473159,14.85
9873260,407780,232,81200,488980,19.91
9873261,9979459,4422,1547700,11527159,15.51
9873262,9990261,4757,1664950,11655211,16.67
9873263,9996056,3745,1310750,11306806,13.11
9873265,9998687,4294,1502900,11501587,15.03
9873266,9983256,3272,1145200,11128456,11.47
9873267,9984335,4818,1686300,11670635,16.89
9873268,2469222,615,215250,2684472,8.72
9873269,9983973,3997,1398950,11382923,14.01
9873270,9977085,3790,1326500,11303585,13.30
9873271,9979797,3026,1059100,11038897,10.61
9873272,9387355,5238,1833300,11220655,19.53
9873273,9988163,2241,784350,10772513,7.85
9873274,9979845,2993,1047550,11027395,10.50
9873275,9970784,2441,854350,10825134,8.57
9873277,9813861,2692,942200,10756061,9.60
9873278,9974448,2502,875700,10850148,8.78
9873279,9992304,3430,1200500,11192804,12.01
9873280,140839,65,22750,163589,16.15
9873281,2613084,1133,396550,3009634,15.18
9873282,614050,289,101150,715200,16.47
9873283,9967206,2199,769650,10736856,7.72
9873284,9963006,4235,1482250,11445256,14.88
9873285,3347128,2090,731500,4078628,21.85
9873286,9985966,2509,878150,10864116,8.79
9873287,9997877,3768,1318800,11316677,13.19
9873288,9901281,2810,983500,10884781,9.93
9873289,9977730,2670,934500,10912230,9.37
9873290,9985592,4568,1598800,11584392,16.01
9873291,9952343,1462,511700,10464043,5.14
9873293,9970715,2210,773500,10744215,7.76
9873294,9972951,1030,360500,10333451,3.61
9873295,9984767,2338,818300,10803067,8.20
9873296,9979613,703,246050,10225663,2.47
9873297,9998335,2984,1044400,11042735,10.45
9873299,9981682,2821,987350,10969032,9.89
9873300,9983554,2358,825300,10808854,8.27
9873301,9966636,2714,949900,10916536,9.53
9873302,9959962,2484,869400,10829362,8.73
9873303,3113629,1830,640500,3754129,20.57
9873304,9957320,4329,1515150,11472470,15.22
9873305,9967765,4085,1429750,11397515,14.34
9873306,9974464,4005,1401750,11376214,14.05
9873307,9834158,612,214200,10048358,2.18
9873308,9951933,3173,1110550,11062483,11.16
9873309,1240357,1166,408100,1648457,32.90
9873310,9956472,2731,955850,10912322,9.60
9873311,962906,473,165550,1128456,17.19
9873312,9959288,3405,1191750,11151038,11.97
9873313,9958849,4416,1545600,11504449,15.52
9873315,2059640,935,327250,2386890,15.89
9873316,852889,265,92750,945639,10.87
9873317,9958648,2940,1029000,10987648,10.33
9873318,561639,277,96950,658589,17.26
9873319,9941279,1497,523950,10465229,5.27
9873320,9947124,2214,774900,10722024,7.79
9873321,9957646,2216,775600,10733246,7.79
9873322,9968915,4518,1581300,11550215,15.86
9873323,9960454,2384,834400,10794854,8.38
9873324,9956729,3603,1261050,11217779,12.67
9873325,9948439,4999,1749650,11698089,17.59
9873326,9950763,3769,1319150,11269913,13.26
9873327,9959749,3613,1264550,11224299,12.70
9873328,9966214,4387,1535450,11501664,15.41
9873329,9967342,6057,2119950,12087292,21.27
9873330,9984564,1421,497350,10481914,4.98
9873331,9978005,2056,719600,10697605,7.21
9873332,9984668,2033,711550,10696218,7.13
9873333,9993249,3408,1192800,11186049,11.94
9873334,9974208,3808,1332800,11307008,13.36
9873335,9980528,2790,976500,10957028,9.78
9873336,9978138,2260,791000,10769138,7.93
9873337,237932,109,38150,276082,16.03
9873338,9981629,3584,1254400,11236029,12.57
9873339,9991032,3114,1089900,11080932,10.91
9873340,9995688,3178,1112300,11107988,11.13
9873341,9996057,2882,1008700,11004757,10.09
9873342,9947126,1763,617050,10564176,6.20
9873343,9982223,978,342300,10324523,3.43
9873344,9992229,2944,1030400,11022629,10.31
9873345,9984589,2148,751800,10736389,7.53
9873346,9960805,1474,515900,10476705,5.18
9873347,9972754,1054,368900,10341654,3.70
9873348,1854547,2202,770700,2625247,41.56
9873349,2692942,1057,369950,3062892,13.74
9873350,9971565,4787,1675450,11647015,16.80
9873351,2084991,1283,449050,2534041,21.54
9873352,9937446,3887,1360450,11297896,13.69
9873353,9978790,3693,1292550,11271340,12.95
9873354,105720,67,23450,129170,22.18
9873355,9982395,4208,1472800,11455195,14.75
9873357,9977964,3392,1187200,11165164,11.90
9873358,9975367,3486,1220100,11195467,12.23
9873359,2294345,595,208250,2502595,9.08
9873360,9973446,3012,1054200,11027646,10.57
9873361,9987523,4152,1453200,11440723,14.55
9873362,9978953,4221,1477350,11456303,14.80
9873363,9985276,2419,846650,10831926,8.48
9873364,9979925,3734,1306900,11286825,13.10
9873365,9971901,2044,715400,10687301,7.17
9873366,9973047,4494,1572900,11545947,15.77
9873367,9980782,3200,1120000,11100782,11.22
9873368,9989287,1108,387800,10377087,3.88
9873369,1676039,1232,431200,2107239,25.73
9873370,9981334,3649,1277150,11258484,12.80
9873371,9990111,2060,721000,10711111,7.22
9873372,9983563,4554,1593900,11577463,15.97
9873373,9956255,3535,1237250,11193505,12.43
9873374,3596924,1419,496650,4093574,13.81
9873375,9987102,4191,1466850,11453952,14.69
9873376,9993958,2901,1015350,11009308,10.16
9873377,130395,95,33250,163645,25.50
9873378,9972305,3182,1113700,11086005,11.17
9873379,9962904,4163,1457050,11419954,14.62
9873380,9947707,1431,500850,10448557,5.03
9873381,9959917,2297,803950,10763867,8.07
9873383,6002092,2877,1006950,7009042,16.78
9873384,9915099,3920,1372000,11287099,13.84
9873385,9896562,5212,1824200,11720762,18.43
9873386,1577674,515,180250,1757924,11.43
9873387,9968421,2517,880950,10849371,8.84
9873388,9969926,3995,1398250,11368176,14.02
9873389,9982964,3603,1261050,11244014,12.63
9873390,9989412,3836,1342600,11332012,13.44
9873391,9988235,1840,644000,10632235,6.45
9873392,1354023,1649,577150,1931173,42.62
9873393,9989362,2948,1031800,11021162,10.33
9873394,9991344,3369,1179150,11170494,11.80
9873395,9972558,2521,882350,10854908,8.85
9873396,9997214,572,200200,10197414,2.00
9873398,9977945,4659,1630650,11608595,16.34
9873399,1853463,513,179550,2033013,9.69
9873400,9969537,2457,859950,10829487,8.63
9873401,963678,471,164850,1128528,17.11
9873402,1819115,604,211400,2030515,11.62
9873403,9957893,1344,470400,10428293,4.72
9873404,9959703,1487,520450,10480153,5.23
9873405,9968478,4695,1643250,11611728,16.48
9873406,1865774,353,123550,1989324,6.62
9873407,9939084,5310,1858500,11797584,18.70
9873408,9951054,5085,1779750,11730804,17.89
9873409,2226246,723,253050,2479296,11.37
9873410,9936753,3489,1221150,11157903,12.29
9873411,9936384,2199,769650,10706034,7.75
9873412,9940212,3046,1066100,11006312,10.73
9873413,9933607,3946,1381100,11314707,13.90
9873414,9934180,3351,1172850,11107030,11.81
9873415,9955026,4120,1442000,11397026,14.49
9873417,9953705,1624,568400,10522105,5.71
9873418,9947457,6039,2113650,12061107,21.25
9873419,9951454,3470,1214500,11165954,12.20
9873420,9949456,1773,620550,10570006,6.24
9873421,9710072,3499,1224650,10934722,12.61
9873423,9925651,3346,1171100,11096751,11.80
9873424,9924390,2807,982450,10906840,9.90
9873425,9939063,4182,1463700,11402763,14.73
9873426,9922129,3181,1113350,11035479,11.22
9873428,9926100,2153,753550,10679650,7.59
9873429,9910393,2444,855400,10765793,8.63
9873430,4411112,2115,740250,5151362,16.78
9873431,9905643,4119,1441650,11347293,14.55
9873432,9884013,4103,1436050,11320063,14.53
9873433,2134353,2171,759850,2894203,35.60
9873434,9877840,4337,1517950,11395790,15.37
9873435,9878777,3184,1114400,10993177,11.28
9873437,4062049,1915,670250,4732299,16.50
9873438,9655223,4011,1403850,11059073,14.54
9873439,9909139,2829,990150,10899289,9.99
9873440,9904780,3038,1063300,10968080,10.74
9873441,9891134,2279,797650,10688784,8.06
9873442,9917126,2867,1003450,10920576,10.12
9873443,9692466,4733,1656550,11349016,17.09
9873444,9886525,2718,951300,10837825,9.62
9873445,1064017,576,201600,1265617,18.95
9873446,9868659,2351,822850,10691509,8.34
9873447,1667340,720,252000,1919340,15.11
9873448,9855381,2874,1005900,10861281,10.21
9873449,9846208,4071,1424850,11271058,14.47
9873450,313375,209,73150,386525,23.34
9873451,9843521,3251,1137850,10981371,11.56
9873452,9847432,3670,1284500,11131932,13.04
9873453,8055498,3199,1119650,9175148,13.90
9873454,9858177,3029,1060150,10918327,10.75
9873455,9830341,4668,1633800,11464141,16.62
9873456,3878941,746,261100,4140041,6.73
9873457,5705042,1868,653800,6358842,11.46
9873458,9834993,2421,847350,10682343,8.62
9873459,9838105,2864,1002400,10840505,10.19
9873460,9832286,4654,1628900,11461186,16.57
9873461,9851472,3132,1096200,10947672,11.13
9873462,9850709,2379,832650,10683359,8.45
9873463,9368998,3939,1378650,10747648,14.72
9873464,9863165,3856,1349600,11212765,13.68
9873465,9867801,3615,1265250,11133051,12.82
9873466,9869923,4484,1569400,11439323,15.90
9873467,1211348,1185,414750,1626098,34.24
9873468,9879096,3481,1218350,11097446,12.33
9873469,893252,455,159250,1052502,17.83
9873470,9848708,3675,1286250,11134958,13.06
9873471,378949,178,62300,441249,16.44
9873472,9845926,2476,866600,10712526,8.80
9873474,5209581,2434,851900,6061481,16.35
9873475,9815781,4904,1716400,11532181,17.49
9873476,9820426,3374,1180900,11001326,12.02
9873477,9826863,2906,1017100,10843963,10.35
9873478,230185,42,14700,244885,6.39
9873479,9821540,3941,1379350,11200890,14.04
9873480,9815024,2336,817600,10632624,8.33
9873481,1118506,96,33600,1152106,3.00
9873482,9710410,2860,1001000,10711410,10.31
9873483,9808739,1708,597800,10406539,6.09
9873484,9795866,4250,1487500,11283366,15.18
9873485,9793229,2359,825650,10618879,8.43
9873486,9757002,3709,1298150,11055152,13.30
9873487,9785132,3511,1228850,11013982,12.56
9873488,2253144,606,212100,2465244,9.41
9873489,9782251,3106,1087100,10869351,11.11
9873490,1338480,587,205450,1543930,15.35
9873491,9755461,4056,1419600,11175061,14.55
9873492,1019887,435,152250,1172137,14.93
9873493,9759731,4628,1619800,11379531,16.60
9873494,9754546,4869,1704150,11458696,17.47
9873495,9762368,5039,1763650,11526018,18.07
9873496,9771888,1827,639450,10411338,6.54
9873497,9779450,4005,1401750,11181200,14.33
9873498,4459584,2304,806400,5265984,18.08
9873499,3183200,1349,472150,3655350,14.83
9873500,9808872,2809,983150,10792022,10.02
9873501,9805852,4894,1712900,11518752,17.47
9873502,9812677,2328,814800,10627477,8.30
9873503,9822983,2662,931700,10754683,9.48
9873504,9808983,4026,1409100,11218083,14.37
9873505,9831291,2368,828800,10660091,8.43
9873506,9832566,2639,923650,10756216,9.39
9873507,9820368,4645,1625750,11446118,16.55
9873508,9828639,5654,1978900,11807539,20.13
9873509,387053,216,75600,462653,19.53
9873510,9838018,3806,1332100,11170118,13.54
9873511,9843066,3020,1057000,10900066,10.74
9873512,9856893,4548,1591800,11448693,16.15
9873513,9851535,3574,1250900,11102435,12.70
9873515,9844564,4547,1591450,11436014,16.17
9873516,9872111,3411,1193850,11065961,12.09
9873517,1908308,1945,680750,2589058,35.67
9873518,9851769,3438,1203300,11055069,12.21
9873519,9875727,2282,798700,10674427,8.09
9873520,9852913,2719,951650,10804563,9.66
9873521,9872168,4844,1695400,11567568,17.17
9873522,9866227,4146,1451100,11317327,14.71
9873523,9864542,4557,1594950,11459492,16.17
9873524,9867353,6071,2124850,11992203,21.53
9873525,9847883,4134,1446900,11294783,14.69
9873526,9830623,5993,2097550,11928173,21.34
9873527,9834414,4479,1567650,11402064,15.94
9873528,9837490,2877,1006950,10844440,10.24
9873529,9844292,1888,660800,10505092,6.71
9873530,9843056,3863,1352050,11195106,13.74
9873531,9859714,3252,1138200,10997914,11.54
9873532,6646748,1693,592550,7239298,8.91
9873534,9851444,2748,961800,10813244,9.76
9873535,9845229,3522,1232700,11077929,12.52
9873536,9828743,3474,1215900,11044643,12.37
9873537,9854679,1798,629300,10483979,6.39
9873538,3486575,1105,386750,3873325,11.09
9873539,9866626,3558,1245300,11111926,12.62
9873540,9873255,3846,1346100,11219355,13.63
9873541,9869785,2094,732900,10602685,7.43
9873542,9870795,3027,1059450,10930245,10.73
9873543,9865653,3280,1148000,11013653,11.64
9873544,9837370,3448,1206800,11044170,12.27
9873545,1145694,546,191100,1336794,16.68
9873546,9850757,3357,1174950,11025707,11.93
9873547,9851986,3683,1289050,11141036,13.08
9873548,9853644,2004,701400,10555044,7.12
9873549,9861373,4609,1613150,11474523,16.36
9873550,9868457,1732,606200,10474657,6.14
9873551,9885614,2484,869400,10755014,8.79
9873552,234012,112,39200,273212,16.75
9873553,9881040,814,284900,10165940,2.88
9873554,9881597,6083,2129050,12010647,21.55
9873555,9869761,4994,1747900,11617661,17.71
9873556,2557860,1963,687050,3244910,26.86
9873557,9853106,5004,1751400,11604506,17.78
9873558,9856116,2628,919800,10775916,9.33
9873559,9850815,5290,1851500,11702315,18.80
9873561,297265,96,33600,330865,11.30
9873562,9854804,2630,920500,10775304,9.34
9873563,9852366,304,106400,9958766,1.08
9873564,9848280,782,273700,10121980,2.78
9873565,9855973,2644,925400,10781373,9.39
9873566,9851841,836,292600,10144441,2.97
9873567,9864622,2903,1016050,10880672,10.30
9873568,9861271,4308,1507800,11369071,15.29
9873569,9865017,4099,1434650,11299667,14.54
9873570,9871163,1589,556150,10427313,5.63
9873571,9874666,4624,1618400,11493066,16.39
9873572,9858892,1312,459200,10318092,4.66
9873573,9878044,2907,1017450,10895494,10.30
9873574,152731,61,21350,174081,13.98
9873575,9873916,1233,431550,10305466,4.37
9873577,9871080,2088,730800,10601880,7.40
9873578,9862594,373,130550,9993144,1.32
9873579,9880131,2528,884800,10764931,8.96
9873581,8540470,3614,1264900,9805370,14.81
9873582,9871795,3542,1239700,11111495,12.56
9873583,9850294,4212,1474200,11324494,14.97
9873584,1083762,281,98350,1182112,9.07
9873585,9889353,6075,2126250,12015603,21.50
9873586,43052,17,5950,49002,13.82
9873587,9878023,3110,1088500,10966523,11.02
9873588,9872742,1646,576100,10448842,5.84
9873589,9874990,467,163450,10038440,1.66
9873590,9883698,3876,1356600,11240298,13.73
9873591,9889053,948,331800,10220853,3.36
9873592,4780952,2904,1016400,5797352,21.26
9873593,9868687,5591,1956850,11825537,19.83
9873594,5192000,3223,1128050,6320050,21.73
9873595,9903745,6233,2181550,12085295,22.03
9873596,9904919,4459,1560650,11465569,15.76
9873597,9901004,5582,1953700,11854704,19.73
9873598,9902824,4657,1629950,11532774,16.46
9873599,9904527,6622,2317700,12222227,23.40
9873600,9824071,7476,2616600,12440671,26.63
9873601,9904034,5095,1783250,11687284,18.01
9873602,1171668,377,131950,1303618,11.26
9873603,9920790,5137,1797950,11718740,18.12
9873604,9928630,3740,1309000,11237630,13.18
9873605,9901810,6168,2158800,12060610,21.80
9873606,318155,173,60550,378705,19.03
9873607,9880080,3739,1308650,11188730,13.25
9873608,9909581,1275,446250,10355831,4.50
9873609,1393029,753,263550,1656579,18.92
9873610,9923369,1052,368200,10291569,3.71
9873611,9930977,2603,911050,10842027,9.17
9873612,135273,19,6650,141923,4.92
9873613,9908326,2266,793100,10701426,8.00
9873614,9924550,3988,1395800,11320350,14.06
9873615,9878400,2268,793800,10672200,8.04
9873616,2712057,943,330050,3042107,12.17
9873617,9904148,1898,664300,10568448,6.71
9873618,1249138,797,278950,1528088,22.33
9873619,9891924,1460,511000,10402924,5.17
9873620,5919461,1245,435750,6355211,7.36
9873621,9909478,3227,1129450,11038928,11.40
9873623,9933864,4055,1419250,11353114,14.29
9873624,9922259,3654,1278900,11201159,12.89
9873625,9927273,2401,840350,10767623,8.47
9873627,9926622,4124,1443400,11370022,14.54
9873628,9931687,1995,698250,10629937,7.03
9873629,9926528,5057,1769950,11696478,17.83
9873630,9697252,5399,1889650,11586902,19.49
9873631,7974305,1813,634550,8608855,7.96
9873632,9945061,2510,878500,10823561,8.83
9873633,9936131,1423,498050,10434181,5.01
9873634,9922633,3474,1215900,11138533,12.25
9873635,9948356,3121,1092350,11040706,10.98
9873636,9957280,5464,1912400,11869680,19.21
9873637,9949213,3733,1306550,11255763,13.13
9873638,9958230,6272,2195200,12153430,22.04
9873640,9960547,6345,2220750,12181297,22.30
9873641,9974946,4341,1519350,11494296,15.23
9873642,3474730,990,346500,3821230,9.97
9873643,5457304,2515,880250,6337554,16.13
9873644,9965765,3232,1131200,11096965,11.35
9873645,9972249,3634,1271900,11244149,12.75
9873646,9968310,6738,2358300,12326610,23.66
9873647,9968650,3016,1055600,11024250,10.59
9873648,9877607,3460,1211000,11088607,12.26
9873649,9715918,4614,1614900,11330818,16.62
9873650,9986125,5542,1939700,11925825,19.42
9873651,9989131,5227,1829450,11818581,18.31
9873652,9971635,6852,2398200,12369835,24.05
9873653,9960697,3731,1305850,11266547,13.11
9873654,9972327,3553,1243550,11215877,12.47
9873655,9981626,6141,2149350,12130976,21.53
9873656,9976822,5470,1914500,11891322,19.19
9873657,9954536,6117,2140950,12095486,21.51
9873658,9980195,4457,1559950,11540145,15.63
9873659,9998853,5210,1823500,11822353,18.24
9873660,9994765,4528,1584800,11579565,15.86
9873661,9996579,3549,1242150,11238729,12.43
9873662,1558154,1545,540750,2098904,34.70
9873663,9989096,3962,1386700,11375796,13.88
9873664,9987755,1357,474950,10462705,4.76
9873665,9978593,3981,1393350,11371943,13.96
9873666,9972849,3169,1109150,11081999,11.12
9873667,1892430,1191,416850,2309280,22.03
9873668,988317,708,247800,1236117,25.07
9873669,9983591,3917,1370950,11354541,13.73
9873670,9983360,2683,939050,10922410,9.41
9873671,9997362,619,216650,10214012,2.17
9873672,817212,387,135450,952662,16.57
9873674,9980463,3099,1084650,11065113,10.87
9873676,9971774,1407,492450,10464224,4.94
9873677,9974230,5836,2042600,12016830,20.48
9873679,1540638,1251,437850,1978488,28.42
9873680,9939291,4497,1573950,11513241,15.84
9873681,9931963,3972,1390200,11322163,14.00
9873682,9941322,3444,1205400,11146722,12.13
9873683,4003485,1786,625100,4628585,15.61
9873684,9934155,4659,1630650,11564805,16.41
9873685,9941091,5663,1982050,11923141,19.94
9873686,648172,563,197050,845222,30.40
9873687,1348192,298,104300,1452492,7.74
9873688,9945527,5483,1919050,11864577,19.30
9873689,9965586,1495,523250,10488836,5.25
9873690,9976848,1584,554400,10531248,5.56
9873691,9964978,3998,1399300,11364278,14.04
9873692,9967082,4797,1678950,11646032,16.84
9873693,9980118,3600,1260000,11240118,12.63
9873694,9981354,3886,1360100,11341454,13.63
9873695,9973454,998,349300,10322754,3.50
9873696,9967716,971,339850,10307566,3.41
9873697,9963994,1194,417900,10381894,4.19
9873698,2899507,1086,380100,3279607,13.11
9873699,9873260,2854,998900,10872160,10.12
9873700,9965282,2397,838950,10804232,8.42
9873701,1284282,96,33600,1317882,2.62
9873702,9975324,1941,679350,10654674,6.81
9873703,9975519,4674,1635900,11611419,16.40
9873704,9989485,2368,828800,10818285,8.30
9873705,3025926,1299,454650,3480576,15.03
9873706,9961569,5063,1772050,11733619,17.79
9873707,9953050,3129,1095150,11048200,11.00
9873708,9958832,2128,744800,10703632,7.48
9873709,9970405,2626,919100,10889505,9.22
9873710,9979630,2980,1043000,11022630,10.45
9873711,9990550,4292,1502200,11492750,15.04
9873712,4024882,1234,431900,4456782,10.73
9873713,9975329,4089,1431150,11406479,14.35
9873714,9963636,3241,1134350,11097986,11.38
9873715,9981949,3873,1355550,11337499,13.58
9873716,9964693,3376,1181600,11146293,11.86
9873717,9987072,4585,1604750,11591822,16.07
9873718,9986008,3987,1395450,11381458,13.97
9873719,9993928,4552,1593200,11587128,15.94
9873720,1490449,2093,732550,2222999,49.15
9873721,9987487,5942,2079700,12067187,20.82
9873722,9982020,3763,1317050,11299070,13.19
9873723,9989918,6584,2304400,12294318,23.07
9873724,2917193,1564,547400,3464593,18.76
9873725,9974534,3523,1233050,11207584,12.36
9873726,9982054,4382,1533700,11515754,15.36
9873727,9989628,3862,1351700,11341328,13.53
9873728,9983400,7300,2555000,12538400,25.59
9873729,9981502,4722,1652700,11634202,16.56
9873730,9982782,6161,2156350,12139132,21.60
9873731,9967415,4810,1683500,11650915,16.89
9873732,9972250,5714,1999900,11972150,20.05
9873733,9979596,5802,2030700,12010296,20.35
9873734,2241462,1162,406700,2648162,18.14
9873735,9984181,4500,1575000,11559181,15.77
9873736,1827842,726,254100,2081942,13.90
9873737,9961161,5009,1753150,11714311,17.60
9873738,9971948,7313,2559550,12531498,25.67
9873739,9987838,3037,1062950,11050788,10.64
9873740,3599393,813,284550,3883943,7.91
9873741,8331401,2480,868000,9199401,10.42
9873742,9962812,4338,1518300,11481112,15.24
9873743,9995041,4084,1429400,11424441,14.30
9873744,9987242,3788,1325800,11313042,13.27
9873745,9980571,5750,2012500,11993071,20.16
9873746,9987798,1897,663950,10651748,6.65
9873747,621447,162,56700,678147,9.12
9873748,9977835,2282,798700,10776535,8.00
9873749,9985512,3984,1394400,11379912,13.96
9873750,9989349,4235,1482250,11471599,14.84
9873751,9999638,3421,1197350,11196988,11.97
9873752,9751670,1054,368900,10120570,3.78
9873753,3211109,1180,413000,3624109,12.86
9873754,140862,149,52150,193012,37.02
9873755,9988245,4390,1536500,11524745,15.38
9873756,1718436,491,171850,1890286,10.00
9873757,9986795,4228,1479800,11466595,14.82
9873758,9987774,3376,1181600,11169374,11.83
9873759,9988749,6907,2417450,12406199,24.20
9873760,9977535,4425,1548750,11526285,15.52
9873761,9783427,3895,1363250,11146677,13.93
9873762,9983709,3178,1112300,11096009,11.14
9873763,9989839,4659,1630650,11620489,16.32
9873764,9985752,2705,946750,10932502,9.48
9873765,9973861,4618,1616300,11590161,16.21
9873766,9981463,5418,1896300,11877763,19.00
9873768,9982042,6661,2331350,12313392,23.36
9873769,9960704,1601,560350,10521054,5.63
9873770,9970701,3408,1192800,11163501,11.96
9873771,9983022,1600,560000,10543022,5.61
9873772,9995529,4757,1664950,11660479,16.66
9873773,9761667,4103,1436050,11197717,14.71
9873774,9987153,6171,2159850,12147003,21.63
9873775,9990505,834,291900,10282405,2.92
9873776,9984485,1751,612850,10597335,6.14
9873777,9982139,1991,696850,10678989,6.98
9873778,9985232,4290,1501500,11486732,15.04
9873779,1279881,125,43750,1323631,3.42
9873780,9973279,4683,1639050,11612329,16.43
9873781,1453258,490,171500,1624758,11.80
9873782,9753878,5066,1773100,11526978,18.18
9873783,9976476,5756,2014600,11991076,20.19
9873784,2263361,522,182700,2446061,8.07
9873785,9989479,5153,1803550,11793029,18.05
9873786,9976847,1541,539350,10516197,5.41
9873787,9947668,3833,1341550,11289218,13.49
9873788,9986361,2583,904050,10890411,9.05
9873789,9998080,3240,1134000,11132080,11.34
9873790,9835929,4727,1654450,11490379,16.82
9873791,558347,705,246750,805097,44.19
9873792,9956278,3930,1375500,11331778,13.82
9873793,9959248,3348,1171800,11131048,11.77
9873794,598703,271,94850,693553,15.84
9873795,2039045,643,225050,2264095,11.04
9873796,9935118,4402,1540700,11475818,15.51
9873797,9938951,4810,1683500,11622451,16.94
9873798,9944163,2575,901250,10845413,9.06
9873799,2696657,539,188650,2885307,7.00
9873800,9927339,5315,1860250,11787589,18.74
9873801,9927328,4084,1429400,11356728,14.40
9873802,286872,152,53200,340072,18.54
9873803,9925514,3677,1286950,11212464,12.97
9873804,9929567,4870,1704500,11634067,17.17
9873805,9921563,1547,541450,10463013,5.46
9873806,9934076,4724,1653400,11587476,16.64
9873807,4717111,2098,734300,5451411,15.57
9873808,9955687,3418,1196300,11151987,12.02
9873809,9958774,1696,593600,10552374,5.96
9873810,9946923,3172,1110200,11057123,11.16
9873811,9956354,1385,484750,10441104,4.87
9873812,9942288,3424,1198400,11140688,12.05
9873813,9946410,2951,1032850,10979260,10.38
9873814,9966890,5236,1832600,11799490,18.39
9873815,805368,207,72450,877818,9.00
9873816,9966085,2719,951650,10917735,9.55
9873817,2995756,1186,415100,3410856,13.86
9873818,9943711,1521,532350,10476061,5.35
9873819,9954483,3495,1223250,11177733,12.29
9873820,9936732,5981,2093350,12030082,21.07
9873821,9956031,4679,1637650,11593681,16.45
9873823,9963642,4732,1656200,11619842,16.62
9873824,9977789,4243,1485050,11462839,14.88
9873825,9986890,5344,1870400,11857290,18.73
9873826,9990940,1888,660800,10651740,6.61
9873827,2063977,783,274050,2338027,13.28
9873828,1273720,362,126700,1400420,9.95
9873829,9991960,3733,1306550,11298510,13.08
9873830,605988,271,94850,700838,15.65
9873831,9973448,4832,1691200,11664648,16.96
9873832,9974414,2854,998900,10973314,10.01
9873833,211105,175,61250,272355,29.01
9873834,9964347,3609,1263150,11227497,12.68
9873835,1797803,950,332500,2130303,18.49
9873836,8692233,3051,1067850,9760083,12.29
9873837,164402,107,37450,201852,22.78
9873838,9973516,3079,1077650,11051166,10.81
9873839,9978756,4180,1463000,11441756,14.66
9873840,9988935,5223,1828050,11816985,18.30
9873841,9994148,3690,1291500,11285648,12.92
9873842,9997957,3887,1360450,11358407,13.61
9873843,9981546,4468,1563800,11545346,15.67
9873844,9983370,3142,1099700,11083070,11.02
9873845,9984553,3917,1370950,11355503,13.73
9873846,9988840,4812,1684200,11673040,16.86
9873847,9987835,4587,1605450,11593285,16.07
9873848,9985477,4110,1438500,11423977,14.41
9873849,9966242,1736,607600,10573842,6.10
9873850,9950764,2972,1040200,10990964,10.45
9873851,9950248,3204,1121400,11071648,11.27
9873852,9942342,2010,703500,10645842,7.08
9873853,9945200,2329,815150,10760350,8.20
9873854,9964212,4197,1468950,11433162,14.74
9873856,9967803,4365,1527750,11495553,15.33
9873857,1886342,388,135800,2022142,7.20
9873858,9960373,5306,1857100,11817473,18.64
9873859,9958002,4859,1700650,11658652,17.08
9873860,9965031,3768,1318800,11283831,13.23
9873862,9955894,3463,1212050,11167944,12.17
9873863,9975409,2031,710850,10686259,7.13
9873864,150258,90,31500,181758,20.96
9873865,9971809,5602,1960700,11932509,19.66
9873866,9983173,3968,1388800,11371973,13.91
9873867,9984372,3784,1324400,11308772,13.26
9873868,9969438,4405,1541750,11511188,15.46
9873869,820812,179,62650,883462,7.63
9873870,9986515,3346,1171100,11157615,11.73
9873871,9976360,3819,1336650,11313010,13.40
9873872,9908887,5193,1817550,11726437,18.34
9873873,9968109,3833,1341550,11309659,13.46
9873874,9970323,3806,1332100,11302423,13.36
9873875,9989867,2724,953400,10943267,9.54
9873876,9994009,3653,1278550,11272559,12.79
9873878,9950591,4404,1541400,11491991,15.49
9873879,9965973,966,338100,10304073,3.39
9873880,9958290,1398,489300,10447590,4.91
9873881,9748560,4540,1589000,11337560,16.30
9873882,508825,176,61600,570425,12.11
9873883,9995048,4590,1606500,11601548,16.07
9873884,1908692,491,171850,2080542,9.00
9873885,9968336,3262,1141700,11110036,11.45
9873886,9967440,5564,1947400,11914840,19.54
9873887,9988713,915,320250,10308963,3.21
9873889,9964353,2761,966350,10930703,9.70
9873890,9968880,3836,1342600,11311480,13.47
9873891,9975421,1167,408450,10383871,4.09
9873892,916392,590,206500,1122892,22.53
9873893,9984684,2659,930650,10915334,9.32
9873894,9988139,3467,1213450,11201589,12.15
9873895,9979852,1771,619850,10599702,6.21
9873896,9978173,3241,1134350,11112523,11.37
9873898,9988315,1850,647500,10635815,6.48
9873899,9983782,2129,745150,10728932,7.46
9873900,9981247,3307,1157450,11138697,11.60
9873901,9980378,2287,800450,10780828,8.02
9873902,9979140,1010,353500,10332640,3.54
9873903,9982647,2731,955850,10938497,9.58
9873904,9991377,1254,438900,10430277,4.39
9873905,9972277,3251,1137850,11110127,11.41
9873906,9981639,3111,1088850,11070489,10.91
9873907,9986729,3881,1358350,11345079,13.60
9873908,9194000,4133,1446550,10640550,15.73
9873909,9995671,2422,847700,10843371,8.48
9873910,9994135,3307,1157450,11151585,11.58
9873911,9995167,2750,962500,10957667,9.63
9873912,9980048,4145,1450750,11430798,14.54
9873913,9987272,4508,1577800,11565072,15.80
9873914,9995043,3969,1389150,11384193,13.90
9873915,9947192,3580,1253000,11200192,12.60
9873916,2775402,712,249200,3024602,8.98
9873917,9974609,3273,1145550,11120159,11.48
9873918,9986002,2821,987350,10973352,9.89
9873919,1945773,742,259700,2205473,13.35
9873920,9973005,2243,785050,10758055,7.87
9873921,480575,147,51450,532025,10.71
9873923,9946839,4065,1422750,11369589,14.30
9873924,9970121,3996,1398600,11368721,14.03
9873925,9888993,3325,1163750,11052743,11.77
9873926,9971529,3738,1308300,11279829,13.12
9873927,9982912,3715,1300250,11283162,13.02
9873928,9994268,2749,962150,10956418,9.63
9873929,9987748,3220,1127000,11114748,11.28
9873930,2203961,1283,449050,2653011,20.37
9873931,1845579,529,185150,2030729,10.03
9873932,9972531,2223,778050,10750581,7.80
9873933,556620,133,46550,603170,8.36
9873934,9983633,2572,900200,10883833,9.02
9873935,630725,200,70000,700725,11.10
9873936,9934213,3599,1259650,11193863,12.68
9873937,9975501,2403,841050,10816551,8.43
9873938,9973630,2219,776650,10750280,7.79
9873939,4387783,1027,359450,4747233,8.19
9873940,9914714,2606,912100,10826814,9.20
9873941,9976496,4125,1443750,11420246,14.47
9873942,9988766,2787,975450,10964216,9.77
9873943,9987558,3482,1218700,11206258,12.20
9873944,9990083,3657,1279950,11270033,12.81
9873945,9961425,2801,980350,10941775,9.84
9873946,3230575,1219,426650,3657225,13.21
9873947,9969470,2583,904050,10873520,9.07
9873948,2535241,804,281400,2816641,11.10
9873949,9978362,3439,1203650,11182012,12.06
9873950,9973695,3043,1065050,11038745,10.68
9873951,1157104,568,198800,1355904,17.18
9873952,9885615,3076,1076600,10962215,10.89
9873953,9972861,4851,1697850,11670711,17.02
9873954,6032480,1270,444500,6476980,7.37
9873955,9967110,2185,764750,10731860,7.67
9873956,6370142,2057,719950,7090092,11.30
9873957,9976683,3250,1137500,11114183,11.40
9873958,9983591,3167,1108450,11092041,11.10
9873959,9976265,2802,980700,10956965,9.83
9873960,9996399,3621,1267350,11263749,12.68
9873961,4155159,319,111650,4266809,2.69
9873962,9959984,2925,1023750,10983734,10.28
9873963,9970719,2091,731850,10702569,7.34
9873964,9987543,4470,1564500,11552043,15.66
9873965,9997126,3450,1207500,11204626,12.08
9873966,9978765,2189,766150,10744915,7.68
9873967,1833540,354,123900,1957440,6.76
9873968,2763333,1117,390950,3154283,14.15
9873969,9970210,2764,967400,10937610,9.70
9873971,9947649,5243,1835050,11782699,18.45
9873972,9961469,2674,935900,10897369,9.40
9873973,9940376,5621,1967350,11907726,19.79
9873974,9974969,3225,1128750,11103719,11.32
9873975,9117092,3967,1388450,10505542,15.23
9873976,9980110,2898,1014300,10994410,10.16
9873977,7867980,3318,1161300,9029280,14.76
9873978,9963340,4064,1422400,11385740,14.28
9873979,9961418,6311,2208850,12170268,22.17
9873980,9956508,2811,983850,10940358,9.88
9873981,9955899,2921,1022350,10978249,10.27
9873982,9947064,4698,1644300,11591364,16.53
9873983,9791858,3944,1380400,11172258,14.10
9873985,9931956,2404,841400,10773356,8.47
9873986,9943381,4004,1401400,11344781,14.09
9873987,9956037,5405,1891750,11847787,19.00
9873988,2342272,741,259350,2601622,11.07
9873989,9953142,3792,1327200,11280342,13.33
9873990,9968300,2812,984200,10952500,9.87
9873991,9979051,3558,1245300,11224351,12.48
9873992,9966443,2964,1037400,11003843,10.41
9873993,9982084,2311,808850,10790934,8.10
9873994,9981191,4071,1424850,11406041,14.28
9873995,9984296,3032,1061200,11045496,10.63
9873996,4881410,1035,362250,5243660,7.42
9873997,9980513,2736,957600,10938113,9.59
9873998,9998199,4020,1407000,11405199,14.07
9873999,9988709,4583,1604050,11592759,16.06
9874000,9983867,4424,1548400,11532267,15.51
9874001,9978404,1775,621250,10599654,6.23
9874002,9981979,3318,1161300,11143279,11.63
9874003,9905013,2437,852950,10757963,8.61
9874004,9988289,2919,1021650,11009939,10.23
9874005,9988297,6438,2253300,12241597,22.56
9874006,1245754,312,109200,1354954,8.77
9874007,745141,624,218400,963541,29.31
9874008,3234687,2231,780850,4015537,24.14
9874009,9965901,5720,2002000,11967901,20.09
9874010,9985514,4119,1441650,11427164,14.44
9874011,9964731,3817,1335950,11300681,13.41
9874013,9988664,3423,1198050,11186714,11.99
9874014,77209,42,14700,91909,19.04
9874015,9971957,956,334600,10306557,3.36
9874016,9988303,2114,739900,10728203,7.41
9874017,1200755,510,178500,1379255,14.87
9874018,9964690,3723,1303050,11267740,13.08
9874019,9971220,2925,1023750,10994970,10.27
9874020,9977647,4738,1658300,11635947,16.62
9874021,9983242,3454,1208900,11192142,12.11
9874022,9989516,2270,794500,10784016,7.95
9874023,9766314,2729,955150,10721464,9.78
9874024,9980413,3641,1274350,11254763,12.77
9874025,9991696,4295,1503250,11494946,15.04
9874026,9963731,5640,1974000,11937731,19.81
9874027,9973643,928,324800,10298443,3.26
9874028,9964081,3546,1241100,11205181,12.46
9874029,9968328,3793,1327550,11295878,13.32
9874030,9975995,4641,1624350,11600345,16.28
9874031,9993063,2701,945350,10938413,9.46
9874032,9982554,2676,936600,10919154,9.38
9874033,9985286,2058,720300,10705586,7.21
9874035,2006770,623,218050,2224820,10.87
9874036,9984476,4324,1513400,11497876,15.16
9874037,1259521,232,81200,1340721,6.45
9874038,9988950,2913,1019550,11008500,10.21
9874040,6789296,960,336000,7125296,4.95
9874041,7820737,4572,1600200,9420937,20.46
9874042,9983643,3245,1135750,11119393,11.38
9874043,9993276,3225,1128750,11122026,11.30
9874044,1142861,809,283150,1426011,24.78
9874045,9979333,2594,907900,10887233,9.10
9874046,9984251,4081,1428350,11412601,14.31
9874047,4242678,1086,380100,4622778,8.96
9874048,6292720,3537,1237950,7530670,19.67
9874049,9993926,2268,793800,10787726,7.94
9874050,2021200,1227,429450,2450650,21.25
9874051,9976889,3523,1233050,11209939,12.36
9874052,9976208,4601,1610350,11586558,16.14
9874053,9980402,3890,1361500,11341902,13.64
9874054,9988241,6826,2389100,12377341,23.92
9874055,9994931,4461,1561350,11556281,15.62
9874056,9982993,2645,925750,10908743,9.27
9874057,3602902,1353,473550,4076452,13.14
9874058,890072,350,122500,1012572,13.76
9874059,9958693,3713,1299550,11258243,13.05
9874060,9992635,3539,1238650,11231285,12.40
9874061,9968582,3079,1077650,11046232,10.81
9874062,9979381,5731,2005850,11985231,20.10
9874063,3675766,1367,478450,4154216,13.02
9874064,3734666,778,272300,4006966,7.29
9874065,9724897,3126,1094100,10818997,11.25
9874066,9958555,1438,503300,10461855,5.05
9874067,9954973,3249,1137150,11092123,11.42
9874068,9960335,2818,986300,10946635,9.90
9874069,9973208,2513,879550,10852758,8.82
9874070,9982404,3955,1384250,11366654,13.87
9874071,9962662,3569,1249150,11211812,12.54
9874072,9983483,4770,1669500,11652983,16.72
9874073,9916630,2615,915250,10831880,9.23
9874074,9985024,3261,1141350,11126374,11.43
9874076,9999244,5443,1905050,11904294,19.05
9874077,9989842,990,346500,10336342,3.47
9874078,9986491,2621,917350,10903841,9.19
9874079,9993735,2505,876750,10870485,8.77
9874080,9989805,1339,468650,10458455,4.69
9874081,9977285,3670,1284500,11261785,12.87
9874082,659605,240,84000,743605,12.73
9874083,9988173,3470,1214500,11202673,12.16
9874084,9984492,1214,424900,10409392,4.26
9874085,9982440,3491,1221850,11204290,12.24
9874086,9994578,2761,966350,10960928,9.67
9874087,9980719,3778,1322300,11303019,13.25
9874088,9981001,3385,1184750,11165751,11.87
9874089,9979122,2269,794150,10773272,7.96
9874090,1636673,775,271250,1907923,16.57
9874091,9976155,4267,1493450,11469605,14.97
9874092,9970257,3144,1100400,11070657,11.04
9874093,9984879,2148,751800,10736679,7.53
9874094,9982153,4897,1713950,11696103,17.17
9874095,2032205,1843,645050,2677255,31.74
9874098,1265596,527,184450,1450046,14.57
9874099,9216990,4031,1410850,10627840,15.31
9874100,262441,157,54950,317391,20.94
9874101,9943362,5103,1786050,11729412,17.96
9874102,9982571,3584,1254400,11236971,12.57
9874103,9997421,4311,1508850,11506271,15.09
9874104,3466271,778,272300,3738571,7.86
9874106,9644253,3641,1274350,10918603,13.21
9874107,9981993,3586,1255100,11237093,12.57
9874108,9966386,5935,2077250,12043636,20.84
9874109,9978480,5011,1753850,11732330,17.58
9874110,9608469,5300,1855000,11463469,19.31
9874111,9981323,2349,822150,10803473,8.24
9874112,9809716,3420,1197000,11006716,12.20
9874114,9989814,4152,1453200,11443014,14.55
9874115,9983366,3903,1366050,11349416,13.68
9874116,2234045,421,147350,2381395,6.60
9874117,9991686,3114,1089900,11081586,10.91
9874118,9992942,2632,921200,10914142,9.22
9874119,9971961,2887,1010450,10982411,10.13
9874120,9977554,6183,2164050,12141604,21.69
9874121,9994014,4490,1571500,11565514,15.72
9874122,3561085,1540,539000,4100085,15.14
9874123,9959814,5751,2012850,11972664,20.21
9874124,5250119,2064,722400,5972519,13.76
9874125,9978338,3919,1371650,11349988,13.75
9874126,9986023,1091,381850,10367873,3.82
9874127,9986562,4322,1512700,11499262,15.15
9874128,1665390,609,213150,1878540,12.80
9874129,9962328,5095,1783250,11745578,17.90
9874131,1268305,690,241500,1509805,19.04
9874132,6249170,3292,1152200,7401370,18.44
9874133,9991689,4900,1715000,11706689,17.16
9874135,9987739,2355,824250,10811989,8.25
9874136,177291,111,38850,216141,21.91
9874137,9986516,4104,1436400,11422916,14.38
9874138,9988810,3483,1219050,11207860,12.20
9874139,9983930,3463,1212050,11195980,12.14
9874140,9992834,3375,1181250,11174084,11.82
9874141,3728590,1443,505050,4233640,13.55
9874142,9985586,4616,1615600,11601186,16.18
9874143,9981608,2068,723800,10705408,7.25
9874144,9958629,5434,1901900,11860529,19.10
9874145,9970733,3861,1351350,11322083,13.55
9874146,9969857,4606,1612100,11581957,16.17
9874147,945895,312,109200,1055095,11.54
9874148,9982036,1925,673750,10655786,6.75
9874149,9957913,2117,740950,10698863,7.44
9874150,9974996,2447,856450,10831446,8.59
9874151,2414067,784,274400,2688467,11.37
9874152,2371958,991,346850,2718808,14.62
9874153,9986457,2130,745500,10731957,7.47
9874154,7821543,1335,467250,8288793,5.97
9874155,9972883,4521,1582350,11555233,15.87
9874156,9963868,4260,1491000,11454868,14.96
9874157,4404718,1070,374500,4779218,8.50
9874158,9967226,3942,1379700,11346926,13.84
9874159,9966189,3737,1307950,11274139,13.12
9874160,9977220,3823,1338050,11315270,13.41
9874161,9975386,5417,1895950,11871336,19.01
9874162,9936126,3365,1177750,11113876,11.85
9874163,1893602,1403,491050,2384652,25.93
9874164,3063225,1477,516950,3580175,16.88
9874165,9971525,4158,1455300,11426825,14.59
9874166,9982216,2510,878500,10860716,8.80
9874167,2279407,911,318850,2598257,13.99
9874168,621694,214,74900,696594,12.05
9874169,9980299,3414,1194900,11175199,11.97
9874170,9981094,3593,1257550,11238644,12.60
9874171,9999690,2232,781200,10780890,7.81
9874172,9995406,3423,1198050,11193456,11.99
9874173,9978125,959,335650,10313775,3.36
9874174,9998437,3109,1088150,11086587,10.88
9874175,274561,139,48650,323211,17.72
9874176,9968012,955,334250,10302262,3.35
9874177,9983792,1313,459550,10443342,4.60
9874178,9965284,3794,1327900,11293184,13.33
9874179,9949887,1138,398300,10348187,4.00
9874180,8675387,3070,1074500,9749887,12.39
9874181,9989715,4644,1625400,11615115,16.27
9874182,9990802,1267,443450,10434252,4.44
9874183,9988261,6316,2210600,12198861,22.13
9874184,9983985,2192,767200,10751185,7.68
9874185,9997953,2476,866600,10864553,8.67
9874186,6887103,1084,379400,7266503,5.51
9874187,1875446,620,217000,2092446,11.57
9874188,7235207,3793,1327550,8562757,18.35
9874189,9958702,3520,1232000,11190702,12.37
9874190,9988163,1856,649600,10637763,6.50
9874191,9985947,759,265650,10251597,2.66
9874192,4948110,1746,611100,5559210,12.35
9874193,9986236,2806,982100,10968336,9.83
9874194,9997811,3776,1321600,11319411,13.22
9874195,9981744,4194,1467900,11449644,14.71
9874196,9994072,5948,2081800,12075872,20.83
9874197,9998857,5779,2022650,12021507,20.23
9874198,2576802,2468,863800,3440602,33.52
9874199,9983128,3534,1236900,11220028,12.39
9874200,9970691,4291,1501850,11472541,15.06
9874201,9981266,2818,986300,10967566,9.88
9874202,9995689,2799,979650,10975339,9.80
9874203,9979824,2078,727300,10707124,7.29
9874204,9979307,2228,779800,10759107,7.81
9874205,9958394,2166,758100,10716494,7.61
9874206,9984187,3483,1219050,11203237,12.21
9874207,9988057,5228,1829800,11817857,18.32
9874208,9988399,4685,1639750,11628149,16.42
9874209,3097311,1374,480900,3578211,15.53
9874211,9970521,4931,1725850,11696371,17.31
9874212,9951407,3220,1127000,11078407,11.33
9874213,9982106,3046,1066100,11048206,10.68
9874214,9993820,4039,1413650,11407470,14.15
9874215,9987995,2410,843500,10831495,8.45
9874216,9686589,3596,1258600,10945189,12.99
9874218,9982349,4561,1596350,11578699,15.99
9874219,930704,149,52150,982854,5.60
9874220,9986342,3235,1132250,11118592,11.34
9874221,9979417,2986,1045100,11024517,10.47
9874222,402617,121,42350,444967,10.52
9874223,9972243,4469,1564150,11536393,15.69
9874224,9976668,3228,1129800,11106468,11.32
9874225,9976522,2376,831600,10808122,8.34
9874226,9966521,5777,2021950,11988471,20.29
9874227,9987643,1626,569100,10556743,5.70
9874228,9986863,3693,1292550,11279413,12.94
9874229,9978388,2223,778050,10756438,7.80
9874230,9983467,3072,1075200,11058667,10.77
9874231,9902222,4209,1473150,11375372,14.88
9874232,9988780,3143,1100050,11088830,11.01
9874233,9848394,4023,1408050,11256444,14.30
9874234,9969381,3464,1212400,11181781,12.16
9874235,9982152,4015,1405250,11387402,14.08
9874236,9979906,3971,1389850,11369756,13.93
9874237,9990566,4536,1587600,11578166,15.89
9874238,9979140,4066,1423100,11402240,14.26
9874239,9853312,3288,1150800,11004112,11.68
9874240,9990145,3875,1356250,11346395,13.58
9874241,9992324,1321,462350,10454674,4.63
9874242,9998713,1265,442750,10441463,4.43
9874243,9978162,4272,1495200,11473362,14.98
9874244,9987651,4902,1715700,11703351,17.18
9874245,9990986,2706,947100,10938086,9.48
9874246,9973909,4266,1493100,11467009,14.97
9874247,9994490,3283,1149050,11143540,11.50
9874248,9983435,5252,1838200,11821635,18.41
9874249,9987347,3250,1137500,11124847,11.39
9874250,9974242,2150,752500,10726742,7.54
9874251,9982743,3343,1170050,11152793,11.72
9874252,9992413,4144,1450400,11442813,14.52
9874253,9972801,6104,2136400,12109201,21.42
9874254,9715096,2153,753550,10468646,7.76
9874255,9966708,4298,1504300,11471008,15.09
9874256,9987932,2619,916650,10904582,9.18
9874257,9974285,2793,977550,10951835,9.80
9874258,9991317,3340,1169000,11160317,11.70
9874259,9984104,1141,399350,10383454,4.00
9874260,9994156,5171,1809850,11804006,18.11
9874261,9992071,2142,749700,10741771,7.50
9874262,719789,603,211050,930839,29.32
9874263,9979262,1765,617750,10597012,6.19
9874264,9976923,3828,1339800,11316723,13.43
9874265,9958598,2677,936950,10895548,9.41
9874266,9962375,3832,1341200,11303575,13.46
9874267,9959431,4298,1504300,11463731,15.10
9874268,9972659,3262,1141700,11114359,11.45
9874269,9976954,3496,1223600,11200554,12.26
9874270,9968566,4464,1562400,11530966,15.67
9874271,9981884,234,81900,10063784,0.82
9874272,9979070,4641,1624350,11603420,16.28
9874273,9984415,3812,1334200,11318615,13.36
9874274,9993357,3847,1346450,11339807,13.47
9874275,7213792,210,73500,7287292,1.02
9874276,9974229,4744,1660400,11634629,16.65
9874277,9971299,5483,1919050,11890349,19.25
9874278,9995249,2741,959350,10954599,9.60
9874279,9968954,4368,1528800,11497754,15.34
9874280,675384,434,151900,827284,22.49
9874281,9967814,3861,1351350,11319164,13.56
9874282,9020520,2195,768250,9788770,8.52
9874283,9988015,3851,1347850,11335865,13.49
9874284,2073718,499,174650,2248368,8.42
9874285,9981047,4158,1455300,11436347,14.58
9874286,531633,215,75250,606883,14.15
9874287,9976082,4372,1530200,11506282,15.34
9874288,9978773,3383,1184050,11162823,11.87
9874289,9969442,3796,1328600,11298042,13.33
9874290,9953567,3041,1064350,11017917,10.69
9874291,9968055,3079,1077650,11045705,10.81
9874293,9966763,3249,1137150,11103913,11.41
9874294,205907,129,45150,251057,21.93
9874295,9971045,3981,1393350,11364395,13.97
9874296,9982778,5780,2023000,12005778,20.26
9874297,9992796,4136,1447600,11440396,14.49
9874298,9961815,5967,2088450,12050265,20.96
9874299,9985523,4570,1599500,11585023,16.02
9874300,9995989,3179,1112650,11108639,11.13
9874301,1915773,830,290500,2206273,15.16
9874302,558378,237,82950,641328,14.86
9874303,9971093,5816,2035600,12006693,20.42
9874304,9981857,2814,984900,10966757,9.87
9874305,9982620,4222,1477700,11460320,14.80
9874306,9968871,2486,870100,10838971,8.73
9874307,9999360,4871,1704850,11704210,17.05
9874308,2238281,842,294700,2532981,13.17
9874309,9923614,2093,732550,10656164,7.38
9874310,9992354,3422,1197700,11190054,11.99
9874311,9984134,3841,1344350,11328484,13.46
9874312,9975189,3645,1275750,11250939,12.79
9874313,9984088,7523,2633050,12617138,26.37
9874314,9965611,3296,1153600,11119211,11.58
9874315,3457664,1946,681100,4138764,19.70
9874316,9974814,3516,1230600,11205414,12.34
9874317,9973679,6471,2264850,12238529,22.71
9874318,9970614,4608,1612800,11583414,16.18
9874319,1167749,972,340200,1507949,29.13
9874320,9991315,2340,819000,10810315,8.20
9874321,9947927,4255,1489250,11437177,14.97
9874322,9995270,2957,1034950,11030220,10.35
9874323,9982964,4722,1652700,11635664,16.56
9874324,9982152,4101,1435350,11417502,14.38
9874325,9931272,1595,558250,10489522,5.62
9874326,9969203,4163,1457050,11426253,14.62
9874327,9956255,1665,582750,10539005,5.85
9874328,9973485,3564,1247400,11220885,12.51
9874329,3226770,241,84350,3311120,2.61
9874330,9966465,3300,1155000,11121465,11.59
9874331,9965921,3209,1123150,11089071,11.27
9874332,2721431,920,322000,3043431,11.83
9874333,9971735,2411,843850,10815585,8.46
9874334,9986421,3700,1295000,11281421,12.97
9874335,9970443,2885,1009750,10980193,10.13
9874336,9952602,765,267750,10220352,2.69
9874337,9958554,4067,1423450,11382004,14.29
9874338,9950090,418,146300,10096390,1.47
9874339,8666113,2668,933800,9599913,10.78
9874340,2479494,715,250250,2729744,10.09
9874341,9955773,4114,1439900,11395673,14.46
9874342,2800847,841,294350,3095197,10.51
9874343,9974232,5572,1950200,11924432,19.55
9874344,5153880,1689,591150,5745030,11.47
9874345,7472363,3854,1348900,8821263,18.05
9874346,9956501,4752,1663200,11619701,16.70
9874347,9972197,3458,1210300,11182497,12.14
9874348,9989796,2683,939050,10928846,9.40
9874349,9991008,2584,904400,10895408,9.05
9874351,9982441,4292,1502200,11484641,15.05
9874352,9977730,3524,1233400,11211130,12.36
9874353,9986222,3133,1096550,11082772,10.98
9874354,9998956,3845,1345750,11344706,13.46
9874355,9992731,3598,1259300,11252031,12.60
9874356,9982749,1171,409850,10392599,4.11
9874357,9985025,3365,1177750,11162775,11.80
9874358,9990264,4090,1431500,11421764,14.33
9874359,9988118,4469,1564150,11552268,15.66
9874360,9983350,3584,1254400,11237750,12.56
9874362,9967833,2693,942550,10910383,9.46
9874363,9945950,2824,988400,10934350,9.94
9874364,6292634,3810,1333500,7626134,21.19
9874365,9945577,3325,1163750,11109327,11.70
9874366,271185,106,37100,308285,13.68
9874367,9940120,4111,1438850,11378970,14.48
9874368,9944784,4380,1533000,11477784,15.42
9874369,9946717,4469,1564150,11510867,15.73
9874370,2049158,533,186550,2235708,9.10
9874371,9947520,3979,1392650,11340170,14.00
9874372,9948985,4407,1542450,11491435,15.50
9874373,9965314,2988,1045800,11011114,10.49
9874374,9954875,2982,1043700,10998575,10.48
9874375,9975125,3834,1341900,11317025,13.45
9874377,9993683,3927,1374450,11368133,13.75
9874378,9973871,2945,1030750,11004621,10.33
9874379,2328141,872,305200,2633341,13.11
9874381,9980379,5231,1830850,11811229,18.34
9874382,9982553,3363,1177050,11159603,11.79
9874383,3012559,659,230650,3243209,7.66
9874384,1843313,891,311850,2155163,16.92
9874385,9959899,3427,1199450,11159349,12.04
9874386,9980271,3269,1144150,11124421,11.46
9874387,9973491,3180,1113000,11086491,11.16
9874388,9964756,4847,1696450,11661206,17.02
9874389,9938513,2260,791000,10729513,7.96
9874390,9909451,3089,1081150,10990601,10.91
9874391,4232880,2924,1023400,5256280,24.18
9874392,9961523,1902,665700,10627223,6.68
9874393,9973427,957,334950,10308377,3.36
9874394,9984170,1145,400750,10384920,4.01
9874395,9987327,2319,811650,10798977,8.13
9874396,9992978,2787,975450,10968428,9.76
9874397,9976244,4834,1691900,11668144,16.96
9874398,9999865,3483,1219050,11218915,12.19
9874399,9971450,3876,1356600,11328050,13.60
9874400,9685394,766,268100,9953494,2.77
9874401,9992761,1467,513450,10506211,5.14
9874402,9985452,3168,1108800,11094252,11.10
9874403,9987032,1263,442050,10429082,4.43
9874404,9993299,3009,1053150,11046449,10.54
9874405,9963154,1551,542850,10506004,5.45
9874406,9991416,2617,915950,10907366,9.17
9874407,9999466,1075,376250,10375716,3.76
9874408,9984365,1137,397950,10382315,3.99
9874409,3345768,827,289450,3635218,8.65
9874410,3422186,1972,690200,4112386,20.17
9874411,9968502,3755,1314250,11282752,13.18
9874412,9935994,1455,509250,10445244,5.13
9874413,9984744,3681,1288350,11273094,12.90
9874414,9952551,780,273000,10225551,2.74
9874415,8974726,3409,1193150,10167876,13.29
9874416,9995453,3320,1162000,11157453,11.63
9874417,9981265,3850,1347500,11328765,13.50
9874418,9992205,3186,1115100,11107305,11.16
9874419,9982050,2105,736750,10718800,7.38
9874420,9977456,3359,1175650,11153106,11.78
9874421,9973934,4365,1527750,11501684,15.32
9874422,9956481,1367,478450,10434931,4.81
9874423,9974707,3522,1232700,11207407,12.36
9874424,9967864,2287,800450,10768314,8.03
9874425,2698439,945,330750,3029189,12.26
9874426,9952411,3907,1367450,11319861,13.74
9874427,9965785,4992,1747200,11712985,17.53
9874428,4086822,1701,595350,4682172,14.57
9874429,9971116,2681,938350,10909466,9.41
9874430,9974730,2615,915250,10889980,9.18
9874431,9987296,3853,1348550,11335846,13.50
9874432,9973976,4453,1558550,11532526,15.63
9874433,9989351,5135,1797250,11786601,17.99
9874434,9980888,4128,1444800,11425688,14.48
9874435,9994469,44,15400,10009869,0.15
9874436,9548733,3504,1226400,10775133,12.84
9874437,9984172,5179,1812650,11796822,18.16
9874438,9983424,3730,1305500,11288924,13.08
9874439,9027671,1812,634200,9661871,7.03
9874440,9884209,42,14700,9898909,0.15
9874441,9984477,3806,1332100,11316577,13.34
9874442,9983526,4355,1524250,11507776,15.27
9874443,8429985,2782,973700,9403685,11.55
9874445,2412739,2631,920850,3333589,38.17
9874446,9955626,3113,1089550,11045176,10.94
9874447,9962742,8185,2864750,12827492,28.75
9874448,9973577,5270,1844500,11818077,18.49
9874449,9980292,3753,1313550,11293842,13.16
9874450,9972476,6691,2341850,12314326,23.48
9874451,9988417,4053,1418550,11406967,14.20
9874452,575498,237,82950,658448,14.41
9874453,9964229,3433,1201550,11165779,12.06
9874454,9950273,4946,1731100,11681373,17.40
9874455,9937479,3104,1086400,11023879,10.93
9874456,9958627,2584,904400,10863027,9.08
9874457,6762493,4970,1739500,8501993,25.72
9874458,9965804,2430,850500,10816304,8.53
9874459,9971564,5155,1804250,11775814,18.09
9874460,9965727,2831,990850,10956577,9.94
9874461,9971122,2159,755650,10726772,7.58
9874462,9973295,2402,840700,10813995,8.43
9874463,9992082,3577,1251950,11244032,12.53
9874464,9972385,2579,902650,10875035,9.05
9874465,9993656,2899,1014650,11008306,10.15
9874466,9968194,3871,1354850,11323044,13.59
9874467,9974651,1771,619850,10594501,6.21
9874468,4449492,941,329350,4778842,7.40
9874469,9985845,69,24150,10009995,0.24
9874470,9983983,3474,1215900,11199883,12.18
9874471,9979584,2268,793800,10773384,7.95
9874472,9982150,4334,1516900,11499050,15.20
9874473,9962433,3466,1213100,11175533,12.18
9874474,1902865,925,323750,2226615,17.01
9874475,9957673,3255,1139250,11096923,11.44
9874476,9951889,3411,1193850,11145739,12.00
9874478,1676217,503,176050,1852267,10.50
9874479,756307,242,84700,841007,11.20
9874480,9918777,4891,1711850,11630627,17.26
9874481,9936145,2372,830200,10766345,8.36
9874482,9940801,3550,1242500,11183301,12.50
9874483,9943837,4940,1729000,11672837,17.39
9874484,2055635,1076,376600,2432235,18.32
9874485,9927525,3040,1064000,10991525,10.72
9874486,9930399,4029,1410150,11340549,14.20
9874487,4487931,2547,891450,5379381,19.86
9874488,9933378,2923,1023050,10956428,10.30
9874489,9935227,2265,792750,10727977,7.98
9874490,9935064,3127,1094450,11029514,11.02
9874491,9938480,2951,1032850,10971330,10.39
9874492,9944338,5066,1773100,11717438,17.83
9874493,9940311,3903,1366050,11306361,13.74
9874494,9952199,3962,1386700,11338899,13.93
9874495,9940860,96,33600,9974460,0.34
9874496,9663144,1036,362600,10025744,3.75
9874497,9970254,4446,1556100,11526354,15.61
9874498,9983759,4811,1683850,11667609,16.87
9874499,9993988,2176,761600,10755588,7.62
9874500,9992398,2391,836850,10829248,8.37
9874501,9758115,4578,1602300,11360415,16.42
9874502,9981110,4594,1607900,11589010,16.11
9874503,9977733,2527,884450,10862183,8.86
9874504,9969900,3138,1098300,11068200,11.02
9874506,9989640,3299,1154650,11144290,11.56
9874507,9984524,4380,1533000,11517524,15.35
9874508,2787531,983,344050,3131581,12.34
9874509,9955248,5224,1828400,11783648,18.37
9874510,3715534,883,309050,4024584,8.32
9874511,9975677,6516,2280600,12256277,22.86
9874512,9971608,3518,1231300,11202908,12.35
9874513,9972139,3337,1167950,11140089,11.71
9874514,9963479,3803,1331050,11294529,13.36
9874515,9965048,5048,1766800,11731848,17.73
9874516,1760840,1580,553000,2313840,31.41
9874517,9969108,3860,1351000,11320108,13.55
9874518,9987751,5086,1780100,11767851,17.82
9874519,9982720,3253,1138550,11121270,11.41
9874520,9977456,4609,1613150,11590606,16.17
9874521,9980785,3525,1233750,11214535,12.36
9874522,3599621,1421,497350,4096971,13.82
9874523,9983940,3231,1130850,11114790,11.33
9874524,5696965,2218,776300,6473265,13.63
9874525,9994883,4749,1662150,11657033,16.63
9874526,9987798,5256,1839600,11827398,18.42
9874527,9959581,2997,1048950,11008531,10.53
9874528,7945437,2127,744450,8689887,9.37
9874529,9989720,2963,1037050,11026770,10.38
9874530,9215214,2944,1030400,10245614,11.18
9874531,9981973,904,316400,10298373,3.17
9874532,4806139,747,261450,5067589,5.44
9874533,9972866,3197,1118950,11091816,11.22
9874534,9952492,3264,1142400,11094892,11.48
9874535,9944066,3871,1354850,11298916,13.62
9874536,9956172,3427,1199450,11155622,12.05
9874537,9942839,1798,629300,10572139,6.33
9874538,9954605,4725,1653750,11608355,16.61
9874539,9953686,2268,793800,10747486,7.97
9874540,9956768,2200,770000,10726768,7.73
9874541,9958609,3552,1243200,11201809,12.48
9874542,9965302,5720,2002000,11967302,20.09
9874544,9971284,4305,1506750,11478034,15.11
9874545,9966723,2276,796600,10763323,7.99
9874546,9981183,4598,1609300,11590483,16.12
9874547,9990689,2535,887250,10877939,8.88
9874548,9977101,3361,1176350,11153451,11.79
9874549,9993892,2206,772100,10765992,7.73
9874550,9984747,3026,1059100,11043847,10.61
9874551,9986745,2174,760900,10747645,7.62
9874552,9991969,4556,1594600,11586569,15.96
9874553,9983374,4373,1530550,11513924,15.33
9874555,9972342,3256,1139600,11111942,11.43
9874556,3926712,632,221200,4147912,5.63
9874557,9988704,4094,1432900,11421604,14.35
9874558,9883554,2684,939400,10822954,9.50
9874559,9978870,3741,1309350,11288220,13.12
9874560,9985013,5183,1814050,11799063,18.17
9874561,9993397,3673,1285550,11278947,12.86
9874562,9973510,3139,1098650,11072160,11.02
9874563,9986636,4448,1556800,11543436,15.59
9874564,3341385,838,293300,3634685,8.78
9874565,3895226,1737,607950,4503176,15.61
9874566,9973561,4050,1417500,11391061,14.21
9874567,9986289,2734,956900,10943189,9.58
9874568,9974568,2673,935550,10910118,9.38
9874570,9982517,2764,967400,10949917,9.69
9874571,9982436,4283,1499050,11481486,15.02
9874572,9945133,4695,1643250,11588383,16.52
9874573,9981168,3319,1161650,11142818,11.64
9874574,9964524,5518,1931300,11895824,19.38
9874575,9976303,2864,1002400,10978703,10.05
9874576,9981185,1975,691250,10672435,6.93
9874577,9990095,3599,1259650,11249745,12.61
9874578,9975141,3732,1306200,11281341,13.09
9874579,9987942,3199,1119650,11107592,11.21
9874580,9969491,3893,1362550,11332041,13.67
9874581,9978963,3457,1209950,11188913,12.13
9874582,9983019,3579,1252650,11235669,12.55
9874583,1937762,513,179550,2117312,9.27
9874584,4536549,790,276500,4813049,6.09
9874586,9963520,4109,1438150,11401670,14.43
9874587,9972065,2910,1018500,10990565,10.21
9874588,9961066,2627,919450,10880516,9.23
9874589,9968004,4402,1540700,11508704,15.46
9874590,9445105,2747,961450,10406555,10.18
9874591,9987739,2213,774550,10762289,7.76
9874592,9978270,4634,1621900,11600170,16.25
9874594,9972633,2965,1037750,11010383,10.41
9874595,9966521,4467,1563450,11529971,15.69
9874596,9976444,3864,1352400,11328844,13.56
9874597,8492912,1268,443800,8936712,5.23
9874598,9976885,1368,478800,10455685,4.80
9874599,5939175,2696,943600,6882775,15.89
9874600,9990137,2606,912100,10902237,9.13
9874601,9824580,2351,822850,10647430,8.38
9874602,9979099,3319,1161650,11140749,11.64
9874603,9974690,2917,1020950,10995640,10.24
9874604,4428633,896,313600,4742233,7.08
9874605,9963326,2957,1034950,10998276,10.39
9874606,4316750,696,243600,4560350,5.64
9874607,9970159,2888,1010800,10980959,10.14
9874608,9971056,5132,1796200,11767256,18.01
9874609,9982277,2037,712950,10695227,7.14
9874610,9968116,3329,1165150,11133266,11.69
9874611,9977985,3300,1155000,11132985,11.58
9874612,413106,331,115850,528956,28.04
9874613,9983659,4565,1597750,11581409,16.00
9874614,9971614,2503,876050,10847664,8.79
9874615,9955649,1835,642250,10597899,6.45
9874616,9966826,2894,1012900,10979726,10.16
9874617,9728109,3842,1344700,11072809,13.82
9874618,9980810,1952,683200,10664010,6.85
9874619,8991511,2952,1033200,10024711,11.49
9874620,9971800,3335,1167250,11139050,11.71
9874621,9982716,1898,664300,10647016,6.65
9874622,9967323,2625,918750,10886073,9.22
9874623,9984279,4329,1515150,11499429,15.18
9874624,9988246,2656,929600,10917846,9.31
9874625,9981141,3977,1391950,11373091,13.95
9874626,9982163,3730,1305500,11287663,13.08
9874627,8591738,2574,900900,9492638,10.49
9874628,9550967,4097,1433950,10984917,15.01
9874629,1988756,1319,461650,2450406,23.21
9874630,9938505,2815,985250,10923755,9.91
9874631,2840975,780,273000,3113975,9.61
9874632,9958528,3124,1093400,11051928,10.98
9874633,9443719,2583,904050,10347769,9.57
9874634,6025283,2877,1006950,7032233,16.71
9874635,9948476,3616,1265600,11214076,12.72
9874636,9957116,3651,1277850,11234966,12.83
9874637,9977989,3030,1060500,11038489,10.63
9874638,9967755,2939,1028650,10996405,10.32
9874639,2292353,561,196350,2488703,8.57
9874641,2960720,1219,426650,3387370,14.41
9874642,9967037,3164,1107400,11074437,11.11
9874643,9970462,2150,752500,10722962,7.55
9874645,9963700,2858,1000300,10964000,10.04
9874646,9977041,2346,821100,10798141,8.23
9874647,3485699,1014,354900,3840599,10.18
9874648,9951170,1050,367500,10318670,3.69
9874649,9954396,6073,2125550,12079946,21.35
9874650,9972552,4521,1582350,11554902,15.87
9874651,9931331,1784,624400,10555731,6.29
9874652,2883023,1241,434350,3317373,15.07
9874653,9964978,2147,751450,10716428,7.54
9874654,9962987,2290,801500,10764487,8.04
9874655,1296744,1436,502600,1799344,38.76
9874656,9971611,3471,1214850,11186461,12.18
9874657,9983508,2676,936600,10920108,9.38
9874658,9979547,3988,1395800,11375347,13.99
9874659,2851930,1075,376250,3228180,13.19
9874660,9974951,2716,950600,10925551,9.53
9874661,9967910,4470,1564500,11532410,15.70
9874662,9968340,4128,1444800,11413140,14.49
9874663,9960077,2766,968100,10928177,9.72
9874664,1527921,360,126000,1653921,8.25
9874665,9982877,1954,683900,10666777,6.85
9874666,9979972,2518,881300,10861272,8.83
9874667,9984723,3569,1249150,11233873,12.51
9874668,4657400,1139,398650,5056050,8.56
9874669,9975348,3538,1238300,11213648,12.41
9874670,5820581,2671,934850,6755431,16.06
9874671,9988731,2446,856100,10844831,8.57
9874672,9984544,3687,1290450,11274994,12.92
9874673,6118319,2202,770700,6889019,12.60
9874674,9837657,2924,1023400,10861057,10.40
9874675,9983185,3864,1352400,11335585,13.55
9874676,9982003,2370,829500,10811503,8.31
9874677,9986746,4324,1513400,11500146,15.15
9874678,9996239,2657,929950,10926189,9.30
9874679,9978724,2037,712950,10691674,7.14
9874680,9999734,4001,1400350,11400084,14.00
9874681,9985217,3137,1097950,11083167,11.00
9874682,9979166,4210,1473500,11452666,14.77
9874683,5986678,2257,789950,6776628,13.20
9874684,4952136,1602,560700,5512836,11.32
9874685,2435743,1164,407400,2843143,16.73
9874686,9734660,4563,1597050,11331710,16.41
9874687,9998953,3943,1380050,11379003,13.80
9874688,9980106,3288,1150800,11130906,11.53
9874689,9988015,3496,1223600,11211615,12.25
9874690,9986341,1780,623000,10609341,6.24
9874693,6533835,1682,588700,7122535,9.01
9874694,9946190,3958,1385300,11331490,13.93
9874695,1170550,1143,400050,1570600,34.18
9874696,9977297,2413,844550,10821847,8.46
9874697,9975268,2615,915250,10890518,9.18
9874698,9971012,3979,1392650,11363662,13.97
9874699,9989304,4147,1451450,11440754,14.53
9874700,1527045,1619,566650,2093695,37.11
9874702,9956369,2713,949550,10905919,9.54
9874703,9952005,3764,1317400,11269405,13.24
9874704,9965026,2814,984900,10949926,9.88
9874705,9974496,2922,1022700,10997196,10.25
9874707,9974426,3050,1067500,11041926,10.70
9874708,9980719,3535,1237250,11217969,12.40
9874709,9984661,1927,674450,10659111,6.75
9874710,9968255,3899,1364650,11332905,13.69
9874711,9977011,4545,1590750,11567761,15.94
9874712,9978384,2588,905800,10884184,9.08
9874713,9977347,5310,1858500,11835847,18.63
9874714,1068039,352,123200,1191239,11.54
9874715,9977271,6348,2221800,12199071,22.27
9874717,7162312,1556,544600,7706912,7.60
9874718,3431675,654,228900,3660575,6.67
9874719,9956999,3978,1392300,11349299,13.98
9874720,9950810,4066,1423100,11373910,14.30
9874721,9962777,2204,771400,10734177,7.74
9874722,9984228,3294,1152900,11137128,11.55
9874723,9987264,2064,722400,10709664,7.23
9874724,9979157,2041,714350,10693507,7.16
9874725,415250,173,60550,475800,14.58
9874726,9973363,3100,1085000,11058363,10.88
9874727,9968640,3409,1193150,11161790,11.97
9874728,9976597,3980,1393000,11369597,13.96
9874729,9974920,3230,1130500,11105420,11.33
9874730,9704835,2730,955500,10660335,9.85
9874731,9999679,3767,1318450,11318129,13.18
9874732,9979913,3281,1148350,11128263,11.51
9874733,9985594,5828,2039800,12025394,20.43
9874734,9959894,4046,1416100,11375994,14.22
9874735,9987661,4703,1646050,11633711,16.48
9874737,9974311,2539,888650,10862961,8.91
9874738,9957883,5624,1968400,11926283,19.77
9874739,3961670,1546,541100,4502770,13.66
9874740,9966660,4715,1650250,11616910,16.56
9874741,9975191,4508,1577800,11552991,15.82
9874742,9986166,4709,1648150,11634316,16.50
9874743,9985116,4660,1631000,11616116,16.33
9874745,9971209,3438,1203300,11174509,12.07
9874746,5145339,1292,452200,5597539,8.79
9874747,9974847,3774,1320900,11295747,13.24
9874748,971841,692,242200,1214041,24.92
9874749,9963860,2819,986650,10950510,9.90
9874750,9949330,2388,835800,10785130,8.40
9874751,9939231,2537,887950,10827181,8.93
9874752,9945210,2125,743750,10688960,7.48
9874753,9962238,2718,951300,10913538,9.55
9874754,9969289,2716,950600,10919889,9.54
9874755,9977557,4102,1435700,11413257,14.39
9874757,9970623,2573,900550,10871173,9.03
9874758,9970440,5165,1807750,11778190,18.13
9874759,9395023,5717,2000950,11395973,21.30
9874760,9934720,2386,835100,10769820,8.41
9874761,9988675,3265,1142750,11131425,11.44
9874762,9998402,3117,1090950,11089352,10.91
9874763,1735643,460,161000,1896643,9.28
9874764,9979866,3928,1374800,11354666,13.78
9874765,9997303,3491,1221850,11219153,12.22
9874766,9990243,3259,1140650,11130893,11.42
9874767,9969030,2415,845250,10814280,8.48
9874768,9978091,3963,1387050,11365141,13.90
9874769,9970573,3243,1135050,11105623,11.38
9874770,9502145,3683,1289050,10791195,13.57
9874771,9972705,3002,1050700,11023405,10.54
9874772,9977156,4999,1749650,11726806,17.54
9874773,9994726,2818,986300,10981026,9.87
9874774,8743943,3705,1296750,10040693,14.83
9874775,9999278,2590,906500,10905778,9.07
9874776,9992551,2260,791000,10783551,7.92
9874777,9980915,3430,1200500,11181415,12.03
9874778,9993803,3092,1082200,11076003,10.83
9874779,9982296,1759,615650,10597946,6.17
9874780,9970860,6463,2262050,12232910,22.69
9874781,9933188,2612,914200,10847388,9.20
9874782,4298231,1691,591850,4890081,13.77
9874783,9982020,5683,1989050,11971070,19.93
9874784,9984102,4011,1403850,11387952,14.06
9874785,9989942,2635,922250,10912192,9.23
9874787,9994903,3303,1156050,11150953,11.57
9874788,9983932,2651,927850,10911782,9.29
9874789,9996914,4073,1425550,11422464,14.26
9874790,9999129,2473,865550,10864679,8.66
9874791,9985530,3503,1226050,11211580,12.28
9874792,9977144,1763,617050,10594194,6.18
9874793,9986776,4000,1400000,11386776,14.02
9874794,9980879,3027,1059450,11040329,10.61
9874795,9988830,3767,1318450,11307280,13.20
9874798,9964638,2900,1015000,10979638,10.19
9874799,9957248,4266,1493100,11450348,15.00
9874800,9959722,2862,1001700,10961422,10.06
9874801,9963995,2968,1038800,11002795,10.43
9874802,9967159,3724,1303400,11270559,13.08
9874803,6015875,2078,727300,6743175,12.09
9874804,9998332,3944,1380400,11378732,13.81
9874805,9983469,2861,1001350,10984819,10.03
9874806,9997685,3584,1254400,11252085,12.55
9874807,9970184,1307,457450,10427634,4.59
9874808,9988830,4158,1455300,11444130,14.57
9874809,9999039,2552,893200,10892239,8.93
9874810,559607,290,101500,661107,18.14
9874811,7642695,2481,868350,8511045,11.36
9874812,9979477,2638,923300,10902777,9.25
9874813,9987634,2313,809550,10797184,8.11
9874814,9979073,2720,952000,10931073,9.54
9874815,7816503,2348,821800,8638303,10.51
9874816,9979146,4456,1559600,11538746,15.63
9874817,5482842,1546,541100,6023942,9.87
9874818,9974198,2928,1024800,10998998,10.27
9874819,9965999,5120,1792000,11757999,17.98
9874820,9971990,3344,1170400,11142390,11.74
9874821,9993252,4177,1461950,11455202,14.63
9874822,9987962,4604,1611400,11599362,16.13
9874823,9989290,3142,1099700,11088990,11.01
9874824,7163249,2882,1008700,8171949,14.08
9874825,9974447,4715,1650250,11624697,16.54
9874826,484424,309,108150,592574,22.33
9874827,4946742,2299,804650,5751392,16.27
9874828,9970892,3668,1283800,11254692,12.88
9874829,9995210,2231,780850,10776060,7.81
9874830,5589302,2322,812700,6402002,14.54
9874831,1382890,411,143850,1526740,10.40
9874832,9966100,3107,1087450,11053550,10.91
9874833,9972278,3276,1146600,11118878,11.50
9874834,9953688,3870,1354500,11308188,13.61
9874835,4605945,1484,519400,5125345,11.28
9874836,1175869,241,84350,1260219,7.17
9874838,9948285,3443,1205050,11153335,12.11
9874839,9940247,4335,1517250,11457497,15.26
9874840,9936789,2893,1012550,10949339,10.19
9874841,9948120,4190,1466500,11414620,14.74
9874842,9961398,2439,853650,10815048,8.57
9874843,9947880,2759,965650,10913530,9.71
9874844,9950632,3977,1391950,11342582,13.99
9874845,6610014,1820,637000,7247014,9.64
9874846,9930640,2561,896350,10826990,9.03
9874847,9945952,2719,951650,10897602,9.57
9874848,9942091,2170,759500,10701591,7.64
9874849,9928446,2874,1005900,10934346,10.13
9874850,9375453,5617,1965950,11341403,20.97
9874851,9933300,233,81550,10014850,0.82
9874852,9946476,2825,988750,10935226,9.94
9874853,9933316,3609,1263150,11196466,12.72
9874854,9275587,3110,1088500,10364087,11.74
9874855,9940207,3853,1348550,11288757,13.57
9874856,568577,349,122150,690727,21.48
9874857,5760891,1205,421750,6182641,7.32
9874858,3983911,1846,646100,4630011,16.22
9874859,9982704,3854,1348900,11331604,13.51
9874860,9965195,2161,756350,10721545,7.59
9874861,8954476,3310,1158500,10112976,12.94
9874862,9972430,2746,961100,10933530,9.64
9874863,9972858,4197,1468950,11441808,14.73
9874864,9984011,4221,1477350,11461361,14.80
9874865,959291,178,62300,1021591,6.49
9874866,9972363,2934,1026900,10999263,10.30
9874867,9993552,3150,1102500,11096052,11.03
9874868,9997015,2053,718550,10715565,7.19
9874869,1668372,495,173250,1841622,10.38
9874870,9979349,1650,577500,10556849,5.79
9874871,9977273,3519,1231650,11208923,12.34
9874872,9996531,2663,932050,10928581,9.32
9874873,9987521,2882,1008700,10996221,10.10
9874874,9983388,5082,1778700,11762088,17.82
9874875,9989275,2515,880250,10869525,8.81
9874876,9995239,2942,1029700,11024939,10.30
9874877,9973720,2559,895650,10869370,8.98
9874879,9972429,3067,1073450,11045879,10.76
9874880,2683383,1560,546000,3229383,20.35
9874881,9944906,2537,887950,10832856,8.93
9874882,9955897,3538,1238300,11194197,12.44
9874883,3636046,1264,442400,4078446,12.17
9874884,9981143,3111,1088850,11069993,10.91
9874885,9959629,1721,602350,10561979,6.05
9874886,9952696,5110,1788500,11741196,17.97
9874887,9952902,3395,1188250,11141152,11.94
9874888,9962677,2493,872550,10835227,8.76
9874889,9967389,3045,1065750,11033139,10.69
9874890,9942066,1110,388500,10330566,3.91
9874891,9952591,2048,716800,10669391,7.20
9874892,9963740,2786,975100,10938840,9.79
9874893,9985717,4067,1423450,11409167,14.25
9874894,9965448,4124,1443400,11408848,14.48
9874895,9972945,2419,846650,10819595,8.49
9874897,9955088,4596,1608600,11563688,16.16
9874898,9978038,3732,1306200,11284238,13.09
9874899,9989925,3706,1297100,11287025,12.98
9874900,9983461,335,117250,10100711,1.17
9874901,9982976,3509,1228150,11211126,12.30
9874903,9982438,3565,1247750,11230188,12.50
9874904,9975247,3705,1296750,11271997,13.00
9874905,9988171,2680,938000,10926171,9.39
9874906,9989830,3756,1314600,11304430,13.16
9874907,9982725,2765,967750,10950475,9.69
9874908,1869544,258,90300,1959844,4.83
9874909,9969267,2856,999600,10968867,10.03
9874910,9976142,4596,1608600,11584742,16.12
9874911,9975462,1810,633500,10608962,6.35
9874912,9989090,2653,928550,10917640,9.30
9874913,6127864,1939,678650,6806514,11.07
9874914,9992362,4261,1491350,11483712,14.92
9874915,9976175,3841,1344350,11320525,13.48
9874916,9978911,3073,1075550,11054461,10.78
9874917,9990727,2490,871500,10862227,8.72
9874918,558630,282,98700,657330,17.67
9874919,9963975,3494,1222900,11186875,12.27
9874920,9977451,3393,1187550,11165001,11.90
9874921,9981157,2916,1020600,11001757,10.23
9874922,9998533,3035,1062250,11060783,10.62
9874923,9995929,2761,966350,10962279,9.67
9874924,1557853,239,83650,1641503,5.37
9874925,9980262,3220,1127000,11107262,11.29
9874926,9981715,2713,949550,10931265,9.51
9874927,9957176,2680,938000,10895176,9.42
9874928,9953611,4213,1474550,11428161,14.81
9874929,9940005,3882,1358700,11298705,13.67
9874930,9941694,1981,693350,10635044,6.97
9874931,9939926,3039,1063650,11003576,10.70
9874932,9955269,2697,943950,10899219,9.48
9874933,9942736,2438,853300,10796036,8.58
9874934,5744576,1421,497350,6241926,8.66
9874935,5973862,2625,918750,6892612,15.38
9874936,8945273,3737,1307950,10253223,14.62
9874937,9950083,2024,708400,10658483,7.12
9874938,5340740,2061,721350,6062090,13.51
9874939,9916381,2725,953750,10870131,9.62
9874940,671258,473,165550,836808,24.66
9874941,3785826,2233,781550,4567376,20.64
9874942,9911293,2032,711200,10622493,7.18
9874943,9904153,2997,1048950,10953103,10.59
9874945,9887215,2979,1042650,10929865,10.55
9874946,9903444,2967,1038450,10941894,10.49
9874947,9919181,1491,521850,10441031,5.26
9874948,9924843,2038,713300,10638143,7.19
9874949,9928272,3462,1211700,11139972,12.20
9874950,9925135,1195,418250,10343385,4.21
9874951,2246878,638,223300,2470178,9.94
9874952,9896203,2294,802900,10699103,8.11
9874953,9939656,926,324100,10263756,3.26
9874954,9951870,2682,938700,10890570,9.43
9874955,1673180,420,147000,1820180,8.79
9874956,9963703,2000,700000,10663703,7.03
9874957,2975514,1956,684600,3660114,23.01
9874958,9986602,3126,1094100,11080702,10.96
9874960,9971374,4126,1444100,11415474,14.48
9874961,9989771,3532,1236200,11225971,12.37
9874962,9991945,2316,810600,10802545,8.11
9874963,9984278,3634,1271900,11256178,12.74
9874964,3037618,803,281050,3318668,9.25
9874965,2640442,1070,374500,3014942,14.18
9874966,9978443,4011,1403850,11382293,14.07
9874967,9994853,2495,873250,10868103,8.74
9874968,56209,42,14700,70909,26.15
9874969,9982509,2406,842100,10824609,8.44
9874970,9971032,3060,1071000,11042032,10.74
9874971,9973497,1192,417200,10390697,4.18
9874972,9978923,4035,1412250,11391173,14.15
9874973,9946741,4047,1416450,11363191,14.24
9874974,9956626,2316,810600,10767226,8.14
9874975,9964702,2870,1004500,10969202,10.08
9874976,9958610,4401,1540350,11498960,15.47
9874977,9974303,2736,957600,10931903,9.60
9874978,7340131,2928,1024800,8364931,13.96
9874979,9978062,3647,1276450,11254512,12.79
9874980,9975143,4656,1629600,11604743,16.34
9874981,9980083,4321,1512350,11492433,15.15
9874982,9999791,2178,762300,10762091,7.62
9874983,9983586,1577,551950,10535536,5.53
9874984,9964813,1235,432250,10397063,4.34
9874985,1283608,1058,370300,1653908,28.85
9874986,9977258,2622,917700,10894958,9.20
9874987,9971822,754,263900,10235722,2.65
9874988,9963205,2672,935200,10898405,9.39
9874989,2366379,1077,376950,2743329,15.93
9874990,6413617,1926,674100,7087717,10.51
9874991,8258913,2963,1037050,9295963,12.56
9874992,2475915,1711,598850,3074765,24.19
9874993,4378311,2042,714700,5093011,16.32
9874994,9972740,2696,943600,10916340,9.46
9874995,9982023,2720,952000,10934023,9.54
9874996,9997963,3664,1282400,11280363,12.83
9874997,9986443,4433,1551550,11537993,15.54
9874998,5641092,1080,378000,6019092,6.70
9874999,4640476,1565,547750,5188226,11.80
9875000,9799778,3012,1054200,10853978,10.76
9875001,9979258,3475,1216250,11195508,12.19
9875002,9980681,4762,1666700,11647381,16.70
9875003,3539698,1230,430500,3970198,12.16
9875004,9957328,6102,2135700,12093028,21.45
9875005,9984650,2922,1022700,11007350,10.24
9875006,9970744,4022,1407700,11378444,14.12
9875007,3321727,2445,855750,4177477,25.76
9875008,9976491,3165,1107750,11084241,11.10
9875009,9991997,1780,623000,10614997,6.23
9875010,9987687,3647,1276450,11264137,12.78
9875011,5859198,2635,922250,6781448,15.74
9875012,9988049,3023,1058050,11046099,10.59
9875013,9986147,1199,419650,10405797,4.20
9875014,9974677,2945,1030750,11005427,10.33
9875015,5414962,2040,714000,6128962,13.19
9875016,9657190,3146,1101100,10758290,11.40
9875017,9971458,2907,1017450,10988908,10.20
9875018,9985002,3446,1206100,11191102,12.08
9875019,9990391,3826,1339100,11329491,13.40
9875020,4435483,2114,739900,5175383,16.68
9875021,9972992,4130,1445500,11418492,14.49
9875022,9975530,3726,1304100,11279630,13.07
9875023,4633016,1281,448350,5081366,9.68
9875024,301424,99,34650,336074,11.50
9875025,9980375,2833,991550,10971925,9.93
9875026,9985225,3699,1294650,11279875,12.97
9875027,9987090,2130,745500,10732590,7.46
9875028,9970168,4097,1433950,11404118,14.38
9875029,9974433,3549,1242150,11216583,12.45
9875030,9782796,2857,999950,10782746,10.22
9875031,9977202,2159,755650,10732852,7.57
9875032,9982811,2799,979650,10962461,9.81
9875033,9972743,2644,925400,10898143,9.28
9875034,9991555,4528,1584800,11576355,15.86
9875035,9998030,617,215950,10213980,2.16
9875036,9980229,2909,1018150,10998379,10.20
9875037,9980632,1371,479850,10460482,4.81
9875038,9989553,1599,559650,10549203,5.60
9875039,9979744,1638,573300,10553044,5.74
9875040,9972331,3007,1052450,11024781,10.55
9875041,9981540,1837,642950,10624490,6.44
9875042,9977832,3560,1246000,11223832,12.49
9875043,9991553,2247,786450,10778003,7.87
9875044,458921,67,23450,482371,5.11
9875045,9977664,3273,1145550,11123214,11.48
9875046,9978029,3177,1111950,11089979,11.14
9875047,2560500,1487,520450,3080950,20.33
9875048,9989386,2560,896000,10885386,8.97
9875049,9963814,2041,714350,10678164,7.17
9875050,9977028,2022,707700,10684728,7.09
9875051,9961188,1268,443800,10404988,4.46
9875052,9969694,2626,919100,10888794,9.22
9875053,9971618,3754,1313900,11285518,13.18
9875054,9974129,3987,1395450,11369579,13.99
9875055,9986761,3520,1232000,11218761,12.34
9875056,9944372,3036,1062600,11006972,10.69
9875057,9986381,1690,591500,10577881,5.92
9875058,9975278,4259,1490650,11465928,14.94
9875059,9982798,3254,1138900,11121698,11.41
9875060,9998355,1000,350000,10348355,3.50
9875061,9979843,2890,1011500,10991343,10.14
9875063,4212711,1583,554050,4766761,13.15
9875064,9985073,3931,1375850,11360923,13.78
9875066,9996783,3280,1148000,11144783,11.48
9875068,9982294,4044,1415400,11397694,14.18
9875069,1375997,499,174650,1550647,12.69
9875070,9982011,3551,1242850,11224861,12.45
9875071,4761266,1605,561750,5323016,11.80
9875072,1020325,1057,369950,1390275,36.26
9875073,9967857,2802,980700,10948557,9.84
9875074,9960716,3795,1328250,11288966,13.33
9875075,9958779,4275,1496250,11455029,15.02
9875076,9963989,4344,1520400,11484389,15.26
9875077,9964338,1708,597800,10562138,6.00
9875078,2184798,651,227850,2412648,10.43
9875079,9951536,3428,1199800,11151336,12.06
9875080,469305,183,64050,533355,13.65
9875081,9958114,2697,943950,10902064,9.48
9875082,3008254,1042,364700,3372954,12.12
9875083,9954521,3460,1211000,11165521,12.17
9875084,9958581,3600,1260000,11218581,12.65
9875085,9968871,3373,1180550,11149421,11.84
9875086,9957136,3988,1395800,11352936,14.02
9875087,547881,42,14700,562581,2.68
9875088,9942334,3211,1123850,11066184,11.30
9875089,9947277,3106,1087100,11034377,10.93
9875090,9953968,2838,993300,10947268,9.98
9875091,9927514,3298,1154300,11081814,11.63
9875092,9963254,3836,1342600,11305854,13.48
9875093,2503064,404,141400,2644464,5.65
9875094,9941656,2613,914550,10856206,9.20
9875095,9950868,2118,741300,10692168,7.45
9875096,9961245,4280,1498000,11459245,15.04
9875097,9970897,3317,1160950,11131847,11.64
9875098,144195,59,20650,164845,14.32
9875099,2125681,1101,385350,2511031,18.13
9875100,477221,253,88550,565771,18.56
9875101,3566363,991,346850,3913213,9.73
9875102,9977627,2132,746200,10723827,7.48
9875103,9988630,5788,2025800,12014430,20.28
9875104,9997787,3225,1128750,11126537,11.29
9875105,9986287,2888,1010800,10997087,10.12
9875106,827738,350,122500,950238,14.80
9875107,3258043,1567,548450,3806493,16.83
9875108,9938883,3440,1204000,11142883,12.11
9875109,9950421,7043,2465050,12415471,24.77
9875110,9975290,4264,1492400,11467690,14.96
9875111,9979837,2647,926450,10906287,9.28
9875112,9957705,3073,1075550,11033255,10.80
9875113,9974684,2985,1044750,11019434,10.47
9875114,9994249,2898,1014300,11008549,10.15
9875115,359719,232,81200,440919,22.57
9875116,9965075,2729,955150,10920225,9.58
9875117,9967899,3226,1129100,11096999,11.33
9875118,9966306,2984,1044400,11010706,10.48
9875119,9974929,2587,905450,10880379,9.08
9875120,3062490,1479,517650,3580140,16.90
9875121,9964448,3484,1219400,11183848,12.24
9875122,9970154,4526,1584100,11554254,15.89
9875123,1908322,1000,350000,2258322,18.34
9875124,3811324,1357,474950,4286274,12.46
9875125,9979827,3251,1137850,11117677,11.40
9875126,9999101,3769,1319150,11318251,13.19
9875127,946770,424,148400,1095170,15.67
9875128,1412611,544,190400,1603011,13.48
9875129,9985844,3423,1198050,11183894,12.00
9875130,9984225,2731,955850,10940075,9.57
9875131,9997261,2800,980000,10977261,9.80
9875132,9986836,2498,874300,10861136,8.75
9875133,9987114,3393,1187550,11174664,11.89
9875134,9980105,2656,929600,10909705,9.31
9875135,2848444,1688,590800,3439244,20.74
9875136,9982839,4160,1456000,11438839,14.59
9875137,9968500,2958,1035300,11003800,10.39
9875138,1326607,621,217350,1543957,16.38
9875139,9984063,4627,1619450,11603513,16.22
9875140,9991092,1219,426650,10417742,4.27
9875141,2754924,944,330400,3085324,11.99
9875142,9970704,4539,1588650,11559354,15.93
9875143,9976470,2828,989800,10966270,9.92
9875144,179090,96,33600,212690,18.76
9875145,9953249,3429,1200150,11153399,12.06
9875146,3923518,673,235550,4159068,6.00
9875147,9972097,2433,851550,10823647,8.54
9875148,9954190,2653,928550,10882740,9.33
9875149,4013579,1431,500850,4514429,12.48
9875150,9952282,3799,1329650,11281932,13.36
9875151,9475708,3373,1180550,10656258,12.46
9875152,9884317,2880,1008000,10892317,10.20
9875154,9956142,4072,1425200,11381342,14.31
9875155,9978486,5922,2072700,12051186,20.77
9875156,9946594,8974,3140900,13087494,31.58
9875157,9922373,3141,1099350,11021723,11.08
9875158,9977374,4431,1550850,11528224,15.54
9875159,9982196,3467,1213450,11195646,12.16
9875160,9977206,2755,964250,10941456,9.66
9875161,9986101,2620,917000,10903101,9.18
9875162,467513,234,81900,549413,17.52
9875163,3362617,896,313600,3676217,9.33
9875164,3432901,1899,664650,4097551,19.36
9875165,9942127,4102,1435700,11377827,14.44
9875166,9952747,3653,1278550,11231297,12.85
9875167,218727,89,31150,249877,14.24
9875168,9949459,4862,1701700,11651159,17.10
9875169,9959800,3097,1083950,11043750,10.88
9875170,9979729,1945,680750,10660479,6.82
9875171,9958246,2566,898100,10856346,9.02
9875172,806720,264,92400,899120,11.45
9875173,9944967,4457,1559950,11504917,15.69
9875174,9958118,3301,1155350,11113468,11.60
9875175,9956990,4661,1631350,11588340,16.38
9875176,472668,199,69650,542318,14.74
9875177,4306078,1238,433300,4739378,10.06
9875178,9952896,4973,1740550,11693446,17.49
9875179,9946827,5127,1794450,11741277,18.04
9875180,9961939,2870,1004500,10966439,10.08
9875181,9969590,4254,1488900,11458490,14.93
9875182,9963469,3321,1162350,11125819,11.67
9875183,9981983,1676,586600,10568583,5.88
9875184,9982424,5014,1754900,11737324,17.58
9875185,9960563,3217,1125950,11086513,11.30
9875186,893022,175,61250,954272,6.86
9875187,9984194,2879,1007650,10991844,10.09
9875188,9974821,1376,481600,10456421,4.83
9875189,9999850,1289,451150,10451000,4.51
9875190,9982572,2014,704900,10687472,7.06
9875191,9980183,3508,1227800,11207983,12.30
9875192,9982202,4618,1616300,11598502,16.19
9875193,1471204,494,172900,1644104,11.75
9875194,9994833,3528,1234800,11229633,12.35
9875195,9991544,3185,1114750,11106294,11.16
9875196,9983785,3650,1277500,11261285,12.80
9875197,9936581,1549,542150,10478731,5.46
9875198,9981681,4230,1480500,11462181,14.83
9875199,9980291,1598,559300,10539591,5.60
9875200,9986898,1979,692650,10679548,6.94
9875201,9982279,2556,894600,10876879,8.96
9875202,9990177,2639,923650,10913827,9.25
9875203,9987777,2880,1008000,10995777,10.09
9875204,9992026,2268,793800,10785826,7.94
9875205,9969389,2968,1038800,11008189,10.42
9875206,9991652,4725,1653750,11645402,16.55
9875208,9982704,1884,659400,10642104,6.61
9875209,9969720,2808,982800,10952520,9.86
9875210,9998452,1861,651350,10649802,6.51
9875211,9976102,2441,854350,10830452,8.56
9875212,9969459,3639,1273650,11243109,12.78
9875213,9953745,3593,1257550,11211295,12.63
9875214,9966264,3401,1190350,11156614,11.94
9875215,9945492,1299,454650,10400142,4.57
9875216,9929178,2256,789600,10718778,7.95
9875217,4109167,881,308350,4417517,7.50
9875218,9979965,2208,772800,10752765,7.74
9875219,9979230,3047,1066450,11045680,10.69
9875220,9984078,5479,1917650,11901728,19.21
9875221,9971885,4835,1692250,11664135,16.97
9875222,2686813,836,292600,2979413,10.89
9875223,9981946,2917,1020950,11002896,10.23
9875224,9978591,2756,964600,10943191,9.67
9875225,8871960,1192,417200,9289160,4.70
9875226,9970976,1738,608300,10579276,6.10
9875227,9990342,3408,1192800,11183142,11.94
9875228,9988549,3505,1226750,11215299,12.28
9875229,9991718,5631,1970850,11962568,19.72
9875230,9998783,2821,987350,10986133,9.87
9875231,9985133,3686,1290100,11275233,12.92
9875232,9993936,4214,1474900,11468836,14.76
9875233,9997077,3434,1201900,11198977,12.02
9875234,9988938,4161,1456350,11445288,14.58
9875235,9980300,3684,1289400,11269700,12.92
9875236,9975864,3009,1053150,11029014,10.56
9875237,1136474,289,101150,1237624,8.90
9875238,1408827,465,162750,1571577,11.55
9875239,9949919,4019,1406650,11356569,14.14
9875240,9959731,3577,1251950,11211681,12.57
9875241,9970804,3044,1065400,11036204,10.69
9875242,9977249,4301,1505350,11482599,15.09
9875243,9990129,5573,1950550,11940679,19.52
9875244,9980471,4217,1475950,11456421,14.79
9875245,9998210,2304,806400,10804610,8.07
9875246,9990713,3169,1109150,11099863,11.10
9875247,9998111,3234,1131900,11130011,11.32
9875248,8903468,3533,1236550,10140018,13.89
9875249,9986605,3237,1132950,11119555,11.34
9875250,3425586,959,335650,3761236,9.80
9875251,9977483,2900,1015000,10992483,10.17
9875252,9991945,3595,1258250,11250195,12.59
9875253,9989840,2441,854350,10844190,8.55
9875254,9587638,4288,1500800,11088438,15.65
9875255,9991973,2522,882700,10874673,8.83
9875256,2580810,728,254800,2835610,9.87
9875257,9961401,3685,1289750,11251151,12.95
9875258,9970068,4809,1683150,11653218,16.88
9875259,9962780,2314,809900,10772680,8.13
9875260,9980210,2726,954100,10934310,9.56
9875261,429042,306,107100,536142,24.96
9875262,9995179,3351,1172850,11168029,11.73
9875263,1162270,504,176400,1338670,15.18
9875264,9965263,2509,878150,10843413,8.81
9875265,9983434,2157,754950,10738384,7.56
9875266,9982406,2627,919450,10901856,9.21
9875267,9982072,4330,1515500,11497572,15.18
9875268,9988611,4987,1745450,11734061,17.47
9875269,9976354,4375,1531250,11507604,15.35
9875270,9986695,2698,944300,10930995,9.46
9875271,9971686,2736,957600,10929286,9.60
9875272,1431831,628,219800,1651631,15.35
9875273,9973939,4249,1487150,11461089,14.91
9875274,9979194,2687,940450,10919644,9.42
9875275,8989903,3663,1282050,10271953,14.26
9875276,3765848,1658,580300,4346148,15.41
9875277,9960039,3744,1310400,11270439,13.16
9875278,560682,252,88200,648882,15.73
9875279,9981654,4328,1514800,11496454,15.18
9875280,9989739,2707,947450,10937189,9.48
9875281,3545523,1415,495250,4040773,13.97
9875282,5681774,3097,1083950,6765724,19.08
9875283,9962035,4137,1447950,11409985,14.53
9875284,9958153,3779,1322650,11280803,13.28
9875285,9965685,3614,1264900,11230585,12.69
9875286,9980759,3420,1197000,11177759,11.99
9875287,9970849,5704,1996400,11967249,20.02
9875288,9977300,3400,1190000,11167300,11.93
9875289,9991189,3333,1166550,11157739,11.68
9875290,9968300,5113,1789550,11757850,17.95
9875291,9979518,3280,1148000,11127518,11.50
9875292,9994206,4208,1472800,11467006,14.74
9875294,9992028,4389,1536150,11528178,15.37
9875295,9970781,5289,1851150,11821931,18.57
9875296,182810,112,39200,222010,21.44
9875297,9947801,4457,1559950,11507751,15.68
9875298,9602129,2603,911050,10513179,9.49
9875299,9961259,2592,907200,10868459,9.11
9875300,9954741,2393,837550,10792291,8.41
9875301,9048048,1784,624400,9672448,6.90
9875302,9970377,3234,1131900,11102277,11.35
9875303,9953486,3124,1093400,11046886,10.99
9875304,9962159,3023,1058050,11020209,10.62
9875305,3791730,1468,513800,4305530,13.55
9875306,9979630,4262,1491700,11471330,14.95
9875308,9775669,3012,1054200,10829869,10.78
9875309,9981371,4347,1521450,11502821,15.24
9875310,9994821,4596,1608600,11603421,16.09
9875311,9988271,3019,1056650,11044921,10.58
9875312,9979458,3564,1247400,11226858,12.50
9875313,1641683,894,312900,1954583,19.06
9875314,9980582,4937,1727950,11708532,17.31
9875315,9980466,3230,1130500,11110966,11.33
9875316,9994763,2383,834050,10828813,8.34
9875317,9998612,2308,807800,10806412,8.08
9875318,9984125,3195,1118250,11102375,11.20
9875319,9985308,2390,836500,10821808,8.38
9875320,9993168,5811,2033850,12027018,20.35
9875321,9997138,2149,752150,10749288,7.52
9875322,900340,443,155050,1055390,17.22
9875323,9960950,3984,1394400,11355350,14.00
9875324,9973554,3260,1141000,11114554,11.44
9875325,9974672,3188,1115800,11090472,11.19
9875326,8256575,3324,1163400,9419975,14.09
9875327,1634707,1085,379750,2014457,23.23
9875328,9987440,2744,960400,10947840,9.62
9875329,9974086,2173,760550,10734636,7.63
9875330,9961298,2456,859600,10820898,8.63
9875331,9963747,3075,1076250,11039997,10.80
9875332,9957854,2543,890050,10847904,8.94
9875333,9974809,3129,1095150,11069959,10.98
9875334,9980351,3940,1379000,11359351,13.82
9875335,9976495,4174,1460900,11437395,14.64
9875336,9983898,3683,1289050,11272948,12.91
9875337,9980312,5337,1867950,11848262,18.72
9875338,258295,85,29750,288045,11.52
9875339,6153717,3352,1173200,7326917,19.06
9875340,9975799,3264,1142400,11118199,11.45
9875341,9965541,5220,1827000,11792541,18.33
9875342,9974265,3547,1241450,11215715,12.45
9875343,9974528,6106,2137100,12111628,21.43
9875344,9985429,2874,1005900,10991329,10.07
9875345,623699,153,53550,677249,8.59
9875346,9975855,3114,1089900,11065755,10.93
9875347,9971423,5323,1863050,11834473,18.68
9875348,162484,98,34300,196784,21.11
9875349,2934321,1099,384650,3318971,13.11
9875350,4445938,1316,460600,4906538,10.36
9875351,9920871,5240,1834000,11754871,18.49
9875352,5762106,1145,400750,6162856,6.95
9875353,9947632,2534,886900,10834532,8.92
9875354,9956678,4794,1677900,11634578,16.85
9875355,420349,144,50400,470749,11.99
9875356,9953748,3533,1236550,11190298,12.42
9875357,9957808,3050,1067500,11025308,10.72
9875358,9963348,3758,1315300,11278648,13.20
9875359,9975750,4390,1536500,11512250,15.40
9875360,9964505,3482,1218700,11183205,12.23
9875361,5971875,3706,1297100,7268975,21.72
9875362,2710190,1178,412300,3122490,15.21
9875363,9962629,5174,1810900,11773529,18.18
9875364,9963083,3477,1216950,11180033,12.21
9875365,9981098,4408,1542800,11523898,15.46
9875366,5845655,1159,405650,6251305,6.94
9875367,9995477,4820,1687000,11682477,16.88
9875368,9990083,5494,1922900,11912983,19.25
9875369,9990972,6343,2220050,12211022,22.22
9875370,9976393,5574,1950900,11927293,19.56
9875371,9982318,4314,1509900,11492218,15.13
9875373,9969627,4097,1433950,11403577,14.38
9875374,9141053,1841,644350,9785403,7.05
9875375,9950239,5887,2060450,12010689,20.71
9875376,9949402,3960,1386000,11335402,13.93
9875377,7844606,4262,1491700,9336306,19.02
9875378,9888294,6277,2196950,12085244,22.22
9875379,9983299,3452,1208200,11191499,12.10
9875380,9982870,3865,1352750,11335620,13.55
9875381,7298975,4237,1482950,8781925,20.32
9875382,9944557,4281,1498350,11442907,15.07
9875383,9970584,6121,2142350,12112934,21.49
9875384,9970507,3777,1321950,11292457,13.26
9875385,9975456,4891,1711850,11687306,17.16
9875386,9966987,7363,2577050,12544037,25.86
9875387,9376528,4463,1562050,10938578,16.66
9875388,9980506,5019,1756650,11737156,17.60
9875389,9985828,4163,1457050,11442878,14.59
9875390,9996932,7358,2575300,12572232,25.76
9875391,9983178,5114,1789900,11773078,17.93
9875392,914143,1162,406700,1320843,44.49
9875393,9987451,2829,990150,10977601,9.91
9875394,9989684,2471,864850,10854534,8.66
9875395,1572008,573,200550,1772558,12.76
9875396,9986788,3473,1215550,11202338,12.17
9875397,9987899,2291,801850,10789749,8.03
9875398,9983510,2793,977550,10961060,9.79
9875399,9982326,2266,793100,10775426,7.95
9875400,719457,243,85050,804507,11.82
9875401,9972955,4174,1460900,11433855,14.65
9875402,9993721,1606,562100,10555821,5.62
9875403,9996104,2496,873600,10869704,8.74
9875404,1465389,528,184800,1650189,12.61
9875405,9812010,1827,639450,10451460,6.52
9875406,9900226,2144,750400,10650626,7.58
9875407,9968973,2271,794850,10763823,7.97
9875408,9966015,3904,1366400,11332415,13.71
9875409,9972080,2549,892150,10864230,8.95
9875410,9995471,6311,2208850,12204321,22.10
9875411,9850693,870,304500,10155193,3.09
9875412,9971543,2967,1038450,11009993,10.41
9875413,5832160,824,288400,6120560,4.94
9875414,9988172,2992,1047200,11035372,10.48
9875415,9989333,5186,1815100,11804433,18.17
9875416,9989362,2768,968800,10958162,9.70
9875417,9988429,2461,861350,10849779,8.62
9875418,9989024,4033,1411550,11400574,14.13
9875419,9976251,3645,1275750,11252001,12.79
9875421,9970492,3929,1375150,11345642,13.79
9875422,9981681,2525,883750,10865431,8.85
9875423,9996794,5187,1815450,11812244,18.16
9875424,9973420,5557,1944950,11918370,19.50
9875425,9990288,3300,1155000,11145288,11.56
9875426,9990623,5833,2041550,12032173,20.43
9875427,9978350,3299,1154650,11133000,11.57
9875428,9978736,5819,2036650,12015386,20.41
9875429,9994901,2353,823550,10818451,8.24
9875430,9996430,3431,1200850,11197280,12.01
9875431,9980833,1875,656250,10637083,6.58
9875432,9990996,1855,649250,10640246,6.50
9875433,9983794,4570,1599500,11583294,16.02
9875434,9975261,3836,1342600,11317861,13.46
9875435,9986049,1947,681450,10667499,6.82
9875436,9989764,2420,847000,10836764,8.48
9875437,9979342,1788,625800,10605142,6.27
9875438,2159143,1051,367850,2526993,17.04
9875439,9976162,2727,954450,10930612,9.57
9875440,638778,217,75950,714728,11.89
9875441,5576661,1320,462000,6038661,8.28
9875442,9984261,3021,1057350,11041611,10.59
9875443,463249,173,60550,523799,13.07
9875444,9998812,2952,1033200,11032012,10.33
9875445,1368225,599,209650,1577875,15.32
9875446,9977288,3341,1169350,11146638,11.72
9875448,9967557,1384,484400,10451957,4.86
9875449,9994561,5377,1881950,11876511,18.83
9875450,9994904,4788,1675800,11670704,16.77
9875451,6042288,1676,586600,6628888,9.71
9875452,3324359,1001,350350,3674709,10.54
9875453,9986612,2390,836500,10823112,8.38
9875454,7496977,903,316050,7813027,4.22
9875455,9992140,2678,937300,10929440,9.38
9875456,9974104,3384,1184400,11158504,11.87
9875457,9992149,2881,1008350,11000499,10.09
9875458,7776781,1866,653100,8429881,8.40
9875459,9995128,3464,1212400,11207528,12.13
9875460,9998864,1641,574350,10573214,5.74
9875461,9996799,2331,815850,10812649,8.16
9875462,8822643,2304,806400,9629043,9.14
9875463,9973151,3235,1132250,11105401,11.35
9875464,9972017,4897,1713950,11685967,17.19
9875466,9958668,3105,1086750,11045418,10.91
9875467,426256,99,34650,460906,8.13
9875468,9947194,2256,789600,10736794,7.94
9875469,2046804,338,118300,2165104,5.78
9875470,5069562,1699,594650,5664212,11.73
9875471,9924024,3187,1115450,11039474,11.24
9875473,9929245,3662,1281700,11210945,12.91
9875474,9924267,3461,1211350,11135617,12.21
9875475,9930777,3306,1157100,11087877,11.65
9875476,9953057,3120,1092000,11045057,10.97
9875477,4070831,1281,448350,4519181,11.01
9875478,9922747,2087,730450,10653197,7.36
9875479,9927303,3006,1052100,10979403,10.60
9875480,8940265,2852,998200,9938465,11.17
9875481,8957734,2865,1002750,9960484,11.19
9875482,9957158,2625,918750,10875908,9.23
9875483,9939527,4598,1609300,11548827,16.19
9875484,9944619,2276,796600,10741219,8.01
9875485,9934988,3460,1211000,11145988,12.19
9875486,9941474,2720,952000,10893474,9.58
9875487,962358,397,138950,1101308,14.44
9875488,9930084,4335,1517250,11447334,15.28
9875489,9937761,2036,712600,10650361,7.17
9875490,9941732,1337,467950,10409682,4.71
9875491,9935348,2329,815150,10750498,8.20
9875492,9952347,3698,1294300,11246647,13.00
9875493,2646544,776,271600,2918144,10.26
9875494,9941745,1479,517650,10459395,5.21
9875495,9947759,1561,546350,10494109,5.49
9875496,6176070,1334,466900,6642970,7.56
9875497,9961062,1957,684950,10646012,6.88
9875498,833797,278,97300,931097,11.67
9875499,9939104,2456,859600,10798704,8.65
9875500,1309029,532,186200,1495229,14.22
9875501,9936997,4413,1544550,11481547,15.54
9875502,9952955,4052,1418200,11371155,14.25
9875503,5078583,872,305200,5383783,6.01
9875504,346696,93,32550,379246,9.39
9875505,9950918,3087,1080450,11031368,10.86
9875506,9942223,2337,817950,10760173,8.23
9875507,9975471,3853,1348550,11324021,13.52
9875508,9976921,3133,1096550,11073471,10.99
9875509,9976985,3469,1214150,11191135,12.17
9875510,9995396,2439,853650,10849046,8.54
9875511,7024012,2056,719600,7743612,10.24
9875512,9973065,4280,1498000,11471065,15.02
9875513,9989827,3503,1226050,11215877,12.27
9875514,9986748,2183,764050,10750798,7.65
9875515,9990274,2740,959000,10949274,9.60
9875516,9973595,2921,1022350,10995945,10.25
9875517,9983002,3489,1221150,11204152,12.23
9875518,9970187,3532,1236200,11206387,12.40
9875519,9972670,2801,980350,10953020,9.83
9875521,9973667,1546,541100,10514767,5.43
9875522,9976919,4003,1401050,11377969,14.04
9875523,9976236,5034,1761900,11738136,17.66
9875524,9947404,4515,1580250,11527654,15.89
9875525,9994888,4293,1502550,11497438,15.03
9875526,7358060,1589,556150,7914210,7.56
9875527,9991227,4031,1410850,11402077,14.12
9875528,9984843,2497,873950,10858793,8.75
9875529,9965620,2977,1041950,11007570,10.46
9875530,9974559,3999,1399650,11374209,14.03
9875531,9964025,2255,789250,10753275,7.92
9875532,9976473,3129,1095150,11071623,10.98
9875533,9967308,3180,1113000,11080308,11.17
9875534,9975567,3033,1061550,11037117,10.64
9875535,9982274,3038,1063300,11045574,10.65
9875536,9981584,2965,1037750,11019334,10.40
9875537,9974882,3930,1375500,11350382,13.79
9875538,9988033,2568,898800,10886833,9.00
9875539,9980577,2791,976850,10957427,9.79
9875540,9986277,5611,1963850,11950127,19.67
9875541,9997092,4127,1444450,11441542,14.45
9875542,9980385,2238,783300,10763685,7.85
9875543,9980024,3102,1085700,11065724,10.88
9875544,9972143,2190,766500,10738643,7.69
9875545,8581560,1661,581350,9162910,6.77
9875546,9975104,2605,911750,10886854,9.14
9875547,9968112,3646,1276100,11244212,12.80
9875548,9949974,3535,1237250,11187224,12.43
9875550,9998644,1979,692650,10691294,6.93
9875551,9978025,3888,1360800,11338825,13.64
9875552,9991937,2734,956900,10948837,9.58
9875553,9981419,2736,957600,10939019,9.59
9875554,9975124,1495,523250,10498374,5.25
9875555,9965540,3427,1199450,11164990,12.04
9875556,9981462,2264,792400,10773862,7.94
9875557,9989418,3579,1252650,11242068,12.54
9875558,9983355,4099,1434650,11418005,14.37
9875559,9994720,3357,1174950,11169670,11.76
9875560,9979118,5445,1905750,11884868,19.10
9875561,9970828,4766,1668100,11638928,16.73
9875562,9972242,3127,1094450,11066692,10.97
9875563,9018485,941,329350,9347835,3.65
9875564,9322787,2016,705600,10028387,7.57
9875565,8577391,2841,994350,9571741,11.59
9875566,9974929,3618,1266300,11241229,12.69
9875567,5917205,1799,629650,6546855,10.64
9875568,9971384,4784,1674400,11645784,16.79
9875569,9971414,2171,759850,10731264,7.62
9875570,9975047,2422,847700,10822747,8.50
9875571,9959964,3842,1344700,11304664,13.50
9875572,2224672,1479,517650,2742322,23.27
9875573,9957536,685,239750,10197286,2.41
9875574,9966975,1465,512750,10479725,5.14
9875575,9961009,3960,1386000,11347009,13.91
9875576,9908063,2692,942200,10850263,9.51
9875577,9971870,3252,1138200,11110070,11.41
9875578,9955322,3719,1301650,11256972,13.07
9875579,9980113,3905,1366750,11346863,13.69
9875580,9975941,3127,1094450,11070391,10.97
9875581,9989696,2191,766850,10756546,7.68
9875582,9965121,3173,1110550,11075671,11.14
9875583,9968185,3539,1238650,11206835,12.43
9875584,9943208,3672,1285200,11228408,12.93
9875585,9970887,3291,1151850,11122737,11.55
9875586,9979968,1963,687050,10667018,6.88
9875587,9999653,4506,1577100,11576753,15.77
9875588,3092950,796,278600,3371550,9.01
9875589,9980130,3399,1189650,11169780,11.92
9875590,9974965,2214,774900,10749865,7.77
9875591,9984878,3070,1074500,11059378,10.76
9875592,9988420,2285,799750,10788170,8.01
9875593,9971415,1646,576100,10547515,5.78
9875594,9974849,4434,1551900,11526749,15.56
9875595,9959572,1402,490700,10450272,4.93
9875597,9966977,2690,941500,10908477,9.45
9875598,9969682,3333,1166550,11136232,11.70
9875599,9981053,1804,631400,10612453,6.33
9875600,9978526,3569,1249150,11227676,12.52
9875601,9991615,1968,688800,10680415,6.89
9875602,9986082,1543,540050,10526132,5.41
9875603,1010194,272,95200,1105394,9.42
9875604,9982185,2270,794500,10776685,7.96
9875605,5645604,1843,645050,6290654,11.43
9875606,9967475,5483,1919050,11886525,19.25
9875607,9997496,2295,803250,10800746,8.03
9875608,9998909,2233,781550,10780459,7.82
9875609,9996825,3604,1261400,11258225,12.62
9875610,9945984,2999,1049650,10995634,10.55
9875611,1221261,234,81900,1303161,6.71
9875612,9992915,2696,943600,10936515,9.44
9875613,9961462,2571,899850,10861312,9.03
9875614,9983514,2957,1034950,11018464,10.37
9875615,9978134,2751,962850,10940984,9.65
9875616,9951043,1772,620200,10571243,6.23
9875617,9958882,3136,1097600,11056482,11.02
9875618,9978571,3487,1220450,11199021,12.23
9875619,9676701,2047,716450,10393151,7.40
9875620,9972239,1296,453600,10425839,4.55
9875621,9967960,3258,1140300,11108260,11.44
9875622,9985270,4262,1491700,11476970,14.94
9875623,1419261,736,257600,1676861,18.15
9875624,9967062,5622,1967700,11934762,19.74
9875625,9969458,4188,1465800,11435258,14.70
9875626,9468247,2741,959350,10427597,10.13
9875627,9976427,4719,1651650,11628077,16.56
9875628,9972656,2769,969150,10941806,9.72
9875629,9985111,3149,1102150,11087261,11.04
9875630,2320048,1638,573300,2893348,24.71
9875631,9996169,3970,1389500,11385669,13.90
9875632,9986582,3814,1334900,11321482,13.37
9875633,9984644,2564,897400,10882044,8.99
9875634,9993333,1944,680400,10673733,6.81
9875635,9984305,4018,1406300,11390605,14.09
9875636,9994095,1955,684250,10678345,6.85
9875637,9979932,4651,1627850,11607782,16.31
9875638,9989546,1955,684250,10673796,6.85
9875639,9999942,3820,1337000,11336942,13.37
9875640,9983553,2599,909650,10893203,9.11
9875642,9969238,3335,1167250,11136488,11.71
9875643,9980674,4647,1626450,11607124,16.30
9875644,9967657,4040,1414000,11381657,14.19
9875645,9963062,4997,1748950,11712012,17.55
9875646,9955804,3672,1285200,11241004,12.91
9875647,9964634,2348,821800,10786434,8.25
9875648,9988782,1600,560000,10548782,5.61
9875649,9986016,4329,1515150,11501166,15.17
9875650,9986208,1917,670950,10657158,6.72
9875651,9970176,3684,1289400,11259576,12.93
9875652,9974830,3400,1190000,11164830,11.93
9875653,9984213,5368,1878800,11863013,18.82
9875654,3362044,1335,467250,3829294,13.90
9875655,9990990,4590,1606500,11597490,16.08
9875657,9973940,3282,1148700,11122640,11.52
9875658,9982118,2894,1012900,10995018,10.15
9875659,9997233,6084,2129400,12126633,21.30
9875660,9989338,3211,1123850,11113188,11.25
9875661,9990184,2089,731150,10721334,7.32
9875662,9987562,2291,801850,10789412,8.03
9875663,9998449,3104,1086400,11084849,10.87
9875664,9987645,3990,1396500,11384145,13.98
9875665,9972453,4819,1686650,11659103,16.91
9875666,9983005,2811,983850,10966855,9.86
9875667,9997883,4480,1568000,11565883,15.68
9875668,9972415,2011,703850,10676265,7.06
9875669,9997942,3348,1171800,11169742,11.72
9875670,9638011,4178,1462300,11100311,15.17
9875671,3392385,1321,462350,3854735,13.63
9875672,7119984,1030,360500,7480484,5.06
9875673,9971007,2668,933800,10904807,9.37
9875674,9952985,2413,844550,10797535,8.49
9875675,9945855,1925,673750,10619605,6.77
9875676,9957150,4725,1653750,11610900,16.61
9875677,9965429,3128,1094800,11060229,10.99
9875679,9986952,4378,1532300,11519252,15.34
9875680,9902980,4797,1678950,11581930,16.95
9875681,8413887,3433,1201550,9615437,14.28
9875682,9987976,2919,1021650,11009626,10.23
9875683,9978002,3295,1153250,11131252,11.56
9875684,3488652,1646,576100,4064752,16.51
9875685,9979160,1867,653450,10632610,6.55
9875686,9985651,2204,771400,10757051,7.73
9875687,9984651,3002,1050700,11035351,10.52
9875689,9961919,3958,1385300,11347219,13.91
9875690,9971892,3495,1223250,11195142,12.27
9875691,8970642,5355,1874250,10844892,20.89
9875692,9978885,3571,1249850,11228735,12.52
9875693,9981404,3617,1265950,11247354,12.68
9875694,9995215,4498,1574300,11569515,15.75
9875695,2930505,1023,358050,3288555,12.22
9875696,9980891,4152,1453200,11434091,14.56
9875697,9965325,1662,581700,10547025,5.84
9875698,9990634,2782,973700,10964334,9.75
9875699,9979780,2014,704900,10684680,7.06
9875700,9969377,2911,1018850,10988227,10.22
9875701,9986701,3496,1223600,11210301,12.25
9875703,9996971,4461,1561350,11558321,15.62
9875704,1186990,639,223650,1410640,18.84
9875705,9968858,4289,1501150,11470008,15.06
9875706,9985088,2866,1003100,10988188,10.05
9875707,9973828,4204,1471400,11445228,14.75
9875708,9970212,5770,2019500,11989712,20.26
9875709,9960065,3526,1234100,11194165,12.39
9875710,9931609,3311,1158850,11090459,11.67
9875711,9939422,2633,921550,10860972,9.27
9875712,9932085,1322,462700,10394785,4.66
9875713,9928234,3518,1231300,11159534,12.40
9875714,9939276,2723,953050,10892326,9.59
9875715,9925887,3537,1237950,11163837,12.47
9875716,9795454,5074,1775900,11571354,18.13
9875717,9943720,3796,1328600,11272320,13.36
9875718,9944913,2031,710850,10655763,7.15
9875719,9927351,4405,1541750,11469101,15.53
9875720,9944849,2713,949550,10894399,9.55
9875721,9937106,2851,997850,10934956,10.04
9875722,9961762,2864,1002400,10964162,10.06
9875723,9960991,5430,1900500,11861491,19.08
9875724,9963264,1922,672700,10635964,6.75
9875725,9945728,2082,728700,10674428,7.33
9875726,9972443,2561,896350,10868793,8.99
9875727,9973731,3576,1251600,11225331,12.55
9875728,9979380,2847,996450,10975830,9.99
9875729,9984277,2311,808850,10793127,8.10
9875730,9969232,1620,567000,10536232,5.69
9875731,9637393,4158,1455300,11092693,15.10
9875732,9988737,2374,830900,10819637,8.32
9875733,9968777,3168,1108800,11077577,11.12
9875734,9952871,3713,1299550,11252421,13.06
9875735,9973571,2256,789600,10763171,7.92
9875736,9968530,3696,1293600,11262130,12.98
9875737,9970383,2522,882700,10853083,8.85
9875738,9973224,2624,918400,10891624,9.21
9875740,9958955,3023,1058050,11017005,10.62
9875742,9979083,2130,745500,10724583,7.47
9875743,9981159,3919,1371650,11352809,13.74
9875744,9987935,3531,1235850,11223785,12.37
9875745,9975622,3446,1206100,11181722,12.09
9875746,9963636,2824,988400,10952036,9.92
9875747,9978345,2673,935550,10913895,9.38
9875748,9984450,2864,1002400,10986850,10.04
9875749,9987168,2200,770000,10757168,7.71
9875750,9975801,3035,1062250,11038051,10.65
9875751,9986793,5256,1839600,11826393,18.42
9875752,9996506,2015,705250,10701756,7.05
9875753,9972658,2837,992950,10965608,9.96
9875754,9986189,2723,953050,10939239,9.54
9875755,4036976,1855,649250,4686226,16.08
9875756,9980869,3402,1190700,11171569,11.93
9875758,9940589,4874,1705900,11646489,17.16
9875759,9950887,3465,1212750,11163637,12.19
9875760,9971465,2478,867300,10838765,8.70
9875761,9970817,2395,838250,10809067,8.41
9875762,3806801,984,344400,4151201,9.05
9875763,9981128,2961,1036350,11017478,10.38
9875764,9975273,3561,1246350,11221623,12.49
9875765,9979834,1385,484750,10464584,4.86
9875766,9981905,2774,970900,10952805,9.73
9875767,9978029,2038,713300,10691329,7.15
9875768,9967078,2558,895300,10862378,8.98
9875769,9980390,2099,734650,10715040,7.36
9875770,9922412,3682,1288700,11211112,12.99
9875771,9924547,2760,966000,10890547,9.73
9875772,9922943,2201,770350,10693293,7.76
9875773,9986348,3283,1149050,11135398,11.51
9875774,9990961,4134,1446900,11437861,14.48
9875775,6498686,2571,899850,7398536,13.85
9875776,9992843,4765,1667750,11660593,16.69
9875777,9991770,4923,1723050,11714820,17.24
9875778,9983583,3763,1317050,11300633,13.19
9875779,9986098,2471,864850,10850948,8.66
9875780,9924896,2394,837900,10762796,8.44
9875781,9902703,2786,975100,10877803,9.85
9875782,9687320,2008,702800,10390120,7.25
9875783,9964048,1552,543200,10507248,5.45
9875784,9961888,2236,782600,10744488,7.86
9875785,9964970,2458,860300,10825270,8.63
9875786,9969646,3490,1221500,11191146,12.25
9875787,9970688,2228,779800,10750488,7.82
9875788,9994543,2758,965300,10959843,9.66
9875789,9974826,3308,1157800,11132626,11.61
9875790,9979838,2481,868350,10848188,8.70
9875791,9994962,5238,1833300,11828262,18.34
9875792,346194,42,14700,360894,4.25
9875793,9962511,3314,1159900,11122411,11.64
9875794,9978195,4220,1477000,11455195,14.80
9875795,9963268,3609,1263150,11226418,12.68
9875796,9960933,2139,748650,10709583,7.52
9875797,9882766,4791,1676850,11559616,16.97
9875798,9989204,2059,720650,10709854,7.21
9875799,9991933,3721,1302350,11294283,13.03
9875800,9968233,1324,463400,10431633,4.65
9875801,9985883,2653,928550,10914433,9.30
9875802,9978236,5729,2005150,11983386,20.10
9875803,8639235,1878,657300,9296535,7.61
9875804,9966189,2481,868350,10834539,8.71
9875805,9963295,2996,1048600,11011895,10.52
9875806,9970373,3314,1159900,11130273,11.63
9875807,9982448,2938,1028300,11010748,10.30
9875808,9970242,4746,1661100,11631342,16.66
9875809,9987517,4159,1455650,11443167,14.57
9875811,9986465,1827,639450,10625915,6.40
9875812,9999425,2246,786100,10785525,7.86
9875813,9977174,2967,1038450,11015624,10.41
9875814,6900067,3311,1158850,8058917,16.79
9875815,9979899,2831,990850,10970749,9.93
9875816,9970108,2925,1023750,10993858,10.27
9875817,9982756,2869,1004150,10986906,10.06
9875818,9985594,3896,1363600,11349194,13.66
9875819,9986297,4446,1556100,11542397,15.58
9875820,9966904,2380,833000,10799904,8.36
9875821,9974659,3113,1089550,11064209,10.92
9875822,9987922,4930,1725500,11713422,17.28
9875823,9984488,2771,969850,10954338,9.71
9875824,9984466,2905,1016750,11001216,10.18
9875825,9976802,1932,676200,10653002,6.78
9875826,9980920,3005,1051750,11032670,10.54
9875827,9986193,3041,1064350,11050543,10.66
9875828,9975174,4443,1555050,11530224,15.59
9875829,9971649,4434,1551900,11523549,15.56
9875830,9567940,5059,1770650,11338590,18.51
9875831,9989761,3914,1369900,11359661,13.71
9875832,9997121,3986,1395100,11392221,13.96
9875833,9994449,3022,1057700,11052149,10.58
9875834,9997174,4717,1650950,11648124,16.51
9875835,9990630,2858,1000300,10990930,10.01
9875836,9981851,3258,1140300,11122151,11.42
9875837,9978008,2805,981750,10959758,9.84
9875838,5318255,1655,579250,5897505,10.89
9875839,9971448,2951,1032850,11004298,10.36
9875840,9975939,6340,2219000,12194939,22.24
9875841,5259611,1279,447650,5707261,8.51
9875842,9969785,3892,1362200,11331985,13.66
9875843,7838925,1745,610750,8449675,7.79
9875844,9888327,4134,1446900,11335227,14.63
9875845,9985853,3573,1250550,11236403,12.52
9875846,9978827,5295,1853250,11832077,18.57
9875847,1103504,733,256550,1360054,23.25
9875848,1878079,743,260050,2138129,13.85
9875849,258376,101,35350,293726,13.68
9875850,9971671,1699,594650,10566321,5.96
9875851,9980457,4162,1456700,11437157,14.60
9875852,9965817,4887,1710450,11676267,17.16
9875854,9953850,2154,753900,10707750,7.57
9875855,9945722,4935,1727250,11672972,17.37
9875856,9873188,3580,1253000,11126188,12.69
9875857,9867751,3012,1054200,10921951,10.68
9875858,9926521,3985,1394750,11321271,14.05
9875859,9937640,4275,1496250,11433890,15.06
9875860,9928239,4811,1683850,11612089,16.96
9875861,9927235,2732,956200,10883435,9.63
9875862,9934690,1895,663250,10597940,6.68
9875863,9928191,5316,1860600,11788791,18.74
9875864,9936471,3406,1192100,11128571,12.00
9875865,9934521,4159,1455650,11390171,14.65
9875866,9939461,3973,1390550,11330011,13.99
9875867,2156057,1265,442750,2598807,20.54
9875868,9934862,2516,880600,10815462,8.86
9875869,8781487,2475,866250,9647737,9.86
9875870,9932352,4624,1618400,11550752,16.29
9875871,5330428,2914,1019900,6350328,19.13
9875872,9934226,3490,1221500,11155726,12.30
9875873,9929076,3333,1166550,11095626,11.75
9875874,9933426,2680,938000,10871426,9.44
9875875,9949629,2872,1005200,10954829,10.10
9875876,9947697,4657,1629950,11577647,16.39
9875877,9960791,4842,1694700,11655491,17.01
9875878,9439083,1579,552650,9991733,5.85
9875879,9957725,4713,1649550,11607275,16.57
9875880,9962140,2459,860650,10822790,8.64
9875881,9963835,3474,1215900,11179735,12.20
9875882,9964117,2489,871150,10835267,8.74
9875883,9975048,2574,900900,10875948,9.03
9875884,9967103,2732,956200,10923303,9.59
9875885,9965731,2815,985250,10950981,9.89
9875886,9931894,5919,2071650,12003544,20.86
9875887,9973686,5342,1869700,11843386,18.75
9875888,9972396,3722,1302700,11275096,13.06
9875889,2281045,551,192850,2473895,8.45
9875890,9985911,2972,1040200,11026111,10.42
9875891,9979304,3716,1300600,11279904,13.03
9875892,9499229,5198,1819300,11318529,19.15
9875893,9981560,2644,925400,10906960,9.27
9875894,9973539,3685,1289750,11263289,12.93
9875895,9994102,4168,1458800,11452902,14.60
9875896,9992054,3192,1117200,11109254,11.18
9875897,9984600,3316,1160600,11145200,11.62
9875898,9970655,1856,649600,10620255,6.52
9875899,9993169,5286,1850100,11843269,18.51
9875900,9980228,2343,820050,10800278,8.22
9875901,9980895,2122,742700,10723595,7.44
9875903,9970892,1357,474950,10445842,4.76
9875904,9957618,3336,1167600,11125218,11.73
9875905,9956081,2821,987350,10943431,9.92
9875906,9970814,3025,1058750,11029564,10.62
9875907,9963475,3503,1226050,11189525,12.31
9875908,2320000,1234,431900,2751900,18.62
9875909,9971125,2805,981750,10952875,9.85
9875910,2177257,1642,574700,2751957,26.40
9875911,9974472,5196,1818600,11793072,18.23
9875912,9988945,5858,2050300,12039245,20.53
9875913,9968865,3650,1277500,11246365,12.81
9875914,9966134,6711,2348850,12314984,23.57
9875915,9980932,2957,1034950,11015882,10.37
9875916,9938620,2581,903350,10841970,9.09
9875917,9974372,2081,728350,10702722,7.30
9875918,9969213,2966,1038100,11007313,10.41
9875919,9981609,2920,1022000,11003609,10.24
9875920,9979213,3270,1144500,11123713,11.47
9875921,9996991,2508,877800,10874791,8.78
9875922,9971086,6546,2291100,12262186,22.98
9875923,9770992,4745,1660750,11431742,17.00
9875924,9984015,2095,733250,10717265,7.34
9875925,9971734,4269,1494150,11465884,14.98
9875926,9977350,3517,1230950,11208300,12.34
9875927,2944511,1776,621600,3566111,21.11
9875928,9736034,1218,426300,10162334,4.38
9875929,9974155,3308,1157800,11131955,11.61
9875930,9964387,1658,580300,10544687,5.82
9875931,9968209,2085,729750,10697959,7.32
9875932,306156,147,51450,357606,16.81
9875933,9966360,2324,813400,10779760,8.16
9875934,9965343,3206,1122100,11087443,11.26
9875935,9957511,1534,536900,10494411,5.39
9875936,9947888,2350,822500,10770388,8.27
9875937,9958674,4408,1542800,11501474,15.49
9875938,9945997,4407,1542450,11488447,15.51
9875939,9941151,5728,2004800,11945951,20.17
9875940,9926895,3694,1292900,11219795,13.02
9875941,9940333,3081,1078350,11018683,10.85
9875942,9944180,3796,1328600,11272780,13.36
9875943,9949796,4173,1460550,11410346,14.68
9875944,9961228,4075,1426250,11387478,14.32
9875945,9972635,4265,1492750,11465385,14.97
9875946,9960424,1828,639800,10600224,6.42
9875947,9974706,3350,1172500,11147206,11.75
9875948,9976999,3127,1094450,11071449,10.97
9875949,9999715,2263,792050,10791765,7.92
9875950,9969295,3576,1251600,11220895,12.55
9875951,9887911,5211,1823850,11711761,18.45
9875952,9970046,2750,962500,10932546,9.65
9875953,9957810,4883,1709050,11666860,17.16
9875954,9949801,2124,743400,10693201,7.47
9875955,9956922,4451,1557850,11514772,15.65
9875956,9962251,1685,589750,10552001,5.92
9875957,9952255,3262,1141700,11093955,11.47
9875958,9860310,3243,1135050,10995360,11.51
9875959,9997696,3104,1086400,11084096,10.87
9875960,9978146,3763,1317050,11295196,13.20
9875961,9985371,1551,542850,10528221,5.44
9875962,9973509,2756,964600,10938109,9.67
9875963,9997275,2665,932750,10930025,9.33
9875964,9987675,3440,1204000,11191675,12.05
9875965,9994388,5129,1795150,11789538,17.96
9875966,9996548,4550,1592500,11589048,15.93
9875967,9997074,3319,1161650,11158724,11.62
9875968,9982113,2689,941150,10923263,9.43
9875969,9978432,1899,664650,10643082,6.66
9875970,9980311,5121,1792350,11772661,17.96
9875972,9967110,1567,548450,10515560,5.50
9875973,9965222,2834,991900,10957122,9.95
9875974,9942489,1219,426650,10369139,4.29
9875975,9946086,3226,1129100,11075186,11.35
9875976,9416321,4714,1649900,11066221,17.52
9875977,9861419,5211,1823850,11685269,18.49
9875978,9936548,6183,2164050,12100598,21.78
9875979,9964516,4058,1420300,11384816,14.25
9875980,9950369,4465,1562750,11513119,15.71
9875981,9959470,3745,1310750,11270220,13.16
9875982,9975335,4094,1432900,11408235,14.36
9875983,9979694,4213,1474550,11454244,14.78
9875984,9967910,2030,710500,10678410,7.13
9875985,9939645,5327,1864450,11804095,18.76
9875986,9973505,2297,803950,10777455,8.06
9875987,9965571,2640,924000,10889571,9.27
9875988,9987563,1984,694400,10681963,6.95
9875989,9991318,2907,1017450,11008768,10.18
9875990,9990030,2270,794500,10784530,7.95
9875992,8200346,1542,539700,8740046,6.58
9875993,9966806,5543,1940050,11906856,19.47
9875994,9966745,3269,1144150,11110895,11.48
9875995,9972063,3710,1298500,11270563,13.02
9875996,9958938,1677,586950,10545888,5.89
9875997,9952898,3663,1282050,11234948,12.88
9875999,9940699,3964,1387400,11328099,13.96
9876000,9959469,1246,436100,10395569,4.38
9876001,9942043,4424,1548400,11490443,15.57
9876002,9962371,3703,1296050,11258421,13.01
9876003,9952696,4519,1581650,11534346,15.89
9876004,9960388,5308,1857800,11818188,18.65
9876006,9963614,4348,1521800,11485414,15.27
9876007,9958760,3510,1228500,11187260,12.34
9876008,9965894,5465,1912750,11878644,19.19
9876009,9980403,2394,837900,10818303,8.40
9876010,5281949,2417,845950,6127899,16.02
9876011,9972685,1809,633150,10605835,6.35
9876012,9995199,5016,1755600,11750799,17.56
9876013,9993505,1247,436450,10429955,4.37
9876014,9979049,4049,1417150,11396199,14.20
9876015,9979865,4783,1674050,11653915,16.77
9876016,9971348,2139,748650,10719998,7.51
9876017,9983783,2837,992950,10976733,9.95
9876018,9974417,4022,1407700,11382117,14.11
9876019,9958969,3499,1224650,11183619,12.30
9876020,9968818,4430,1550500,11519318,15.55
9876021,9977129,5249,1837150,11814279,18.41
9876022,9979692,4117,1440950,11420642,14.44
9876023,9974273,3332,1166200,11140473,11.69
9876024,9980743,4994,1747900,11728643,17.51
9876025,9993663,3103,1086050,11079713,10.87
9876026,9971592,3404,1191400,11162992,11.95
9876027,9987334,3664,1282400,11269734,12.84
9876028,9985948,3205,1121750,11107698,11.23
9876029,9976697,2641,924350,10901047,9.27
9876030,9991735,3659,1280650,11272385,12.82
9876031,9981963,4908,1717800,11699763,17.21
9876032,9994441,4980,1743000,11737441,17.44
9876033,9984592,2970,1039500,11024092,10.41
9876034,9981304,2845,995750,10977054,9.98
9876035,9987311,4621,1617350,11604661,16.19
9876036,9982057,2650,927500,10909557,9.29
9876037,9973831,3102,1085700,11059531,10.89
9876038,9966074,2996,1048600,11014674,10.52
9876039,5220395,959,335650,5556045,6.43
9876040,9976215,3368,1178800,11155015,11.82
9876042,9987048,3943,1380050,11367098,13.82
9876043,9997294,3790,1326500,11323794,13.27
9876044,9997774,5131,1795850,11793624,17.96
9876045,9986772,4577,1601950,11588722,16.04
9876046,9976463,3944,1380400,11356863,13.84
9876047,9974436,4530,1585500,11559936,15.90
9876048,9978000,4279,1497650,11475650,15.01
9876049,9994428,6184,2164400,12158828,21.66
9876050,9635814,3779,1322650,10958464,13.73
9876051,9489930,4765,1667750,11157680,17.57
9876052,9996427,3519,1231650,11228077,12.32
9876053,9987512,2163,757050,10744562,7.58
9876054,9278554,3815,1335250,10613804,14.39
9876055,9991806,4094,1432900,11424706,14.34
9876056,9637563,3237,1132950,10770513,11.76
9876057,9983703,6616,2315600,12299303,23.19
9876058,9981746,4531,1585850,11567596,15.89
9876059,9961714,5786,2025100,11986814,20.33
9876060,9426586,2754,963900,10390486,10.23
9876061,9973770,3838,1343300,11317070,13.47
9876062,9472057,4021,1407350,10879407,14.86
9876063,9955502,4566,1598100,11553602,16.05
9876064,9967002,2889,1011150,10978152,10.14
9876065,9950890,3139,1098650,11049540,11.04
9876066,9943555,4946,1731100,11674655,17.41
9876067,9952723,2945,1030750,10983473,10.36
9876068,9973121,4700,1645000,11618121,16.49
9876070,9979805,3037,1062950,11042755,10.65
9876072,9974967,4466,1563100,11538067,15.67
9876073,9969937,4561,1596350,11566287,16.01
9876074,9986536,2010,703500,10690036,7.04
9876075,9974669,3508,1227800,11202469,12.31
9876076,9989661,2654,928900,10918561,9.30
9876077,9979070,2977,1041950,11021020,10.44
9876078,9988441,1791,626850,10615291,6.28
9876079,9978328,5487,1920450,11898778,19.25
9876080,9993441,6309,2208150,12201591,22.10
9876081,9988701,5229,1830150,11818851,18.32
9876082,9994820,5748,2011800,12006620,20.13
9876083,9979540,4227,1479450,11458990,14.82
9876084,9969513,2298,804300,10773813,8.07
9876085,9984207,4207,1472450,11456657,14.75
9876086,9986704,3149,1102150,11088854,11.04
9876087,9997678,2525,883750,10881428,8.84
9876088,9962126,2989,1046150,11008276,10.50
9876089,3463533,951,332850,3796383,9.61
9876090,9977766,5387,1885450,11863216,18.90
9876091,9983858,5275,1846250,11830108,18.49
9876092,9974298,3200,1120000,11094298,11.23
9876093,9989426,4751,1662850,11652276,16.65
9876094,9998004,2346,821100,10819104,8.21
9876095,9982021,5551,1942850,11924871,19.46
9876096,9996602,3689,1291150,11287752,12.92
9876097,9990085,2153,753550,10743635,7.54
9876098,9168636,3860,1351000,10519636,14.74
9876100,9967718,3077,1076950,11044668,10.80
9876101,9972445,2516,880600,10853045,8.83
9876102,9961616,3896,1363600,11325216,13.69
9876103,9971027,3502,1225700,11196727,12.29
9876104,9982192,3935,1377250,11359442,13.80
9876105,9988792,3510,1228500,11217292,12.30
9876106,9498130,5004,1751400,11249530,18.44
9876107,9979338,2509,878150,10857488,8.80
9876108,9989015,3259,1140650,11129665,11.42
9876109,9986241,2868,1003800,10990041,10.05
9876110,9996386,4202,1470700,11467086,14.71
9876111,9905207,4733,1656550,11561757,16.72
9876112,9988696,6020,2107000,12095696,21.09
9876113,9980220,2770,969500,10949720,9.71
9876114,9983830,4186,1465100,11448930,14.67
9876115,4618798,923,323050,4941848,6.99
9876116,9969177,3479,1217650,11186827,12.21
9876117,9992378,5778,2022300,12014678,20.24
9876118,9980567,2561,896350,10876917,8.98
9876119,9973103,2986,1045100,11018203,10.48
9876120,9986604,4481,1568350,11554954,15.70
9876121,9985485,3996,1398600,11384085,14.01
9876122,9991918,2390,836500,10828418,8.37
9876123,9986606,4151,1452850,11439456,14.55
9876124,9988894,2467,863450,10852344,8.64
9876125,9496941,3082,1078700,10575641,11.36
9876126,963100,181,63350,1026450,6.58
9876127,9968259,4950,1732500,11700759,17.38
9876128,9991433,2817,985950,10977383,9.87
9876129,9688732,2402,840700,10529432,8.68
9876130,9984329,3450,1207500,11191829,12.09
9876131,2069603,604,211400,2281003,10.21
9876132,9985257,3717,1300950,11286207,13.03
9876133,9634280,2861,1001350,10635630,10.39
9876134,9975984,1968,688800,10664784,6.90
9876135,9991270,3334,1166900,11158170,11.68
9876136,8981323,4213,1474550,10455873,16.42
9876137,8993779,3650,1277500,10271279,14.20
9876138,9992303,2798,979300,10971603,9.80
9876139,9980894,3874,1355900,11336794,13.58
9876140,1382336,200,70000,1452336,5.06
9876141,9947828,3599,1259650,11207478,12.66
9876142,9986063,2093,732550,10718613,7.34
9876143,9990274,3292,1152200,11142474,11.53
9876144,9981193,4091,1431850,11413043,14.35
9876145,9962442,3892,1362200,11324642,13.67
9876146,9831218,1387,485450,10316668,4.94
9876147,9982930,2590,906500,10889430,9.08
9876148,9991420,3301,1155350,11146770,11.56
9876149,9988447,3642,1274700,11263147,12.76
9876150,9988474,1394,487900,10476374,4.88
9876151,9984099,2907,1017450,11001549,10.19
9876152,9941065,3570,1249500,11190565,12.57
9876153,9990772,3657,1279950,11270722,12.81
9876154,729415,114,39900,769315,5.47
9876155,9989691,3700,1295000,11284691,12.96
9876156,9974690,2231,780850,10755540,7.83
9876157,9717358,1120,392000,10109358,4.03
9876158,9972564,5452,1908200,11880764,19.13
9876159,9990853,2244,785400,10776253,7.86
9876160,9983526,2539,888650,10872176,8.90
9876161,9973837,2457,859950,10833787,8.62
9876162,9975198,4083,1429050,11404248,14.33
9876163,9988419,2891,1011850,11000269,10.13
9876164,9988359,4766,1668100,11656459,16.70
9876165,9962571,4266,1493100,11455671,14.99
9876166,9955790,4045,1415750,11371540,14.22
9876167,9966356,1886,660100,10626456,6.62
9876168,9978408,3368,1178800,11157208,11.81
9876169,9987838,2264,792400,10780238,7.93
9876170,9992646,3148,1101800,11094446,11.03
9876171,9995731,4864,1702400,11698131,17.03
9876172,6521077,1645,575750,7096827,8.83
9876173,4971656,2628,919800,5891456,18.50
9876174,9822725,3609,1263150,11085875,12.86
9876175,9830409,1563,547050,10377459,5.56
9876176,9967914,3992,1397200,11365114,14.02
9876177,9987809,3871,1354850,11342659,13.57
9876178,9081843,3284,1149400,10231243,12.66
9876179,9987416,3521,1232350,11219766,12.34
9876180,9989364,4477,1566950,11556314,15.69
9876181,9974655,3345,1170750,11145405,11.74
9876182,9918780,2380,833000,10751780,8.40
9876183,7929941,3741,1309350,9239291,16.51
9876184,9959568,2522,882700,10842268,8.86
9876185,9964917,3044,1065400,11030317,10.69
9876186,9943099,2649,927150,10870249,9.32
9876187,9968550,1997,698950,10667500,7.01
9876188,9978056,918,321300,10299356,3.22
9876189,9979206,2118,741300,10720506,7.43
9876190,9986053,2908,1017800,11003853,10.19
9876191,9970088,1058,370300,10340388,3.71
9876192,9986487,2725,953750,10940237,9.55
9876193,9974552,4409,1543150,11517702,15.47
9876194,9979512,3650,1277500,11257012,12.80
9876195,9974302,1141,399350,10373652,4.00
9876196,9976225,1741,609350,10585575,6.11
9876197,9972346,2581,903350,10875696,9.06
9876198,9993344,2361,826350,10819694,8.27
9876199,9996243,4577,1601950,11598193,16.03
9876200,9989762,3205,1121750,11111512,11.23
9876201,9988504,3427,1199450,11187954,12.01
9876203,9932337,4158,1455300,11387637,14.65
9876204,9899264,3204,1121400,11020664,11.33
9876205,9990230,2503,876050,10866280,8.77
9876206,9982841,6511,2278850,12261691,22.83
9876207,9990481,2660,931000,10921481,9.32
9876208,9979866,4128,1444800,11424666,14.48
9876209,9982207,978,342300,10324507,3.43
9876210,9979059,4065,1422750,11401809,14.26
9876211,9988388,4851,1697850,11686238,17.00
9876212,9987797,2819,986650,10974447,9.88
9876213,9983543,2453,858550,10842093,8.60
9876214,9981917,4857,1699950,11681867,17.03
9876215,9993179,2287,800450,10793629,8.01
9876216,9646864,3144,1100400,10747264,11.41
9876217,9979715,2787,975450,10955165,9.77
9876218,9985117,2051,717850,10702967,7.19
9876219,9992262,3573,1250550,11242812,12.52
9876220,1704429,723,253050,1957479,14.85
9876221,8495513,1959,685650,9181163,8.07
9876222,866345,652,228200,1094545,26.34
9876223,9961926,5394,1887900,11849826,18.95
9876224,9988227,2616,915600,10903827,9.17
9876225,9985847,5427,1899450,11885297,19.02
9876226,9993828,3917,1370950,11364778,13.72
9876227,9973459,3948,1381800,11355259,13.85
9876228,9886580,2345,820750,10707330,8.30
9876229,9967474,3945,1380750,11348224,13.85
9876230,9975116,4667,1633450,11608566,16.38
9876231,9712893,5131,1795850,11508743,18.49
9876232,9925168,2882,1008700,10933868,10.16
9876233,8176089,2293,802550,8978639,9.82
9876234,9964585,2445,855750,10820335,8.59
9876235,9958474,3610,1263500,11221974,12.69
9876236,9961948,5192,1817200,11779148,18.24
9876237,9968469,3039,1063650,11032119,10.67
9876238,9974851,2251,787850,10762701,7.90
9876239,1512340,825,288750,1801090,19.09
9876240,9954854,130,45500,10000354,0.46
9876241,7503398,4471,1564850,9068248,20.86
9876242,9937028,2999,1049650,10986678,10.56
9876243,7105528,2069,724150,7829678,10.19
9876244,9946839,3155,1104250,11051089,11.10
9876245,9961592,2720,952000,10913592,9.56
9876246,9960255,3031,1060850,11021105,10.65
9876247,9953484,2080,728000,10681484,7.31
9876248,9970517,1825,638750,10609267,6.41
9876249,9954405,5380,1883000,11837405,18.92
9876250,9966778,3229,1130150,11096928,11.34
9876251,9963360,4097,1433950,11397310,14.39
9876252,9984752,4047,1416450,11401202,14.19
9876253,9203889,2873,1005550,10209439,10.93
9876254,9980520,3358,1175300,11155820,11.78
9876255,9961271,4530,1585500,11546771,15.92
9876256,9966558,2403,841050,10807608,8.44
9876257,2832556,1101,385350,3217906,13.60
9876258,9948656,3098,1084300,11032956,10.90
9876259,9923403,3138,1098300,11021703,11.07
9876260,9896925,3047,1066450,10963375,10.78
9876261,9972806,5483,1919050,11891856,19.24
9876262,9988704,3710,1298500,11287204,13.00
9876263,9964326,1628,569800,10534126,5.72
9876264,9984466,3777,1321950,11306416,13.24
9876265,9966823,2440,854000,10820823,8.57
9876266,9980221,3579,1252650,11232871,12.55
9876267,9950340,3052,1068200,11018540,10.74
9876268,9961468,3405,1191750,11153218,11.96
9876269,9970075,4019,1406650,11376725,14.11
9876270,9963472,2578,902300,10865772,9.06
9876271,9963587,3368,1178800,11142387,11.83
9876272,9977707,4237,1482950,11460657,14.86
9876273,9979211,4168,1458800,11438011,14.62
9876274,9983871,3018,1056300,11040171,10.58
9876275,9970133,2048,716800,10686933,7.19
9876276,9973180,1905,666750,10639930,6.69
9876277,9971664,4022,1407700,11379364,14.12
9876278,9969002,2470,864500,10833502,8.67
9876279,9960664,4384,1534400,11495064,15.40
9876280,9967142,2815,985250,10952392,9.88
9876281,9965416,5400,1890000,11855416,18.97
9876282,8979904,4026,1409100,10389004,15.69
9876283,6112024,4532,1586200,7698224,25.95
9876284,8955518,1883,659050,9614568,7.36
9876285,9991058,2401,840350,10831408,8.41
9876286,9995159,5788,2025800,12020959,20.27
9876287,4282468,1167,408450,4690918,9.54
9876288,9977635,3080,1078000,11055635,10.80
9876290,9968704,2298,804300,10773004,8.07
9876291,9239967,3972,1390200,10630167,15.05
9876292,8970831,2735,957250,9928081,10.67
9876293,8977493,6106,2137100,11114593,23.81
9876294,9993823,3185,1114750,11108573,11.15
9876295,9907495,2126,744100,10651595,7.51
9876296,9971882,3712,1299200,11271082,13.03
9876297,865473,277,96950,962423,11.20
9876298,9976491,3408,1192800,11169291,11.96
9876299,9947911,3730,1305500,11253411,13.12
9876300,1756223,605,211750,1967973,12.06
9876301,8971940,6317,2210950,11182890,24.64
9876302,909592,218,76300,985892,8.39
9876303,9986884,3610,1263500,11250384,12.65
9876304,9982545,1917,670950,10653495,6.72
9876305,9987869,3697,1293950,11281819,12.96
9876306,9996186,3548,1241800,11237986,12.42
9876307,2706847,933,326550,3033397,12.06
9876308,9964636,3227,1129450,11094086,11.33
9876310,9975742,6327,2214450,12190192,22.20
9876311,9985557,4209,1473150,11458707,14.75
9876312,9988296,2958,1035300,11023596,10.37
9876313,9995442,5993,2097550,12092992,20.99
9876314,9993572,3690,1291500,11285072,12.92
9876315,9983319,5482,1918700,11902019,19.22
9876316,9981215,6163,2157050,12138265,21.61
9876317,9974980,4612,1614200,11589180,16.18
9876318,9986988,2073,725550,10712538,7.26
9876320,9994478,5779,2022650,12017128,20.24
9876321,9988638,2439,853650,10842288,8.55
9876322,9991577,1444,505400,10496977,5.06
9876323,9995468,2776,971600,10967068,9.72
9876324,9982056,3168,1108800,11090856,11.11
9876326,9973727,4108,1437800,11411527,14.42
9876327,9988765,3304,1156400,11145165,11.58
9876328,9985110,3512,1229200,11214310,12.31
9876329,9985187,3582,1253700,11238887,12.56
9876330,9990093,3606,1262100,11252193,12.63
9876331,9976058,2619,916650,10892708,9.19
9876332,9978878,3157,1104950,11083828,11.07
9876333,9972614,3618,1266300,11238914,12.70
9876334,9972085,2272,795200,10767285,7.97
9876335,9985919,3256,1139600,11125519,11.41
9876336,9995757,2587,905450,10901207,9.06
9876337,9980617,3184,1114400,11095017,11.17
9876338,9992281,3265,1142750,11135031,11.44
9876339,9979971,4367,1528450,11508421,15.32
9876340,9985800,3297,1153950,11139750,11.56
9876341,9962892,1781,623350,10586242,6.26
9876342,9971297,2024,708400,10679697,7.10
9876343,9994457,4321,1512350,11506807,15.13
9876344,9992053,5881,2058350,12050403,20.60
9876345,9986748,3599,1259650,11246398,12.61
9876346,9979093,1714,599900,10578993,6.01
9876347,9908642,1491,521850,10430492,5.27
9876348,9966275,3398,1189300,11155575,11.93
9876349,9972389,4496,1573600,11545989,15.78
9876350,9985181,3871,1354850,11340031,13.57
9876351,9982530,3119,1091650,11074180,10.94
9876352,9943783,1912,669200,10612983,6.73
9876353,9947762,1701,595350,10543112,5.98
9876354,9968000,3843,1345050,11313050,13.49
9876355,9958656,2955,1034250,10992906,10.39
9876356,9960316,4142,1449700,11410016,14.55
9876357,9965129,4444,1555400,11520529,15.61
9876358,9961517,3331,1165850,11127367,11.70
9876359,9945815,3976,1391600,11337415,13.99
9876360,9942710,2901,1015350,10958060,10.21
9876361,9961001,3938,1378300,11339301,13.84
9876362,9970596,2159,755650,10726246,7.58
9876363,9970764,3461,1211350,11182114,12.15
9876364,9977880,2727,954450,10932330,9.57
9876365,9967578,3144,1100400,11067978,11.04
9876366,9958970,3095,1083250,11042220,10.88
9876367,9979264,3134,1096900,11076164,10.99
9876368,9984030,4190,1466500,11450530,14.69
9876369,9968083,3034,1061900,11029983,10.65
9876370,9968090,1862,651700,10619790,6.54
9876371,9989896,5601,1960350,11950246,19.62
9876372,9978127,1276,446600,10424727,4.48
9876373,9911239,2894,1012900,10924139,10.22
9876374,9995180,3063,1072050,11067230,10.73
9876375,9982329,7225,2528750,12511079,25.33
9876376,9984824,3582,1253700,11238524,12.56
9876377,9990273,4592,1607200,11597473,16.09
9876378,9969833,4097,1433950,11403783,14.38
9876379,9966090,1374,480900,10446990,4.83
9876380,9967345,1265,442750,10410095,4.44
9876381,9586003,3246,1136100,10722103,11.85
9876382,9588575,2924,1023400,10611975,10.67
9876383,9986731,3056,1069600,11056331,10.71
9876384,9874947,5490,1921500,11796447,19.46
9876385,1904323,742,259700,2164023,13.64
9876386,9992520,2903,1016050,11008570,10.17
9876387,9987455,3156,1104600,11092055,11.06
9876388,2267375,1498,524300,2791675,23.12
9876389,9973644,2747,961450,10935094,9.64
9876390,3505677,1096,383600,3889277,10.94
9876391,9979686,4751,1662850,11642536,16.66
9876392,9991168,3079,1077650,11068818,10.79
9876394,1143048,431,150850,1293898,13.20
9876395,9986395,4193,1467550,11453945,14.70
9876396,9971452,2563,897050,10868502,9.00
9876397,9981897,3838,1343300,11325197,13.46
9876398,9980886,3921,1372350,11353236,13.75
9876399,9956234,2473,865550,10821784,8.69
9876400,2213797,572,200200,2413997,9.04
9876401,9969466,1829,640150,10609616,6.42
9876402,9807298,2596,908600,10715898,9.26
9876403,9990816,4165,1457750,11448566,14.59
9876404,9986491,4797,1678950,11665441,16.81
9876405,9989137,5456,1909600,11898737,19.12
9876406,9833325,5214,1824900,11658225,18.56
9876407,9632215,2681,938350,10570565,9.74
9876408,3955741,1812,634200,4589941,16.03
9876409,9962464,4300,1505000,11467464,15.11
9876410,9976880,2137,747950,10724830,7.50
9876411,9952165,2994,1047900,11000065,10.53
9876412,9989401,2122,742700,10732101,7.43
9876413,2278904,697,243950,2522854,10.70
9876414,9978804,3174,1110900,11089704,11.13
9876415,3749366,1613,564550,4313916,15.06
9876416,9957834,4631,1620850,11578684,16.28
9876417,9963071,2923,1023050,10986121,10.27
9876418,9979238,1932,676200,10655438,6.78
9876419,9973545,2286,800100,10773645,8.02
9876420,9975265,1221,427350,10402615,4.28
9876421,9978394,3791,1326850,11305244,13.30
9876422,3634129,1793,627550,4261679,17.27
9876423,9963144,2832,991200,10954344,9.95
9876424,9977740,4091,1431850,11409590,14.35
9876425,9985942,3061,1071350,11057292,10.73
9876426,9992073,3624,1268400,11260473,12.69
9876427,9983230,1487,520450,10503680,5.21
9876428,3840598,1663,582050,4422648,15.16
9876429,1205706,595,208250,1413956,17.27
9876430,3369996,1990,696500,4066496,20.67
9876431,9953444,4168,1458800,11412244,14.66
9876432,9973260,1738,608300,10581560,6.10
9876433,9975491,2492,872200,10847691,8.74
9876434,9979644,1813,634550,10614194,6.36
9876435,9980462,5038,1763300,11743762,17.67
9876436,3525160,1184,414400,3939560,11.76
9876437,9982384,4774,1670900,11653284,16.74
9876438,9972923,2475,866250,10839173,8.69
9876439,9965137,2887,1010450,10975587,10.14
9876440,9990211,3145,1100750,11090961,11.02
9876441,9979552,3868,1353800,11333352,13.57
9876442,9975756,1447,506450,10482206,5.08
9876443,9998845,7168,2508800,12507645,25.09
9876444,8875350,3332,1166200,10041550,13.14
9876445,9991213,4737,1657950,11649163,16.59
9876446,9991606,3555,1244250,11235856,12.45
9876447,9996218,4042,1414700,11410918,14.15
9876448,9996632,2788,975800,10972432,9.76
9876449,9978309,2579,902650,10880959,9.05
9876450,9993268,4622,1617700,11610968,16.19
9876451,3154265,1538,538300,3692565,17.07
9876452,9968044,2813,984550,10952594,9.88
9876453,9985845,2291,801850,10787695,8.03
9876454,9975413,3777,1321950,11297363,13.25
9876455,9982905,4662,1631700,11614605,16.34
9876456,9975719,3869,1354150,11329869,13.57
9876457,9994585,5268,1843800,11838385,18.45
9876458,9981468,4194,1467900,11449368,14.71
9876459,9991624,5459,1910650,11902274,19.12
9876460,9979670,3772,1320200,11299870,13.23
9876461,9976917,2498,874300,10851217,8.76
9876462,9978494,4167,1458450,11436944,14.62
9876464,9979409,3562,1246700,11226109,12.49
9876465,6881050,1818,636300,7517350,9.25
9876466,9972088,3313,1159550,11131638,11.63
9876467,9985168,2333,816550,10801718,8.18
9876468,9984361,1288,450800,10435161,4.52
9876469,9988499,2821,987350,10975849,9.88
9876470,4186863,1005,351750,4538613,8.40
9876471,9983974,3076,1076600,11060574,10.78
9876472,9992285,2827,989450,10981735,9.90
9876473,9984340,2957,1034950,11019290,10.37
9876474,9994229,2684,939400,10933629,9.40
9876475,9993234,4358,1525300,11518534,15.26
9876476,9987596,2274,795900,10783496,7.97
9876477,9985189,2319,811650,10796839,8.13
9876478,9901014,5331,1865850,11766864,18.85
9876479,9977314,3587,1255450,11232764,12.58
9876480,9974481,2036,712600,10687081,7.14
9876481,9989212,3101,1085350,11074562,10.87
9876482,9965373,3325,1163750,11129123,11.68
9876483,9958838,3526,1234100,11192938,12.39
9876484,9989479,2504,876400,10865879,8.77
9876485,9986386,1684,589400,10575786,5.90
9876486,9989494,2797,978950,10968444,9.80
9876487,9987669,3917,1370950,11358619,13.73
9876488,9971901,2402,840700,10812601,8.43
9876489,9993847,2592,907200,10901047,9.08
9876490,9983509,5072,1775200,11758709,17.78
9876491,1343476,2163,757050,2100526,56.35
9876492,9978921,3473,1215550,11194471,12.18
9876493,9980219,3018,1056300,11036519,10.58
9876494,9991022,4984,1744400,11735422,17.46
9876495,9994953,2686,940100,10935053,9.41
9876497,9972810,3665,1282750,11255560,12.86
9876498,9980086,2648,926800,10906886,9.29
9876499,9978817,4963,1737050,11715867,17.41
9876500,9962591,4248,1486800,11449391,14.92
9876501,9967282,3257,1139950,11107232,11.44
9876502,9966191,5125,1793750,11759941,18.00
9876503,9963806,2146,751100,10714906,7.54
9876505,9971869,4010,1403500,11375369,14.07
9876506,9981897,2796,978600,10960497,9.80
9876507,9980152,2007,702450,10682602,7.04
9876508,9978395,2229,780150,10758545,7.82
9876509,9980647,4861,1701350,11681997,17.05
9876510,9991223,3225,1128750,11119973,11.30
9876511,9985809,2881,1008350,10994159,10.10
9876512,9991883,5691,1991850,11983733,19.93
9876513,9986233,2463,862050,10848283,8.63
9876514,9987103,3963,1387050,11374153,13.89
9876515,9987123,4563,1597050,11584173,15.99
9876516,9977186,2930,1025500,11002686,10.28
9876517,9966742,3566,1248100,11214842,12.52
9876518,9981986,4543,1590050,11572036,15.93
9876519,9999133,2541,889350,10888483,8.89
9876520,9997609,6863,2402050,12399659,24.03
9876521,9856511,2937,1027950,10884461,10.43
9876522,9983078,3556,1244600,11227678,12.47
9876523,9983632,3276,1146600,11130232,11.48
9876524,4609854,1514,529900,5139754,11.49
9876525,9998809,4743,1660050,11658859,16.60
9876526,9996159,3325,1163750,11159909,11.64
9876528,5299217,1346,471100,5770317,8.89
9876529,5526713,2538,888300,6415013,16.07
9876530,6694584,1345,470750,7165334,7.03
9876531,9987630,4358,1525300,11512930,15.27
9876532,9982405,2926,1024100,11006505,10.26
9876533,9995604,5455,1909250,11904854,19.10
9876534,9975605,4971,1739850,11715455,17.44
9876535,9994394,2005,701750,10696144,7.02
9876536,9986276,4261,1491350,11477626,14.93
9876537,9979475,6049,2117150,12096625,21.22
9876539,9960817,4537,1587950,11548767,15.94
9876540,9916392,2036,712600,10628992,7.19
9876541,9962856,6317,2210950,12173806,22.19
9876542,9993021,5131,1795850,11788871,17.97
9876543,9985100,3249,1137150,11122250,11.39
9876544,9977764,4610,1613500,11591264,16.17
9876545,9999725,5525,1933750,11933475,19.34
9876546,9978217,4301,1505350,11483567,15.09
9876547,3572382,2611,913850,4486232,25.58
9876548,306043,285,99750,405793,32.59
9876549,9972830,3879,1357650,11330480,13.61
9876550,9992808,4414,1544900,11537708,15.46
9876551,9773782,3013,1054550,10828332,10.79
9876552,9981794,4053,1418550,11400344,14.21
9876553,9507659,2056,719600,10227259,7.57
9876554,9986053,2018,706300,10692353,7.07
9876555,9965807,3162,1106700,11072507,11.10
9876556,9986345,4779,1672650,11658995,16.75
9876557,9868293,3510,1228500,11096793,12.45
9876558,9993221,2365,827750,10820971,8.28
9876559,9472940,2637,922950,10395890,9.74
9876560,9993009,4978,1742300,11735309,17.44
9876561,9980568,3344,1170400,11150968,11.73
9876562,9974139,3636,1272600,11246739,12.76
9876563,9984128,3828,1339800,11323928,13.42
9876564,9972227,2353,823550,10795777,8.26
9876565,9964057,2655,929250,10893307,9.33
9876566,9972986,3527,1234450,11207436,12.38
9876567,9976525,4698,1644300,11620825,16.48
9876568,9984034,3708,1297800,11281834,13.00
9876569,9934351,1313,459550,10393901,4.63
9876570,9998177,4786,1675100,11673277,16.75
9876572,9986094,2684,939400,10925494,9.41
9876573,9989994,5028,1759800,11749794,17.62
9876574,3480083,1251,437850,3917933,12.58
9876575,9949912,3117,1090950,11040862,10.96
9876576,9970031,6694,2342900,12312931,23.50
9876577,9627303,2646,926100,10553403,9.62
9876579,9990989,4083,1429050,11420039,14.30
9876580,9983760,5493,1922550,11906310,19.26
9876581,9985943,4065,1422750,11408693,14.25
9876582,9987569,5465,1912750,11900319,19.15
9876583,9999477,4089,1431150,11430627,14.31
9876584,9980455,4427,1549450,11529905,15.52
9876585,5735377,2702,945700,6681077,16.49
9876586,5152112,3508,1227800,6379912,23.83
9876587,9975400,2450,857500,10832900,8.60
9876588,9538765,4443,1555050,11093815,16.30
9876589,9539762,2652,928200,10467962,9.73
9876590,9982720,3511,1228850,11211570,12.31
9876591,7044081,2426,849100,7893181,12.05
9876592,1324712,176,61600,1386312,4.65
9876593,9945771,5229,1830150,11775921,18.40
9876594,9984904,3997,1398950,11383854,14.01
9876595,9987691,4254,1488900,11476591,14.91
9876596,9979451,3497,1223950,11203401,12.26
9876597,9988078,3141,1099350,11087428,11.01
9876598,9973987,4049,1417150,11391137,14.21
9876599,9981944,4521,1582350,11564294,15.85
9876600,9985826,3671,1284850,11270676,12.87
9876601,9980247,5599,1959650,11939897,19.64
9876602,9984611,4115,1440250,11424861,14.42
9876603,9983786,2467,863450,10847236,8.65
9876604,9975601,3950,1382500,11358101,13.86
9876605,9961620,4332,1516200,11477820,15.22
9876606,9974624,4016,1405600,11380224,14.09
9876607,9994569,4262,1491700,11486269,14.93
9876608,9973170,5159,1805650,11778820,18.11
9876609,9815035,3080,1078000,10893035,10.98
9876610,9999388,5401,1890350,11889738,18.90
9876612,9974823,4198,1469300,11444123,14.73
9876613,9978095,2801,980350,10958445,9.83
9876614,9984192,4313,1509550,11493742,15.12
9876615,9981396,3834,1341900,11323296,13.44
9876617,9977773,3683,1289050,11266823,12.92
9876618,9975957,4689,1641150,11617107,16.45
9876619,9971080,5671,1984850,11955930,19.91
9876620,9960154,5512,1929200,11889354,19.37
9876621,9952429,4377,1531950,11484379,15.39
9876622,9875567,5905,2066750,11942317,20.93
9876623,7479101,1644,575400,8054501,7.69
9876624,9959486,1457,509950,10469436,5.12
9876625,9970473,5053,1768550,11739023,17.74
9876626,9960217,2887,1010450,10970667,10.14
9876627,9965798,3193,1117550,11083348,11.21
9876629,9446276,3293,1152550,10598826,12.20
9876630,9975708,4319,1511650,11487358,15.15
9876631,9992252,2805,981750,10974002,9.83
9876632,9971613,5339,1868650,11840263,18.74
9876633,635629,275,96250,731879,15.14
9876634,9965823,4496,1573600,11539423,15.79
9876635,9985292,3773,1320550,11305842,13.22
9876636,9984320,6881,2408350,12392670,24.12
9876637,9984822,4821,1687350,11672172,16.90
9876638,9971758,3289,1151150,11122908,11.54
9876639,9950534,4183,1464050,11414584,14.71
9876640,9963677,4528,1584800,11548477,15.91
9876641,8961566,2917,1020950,9982516,11.39
9876642,9976885,1716,600600,10577485,6.02
9876643,9955708,2686,940100,10895808,9.44
9876644,1010291,351,122850,1133141,12.16
9876645,9955096,2327,814450,10769546,8.18
9876646,9895367,1653,578550,10473917,5.85
9876647,9982068,3018,1056300,11038368,10.58
9876648,9968887,2970,1039500,11008387,10.43
9876649,9045852,4795,1678250,10724102,18.55
9876650,9972207,3930,1375500,11347707,13.79
9876651,6533385,3650,1277500,7810885,19.55
9876652,9979047,2280,798000,10777047,8.00
9876653,1265337,1215,425250,1690587,33.61
9876654,9960104,3459,1210650,11170754,12.15
9876655,8828148,2381,833350,9661498,9.44
9876656,9971430,5097,1783950,11755380,17.89
9876657,9952141,3194,1117900,11070041,11.23
9876658,9966558,3355,1174250,11140808,11.78
9876659,9976266,4722,1652700,11628966,16.57
9876660,9975880,4479,1567650,11543530,15.71
9876661,7113453,3080,1078000,8191453,15.15
9876662,9973038,2593,907550,10880588,9.10
9876663,9993542,4097,1433950,11427492,14.35
9876665,9976123,3525,1233750,11209873,12.37
9876666,9973509,3844,1345400,11318909,13.49
9876667,1052241,198,69300,1121541,6.59
9876668,9956705,2460,861000,10817705,8.65
9876669,9969570,4838,1693300,11662870,16.98
9876670,9979572,3616,1265600,11245172,12.68
9876671,9916098,4102,1435700,11351798,14.48
9876672,9902855,5154,1803900,11706755,18.22
9876673,9773266,3316,1160600,10933866,11.88
9876674,9952229,5310,1858500,11810729,18.67
9876675,9971135,4977,1741950,11713085,17.47
9876676,9962025,4240,1484000,11446025,14.90
9876677,9980387,3879,1357650,11338037,13.60
9876678,8401959,1409,493150,8895109,5.87
9876679,9969052,5054,1768900,11737952,17.74
9876680,9962179,3177,1111950,11074129,11.16
9876681,9968397,1396,488600,10456997,4.90
9876683,2646445,1008,352800,2999245,13.33
9876684,9967536,1472,515200,10482736,5.17
9876685,9954366,4058,1420300,11374666,14.27
9876686,9962597,4046,1416100,11378697,14.21
9876687,9958283,3107,1087450,11045733,10.92
9876688,9969163,3574,1250900,11220063,12.55
9876689,9966382,2766,968100,10934482,9.71
9876690,9959043,3928,1374800,11333843,13.80
9876691,9969526,4054,1418900,11388426,14.23
9876692,9965758,2524,883400,10849158,8.86
9876693,9968304,2122,742700,10711004,7.45
9876694,9983544,5609,1963150,11946694,19.66
9876695,9961816,2079,727650,10689466,7.30
9876696,9979497,1311,458850,10438347,4.60
9876697,7855184,2855,999250,8854434,12.72
9876698,9979396,4446,1556100,11535496,15.59
9876699,2639631,180,63000,2702631,2.39
9876700,9984007,2567,898450,10882457,9.00
9876701,9989920,3578,1252300,11242220,12.54
9876703,9971096,5532,1936200,11907296,19.42
9876705,9977001,3072,1075200,11052201,10.78
9876706,9966739,5140,1799000,11765739,18.05
9876707,9981727,2916,1020600,11002327,10.22
9876708,251820,159,55650,307470,22.10
9876709,9982649,2706,947100,10929749,9.49
9876710,9984772,4880,1708000,11692772,17.11
9876711,9989319,3594,1257900,11247219,12.59
9876712,8858721,3278,1147300,10006021,12.95
9876713,9470029,3298,1154300,10624329,12.19
9876714,4165376,2209,773150,4938526,18.56
9876715,9961310,3416,1195600,11156910,12.00
9876716,8333171,3410,1193500,9526671,14.32
9876717,9977774,2822,987700,10965474,9.90
9876718,9985289,4005,1401750,11387039,14.04
9876719,9983491,3993,1397550,11381041,14.00
9876720,9566043,3584,1254400,10820443,13.11
9876722,9977921,3984,1394400,11372321,13.97
9876723,8975280,4365,1527750,10503030,17.02
9876724,9984178,4908,1717800,11701978,17.21
9876725,9991647,3921,1372350,11363997,13.73
9876726,9976705,4120,1442000,11418705,14.45
9876727,9986427,4252,1488200,11474627,14.90
9876728,9987050,4495,1573250,11560300,15.75
9876729,9981789,4390,1536500,11518289,15.39
9876730,9984804,3069,1074150,11058954,10.76
9876731,9997802,3949,1382150,11379952,13.82
9876732,9983882,2971,1039850,11023732,10.42
9876733,9985793,4689,1641150,11626943,16.43
9876734,9975937,4522,1582700,11558637,15.87
9876735,9966862,6297,2203950,12170812,22.11
9876736,9961193,4514,1579900,11541093,15.86
9876737,1401380,641,224350,1625730,16.01
9876738,9975880,3855,1349250,11325130,13.53
9876739,9968793,2617,915950,10884743,9.19
9876740,9976348,3003,1051050,11027398,10.54
9876741,9994632,3944,1380400,11375032,13.81
9876742,9994312,1128,394800,10389112,3.95
9876743,9982039,2586,905100,10887139,9.07
9876744,9974043,4208,1472800,11446843,14.77
9876745,9964806,5002,1750700,11715506,17.57
9876746,9837443,4187,1465450,11302893,14.90
9876747,9988736,5060,1771000,11759736,17.73
9876748,9980658,2654,928900,10909558,9.31
9876749,9999436,3289,1151150,11150586,11.51
9876750,9972965,4253,1488550,11461515,14.93
9876751,4796530,1033,361550,5158080,7.54
9876752,9988271,4849,1697150,11685421,16.99
9876753,9989362,4206,1472100,11461462,14.74
9876754,9973213,4344,1520400,11493613,15.24
9876755,9978565,2814,984900,10963465,9.87
9876756,9967286,6379,2232650,12199936,22.40
9876757,9976211,3461,1211350,11187561,12.14
9876758,9991441,2418,846300,10837741,8.47
9876759,9980433,4033,1411550,11391983,14.14
9876760,2546786,1345,470750,3017536,18.48
9876761,9983003,3485,1219750,11202753,12.22
9876762,9966081,5047,1766450,11732531,17.72
9876763,9971533,4332,1516200,11487733,15.21
9876764,9977897,3210,1123500,11101397,11.26
9876765,9974956,3304,1156400,11131356,11.59
9876766,9979705,2907,1017450,10997155,10.20
9876767,9969087,2932,1026200,10995287,10.29
9876768,9968199,5002,1750700,11718899,17.56
9876769,9990939,2735,957250,10948189,9.58
9876770,746018,198,69300,815318,9.29
9876771,9958986,2639,923650,10882636,9.27
9876772,3997718,2031,710850,4708568,17.78
9876773,9961844,4413,1544550,11506394,15.50
9876774,9989510,4471,1564850,11554360,15.66
9876775,9997430,2818,986300,10983730,9.87
9876776,9973900,1540,539000,10512900,5.40
9876777,9974174,3696,1293600,11267774,12.97
9876778,9997622,4090,1431500,11429122,14.32
9876779,9984782,5641,1974350,11959132,19.77
9876780,9995871,5890,2061500,12057371,20.62
9876781,9986138,2568,898800,10884938,9.00
9876783,9974473,4832,1691200,11665673,16.96
9876784,9988323,4241,1484350,11472673,14.86
9876785,9983628,3802,1330700,11314328,13.33
9876788,9974667,4431,1550850,11525517,15.55
9876789,9969151,585,204750,10173901,2.05
9876790,9969699,2548,891800,10861499,8.95
9876791,9968174,2934,1026900,10995074,10.30
9876792,9982175,4031,1410850,11393025,14.13
9876793,9993814,3451,1207850,11201664,12.09
9876794,9986164,4098,1434300,11420464,14.36
9876795,9985120,3218,1126300,11111420,11.28
9876796,5019827,1199,419650,5439477,8.36
9876797,9873893,4122,1442700,11316593,14.61
9876798,9981684,3807,1332450,11314134,13.35
9876799,9983656,2943,1030050,11013706,10.32
9876800,3603844,855,299250,3903094,8.30
9876801,9982398,4270,1494500,11476898,14.97
9876802,9976388,3661,1281350,11257738,12.84
9876804,9987416,3332,1166200,11153616,11.68
9876805,9989351,4103,1436050,11425401,14.38
9876806,9976856,3856,1349600,11326456,13.53
9876807,9886284,5325,1863750,11750034,18.85
9876808,9982372,2656,929600,10911972,9.31
9876809,9974723,4673,1635550,11610273,16.40
9876810,9973592,5751,2012850,11986442,20.18
9876811,9974486,3871,1354850,11329336,13.58
9876812,9987861,3684,1289400,11277261,12.91
9876813,9991431,4372,1530200,11521631,15.32
9876814,9970678,2756,964600,10935278,9.67
9876815,9991060,3873,1355550,11346610,13.57
9876816,9983763,3138,1098300,11082063,11.00
9876817,773839,673,235550,1009389,30.44
9876818,9976757,1268,443800,10420557,4.45
9876819,9954854,130,45500,10000354,0.46
9876820,9906228,3724,1303400,11209628,13.16
9876821,842653,408,142800,985453,16.95
9876822,648144,881,308350,956494,47.57
9876823,9932277,2893,1012550,10944827,10.19
9876824,9941283,3856,1349600,11290883,13.58
9876825,9958431,5742,2009700,11968131,20.18
9876826,9961468,4271,1494850,11456318,15.01
9876827,9967317,3005,1051750,11019067,10.55
9876828,9953349,3802,1330700,11284049,13.37
9876829,9955546,2833,991550,10947096,9.96
9876830,9969497,5163,1807050,11776547,18.13
9876831,9972018,2930,1025500,10997518,10.28
9876832,1303296,1065,372750,1676046,28.60
9876833,9957841,3498,1224300,11182141,12.29
9876834,9945443,4608,1612800,11558243,16.22
9876835,9926273,2571,899850,10826123,9.07
9876836,9932591,1615,565250,10497841,5.69
9876837,4645013,1827,639450,5284463,13.77
9876838,9932385,2458,860300,10792685,8.66
9876839,9926566,5292,1852200,11778766,18.66
9876840,9929734,3369,1179150,11108884,11.87
9876841,9923591,3717,1300950,11224541,13.11
9876842,9938359,2952,1033200,10971559,10.40
9876843,9943387,3134,1096900,11040287,11.03
9876844,9946228,3492,1222200,11168428,12.29
9876845,9963047,3372,1180200,11143247,11.85
9876846,9961482,3057,1069950,11031432,10.74
9876848,9955579,2901,1015350,10970929,10.20
9876849,9952505,4744,1660400,11612905,16.68
9876850,9952228,2295,803250,10755478,8.07
9876852,3839214,1107,387450,4226664,10.09
9876853,9963344,3384,1184400,11147744,11.89
9876854,9965248,3708,1297800,11263048,13.02
9876855,9954630,4248,1486800,11441430,14.94
9876856,9969981,4546,1591100,11561081,15.96
9876857,9536532,2775,971250,10507782,10.18
9876858,9982075,2555,894250,10876325,8.96
9876859,9968941,2393,837550,10806491,8.40
9876860,9990403,1360,476000,10466403,4.76
9876861,9992629,4476,1566600,11559229,15.68
9876862,9972573,3079,1077650,11050223,10.81
9876863,9981273,5146,1801100,11782373,18.04
9876864,9994955,2260,791000,10785955,7.91
9876865,9977972,3671,1284850,11262822,12.88
9876866,9981297,3810,1333500,11314797,13.36
9876867,9980693,3696,1293600,11274293,12.96
9876868,1381103,908,317800,1698903,23.01
9876869,9987110,4154,1453900,11441010,14.56
9876870,9973095,5000,1750000,11723095,17.55
9876871,9979188,910,318500,10297688,3.19
9876872,9956608,3201,1120350,11076958,11.25
9876873,9975643,3528,1234800,11210443,12.38
9876874,9999305,3940,1379000,11378305,13.79
9876875,9988873,2892,1012200,11001073,10.13
9876876,9981071,2946,1031100,11012171,10.33
9876877,9994858,3279,1147650,11142508,11.48
9876878,6194929,1789,626150,6821079,10.11
9876879,5573610,3108,1087800,6661410,19.52
9876880,9966938,1937,677950,10644888,6.80
9876881,9978101,3645,1275750,11253851,12.79
9876882,9978950,3778,1322300,11301250,13.25
9876883,9990226,2197,768950,10759176,7.70
9876884,9979551,4367,1528450,11508001,15.32
9876885,9997984,6607,2312450,12310434,23.13
9876886,9974926,4647,1626450,11601376,16.31
9876887,9993266,3574,1250900,11244166,12.52
9876888,9993194,3798,1329300,11322494,13.30
9876889,9975870,4945,1730750,11706620,17.35
9876890,9977993,4576,1601600,11579593,16.05
9876891,2233058,1047,366450,2599508,16.41
9876892,9979006,4554,1593900,11572906,15.97
9876893,9998671,3909,1368150,11366821,13.68
9876894,9981788,7050,2467500,12449288,24.72
9876895,9983760,5025,1758750,11742510,17.62
9876896,9832510,4478,1567300,11399810,15.94
9876897,9977831,2639,923650,10901481,9.26
9876898,9984876,5553,1943550,11928426,19.46
9876899,9995969,4324,1513400,11509369,15.14
9876900,9982893,4730,1655500,11638393,16.58
9876901,9990009,1963,687050,10677059,6.88
9876902,9987967,3393,1187550,11175517,11.89
9876903,9979752,7278,2547300,12527052,25.52
9876904,9990675,7220,2527000,12517675,25.29
9876905,9987291,4315,1510250,11497541,15.12
9876906,9986586,5843,2045050,12031636,20.48
9876907,9982999,5004,1751400,11734399,17.54
9876908,9976480,3185,1114750,11091230,11.17
9876909,9979852,3687,1290450,11270302,12.93
9876911,9973837,5498,1924300,11898137,19.29
9876912,9984452,4161,1456350,11440802,14.59
9876913,9971024,4514,1579900,11550924,15.84
9876914,9999869,4258,1490300,11490169,14.90
9876915,9970226,5933,2076550,12046776,20.83
9876916,9961948,7623,2668050,12629998,26.78
9876917,9969313,3786,1325100,11294413,13.29
9876918,9980145,5946,2081100,12061245,20.85
9876919,1235922,186,65100,1301022,5.27
9876920,9983745,5551,1942850,11926595,19.46
9876921,9376569,3487,1220450,10597019,13.02
9876922,1150338,216,75600,1225938,6.57
9876923,9961546,4765,1667750,11629296,16.74
9876924,6887444,5276,1846600,8734044,26.81
9876925,9979713,4801,1680350,11660063,16.84
9876926,9992588,3410,1193500,11186088,11.94
9876927,9976764,2078,727300,10704064,7.29
9876928,2507722,490,171500,2679222,6.84
9876929,5529862,1580,553000,6082862,10.00
9876930,9970805,3696,1293600,11264405,12.97
9876931,9982428,5210,1823500,11805928,18.27
9876932,9987650,6352,2223200,12210850,22.26
9876933,9998031,5799,2029650,12027681,20.30
9876934,9972884,3061,1071350,11044234,10.74
9876935,8335438,2080,728000,9063438,8.73
9876936,9974527,4830,1690500,11665027,16.95
9876937,9960806,5400,1890000,11850806,18.97
9876938,9941187,2544,890400,10831587,8.96
9876939,9982310,4501,1575350,11557660,15.78
9876940,9978376,5039,1763650,11742026,17.67
9876941,2218652,1002,350700,2569352,15.81
9876942,9957430,3228,1129800,11087230,11.35
9876943,9951340,4994,1747900,11699240,17.56
9876944,9946970,2157,754950,10701920,7.59
9876945,9900096,4034,1411900,11311996,14.26
9876946,5949557,2022,707700,6657257,11.90
9876947,9943799,3993,1397550,11341349,14.05
9876948,9948364,3543,1240050,11188414,12.46
9876949,9966646,4651,1627850,11594496,16.33
9876950,9980228,4826,1689100,11669328,16.92
9876951,9979144,6350,2222500,12201644,22.27
9876952,9974964,4691,1641850,11616814,16.46
9876953,9961526,4563,1597050,11558576,16.03
9876954,9969011,4416,1545600,11514611,15.50
9876955,9978926,3817,1335950,11314876,13.39
9876956,2213826,688,240800,2454626,10.88
9876957,9976448,4381,1533350,11509798,15.37
9876958,9963822,4327,1514450,11478272,15.20
9876959,9966040,4776,1671600,11637640,16.77
9876960,9962090,3687,1290450,11252540,12.95
9876961,9973402,4940,1729000,11702402,17.34
9876962,9962220,3767,1318450,11280670,13.23
9876963,9967815,2359,825650,10793465,8.28
9876966,9969750,4169,1459150,11428900,14.64
9876967,656472,198,69300,725772,10.56
9876968,9940239,3318,1161300,11101539,11.68
9876969,9952617,2229,780150,10732767,7.84
9876971,9979913,2772,970200,10950113,9.72
9876972,9983019,5478,1917300,11900319,19.21
9876973,9974298,4254,1488900,11463198,14.93
9876974,9979594,5804,2031400,12010994,20.36
9876975,9971894,4716,1650600,11622494,16.55
9876976,9973392,6131,2145850,12119242,21.52
9876977,9979864,4118,1441300,11421164,14.44
9876978,9974036,3798,1329300,11303336,13.33
9876979,9985999,5437,1902950,11888949,19.06
9876980,9985134,4319,1511650,11496784,15.14
9876981,9990386,2269,794150,10784536,7.95
9876982,9993058,5886,2060100,12053158,20.62
9876983,9982328,1827,639450,10621778,6.41
9876984,9513445,2266,793100,10306545,8.34
9876985,9999034,5614,1964900,11963934,19.65
9876986,2643930,846,296100,2940030,11.20
9876987,9999236,2723,953050,10952286,9.53
9876988,9980460,2660,931000,10911460,9.33
9876989,9978989,7018,2456300,12435289,24.61
9876990,9975327,4020,1407000,11382327,14.10
9876991,9977784,1829,640150,10617934,6.42
9876992,9988227,2166,758100,10746327,7.59
9876993,9990093,3748,1311800,11301893,13.13
9876994,9985342,4744,1660400,11645742,16.63
9876995,9941621,3156,1104600,11046221,11.11
9876996,9978969,2041,714350,10693319,7.16
9876997,9979957,1720,602000,10581957,6.03
9876998,9968689,4940,1729000,11697689,17.34
9876999,9959751,2102,735700,10695451,7.39
9877000,9980265,3248,1136800,11117065,11.39
9877001,9994864,3995,1398250,11393114,13.99
9877002,9966637,4263,1492050,11458687,14.97
9877003,9967822,4765,1667750,11635572,16.73
9877004,9975268,3905,1366750,11342018,13.70
9877005,8961533,3469,1214150,10175683,13.55
9877006,9959665,3285,1149750,11109415,11.54
9877007,9973001,6083,2129050,12102051,21.35
9877008,9990501,4403,1541050,11531551,15.43
9877009,9992231,4788,1675800,11668031,16.77
9877010,9971343,4599,1609650,11580993,16.14
9877012,9974163,3976,1391600,11365763,13.95
9877013,9970572,2453,858550,10829122,8.61
9877015,9955225,2609,913150,10868375,9.17
9877016,9948324,4672,1635200,11583524,16.44
9877017,9957069,2658,930300,10887369,9.34
9877018,9965280,3208,1122800,11088080,11.27
9877019,9970626,2443,855050,10825676,8.58
9877020,9983156,4203,1471050,11454206,14.74
9877021,9983216,2025,708750,10691966,7.10
9877022,9995617,3056,1069600,11065217,10.70
9877023,9983385,5138,1798300,11781685,18.01
9877024,9966063,4861,1701350,11667413,17.07
9877026,9979846,3699,1294650,11274496,12.97
9877027,9964101,1731,605850,10569951,6.08
9877028,9958293,2727,954450,10912743,9.58
9877029,9950144,3170,1109500,11059644,11.15
9877030,9951914,2212,774200,10726114,7.78
9877031,9948063,3753,1313550,11261613,13.20
9877032,9972325,6718,2351300,12323625,23.58
9877033,9980738,5339,1868650,11849388,18.72
9877034,9973731,3577,1251950,11225681,12.55
9877035,9968867,2914,1019900,10988767,10.23
9877036,9967861,2703,946050,10913911,9.49
9877037,9960139,5680,1988000,11948139,19.96
9877038,5235549,3929,1375150,6610699,26.27
9877039,9951925,3624,1268400,11220325,12.75
9877040,9962586,3030,1060500,11023086,10.64
9877041,8954224,4366,1528100,10482324,17.07
9877042,3989366,1304,456400,4445766,11.44
9877043,9954346,4627,1619450,11573796,16.27
9877044,9944023,5073,1775550,11719573,17.86
9877045,9957134,3477,1216950,11174084,12.22
9877046,9956238,4727,1654450,11610688,16.62
9877047,9953855,2670,934500,10888355,9.39
9877048,9951372,3440,1204000,11155372,12.10
9877049,9949074,4917,1720950,11670024,17.30
9877050,9945657,3296,1153600,11099257,11.60
9877051,9962566,4940,1729000,11691566,17.35
9877052,9952524,3553,1243550,11196074,12.49
9877053,9398330,1807,632450,10030780,6.73
9877055,9971782,2246,786100,10757882,7.88
9877056,9968195,4296,1503600,11471795,15.08
9877057,9976188,3831,1340850,11317038,13.44
9877058,9963509,4460,1561000,11524509,15.67
9877059,9988692,2701,945350,10934042,9.46
9877060,9990009,4034,1411900,11401909,14.13
9877061,9946829,2741,959350,10906179,9.64
9877062,9965274,4900,1715000,11680274,17.21
9877063,9996547,3391,1186850,11183397,11.87
9877064,9968503,5039,1763650,11732153,17.69
9877065,9980840,3499,1224650,11205490,12.27
9877067,3846085,1996,698600,4544685,18.16
9877068,9807437,1776,621600,10429037,6.34
9877069,9988213,4795,1678250,11666463,16.80
9877070,9969007,3471,1214850,11183857,12.19
9877071,9973229,1928,674800,10648029,6.77
9877074,9953630,3608,1262800,11216430,12.69
9877075,9971083,4828,1689800,11660883,16.95
9877076,9961829,4338,1518300,11480129,15.24
9877077,9955505,2829,990150,10945655,9.95
9877079,9951121,6738,2358300,12309421,23.70
9877080,9965262,3770,1319500,11284762,13.24
9877081,9964755,2299,804650,10769405,8.07
9877082,9184445,4176,1461600,10646045,15.91
9877083,9985363,3497,1223950,11209313,12.26
9877085,9965283,4464,1562400,11527683,15.68
9877086,9954836,5328,1864800,11819636,18.73
9877087,9970362,2627,919450,10889812,9.22
9877088,9993523,6076,2126600,12120123,21.28
9877089,9992064,4883,1709050,11701114,17.10
9877090,9980274,4068,1423800,11404074,14.27
9877091,9985608,3892,1362200,11347808,13.64
9877092,9990972,2543,890050,10881022,8.91
9877093,9985384,4350,1522500,11507884,15.25
9877094,9995173,3786,1325100,11320273,13.26
9877095,9979103,2552,893200,10872303,8.95
9877096,9986338,5947,2081450,12067788,20.84
9877097,9965332,2700,945000,10910332,9.48
9877098,9966401,3030,1060500,11026901,10.64
9877099,9960555,4093,1432550,11393105,14.38
9877100,9945283,2581,903350,10848633,9.08
9877101,9957793,5165,1807750,11765543,18.15
9877102,9940770,4780,1673000,11613770,16.83
9877103,9949833,2652,928200,10878033,9.33
9877104,9969929,1940,679000,10648929,6.81
9877105,9869976,2473,865550,10735526,8.77
9877106,9984051,2891,1011850,10995901,10.13
9877107,9982250,2827,989450,10971700,9.91
9877108,9974722,7797,2728950,12703672,27.36
9877109,9988579,4040,1414000,11402579,14.16
9877111,9984577,3726,1304100,11288677,13.06
9877112,9998454,3493,1222550,11221004,12.23
9877113,9966640,4704,1646400,11613040,16.52
9877114,9975182,5317,1860950,11836132,18.66
9877115,9989814,5233,1831550,11821364,18.33
9877116,9987296,3922,1372700,11359996,13.74
9877117,9988277,5337,1867950,11856227,18.70
9877118,9983739,1888,660800,10644539,6.62
9877119,9991199,3485,1219750,11210949,12.21
9877120,9993741,2676,936600,10930341,9.37
9877121,9972530,4415,1545250,11517780,15.50
9877122,9997559,3405,1191750,11189309,11.92
9877123,9979085,1321,462350,10441435,4.63
9877124,9997748,4745,1660750,11658498,16.61
9877125,9993779,5394,1887900,11881679,18.89
9877126,9983764,2485,869750,10853514,8.71
9877127,9970913,4029,1410150,11381063,14.14
9877128,9896686,5233,1831550,11728236,18.51
9877129,9985611,1539,538650,10524261,5.39
9877130,4626253,2620,917000,5543253,19.82
9877131,9979979,7153,2503550,12483529,25.09
9877132,9986710,5166,1808100,11794810,18.11
9877133,9995726,5337,1867950,11863676,18.69
9877134,9994345,4343,1520050,11514395,15.21
9877135,9980889,3105,1086750,11067639,10.89
9877136,1124261,827,289450,1413711,25.75
9877137,9974234,3585,1254750,11228984,12.58
9877138,9608495,4567,1598450,11206945,16.64
9877139,9980437,4057,1419950,11400387,14.23
9877140,6624241,2672,935200,7559441,14.12
9877141,9986497,3419,1196650,11183147,11.98
9877142,9979573,2643,925050,10904623,9.27
9877143,9976121,5648,1976800,11952921,19.82
9877144,9994165,5013,1754550,11748715,17.56
9877145,6962701,4242,1484700,8447401,21.32
9877146,9991022,5510,1928500,11919522,19.30
9877147,9988173,5763,2017050,12005223,20.19
9877148,9989540,4467,1563450,11552990,15.65
9877149,9816334,3186,1115100,10931434,11.36
9877150,9984634,4754,1663900,11648534,16.66
9877151,9994548,3877,1356950,11351498,13.58
9877152,9987197,2192,767200,10754397,7.68
9877153,9983660,4131,1445850,11429510,14.48
9877154,8985864,4930,1725500,10711364,19.20
9877155,9994965,4000,1400000,11394965,14.01
9877156,9992222,2078,727300,10719522,7.28
9877157,9994448,1957,684950,10679398,6.85
9877158,9985694,4417,1545950,11531644,15.48
9877159,9968214,1617,565950,10534164,5.68
9877160,9975804,1739,608650,10584454,6.10
9877161,9869735,2229,780150,10649885,7.90
9877162,9984672,3554,1243900,11228572,12.46
9877163,9992490,6607,2312450,12304940,23.14
9877164,9999130,5350,1872500,11871630,18.73
9877165,7353363,2905,1016750,8370113,13.83
9877166,9976957,2701,945350,10922307,9.48
9877167,9965084,5600,1960000,11925084,19.67
9877168,9973286,3544,1240400,11213686,12.44
9877169,9992192,2295,803250,10795442,8.04
9877170,9991240,3668,1283800,11275040,12.85
9877171,9745066,4263,1492050,11237116,15.31
9877172,9994081,5129,1795150,11789231,17.96
9877174,9959536,2619,916650,10876186,9.20
9877175,9951338,3985,1394750,11346088,14.02
9877176,9990148,2141,749350,10739498,7.50
9877177,9995692,5045,1765750,11761442,17.67
9877178,9983810,3439,1203650,11187460,12.06
9877179,2514851,1535,537250,3052101,21.36
9877180,9976332,4623,1618050,11594382,16.22
9877181,9976290,3247,1136450,11112740,11.39
9877182,9989794,2202,770700,10760494,7.71
9877183,9976119,5178,1812300,11788419,18.17
9877184,9979692,5159,1805650,11785342,18.09
9877185,9987085,3993,1397550,11384635,13.99
9877186,9974408,3164,1107400,11081808,11.10
9877187,9962766,4946,1731100,11693866,17.38
9877188,9982515,5479,1917650,11900165,19.21
9877189,8988171,3400,1190000,10178171,13.24
9877190,9987105,3428,1199800,11186905,12.01
9877191,9975720,3145,1100750,11076470,11.03
9877192,9987819,4697,1643950,11631769,16.46
9877193,9989068,4871,1704850,11693918,17.07
9877194,9975980,3243,1135050,11111030,11.38
9877195,9988591,5514,1929900,11918491,19.32
9877196,2764006,1111,388850,3152856,14.07
9877197,9981336,3422,1197700,11179036,12.00
9877198,9618580,3959,1385650,11004230,14.41
9877199,9977553,4530,1585500,11563053,15.89
9877200,9986417,4355,1524250,11510667,15.26
9877201,4660906,717,250950,4911856,5.38
9877202,3448993,2346,821100,4270093,23.81
9877203,9985604,1457,509950,10495554,5.11
9877204,9974760,3772,1320200,11294960,13.24
9877205,4850356,2844,995400,5845756,20.52
9877206,9952208,3941,1379350,11331558,13.86
9877207,9996668,3799,1329650,11326318,13.30
9877208,9997402,4536,1587600,11585002,15.88
9877209,9898320,2895,1013250,10911570,10.24
9877210,9995120,3107,1087450,11082570,10.88
9877211,9978121,3901,1365350,11343471,13.68
9877212,9970531,5697,1993950,11964481,20.00
9877213,9983240,2222,777700,10760940,7.79
9877214,9971541,3469,1214150,11185691,12.18
9877215,9993784,5071,1774850,11768634,17.76
9877216,9980024,5590,1956500,11936524,19.60
9877217,9993733,4032,1411200,11404933,14.12
9877218,9996550,3663,1282050,11278600,12.82
9877219,9971006,3853,1348550,11319556,13.52
9877220,8964613,4862,1701700,10666313,18.98
9877221,9969165,5068,1773800,11742965,17.79
9877223,9947161,4524,1583400,11530561,15.92
9877224,9699768,6708,2347800,12047568,24.20
9877225,9939566,4191,1466850,11406416,14.76
9877226,9957223,3087,1080450,11037673,10.85
9877227,9955289,5211,1823850,11779139,18.32
9877228,9968476,4171,1459850,11428326,14.64
9877229,9972384,6067,2123450,12095834,21.29
9877230,9875461,4304,1506400,11381861,15.25
9877231,9978143,2869,1004150,10982293,10.06
9877232,9997387,2950,1032500,11029887,10.33
9877233,9981593,6289,2201150,12182743,22.05
9877234,9978805,2437,852950,10831755,8.55
9877235,9981414,3366,1178100,11159514,11.80
9877236,9986489,4756,1664600,11651089,16.67
9877237,9991975,3662,1281700,11273675,12.83
9877238,9987318,3314,1159900,11147218,11.61
9877239,9979035,2919,1021650,11000685,10.24
9877240,9987204,5404,1891400,11878604,18.94
9877241,9993625,4289,1501150,11494775,15.02
9877242,9983673,2966,1038100,11021773,10.40
9877243,9991157,5341,1869350,11860507,18.71
9877244,9974110,2902,1015700,10989810,10.18
9877245,9981569,2817,985950,10967519,9.88
9877246,9975557,1750,612500,10588057,6.14
9877247,8735997,2054,718900,9454897,8.23
9877248,8195961,3557,1244950,9440911,15.19
9877249,8981822,2510,878500,9860322,9.78
9877250,8997989,4182,1463700,10461689,16.27
9877251,9992670,3965,1387750,11380420,13.89
9877252,9985079,3412,1194200,11179279,11.96
9877253,9994074,3020,1057000,11051074,10.58
9877254,9980163,3526,1234100,11214263,12.37
9877255,9998942,2914,1019900,11018842,10.20
9877256,9972394,3679,1287650,11260044,12.91
9877258,9962552,5929,2075150,12037702,20.83
9877259,9957545,3632,1271200,11228745,12.77
9877260,9947030,1254,438900,10385930,4.41
9877261,9926359,4221,1477350,11403709,14.88
9877262,8926962,3314,1159900,10086862,12.99
9877263,9916127,3939,1378650,11294777,13.90
9877264,9915278,3162,1106700,11021978,11.16
9877265,9915036,3694,1292900,11207936,13.04
9877266,9903133,4031,1410850,11313983,14.25
9877267,9906172,3019,1056650,10962822,10.67
9877268,9923830,3399,1189650,11113480,11.99
9877269,9898051,3248,1136800,11034851,11.49
9877270,9890690,5159,1805650,11696340,18.26
9877271,9896631,5082,1778700,11675331,17.97
9877272,3322935,536,187600,3510535,5.65
9877273,9879968,6183,2164050,12044018,21.90
9877274,9873210,3470,1214500,11087710,12.30
9877275,9873085,1782,623700,10496785,6.32
9877276,9890372,1533,536550,10426922,5.42
9877277,9867500,4020,1407000,11274500,14.26
9877278,9877646,3958,1385300,11262946,14.02
9877279,9878013,4156,1454600,11332613,14.73
9877280,9891070,2408,842800,10733870,8.52
9877281,9894576,2887,1010450,10905026,10.21
9877282,9888585,4504,1576400,11464985,15.94
9877283,9888119,3544,1240400,11128519,12.54
9877284,9886904,5436,1902600,11789504,19.24
9877285,9895562,4607,1612450,11508012,16.29
9877287,9872072,2089,731150,10603222,7.41
9877288,9875041,3642,1274700,11149741,12.91
9877289,9877481,6426,2249100,12126581,22.77
9877290,9874460,6266,2193100,12067560,22.21
9877291,9880262,3595,1258250,11138512,12.73
9877292,9898799,5508,1927800,11826599,19.48
9877293,9876545,2818,986300,10862845,9.99
9877294,8674312,2814,984900,9659212,11.35
9877295,9892051,4646,1626100,11518151,16.44
9877296,9901178,4980,1743000,11644178,17.60
9877297,9912537,2966,1038100,10950637,10.47
9877298,9922144,5914,2069900,11992044,20.86
9877299,9925814,3222,1127700,11053514,11.36
9877300,9929619,2013,704550,10634169,7.10
9877301,7165626,3164,1107400,8273026,15.45
9877302,9925202,3644,1275400,11200602,12.85
9877303,9939345,4657,1629950,11569295,16.40
9877304,9939750,3616,1265600,11205350,12.73
9877305,2087322,1172,410200,2497522,19.65
9877306,9939733,3500,1225000,11164733,12.32
9877307,7543037,2609,913150,8456187,12.11
9877309,9942607,3222,1127700,11070307,11.34
9877310,9918923,6384,2234400,12153323,22.53
9877311,9934186,7362,2576700,12510886,25.94
9877312,9940793,4168,1458800,11399593,14.67
9877313,9947206,5988,2095800,12043006,21.07
9877314,9941224,3349,1172150,11113374,11.79
9877315,9452341,2381,833350,10285691,8.82
9877316,9973491,2795,978250,10951741,9.81
9877317,9965338,1061,371350,10336688,3.73
9877318,9965199,2598,909300,10874499,9.12
9877319,9963483,2966,1038100,11001583,10.42
9877320,9966887,2394,837900,10804787,8.41
9877321,9971143,2601,910350,10881493,9.13
9877322,9964628,4113,1439550,11404178,14.45
9877323,9963262,361,126350,10089612,1.27
9877324,9960278,3000,1050000,11010278,10.54
9877325,9963111,3835,1342250,11305361,13.47
9877326,9957773,3637,1272950,11230723,12.78
9877327,9942617,3956,1384600,11327217,13.93
9877328,9956306,5675,1986250,11942556,19.95
9877329,9961545,3134,1096900,11058445,11.01
9877330,9975450,2301,805350,10780800,8.07
9877331,9982289,3399,1189650,11171939,11.92
9877332,9972068,4063,1422050,11394118,14.26
9877333,9453222,5081,1778350,11231572,18.81
9877334,9992080,2803,981050,10973130,9.82
9877335,9992212,6087,2130450,12122662,21.32
9877336,9974513,5645,1975750,11950263,19.81
9877339,9971350,3094,1082900,11054250,10.86
9877340,5651888,3624,1268400,6920288,22.44
9877342,9973381,4725,1653750,11627131,16.58
9877343,9963743,4294,1502900,11466643,15.08
9877344,9964875,3121,1092350,11057225,10.96
9877345,9962195,2262,791700,10753895,7.95
9877346,9960429,4026,1409100,11369529,14.15
9877348,9971797,5588,1955800,11927597,19.61
9877349,9985727,3593,1257550,11243277,12.59
9877350,9981345,6660,2331000,12312345,23.35
9877351,9978128,4732,1656200,11634328,16.60
9877352,9988198,5027,1759450,11747648,17.62
9877353,9972761,6068,2123800,12096561,21.30
9877354,9986593,4675,1636250,11622843,16.38
9877355,9979931,4311,1508850,11488781,15.12
9877356,9988530,3871,1354850,11343380,13.56
9877357,9975877,4320,1512000,11487877,15.16
9877358,6774790,1419,496650,7271440,7.33
9877359,9980518,3479,1217650,11198168,12.20
9877360,9986908,3025,1058750,11045658,10.60
9877361,9973688,6236,2182600,12156288,21.88
9877362,9976736,5863,2052050,12028786,20.57
9877363,9961563,2910,1018500,10980063,10.22
9877364,9968481,2947,1031450,10999931,10.35
9877365,2091734,61,21350,2113084,1.02
9877366,2398245,2014,704900,3103145,29.39
9877367,9916452,3253,1138550,11055002,11.48
9877368,9991848,5819,2036650,12028498,20.38
9877369,9989296,5417,1895950,11885246,18.98
9877370,9995843,2682,938700,10934543,9.39
9877371,9981714,2532,886200,10867914,8.88
9877372,9997903,1933,676550,10674453,6.77
9877373,9978083,3135,1097250,11075333,11.00
9877374,6159239,1876,656600,6815839,10.66
9877375,3171114,1517,530950,3702064,16.74
9877376,9977854,3957,1384950,11362804,13.88
9877377,9979516,3436,1202600,11182116,12.05
9877378,9983965,2800,980000,10963965,9.82
9877379,2528580,777,271950,2800530,10.76
9877380,9993984,4779,1672650,11666634,16.74
9877381,9991027,5848,2046800,12037827,20.49
9877382,9977762,3079,1077650,11055412,10.80
9877383,4602085,1733,606550,5208635,13.18
9877384,9978528,4154,1453900,11432428,14.57
9877385,9989607,4468,1563800,11553407,15.65
9877386,9984728,3098,1084300,11069028,10.86
9877387,9982973,2831,990850,10973823,9.93
9877388,9970066,4506,1577100,11547166,15.82
9877390,9972516,1102,385700,10358216,3.87
9877391,9977638,4848,1696800,11674438,17.01
9877392,9970591,2343,820050,10790641,8.22
9877393,9990059,4747,1661450,11651509,16.63
9877394,2206217,802,280700,2486917,12.72
9877395,9960722,3862,1351700,11312422,13.57
9877396,8140810,1745,610750,8751560,7.50
9877397,9987534,4477,1566950,11554484,15.69
9877398,9980014,1659,580650,10560664,5.82
9877399,9956980,3264,1142400,11099380,11.47
9877400,9959595,4379,1532650,11492245,15.39
9877401,9969793,2720,952000,10921793,9.55
9877402,9952870,2730,955500,10908370,9.60
9877403,9975473,4733,1656550,11632023,16.61
9877404,9976618,3742,1309700,11286318,13.13
9877405,9591138,2723,953050,10544188,9.94
9877406,9964413,3208,1122800,11087213,11.27
9877407,9989046,3575,1251250,11240296,12.53
9877408,9947537,1874,655900,10603437,6.59
9877409,9997026,2081,728350,10725376,7.29
9877410,9988297,3594,1257900,11246197,12.59
9877411,9981979,5139,1798650,11780629,18.02
9877412,9986825,3886,1360100,11346925,13.62
9877413,9998752,3040,1064000,11062752,10.64
9877414,9982550,4599,1609650,11592200,16.12
9877415,9985509,4217,1475950,11461459,14.78
9877416,9963344,2329,815150,10778494,8.18
9877417,9975153,3965,1387750,11362903,13.91
9877418,9971581,4074,1425900,11397481,14.30
9877419,9969555,4204,1471400,11440955,14.76
9877420,9977931,4131,1445850,11423781,14.49
9877421,9975508,3702,1295700,11271208,12.99
9877422,9894150,6128,2144800,12038950,21.68
9877423,9983859,5375,1881250,11865109,18.84
9877424,9986522,5168,1808800,11795322,18.11
9877425,9985353,1814,634900,10620253,6.36
9877426,9972468,2627,919450,10891918,9.22
9877427,9950820,2660,931000,10881820,9.36
9877428,9957295,4568,1598800,11556095,16.06
9877429,9957897,2509,878150,10836047,8.82
9877430,9957083,2931,1025850,10982933,10.30
9877431,9952767,3762,1316700,11269467,13.23
9877432,9954717,5325,1863750,11818467,18.72
9877433,9977243,5126,1794100,11771343,17.98
9877434,9956922,1102,385700,10342622,3.87
9877435,9968866,3114,1089900,11058766,10.93
9877436,9946169,2446,856100,10802269,8.61
9877437,7050123,2098,734300,7784423,10.42
9877438,9944968,3063,1072050,11017018,10.78
9877439,9950909,4277,1496950,11447859,15.04
9877440,9962104,3987,1395450,11357554,14.01
9877442,9954071,2936,1027600,10981671,10.32
9877443,9947489,3730,1305500,11252989,13.12
9877444,9968962,3058,1070300,11039262,10.74
9877445,9973494,4639,1623650,11597144,16.28
9877446,9985276,2248,786800,10772076,7.88
9877447,9954763,2378,832300,10787063,8.36
9877448,9979618,2971,1039850,11019468,10.42
9877449,9972422,4471,1564850,11537272,15.69
9877450,9984004,4129,1445150,11429154,14.47
9877451,9986209,3643,1275050,11261259,12.77
9877452,9978757,2742,959700,10938457,9.62
9877453,9964759,3599,1259650,11224409,12.64
9877454,9998617,4295,1503250,11501867,15.03
9877455,9984204,2579,902650,10886854,9.04
9877456,9981234,4733,1656550,11637784,16.60
9877457,9969629,2809,983150,10952779,9.86
9877458,9982221,3781,1323350,11305571,13.26
9877459,9976351,3461,1211350,11187701,12.14
9877460,9985860,4492,1572200,11558060,15.74
9877461,9998720,3515,1230250,11228970,12.30
9877462,9996625,4322,1512700,11509325,15.13
9877463,9970770,3779,1322650,11293420,13.27
9877464,9978217,4825,1688750,11666967,16.92
9877465,9983659,3533,1236550,11220209,12.39
9877466,9958352,2363,827050,10785402,8.31
9877467,9984924,4347,1521450,11506374,15.24
9877468,9972518,2580,903000,10875518,9.05
9877469,9982039,6202,2170700,12152739,21.75
9877471,9980384,2488,870800,10851184,8.73
9877472,9985987,3778,1322300,11308287,13.24
9877473,9995996,3671,1284850,11280846,12.85
9877474,9988747,2555,894250,10882997,8.95
9877475,9974344,4603,1611050,11585394,16.15
9877476,9992530,2593,907550,10900080,9.08
9877478,9968564,3792,1327200,11295764,13.31
9877479,7449770,3264,1142400,8592170,15.33
9877480,9970214,2961,1036350,11006564,10.39
9877481,9972068,3295,1153250,11125318,11.56
9877482,9967700,2561,896350,10864050,8.99
9877483,8976571,3131,1095850,10072421,12.21
9877484,9989247,3676,1286600,11275847,12.88
9877485,9966563,5589,1956150,11922713,19.63
9877486,2558085,685,239750,2797835,9.37
9877487,9973647,2657,929950,10903597,9.32
9877488,9974263,2449,857150,10831413,8.59
9877489,9973033,3784,1324400,11297433,13.28
9877490,9990807,3174,1110900,11101707,11.12
9877491,9979202,4706,1647100,11626302,16.51
9877492,9979871,3542,1239700,11219571,12.42
9877493,9993625,5524,1933400,11927025,19.35
9877494,9976015,4122,1442700,11418715,14.46
9877495,9962232,4082,1428700,11390932,14.34
9877496,9630354,3589,1256150,10886504,13.04
9877497,9978144,2979,1042650,11020794,10.45
9877498,9891560,3847,1346450,11238010,13.61
9877499,9986311,3315,1160250,11146561,11.62
9877500,9985545,3761,1316350,11301895,13.18
9877501,9969298,2240,784000,10753298,7.86
9877502,9960011,2372,830200,10790211,8.34
9877503,9979785,3537,1237950,11217735,12.40
9877505,9963264,2629,920150,10883414,9.24
9877506,9979590,4527,1584450,11564040,15.88
9877507,9969801,2202,770700,10740501,7.73
9877508,9990256,3782,1323700,11313956,13.25
9877509,9501337,2984,1044400,10545737,10.99
9877510,9981445,3137,1097950,11079395,11.00
9877511,2984045,1532,536200,3520245,17.97
9877512,9979126,2186,765100,10744226,7.67
9877513,9982295,5475,1916250,11898545,19.20
9877514,9980893,2070,724500,10705393,7.26
9877515,9984070,4665,1632750,11616820,16.35
9877516,9974881,2619,916650,10891531,9.19
9877517,9981995,5124,1793400,11775395,17.97
9877518,795538,270,94500,890038,11.88
9877519,9974508,1947,681450,10655958,6.83
9877520,9992267,2318,811300,10803567,8.12
9877521,9999897,3107,1087450,11087347,10.87
9877522,9975584,1171,409850,10385434,4.11
9877523,9970123,3671,1284850,11254973,12.89
9877524,9989258,2488,870800,10860058,8.72
9877525,9984605,2859,1000650,10985255,10.02
9877526,9984983,3122,1092700,11077683,10.94
9877527,9976091,5181,1813350,11789441,18.18
9877528,9982882,4380,1533000,11515882,15.36
9877529,9997312,2451,857850,10855162,8.58
9877530,9984075,2331,815850,10799925,8.17
9877531,9984423,3118,1091300,11075723,10.93
9877532,8813758,3296,1153600,9967358,13.09
9877533,9990730,2851,997850,10988580,9.99
9877534,9990581,5359,1875650,11866231,18.77
9877535,9982061,3283,1149050,11131111,11.51
9877536,9989730,3567,1248450,11238180,12.50
9877537,9983461,5742,2009700,11993161,20.13
9877538,9971963,4174,1460900,11432863,14.65
9877539,9965616,2344,820400,10786016,8.23
9877540,9973311,2776,971600,10944911,9.74
9877541,9966338,5620,1967000,11933338,19.74
9877542,9970147,3059,1070650,11040797,10.74
9877543,9960980,4704,1646400,11607380,16.53
9877544,9966680,4236,1482600,11449280,14.88
9877545,9974592,2744,960400,10934992,9.63
9877546,9966297,4840,1694000,11660297,17.00
9877547,9959607,3077,1076950,11036557,10.81
9877548,8971889,2468,863800,9835689,9.63
9877549,9885965,1461,511350,10397315,5.17
9877550,9471832,4255,1489250,10961082,15.72
9877551,9985964,2664,932400,10918364,9.34
9877552,9988658,3563,1247050,11235708,12.48
9877553,9984044,3856,1349600,11333644,13.52
9877554,9985004,4839,1693650,11678654,16.96
9877555,7496183,2171,759850,8256033,10.14
9877557,9972614,3836,1342600,11315214,13.46
9877558,9960675,4089,1431150,11391825,14.37
9877559,9962239,3151,1102850,11065089,11.07
9877560,9966361,5240,1834000,11800361,18.40
9877561,9976772,3233,1131550,11108322,11.34
9877562,9980280,3207,1122450,11102730,11.25
9877563,9980272,5357,1874950,11855222,18.79
9877564,9985221,3224,1128400,11113621,11.30
9877565,9991251,2931,1025850,11017101,10.27
9877566,9980757,3311,1158850,11139607,11.61
9877567,9982060,1916,670600,10652660,6.72
9877568,9998159,4179,1462650,11460809,14.63
9877569,9974868,2258,790300,10765168,7.92
9877570,9967707,3077,1076950,11044657,10.80
9877571,9981309,3176,1111600,11092909,11.14
9877572,9991331,4792,1677200,11668531,16.79
9877573,9998621,3237,1132950,11131571,11.33
9877574,9999228,3551,1242850,11242078,12.43
9877575,9973805,3277,1146950,11120755,11.50
9877576,9989649,3315,1160250,11149899,11.61
9877577,9989767,4415,1545250,11535017,15.47
9877578,9993770,3925,1373750,11367520,13.75
9877579,9845217,5290,1851500,11696717,18.81
9877580,4332124,1056,369600,4701724,8.53
9877581,9969615,3963,1387050,11356665,13.91
9877582,9996643,3246,1136100,11132743,11.36
9877583,9971240,2014,704900,10676140,7.07
9877585,9982645,4186,1465100,11447745,14.68
9877586,9003171,2957,1034950,10038121,11.50
9877587,9989743,4451,1557850,11547593,15.59
9877588,9990999,2568,898800,10889799,9.00
9877589,9976235,3153,1103550,11079785,11.06
9877590,4867788,2055,719250,5587038,14.78
9877591,9996594,3672,1285200,11281794,12.86
9877592,9961465,2838,993300,10954765,9.97
9877593,9981475,3393,1187550,11169025,11.90
9877594,8977239,2735,957250,9934489,10.66
9877595,9998575,4040,1414000,11412575,14.14
9877596,9983966,4099,1434650,11418616,14.37
9877597,9978024,4989,1746150,11724174,17.50
9877599,9981838,3413,1194550,11176388,11.97
9877600,9981547,6859,2400650,12382197,24.05
9877601,9982275,4605,1611750,11594025,16.15
9877602,9976302,3598,1259300,11235602,12.62
9877603,9982944,2611,913850,10896794,9.15
9877604,9988425,5524,1933400,11921825,19.36
9877605,9985260,3127,1094450,11079710,10.96
9877606,9977236,3187,1115450,11092686,11.18
9877607,9564106,4144,1450400,11014506,15.17
9877608,9990335,3251,1137850,11128185,11.39
9877609,9972827,3143,1100050,11072877,11.03
9877610,9982259,4065,1422750,11405009,14.25
9877611,9974520,4094,1432900,11407420,14.37
9877612,9988183,7602,2660700,12648883,26.64
9877613,9984191,2848,996800,10980991,9.98
9877614,9936252,2849,997150,10933402,10.04
9877615,9949806,2649,927150,10876956,9.32
9877617,9964719,3557,1244950,11209669,12.49
9877618,968000,43,15050,983050,1.55
9877619,9972743,1926,674100,10646843,6.76
9877620,9976609,3583,1254050,11230659,12.57
9877621,9993222,1461,511350,10504572,5.12
9877622,9987997,4106,1437100,11425097,14.39
9877623,9980383,3562,1246700,11227083,12.49
9877624,9994095,5472,1915200,11909295,19.16
9877625,9997351,1795,628250,10625601,6.28
9877626,9984620,3030,1060500,11045120,10.62
9877627,9074770,3415,1195250,10270020,13.17
9877628,9217957,3352,1173200,10391157,12.73
9877629,9983733,1204,421400,10405133,4.22
9877630,9998792,5183,1814050,11812842,18.14
9877631,9999706,5353,1873550,11873256,18.74
9877632,4081652,1205,421750,4503402,10.33
9877633,9985888,4775,1671250,11657138,16.74
9877634,9925664,4580,1603000,11528664,16.15
9877635,9992608,5143,1800050,11792658,18.01
9877636,9998577,3901,1365350,11363927,13.66
9877637,8997549,2774,970900,9968449,10.79
9877638,9978768,3270,1144500,11123268,11.47
9877639,9978754,3305,1156750,11135504,11.59
9877640,3106031,511,178850,3284881,5.76
9877641,9989922,3979,1392650,11382572,13.94
9877642,9978250,1742,609700,10587950,6.11
9877643,9985171,1621,567350,10552521,5.68
9877644,9985685,2270,794500,10780185,7.96
9877645,9994955,1845,645750,10640705,6.46
9877647,9955431,3588,1255800,11211231,12.61
9877648,9973420,4303,1506050,11479470,15.10
9877649,9967873,4136,1447600,11415473,14.52
9877650,9977089,2793,977550,10954639,9.80
9877651,3949145,1229,430150,4379295,10.89
9877652,9982022,2716,950600,10932622,9.52
9877653,9971617,4458,1560300,11531917,15.65
9877654,9977695,2462,861700,10839395,8.64
9877655,9958846,3228,1129800,11088646,11.34
9877656,9975181,3526,1234100,11209281,12.37
9877657,9975574,3666,1283100,11258674,12.86
9877658,9834771,3858,1350300,11185071,13.73
9877659,9987545,5117,1790950,11778495,17.93
9877660,427844,207,72450,500294,16.93
9877661,9963399,2405,841750,10805149,8.45
9877662,9974043,3156,1104600,11078643,11.07
9877663,9971196,4235,1482250,11453446,14.87
9877664,9975081,4247,1486450,11461531,14.90
9877665,9204949,4004,1401400,10606349,15.22
9877666,9973592,3193,1117550,11091142,11.21
9877667,9476538,4393,1537550,11014088,16.22
9877668,9992317,3176,1111600,11103917,11.12
9877669,9977707,1253,438550,10416257,4.40
9877670,9616401,2689,941150,10557551,9.79
9877671,9949078,3355,1174250,11123328,11.80
9877672,9991640,1118,391300,10382940,3.92
9877673,6523034,2960,1036000,7559034,15.88
9877674,9986627,4178,1462300,11448927,14.64
9877675,9983852,4462,1561700,11545552,15.64
9877676,9977933,4038,1413300,11391233,14.16
9877677,9968860,4514,1579900,11548760,15.85
9877678,9959724,4377,1531950,11491674,15.38
9877679,1323146,328,114800,1437946,8.68
9877680,9962709,3523,1233050,11195759,12.38
9877681,9953135,4740,1659000,11612135,16.67
9877682,9953217,2822,987700,10940917,9.92
9877683,9955334,4684,1639400,11594734,16.47
9877684,9974105,4504,1576400,11550505,15.80
9877685,9978071,3712,1299200,11277271,13.02
9877687,9953865,2983,1044050,10997915,10.49
9877688,9964417,5138,1798300,11762717,18.05
9877689,2178120,742,259700,2437820,11.92
9877690,9942096,3220,1127000,11069096,11.34
9877691,9941826,2857,999950,10941776,10.06
9877692,9970710,3461,1211350,11182060,12.15
9877694,726200,458,160300,886500,22.07
9877695,9967004,2054,718900,10685904,7.21
9877696,9412908,3610,1263500,10676408,13.42
9877698,9965418,3159,1105650,11071068,11.09
9877699,9977430,3056,1069600,11047030,10.72
9877700,9973815,3839,1343650,11317465,13.47
9877701,9985389,3718,1301300,11286689,13.03
9877702,9983621,2747,961450,10945071,9.63
9877703,9966287,4934,1726900,11693187,17.33
9877704,9952542,2595,908250,10860792,9.13
9877705,9964196,1723,603050,10567246,6.05
9877706,9983954,3272,1145200,11129154,11.47
9877707,9985737,3757,1314950,11300687,13.17
9877708,9939076,3944,1380400,11319476,13.89
9877709,9978515,3227,1129450,11107965,11.32
9877710,1705378,2306,807100,2512478,47.33
9877711,9960613,3350,1172500,11133113,11.77
9877712,9958114,2844,995400,10953514,10.00
9877713,9966252,3327,1164450,11130702,11.68
9877714,9969552,4891,1711850,11681402,17.17
9877715,9975859,4221,1477350,11453209,14.81
9877716,2500985,1181,413350,2914335,16.53
9877717,9960975,3054,1068900,11029875,10.73
9877718,9952758,3651,1277850,11230608,12.84
9877719,9929452,4656,1629600,11559052,16.41
9877720,9948081,4816,1685600,11633681,16.94
9877721,9934046,4290,1501500,11435546,15.11
9877722,9936585,3454,1208900,11145485,12.17
9877723,6861563,3574,1250900,8112463,18.23
9877724,9935518,4381,1533350,11468868,15.43
9877725,9955637,1183,414050,10369687,4.16
9877726,2822217,802,280700,3102917,9.95
9877727,942260,406,142100,1084360,15.08
9877728,9966830,4703,1646050,11612880,16.52
9877729,9976918,3924,1373400,11350318,13.77
9877730,9958213,4316,1510600,11468813,15.17
9877731,9968303,2292,802200,10770503,8.05
9877732,8694954,3814,1334900,10029854,15.35
9877733,9988720,3410,1193500,11182220,11.95
9877735,9961955,5369,1879150,11841105,18.86
9877736,9980822,4639,1623650,11604472,16.27
9877737,9979476,3473,1215550,11195026,12.18
9877738,9980367,3079,1077650,11058017,10.80
9877739,9976318,2938,1028300,11004618,10.31
9877740,9996707,2979,1042650,11039357,10.43
9877741,9987496,3958,1385300,11372796,13.87
9877742,9981036,2861,1001350,10982386,10.03
9877743,9970680,3802,1330700,11301380,13.35
9877744,2405155,640,224000,2629155,9.31
9877746,9998267,1779,622650,10620917,6.23
9877747,793014,213,74550,867564,9.40
9877748,9972464,3161,1106350,11078814,11.09
9877749,1539383,824,288400,1827783,18.73
9877750,3160453,2181,763350,3923803,24.15
9877751,9971245,1782,623700,10594945,6.25
9877752,2401003,520,182000,2583003,7.58
9877753,9969441,3704,1296400,11265841,13.00
9877754,9978567,3550,1242500,11221067,12.45
9877755,9985810,5856,2049600,12035410,20.53
9877756,9976634,4652,1628200,11604834,16.32
9877757,9791702,3504,1226400,11018102,12.52
9877758,9971151,4192,1467200,11438351,14.71
9877759,9978720,4653,1628550,11607270,16.32
9877760,9966004,3696,1293600,11259604,12.98
9877761,658213,413,144550,802763,21.96
9877762,9980121,2509,878150,10858271,8.80
9877763,9974407,4783,1674050,11648457,16.78
9877764,9988040,4929,1725150,11713190,17.27
9877765,9987416,4772,1670200,11657616,16.72
9877766,9971859,3378,1182300,11154159,11.86
9877767,424008,139,48650,472658,11.47
9877768,9974534,3193,1117550,11092084,11.20
9877769,6853954,2495,873250,7727204,12.74
9877770,9979936,3642,1274700,11254636,12.77
9877771,4252182,2013,704550,4956732,16.57
9877772,7181338,461,161350,7342688,2.25
9877773,9972931,2816,985600,10958531,9.88
9877774,4222363,1334,466900,4689263,11.06
9877775,9982885,3668,1283800,11266685,12.86
9877776,9999512,4585,1604750,11604262,16.05
9877777,9992295,2788,975800,10968095,9.77
9877778,9974355,4460,1561000,11535355,15.65
9877779,3445544,905,316750,3762294,9.19
9877780,9991938,3996,1398600,11390538,14.00
9877781,9976768,3702,1295700,11272468,12.99
9877783,9965428,4059,1420650,11386078,14.26
9877784,9964142,3087,1080450,11044592,10.84
9877785,720605,326,114100,834705,15.83
9877786,9967147,3595,1258250,11225397,12.62
9877787,9969309,3050,1067500,11036809,10.71
9877788,3691819,2296,803600,4495419,21.77
9877789,9964736,5281,1848350,11813086,18.55
9877791,9974712,2357,824950,10799662,8.27
9877792,9977844,5712,1999200,11977044,20.04
9877793,9801296,3799,1329650,11130946,13.57
9877794,9977396,3628,1269800,11247196,12.73
9877795,9723185,3788,1325800,11048985,13.64
9877796,9979263,4772,1670200,11649463,16.74
9877797,9986112,2683,939050,10925162,9.40
9877798,9983358,3456,1209600,11192958,12.12
9877799,9986195,3955,1384250,11370445,13.86
9877800,9996738,520,182000,10178738,1.82
9877801,9986912,4846,1696100,11683012,16.98
9877802,9992586,3797,1328950,11321536,13.30
9877803,9798206,3748,1311800,11110006,13.39
9877804,9973358,814,284900,10258258,2.86
9877805,9983178,3894,1362900,11346078,13.65
9877806,9983681,3154,1103900,11087581,11.06
9877807,1631683,285,99750,1731433,6.11
9877808,9993876,2005,701750,10695626,7.02
9877809,9968541,4534,1586900,11555441,15.92
9877810,9997184,1703,596050,10593234,5.96
9877811,9989565,2226,779100,10768665,7.80
9877812,9995732,1417,495950,10491682,4.96
9877813,9980355,4955,1734250,11714605,17.38
9877814,9984897,3818,1336300,11321197,13.38
9877815,9983630,4371,1529850,11513480,15.32
9877816,9979871,4392,1537200,11517071,15.40
9877817,9981041,2961,1036350,11017391,10.38
9877818,9980766,3724,1303400,11284166,13.06
9877819,3767416,443,155050,3922466,4.12
9877820,9972581,1535,537250,10509831,5.39
9877822,9963144,1903,666050,10629194,6.69
9877823,9969745,6266,2193100,12162845,22.00
9877824,9967811,3472,1215200,11183011,12.19
9877825,6273906,3678,1287300,7561206,20.52
9877826,9962046,5149,1802150,11764196,18.09
9877827,9969930,3319,1161650,11131580,11.65
9877828,5538960,2077,726950,6265910,13.12
9877829,9077903,3545,1240750,10318653,13.67
9877830,9955125,2611,913850,10868975,9.18
9877831,9936706,2095,733250,10669956,7.38
9877832,9930268,3046,1066100,10996368,10.74
9877833,9936796,2395,838250,10775046,8.44
9877834,9940304,2870,1004500,10944804,10.11
9877835,9968890,4005,1401750,11370640,14.06
9877837,9904911,4082,1428700,11333611,14.42
9877838,9984594,3918,1371300,11355894,13.73
9877839,9988654,2886,1010100,10998754,10.11
9877840,352853,251,87850,440703,24.90
9877841,9950362,2638,923300,10873662,9.28
9877842,9967560,5663,1982050,11949610,19.89
9877843,9959989,4185,1464750,11424739,14.71
9877844,9952900,4661,1631350,11584250,16.39
9877845,9943622,1515,530250,10473872,5.33
9877846,9958987,1456,509600,10468587,5.12
9877847,9947531,3528,1234800,11182331,12.41
9877848,9959650,1972,690200,10649850,6.93
9877849,9977845,3421,1197350,11175195,12.00
9877850,2378265,890,311500,2689765,13.10
9877851,9970217,5163,1807050,11777267,18.12
9877852,9967551,3377,1181950,11149501,11.86
9877853,9978822,2013,704550,10683372,7.06
9877854,9993189,3327,1164450,11157639,11.65
9877855,9984144,2051,717850,10701994,7.19
9877856,9960487,3339,1168650,11129137,11.73
9877857,9979073,5342,1869700,11848773,18.74
9877858,9949734,3829,1340150,11289884,13.47
9877859,9968426,3206,1122100,11090526,11.26
9877860,9979879,4545,1590750,11570629,15.94
9877861,1564962,440,154000,1718962,9.84
9877863,9941903,4063,1422050,11363953,14.30
9877864,9963528,6723,2353050,12316578,23.62
9877865,9966981,3186,1115100,11082081,11.19
9877866,3687962,2838,993300,4681262,26.93
9877867,9959101,1993,697550,10656651,7.00
9877868,9967244,3702,1295700,11262944,13.00
9877869,9982229,3742,1309700,11291929,13.12
9877870,9965033,4424,1548400,11513433,15.54
9877871,9970271,4306,1507100,11477371,15.12
9877872,9979616,2836,992600,10972216,9.95
9877873,9969943,4493,1572550,11542493,15.77
9877874,7524537,1448,506800,8031337,6.74
9877875,9963726,3938,1378300,11342026,13.83
9877876,9977441,4076,1426600,11404041,14.30
9877877,9438401,3651,1277850,10716251,13.54
9877878,8493290,2661,931350,9424640,10.97
9877879,9932572,3278,1147300,11079872,11.55
9877880,4688692,1185,414750,5103442,8.85
9877881,9969395,2311,808850,10778245,8.11
9877882,9957406,4884,1709400,11666806,17.17
9877883,9980910,4342,1519700,11500610,15.23
9877884,9979915,4225,1478750,11458665,14.82
9877885,9985829,584,204400,10190229,2.05
9877886,9985367,1267,443450,10428817,4.44
9877887,9963798,3573,1250550,11214348,12.55
9877888,9969178,1688,590800,10559978,5.93
9877889,2716185,1417,495950,3212135,18.26
9877890,966647,388,135800,1102447,14.05
9877891,9950362,3684,1289400,11239762,12.96
9877892,9957892,5841,2044350,12002242,20.53
9877893,1428249,564,197400,1625649,13.82
9877895,9953929,2909,1018150,10972079,10.23
9877896,9967343,5163,1807050,11774393,18.13
9877897,4774302,1421,497350,5271652,10.42
9877898,9911222,4318,1511300,11422522,15.25
9877899,5788194,4292,1502200,7290394,25.95
9877900,893194,448,156800,1049994,17.55
9877901,9944277,3002,1050700,10994977,10.57
9877902,2044294,1473,515550,2559844,25.22
9877903,9956439,3120,1092000,11048439,10.97
9877904,9958026,5406,1892100,11850126,19.00
9877905,828112,492,172200,1000312,20.79
9877906,9937187,2990,1046500,10983687,10.53
9877907,9946408,3888,1360800,11307208,13.68
9877908,9953497,3563,1247050,11200547,12.53
9877909,9952467,4985,1744750,11697217,17.53
9877910,9960401,3188,1115800,11076201,11.20
9877911,9978413,2326,814100,10792513,8.16
9877912,9978603,4425,1548750,11527353,15.52
9877913,9966165,4963,1737050,11703215,17.43
9877914,9982793,5692,1992200,11974993,19.96
9877915,9998760,890,311500,10310260,3.12
9877916,9994180,3392,1187200,11181380,11.88
9877917,9976900,3659,1280650,11257550,12.84
9877918,9967193,5279,1847650,11814843,18.54
9877919,9719436,4706,1647100,11366536,16.95
9877920,9984922,4053,1418550,11403472,14.21
9877921,9997018,3353,1173550,11170568,11.74
9877923,4360346,1784,624400,4984746,14.32
9877924,9993714,3513,1229550,11223264,12.30
9877925,9992211,1902,665700,10657911,6.66
9877926,1146681,406,142100,1288781,12.39
9877927,9963692,3776,1321600,11285292,13.26
9877928,9979634,4588,1605800,11585434,16.09
9877929,9987932,6576,2301600,12289532,23.04
9877930,8980981,1911,668850,9649831,7.45
9877931,8971360,3775,1321250,10292610,14.73
9877932,9974247,3598,1259300,11233547,12.63
9877933,5781037,1542,539700,6320737,9.34
9877934,4180004,2213,774550,4954554,18.53
9877935,9982315,3099,1084650,11066965,10.87
9877936,9970741,4429,1550150,11520891,15.55
9877937,9959369,3481,1218350,11177719,12.23
9877938,9948066,3154,1103900,11051966,11.10
9877939,8348404,3134,1096900,9445304,13.14
9877940,9959799,3336,1167600,11127399,11.72
9877941,9924840,4603,1611050,11535890,16.23
9877942,9957224,2679,937650,10894874,9.42
9877943,9931993,2990,1046500,10978493,10.54
9877944,9949567,3485,1219750,11169317,12.26
9877946,9939533,2803,981050,10920583,9.87
9877947,8773271,2722,952700,9725971,10.86
9877948,9957067,3864,1352400,11309467,13.58
9877949,9950164,6611,2313850,12264014,23.25
9877950,9969849,4554,1593900,11563749,15.99
9877951,9948382,4710,1648500,11596882,16.57
9877953,635031,775,271250,906281,42.71
9877954,744041,414,144900,888941,19.47
9877955,9941166,5247,1836450,11777616,18.47
9877956,9968852,3310,1158500,11127352,11.62
9877957,9940956,3865,1352750,11293706,13.61
9877958,9961827,3767,1318450,11280277,13.24
9877959,9959663,4167,1458450,11418113,14.64
9877960,9967912,3462,1211700,11179612,12.16
9877961,4971952,2993,1047550,6019502,21.07
9877962,9908845,4370,1529500,11438345,15.44
9877963,9967250,2303,806050,10773300,8.09
9877964,9969532,5777,2021950,11991482,20.28
9877965,4444774,1125,393750,4838524,8.86
9877966,9980763,1869,654150,10634913,6.55
9877967,9967904,4040,1414000,11381904,14.19
9877968,9976043,3891,1361850,11337893,13.65
9877969,9975971,1870,654500,10630471,6.56
9877970,9966205,4332,1516200,11482405,15.21
9877971,9984111,5961,2086350,12070461,20.90
9877972,9981116,3862,1351700,11332816,13.54
9877973,9979689,3457,1209950,11189639,12.12
9877974,4040435,2292,802200,4842635,19.85
9877975,9078447,5373,1880550,10958997,20.71
9877976,9988415,2929,1025150,11013565,10.26
9877978,9970073,3489,1221150,11191223,12.25
9877979,9736877,5465,1912750,11649627,19.64
9877981,9965573,3727,1304450,11270023,13.09
9877982,6682992,2253,788550,7471542,11.80
9877983,5998000,2318,811300,6809300,13.53
9877984,9959218,1491,521850,10481068,5.24
9877985,8187304,2848,996800,9184104,12.17
9877986,9956690,4597,1608950,11565640,16.16
9877987,3073999,2227,779450,3853449,25.36
9877988,8944138,3190,1116500,10060638,12.48
9877989,9950751,3976,1391600,11342351,13.98
9877990,9950936,5328,1864800,11815736,18.74
9877991,9967739,2906,1017100,10984839,10.20
9877992,9975393,4872,1705200,11680593,17.09
9877993,9918513,3125,1093750,11012263,11.03
9877994,9989030,3827,1339450,11328480,13.41
9877995,9995042,2712,949200,10944242,9.50
9877996,9928257,7687,2690450,12618707,27.10
9877997,9926989,3002,1050700,10977689,10.58
9877998,9979940,5093,1782550,11762490,17.86
9877999,9978659,2844,995400,10974059,9.98
9878000,9967513,3265,1142750,11110263,11.46
9878001,9958438,5130,1795500,11753938,18.03
9878003,9952337,5036,1762600,11714937,17.71
9878004,9933784,2504,876400,10810184,8.82
9878005,9921324,1742,609700,10531024,6.15
9878006,7732047,3901,1365350,9097397,17.66
9878007,9904853,3296,1153600,11058453,11.65
9878008,9913009,3598,1259300,11172309,12.70
9878009,9924409,3055,1069250,10993659,10.77
9878010,9912267,3103,1086050,10998317,10.96
9878011,9924407,4914,1719900,11644307,17.33
9878012,7138494,2666,933100,8071594,13.07
9878013,9925237,4932,1726200,11651437,17.39
9878014,9930494,5823,2038050,11968544,20.52
9878016,9927638,3919,1371650,11299288,13.82
9878017,9935865,3520,1232000,11167865,12.40
9878018,9675849,2823,988050,10663899,10.21
9878019,7830993,1806,632100,8463093,8.07
9878020,7906428,3891,1361850,9268278,17.22
9878021,9936549,3752,1313200,11249749,13.22
9878022,9937787,2670,934500,10872287,9.40
9878023,9917408,3898,1364300,11281708,13.76
9878024,9923170,3354,1173900,11097070,11.83
9878025,9904347,1398,489300,10393647,4.94
9878026,9912798,3732,1306200,11218998,13.18
9878027,9913540,2552,893200,10806740,9.01
9878028,3119417,2320,812000,3931417,26.03
9878029,9922486,3094,1082900,11005386,10.91
9878030,9924181,2693,942550,10866731,9.50
9878031,9940595,4343,1520050,11460645,15.29
9878032,9944973,4209,1473150,11418123,14.81
9878033,9946392,2980,1043000,10989392,10.49
9878034,5987533,771,269850,6257383,4.51
9878035,9938372,1719,601650,10540022,6.05
9878036,9955848,3469,1214150,11169998,12.20
9878037,9949754,5146,1801100,11750854,18.10
9878038,9961626,2747,961450,10923076,9.65
9878039,9982073,4504,1576400,11558473,15.79
9878040,889036,450,157500,1046536,17.72
9878041,9968517,4325,1513750,11482267,15.19
9878042,8052377,2050,717500,8769877,8.91
9878043,9992954,4145,1450750,11443704,14.52
9878044,9932765,3903,1366050,11298815,13.75
9878045,9979577,4740,1659000,11638577,16.62
9878046,9990122,3648,1276800,11266922,12.78
9878047,7454738,3184,1114400,8569138,14.95
9878048,9896012,2796,978600,10874612,9.89
9878050,9985595,2789,976150,10961745,9.78
9878051,9981059,2389,836150,10817209,8.38
9878052,9967217,4532,1586200,11553417,15.91
9878053,9977256,4803,1681050,11658306,16.85
9878054,9962628,2762,966700,10929328,9.70
9878055,9974161,3624,1268400,11242561,12.72
9878056,9993815,3449,1207150,11200965,12.08
9878057,9970315,1837,642950,10613265,6.45
9878058,9988075,4291,1501850,11489925,15.04
9878059,9988098,3162,1106700,11094798,11.08
9878060,9964417,4476,1566600,11531017,15.72
9878061,9976929,1174,410900,10387829,4.12
9878062,743041,289,101150,844191,13.61
9878063,9979819,3223,1128050,11107869,11.30
9878064,9984446,4612,1614200,11598646,16.17
9878065,9979614,4762,1666700,11646314,16.70
9878066,9995542,4887,1710450,11705992,17.11
9878067,9993367,2903,1016050,11009417,10.17
9878069,7116381,2807,982450,8098831,13.81
9878071,9972962,5055,1769250,11742212,17.74
9878072,9971792,4911,1718850,11690642,17.24
9878073,9990785,4228,1479800,11470585,14.81
9878074,9999674,3570,1249500,11249174,12.50
9878075,9995416,2764,967400,10962816,9.68
9878076,9978874,3189,1116150,11095024,11.19
9878077,9953562,2579,902650,10856212,9.07
9878078,9980949,1054,368900,10349849,3.70
9878079,9985968,4729,1655150,11641118,16.57
9878080,9973723,1876,656600,10630323,6.58
9878081,9979511,3684,1289400,11268911,12.92
9878082,9968567,5709,1998150,11966717,20.04
9878083,9966568,3963,1387050,11353618,13.92
9878084,7479677,3288,1150800,8630477,15.39
9878085,9931345,2855,999250,10930595,10.06
9878086,6080513,1971,689850,6770363,11.35
9878087,9993502,2890,1011500,11005002,10.12
9878088,9926302,4986,1745100,11671402,17.58
9878089,9979161,3282,1148700,11127861,11.51
9878090,9751219,2238,783300,10534519,8.03
9878091,9994560,5371,1879850,11874410,18.81
9878092,7013954,332,116200,7130154,1.66
9878093,9814367,2725,953750,10768117,9.72
9878094,9985572,2217,775950,10761522,7.77
9878095,9982315,2049,717150,10699465,7.18
9878096,9976628,3273,1145550,11122178,11.48
9878097,9981253,2453,858550,10839803,8.60
9878098,9981594,828,289800,10271394,2.90
9878099,9987831,1025,358750,10346581,3.59
9878100,9972039,1543,540050,10512089,5.42
9878102,9980549,1941,679350,10659899,6.81
9878103,9974228,3415,1195250,11169478,11.98
9878104,9796221,1363,477050,10273271,4.87
9878105,9999355,2727,954450,10953805,9.55
9878106,9989292,4091,1431850,11421142,14.33
9878107,9997634,3551,1242850,11240484,12.43
9878108,9562881,2161,756350,10319231,7.91
9878109,9986530,3351,1172850,11159380,11.74
9878110,9988494,5390,1886500,11874994,18.89
9878111,9965397,5145,1800750,11766147,18.07
9878112,9964435,5696,1993600,11958035,20.01
9878113,9967851,4810,1683500,11651351,16.89
9878114,9945243,3432,1201200,11146443,12.08
9878115,9979866,1153,403550,10383416,4.04
9878116,9979561,3294,1152900,11132461,11.55
9878117,9984936,3243,1135050,11119986,11.37
9878118,9991627,4249,1487150,11478777,14.88
9878119,9996984,3821,1337350,11334334,13.38
9878120,9984387,3310,1158500,11142887,11.60
9878121,9981681,3988,1395800,11377481,13.98
9878122,9989833,5493,1922550,11912383,19.25
9878123,9874391,4869,1704150,11578541,17.26
9878124,9941896,3851,1347850,11289746,13.56
9878125,9724795,4627,1619450,11344245,16.65
9878126,9989330,3378,1182300,11171630,11.84
9878127,9984027,4711,1648850,11632877,16.51
9878128,9984590,3020,1057000,11041590,10.59
9878129,9980927,3307,1157450,11138377,11.60
9878130,9921556,4162,1456700,11378256,14.68
9878132,9979513,3918,1371300,11350813,13.74
9878133,9969945,3006,1052100,11022045,10.55
9878134,9988729,3769,1319150,11307879,13.21
9878135,9479529,868,303800,9783329,3.20
9878136,9968007,3815,1335250,11303257,13.40
9878138,9958414,4119,1441650,11400064,14.48
9878139,9944576,3486,1220100,11164676,12.27
9878140,9838105,4889,1711150,11549255,17.39
9878141,9959153,3648,1276800,11235953,12.82
9878142,9185171,4670,1634500,10819671,17.79
9878143,9956559,3087,1080450,11037009,10.85
9878144,9977072,4605,1611750,11588822,16.15
9878145,4001829,475,166250,4168079,4.15
9878146,9878252,2738,958300,10836552,9.70
9878147,3762351,2437,852950,4615301,22.67
9878148,9986477,5233,1831550,11818027,18.34
9878149,3236859,2182,763700,4000559,23.59
9878150,751867,335,117250,869117,15.59
9878151,9972237,4191,1466850,11439087,14.71
9878152,9963967,2623,918050,10882017,9.21
9878154,9710465,6984,2444400,12154865,25.17
9878155,9966137,4839,1693650,11659787,16.99
9878156,9959473,3590,1256500,11215973,12.62
9878157,9966968,4880,1708000,11674968,17.14
9878158,1539791,557,194950,1734741,12.66
9878159,3004782,2307,807450,3812232,26.87
9878160,9974687,3028,1059800,11034487,10.62
9878161,9986209,3766,1318100,11304309,13.20
9878162,9985250,2868,1003800,10989050,10.05
9878163,9980555,483,169050,10149605,1.69
9878164,9980662,4935,1727250,11707912,17.31
9878165,9997367,3680,1288000,11285367,12.88
9878167,9978440,2499,874650,10853090,8.77
9878168,9971577,4681,1638350,11609927,16.43
9878169,9974931,3825,1338750,11313681,13.42
9878170,9964346,5306,1857100,11821446,18.64
9878171,9960926,4243,1485050,11445976,14.91
9878172,1692687,903,316050,2008737,18.67
9878173,1123019,651,227850,1350869,20.29
9878174,9980023,3862,1351700,11331723,13.54
9878175,9950877,3562,1246700,11197577,12.53
9878176,9969321,3236,1132600,11101921,11.36
9878177,9948692,2927,1024450,10973142,10.30
9878178,2135057,126,44100,2179157,2.07
9878179,9946677,4861,1701350,11648027,17.10
9878180,2839280,2837,992950,3832230,34.97
9878181,9967954,2253,788550,10756504,7.91
9878182,9959527,2380,833000,10792527,8.36
9878183,279560,94,32900,312460,11.77
9878184,9954843,3679,1287650,11242493,12.93
9878185,9968547,2593,907550,10876097,9.10
9878186,9965487,4830,1690500,11655987,16.96
9878187,9966866,4377,1531950,11498816,15.37
9878188,329692,188,65800,395492,19.96
9878189,9982003,698,244300,10226303,2.45
9878190,9969236,3161,1106350,11075586,11.10
9878191,9965040,5185,1814750,11779790,18.21
9878192,9918792,5377,1881950,11800742,18.97
9878193,9945344,2235,782250,10727594,7.87
9878194,9980274,2601,910350,10890624,9.12
9878195,9974260,4034,1411900,11386160,14.16
9878196,9989501,4603,1611050,11600551,16.13
9878197,9993873,1699,594650,10588523,5.95
9878198,9989901,2125,743750,10733651,7.45
9878199,9972836,3512,1229200,11202036,12.33
9878200,9992391,1734,606900,10599291,6.07
9878201,9994570,3921,1372350,11366920,13.73
9878203,9993439,3264,1142400,11135839,11.43
9878205,9976724,3381,1183350,11160074,11.86
9878206,3227510,1431,500850,3728360,15.52
9878207,7089918,4059,1420650,8510568,20.04
9878208,9959774,3607,1262450,11222224,12.68
9878209,9994903,3983,1394050,11388953,13.95
9878210,9996298,4679,1637650,11633948,16.38
9878211,6439822,1094,382900,6822722,5.95
9878213,9970257,3844,1345400,11315657,13.49
9878214,9969577,3138,1098300,11067877,11.02
9878215,9988394,5278,1847300,11835694,18.49
9878216,7417730,3398,1189300,8607030,16.03
9878217,9973314,4022,1407700,11381014,14.11
9878218,9970059,3900,1365000,11335059,13.69
9878219,9543694,2989,1046150,10589844,10.96
9878220,9961639,5307,1857450,11819089,18.65
9878221,9967201,5865,2052750,12019951,20.60
9878222,9965446,3847,1346450,11311896,13.51
9878223,9967622,4537,1587950,11555572,15.93
9878224,5556020,2339,818650,6374670,14.73
9878225,9959740,4162,1456700,11416440,14.63
9878226,9935499,3103,1086050,11021549,10.93
9878227,9932701,1671,584850,10517551,5.89
9878228,9934288,3869,1354150,11288438,13.63
9878229,9675650,5143,1800050,11475700,18.60
9878230,9941089,3343,1170050,11111139,11.77
9878231,9938171,3872,1355200,11293371,13.64
9878232,9953838,3445,1205750,11159588,12.11
9878233,9432961,2203,771050,10204011,8.17
9878234,9973472,2741,959350,10932822,9.62
9878235,9974260,2767,968450,10942710,9.71
9878236,8973677,2450,857500,9831177,9.56
9878237,9974894,4816,1685600,11660494,16.90
9878238,7263268,2172,760200,8023468,10.47
9878240,9958472,4153,1453550,11412022,14.60
9878241,9969658,3539,1238650,11208308,12.42
9878242,8338766,2624,918400,9257166,11.01
9878243,4511296,1410,493500,5004796,10.94
9878244,8958371,4251,1487850,10446221,16.61
9878245,9950516,5703,1996050,11946566,20.06
9878246,3396304,292,102200,3498504,3.01
9878247,9945623,4149,1452150,11397773,14.60
9878248,9939664,4610,1613500,11553164,16.23
9878249,9957913,4668,1633800,11591713,16.41
9878250,9959456,5077,1776950,11736406,17.84
9878251,9955418,2904,1016400,10971818,10.21
9878252,9946885,3514,1229900,11176785,12.36
9878253,9961082,4713,1649550,11610632,16.56
9878254,9962702,4487,1570450,11533152,15.76
9878255,9952872,3342,1169700,11122572,11.75
9878256,9716797,3065,1072750,10789547,11.04
9878258,9859521,3237,1132950,10992471,11.49
9878259,9924847,4683,1639050,11563897,16.51
9878260,9963785,5893,2062550,12026335,20.70
9878261,9962881,3165,1107750,11070631,11.12
9878262,9946614,3463,1212050,11158664,12.19
9878263,9968278,5891,2061850,12030128,20.68
9878264,9976554,2759,965650,10942204,9.68
9878265,9970057,4413,1544550,11514607,15.49
9878266,9976012,4069,1424150,11400162,14.28
9878269,8515907,756,264600,8780507,3.11
9878270,9977693,2396,838600,10816293,8.40
9878271,9967044,1814,634900,10601944,6.37
9878272,9963470,3611,1263850,11227320,12.68
9878273,9978101,3325,1163750,11141851,11.66
9878274,9969709,2554,893900,10863609,8.97
9878275,9941474,3852,1348200,11289674,13.56
9878276,9987527,5872,2055200,12042727,20.58
9878277,9980594,3541,1239350,11219944,12.42
9878278,9987110,4166,1458100,11445210,14.60
9878279,9998400,2743,960050,10958450,9.60
9878280,9977992,3304,1156400,11134392,11.59
9878281,9979686,4755,1664250,11643936,16.68
9878283,9971657,5698,1994300,11965957,20.00
9878285,9975220,2103,736050,10711270,7.38
9878286,9982577,3983,1394050,11376627,13.96
9878287,9985873,2204,771400,10757273,7.72
9878288,9992550,3298,1154300,11146850,11.55
9878289,9993217,3552,1243200,11236417,12.44
9878290,9983374,2048,716800,10700174,7.18
9878291,9978160,3965,1387750,11365910,13.91
9878292,1814538,726,254100,2068638,14.00
9878293,9990788,3864,1352400,11343188,13.54
9878294,9987692,2797,978950,10966642,9.80
9878295,9996144,2482,868700,10864844,8.69
9878296,9992497,2800,980000,10972497,9.81
9878297,9982210,3676,1286600,11268810,12.89
9878298,9986758,1889,661150,10647908,6.62
9878299,9977141,2153,753550,10730691,7.55
9878300,9988180,1727,604450,10592630,6.05
9878301,1393348,455,159250,1552598,11.43
9878302,9979637,3116,1090600,11070237,10.93
9878303,5052375,1915,670250,5722625,13.27
9878304,9948911,5051,1767850,11716761,17.77
9878305,9968705,2434,851900,10820605,8.55
9878306,9962507,2458,860300,10822807,8.64
9878307,1503208,987,345450,1848658,22.98
9878308,9952523,4867,1703450,11655973,17.12
9878309,9956445,2239,783650,10740095,7.87
9878310,9961811,4527,1584450,11546261,15.91
9878311,9970799,4726,1654100,11624899,16.59
9878312,2766138,328,114800,2880938,4.15
9878313,9994145,4338,1518300,11512445,15.19
9878314,9988510,5087,1780450,11768960,17.82
9878315,9970914,3645,1275750,11246664,12.79
9878316,9989601,2547,891450,10881051,8.92
9878317,357834,182,63700,421534,17.80
9878318,9976133,3182,1113700,11089833,11.16
9878319,9985236,4815,1685250,11670486,16.88
9878320,9995199,3739,1308650,11303849,13.09
9878321,9984220,3658,1280300,11264520,12.82
9878322,9971633,2097,733950,10705583,7.36
9878323,9990428,3762,1316700,11307128,13.18
9878324,7237569,2903,1016050,8253619,14.04
9878325,6922474,1370,479500,7401974,6.93
9878326,9983905,2888,1010800,10994705,10.12
9878327,9966782,5382,1883700,11850482,18.90
9878329,9997972,1994,697900,10695872,6.98
9878330,9999594,1294,452900,10452494,4.53
9878331,5534452,1643,575050,6109502,10.39
9878332,9986945,3242,1134700,11121645,11.36
9878333,9988015,3334,1166900,11154915,11.68
9878334,9974465,2920,1022000,10996465,10.25
9878335,9109247,3037,1062950,10172197,11.67
9878336,8956337,2230,780500,9736837,8.71
9878337,9946602,1456,509600,10456202,5.12
9878338,9655356,2230,780500,10435856,8.08
9878339,9960938,2023,708050,10668988,7.11
9878340,9963302,1635,572250,10535552,5.74
9878341,9975771,1803,631050,10606821,6.33
9878342,9967963,2663,932050,10900013,9.35
9878343,9975276,2856,999600,10974876,10.02
9878344,529095,118,41300,570395,7.81
9878345,9868916,2004,701400,10570316,7.11
9878346,9916923,2991,1046850,10963773,10.56
9878347,9906834,1903,666050,10572884,6.72
9878348,9478336,1111,388850,9867186,4.10
9878349,9976282,1756,614600,10590882,6.16
9878350,9982023,3904,1366400,11348423,13.69
9878351,9634465,2055,719250,10353715,7.47
9878352,9982216,3112,1089200,11071416,10.91
9878353,338581,158,55300,393881,16.33
9878354,9937212,3994,1397900,11335112,14.07
9878356,9946826,4538,1588300,11535126,15.97
9878357,5944735,550,192500,6137235,3.24
9878358,9930103,2437,852950,10783053,8.59
9878359,7525538,2754,963900,8489438,12.81
9878360,9934238,6817,2385950,12320188,24.02
9878361,9957267,4575,1601250,11558517,16.08
9878362,9942910,2997,1048950,10991860,10.55
9878363,9936990,4885,1709750,11646740,17.21
9878364,9944448,4681,1638350,11582798,16.48
9878365,9941992,5927,2074450,12016442,20.87
9878366,9936583,3777,1321950,11258533,13.30
9878367,2554147,589,206150,2760297,8.07
9878368,9245236,3002,1050700,10295936,11.36
9878369,9942156,3825,1338750,11280906,13.47
9878370,9946202,3084,1079400,11025602,10.85
9878371,9942213,1499,524650,10466863,5.28
9878372,9938708,4040,1414000,11352708,14.23
9878373,9946057,2577,901950,10848007,9.07
9878374,9919209,4966,1738100,11657309,17.52
9878375,9948879,3110,1088500,11037379,10.94
9878376,9945846,4048,1416800,11362646,14.25
9878377,9952241,3569,1249150,11201391,12.55
9878378,9950974,1492,522200,10473174,5.25
9878379,9961944,4275,1496250,11458194,15.02
9878380,9949191,3896,1363600,11312791,13.71
9878381,9964224,3430,1200500,11164724,12.05
9878382,9969986,3072,1075200,11045186,10.78
9878383,9975228,3041,1064350,11039578,10.67
9878384,9984272,4858,1700300,11684572,17.03
9878385,9969147,2634,921900,10891047,9.25
9878386,9985020,2382,833700,10818720,8.35
9878387,5566532,1479,517650,6084182,9.30
9878388,9300457,2830,990500,10290957,10.65
9878389,9962131,5481,1918350,11880481,19.26
9878390,9956437,4263,1492050,11448487,14.99
9878391,9982200,2722,952700,10934900,9.54
9878392,9979963,7930,2775500,12755463,27.81
9878393,9982644,2129,745150,10727794,7.46
9878394,9988745,4889,1711150,11699895,17.13
9878395,9982281,2335,817250,10799531,8.19
9878396,9961365,981,343350,10304715,3.45
9878397,8983851,1495,523250,9507101,5.82
9878398,9985463,3522,1232700,11218163,12.34
9878399,5919105,1932,676200,6595305,11.42
9878400,9712801,3043,1065050,10777851,10.97
9878401,9955176,3172,1110200,11065376,11.15
9878402,9961740,1585,554750,10516490,5.57
9878403,9967405,4445,1555750,11523155,15.61
9878404,590938,262,91700,682638,15.52
9878405,9964331,2008,702800,10667131,7.05
9878406,73313,60,21000,94313,28.64
9878407,9988325,2492,872200,10860525,8.73
9878409,7256948,1451,507850,7764798,7.00
9878410,9968664,3755,1314250,11282914,13.18
9878412,9971868,4106,1437100,11408968,14.41
9878413,9981813,1529,535150,10516963,5.36
9878414,9991427,2558,895300,10886727,8.96
9878415,3882350,329,115150,3997500,2.97
9878416,9693464,3546,1241100,10934564,12.80
9878417,9982691,4757,1664950,11647641,16.68
9878418,9908485,2941,1029350,10937835,10.39
9878419,9968957,3665,1282750,11251707,12.87
9878420,9989791,4030,1410500,11400291,14.12
9878421,9976914,3522,1232700,11209614,12.36
9878422,9981554,4285,1499750,11481304,15.03
9878423,9988915,3853,1348550,11337465,13.50
9878424,9981780,2808,982800,10964580,9.85
9878425,1562650,502,175700,1738350,11.24
9878426,6031159,1214,424900,6456059,7.05
9878427,9957836,4996,1748600,11706436,17.56
9878428,9950612,5354,1873900,11824512,18.83
9878429,7107958,2100,735000,7842958,10.34
9878430,9945077,3171,1109850,11054927,11.16
9878431,9955699,3893,1362550,11318249,13.69
9878432,9974819,3299,1154650,11129469,11.58
9878433,9984346,1577,551950,10536296,5.53
9878434,9969247,3503,1226050,11195297,12.30
9878435,9987985,3504,1226400,11214385,12.28
9878436,9980354,3891,1361850,11342204,13.65
9878437,9984768,2605,911750,10896518,9.13
9878438,9972999,6322,2212700,12185699,22.19
9878439,9983321,3566,1248100,11231421,12.50
9878440,9984643,1598,559300,10543943,5.60
9878441,9958686,3156,1104600,11063286,11.09
9878442,9977862,3217,1125950,11103812,11.28
9878443,9965243,5028,1759800,11725043,17.66
9878444,9974667,2906,1017100,10991767,10.20
9878445,9995515,3746,1311100,11306615,13.12
9878446,9992737,3963,1387050,11379787,13.88
9878447,9980940,2923,1023050,11003990,10.25
9878448,9978795,5091,1781850,11760645,17.86
9878449,9985788,2256,789600,10775388,7.91
9878450,2903631,964,337400,3241031,11.62
9878451,3005603,889,311150,3316753,10.35
9878452,9975601,3524,1233400,11209001,12.36
9878453,9979065,4411,1543850,11522915,15.47
9878454,1528807,1027,359450,1888257,23.51
9878455,9982400,3245,1135750,11118150,11.38
9878456,9990300,2397,838950,10829250,8.40
9878457,2242512,600,210000,2452512,9.36
9878458,1826901,211,73850,1900751,4.04
9878459,9959834,6062,2121700,12081534,21.30
9878460,9966508,3299,1154650,11121158,11.59
9878461,9986399,1998,699300,10685699,7.00
9878462,9997109,3848,1346800,11343909,13.47
9878463,9997144,1300,455000,10452144,4.55
9878464,9994508,1208,422800,10417308,4.23
9878465,9973596,2784,974400,10947996,9.77
9878466,9986247,3483,1219050,11205297,12.21
9878468,9987226,4460,1561000,11548226,15.63
9878469,9979175,2921,1022350,11001525,10.24
9878470,388289,256,89600,477889,23.08
9878471,9967839,4408,1542800,11510639,15.48
9878472,800354,538,188300,988654,23.53
9878473,9973169,5544,1940400,11913569,19.46
9878474,9965627,2844,995400,10961027,9.99
9878475,1828137,897,313950,2142087,17.17
9878476,9960689,4049,1417150,11377839,14.23
9878477,9968224,4509,1578150,11546374,15.83
9878478,9982876,4446,1556100,11538976,15.59
9878479,9988735,4172,1460200,11448935,14.62
9878480,9993210,2918,1021300,11014510,10.22
9878481,9996632,3059,1070650,11067282,10.71
9878482,9984155,3821,1337350,11321505,13.39
9878483,964032,342,119700,1083732,12.42
9878484,9979386,2476,866600,10845986,8.68
9878485,6124393,1054,368900,6493293,6.02
9878486,9953186,3807,1332450,11285636,13.39
9878487,3997691,1405,491750,4489441,12.30
9878488,9960238,3353,1173550,11133788,11.78
9878489,9974408,3490,1221500,11195908,12.25
9878490,9975250,2330,815500,10790750,8.18
9878491,9959134,3566,1248100,11207234,12.53
9878492,9953816,4644,1625400,11579216,16.33
9878493,9981943,2690,941500,10923443,9.43
9878494,9977334,4790,1676500,11653834,16.80
9878495,9979485,1815,635250,10614735,6.37
9878496,9991985,4632,1621200,11613185,16.23
9878497,9998735,2694,942900,10941635,9.43
9878499,9972896,3512,1229200,11202096,12.33
9878500,9960047,3620,1267000,11227047,12.72
9878501,9955571,3590,1256500,11212071,12.62
9878502,9962256,3306,1157100,11119356,11.61
9878503,9979977,2787,975450,10955427,9.77
9878504,2839465,1956,684600,3524065,24.11
9878505,9978321,2465,862750,10841071,8.65
9878506,1333351,422,147700,1481051,11.08
9878507,9952160,2684,939400,10891560,9.44
9878508,9969937,3331,1165850,11135787,11.69
9878509,9977410,3594,1257900,11235310,12.61
9878510,9974073,3173,1110550,11084623,11.13
9878511,676020,240,84000,760020,12.43
9878512,9959987,4333,1516550,11476537,15.23
9878513,9961809,3106,1087100,11048909,10.91
9878514,9972291,4701,1645350,11617641,16.50
9878515,2793266,2347,821450,3614716,29.41
9878516,9950840,2677,936950,10887790,9.42
9878517,9964638,3041,1064350,11028988,10.68
9878518,974423,68,23800,998223,2.44
9878519,2750875,1419,496650,3247525,18.05
9878520,9948771,2264,792400,10741171,7.96
9878521,9931135,2493,872550,10803685,8.79
9878522,714430,238,83300,797730,11.66
9878523,3384596,1677,586950,3971546,17.34
9878524,9960559,3083,1079050,11039609,10.83
9878525,9973078,4027,1409450,11382528,14.13
9878526,9987630,5190,1816500,11804130,18.19
9878527,9996649,2367,828450,10825099,8.29
9878528,9994769,5752,2013200,12007969,20.14
9878529,967898,506,177100,1144998,18.30
9878530,9974425,2036,712600,10687025,7.14
9878531,5366686,1395,488250,5854936,9.10
9878532,9963452,2617,915950,10879402,9.19
9878533,434259,302,105700,539959,24.34
9878534,6568291,2678,937300,7505591,14.27
9878535,9960987,3699,1294650,11255637,13.00
9878536,9963891,6640,2324000,12287891,23.32
9878537,2160998,1573,550550,2711548,25.48
9878539,9959334,3565,1247750,11207084,12.53
9878540,9932149,2615,915250,10847399,9.22
9878541,9922024,2948,1031800,10953824,10.40
9878542,9937933,4669,1634150,11572083,16.44
9878543,9941719,3096,1083600,11025319,10.90
9878544,9948951,3348,1171800,11120751,11.78
9878545,9953048,4720,1652000,11605048,16.60
9878546,9936944,4874,1705900,11642844,17.17
9878547,9974771,3518,1231300,11206071,12.34
9878548,9965136,2141,749350,10714486,7.52
9878549,9977734,4534,1586900,11564634,15.90
9878550,9972528,1926,674100,10646628,6.76
9878551,1752481,575,201250,1953731,11.48
9878552,9967824,3118,1091300,11059124,10.95
9878553,9971490,1870,654500,10625990,6.56
9878554,9980036,2995,1048250,11028286,10.50
9878555,9992280,2865,1002750,10995030,10.04
9878556,9998575,4237,1482950,11481525,14.83
9878557,9982134,5439,1903650,11885784,19.07
9878558,9058305,1909,668150,9726455,7.38
9878560,4685491,829,290150,4975641,6.19
9878561,6371525,2810,983500,7355025,15.44
9878562,9943707,3707,1297450,11241157,13.05
9878563,503158,252,88200,591358,17.53
9878564,8913617,2323,813050,9726667,9.12
9878565,9931963,4117,1440950,11372913,14.51
9878566,9936993,2910,1018500,10955493,10.25
9878567,9940601,4218,1476300,11416901,14.85
9878568,820629,133,46550,867179,5.67
9878569,5693266,2204,771400,6464666,13.55
9878570,9943544,3910,1368500,11312044,13.76
9878571,9953582,3649,1277150,11230732,12.83
9878572,9960597,4408,1542800,11503397,15.49
9878573,9958250,2443,855050,10813300,8.59
9878574,9959092,4263,1492050,11451142,14.98
9878575,9960905,5087,1780450,11741355,17.87
9878576,9969886,2431,850850,10820736,8.53
9878577,1295158,672,235200,1530358,18.16
9878578,9946567,2903,1016050,10962617,10.22
9878579,9960621,4620,1617000,11577621,16.23
9878580,2034705,1140,399000,2433705,19.61
9878581,9881873,4109,1438150,11320023,14.55
9878582,9977638,3222,1127700,11105338,11.30
9878583,9981862,4685,1639750,11621612,16.43
9878584,1664686,321,112350,1777036,6.75
9878585,9956368,5596,1958600,11914968,19.67
9878586,9618144,4397,1538950,11157094,16.00
9878587,3801459,1167,408450,4209909,10.74
9878588,9977829,4014,1404900,11382729,14.08
9878589,9988410,2985,1044750,11033160,10.46
9878590,9966912,7255,2539250,12506162,25.48
9878591,3301351,2016,705600,4006951,21.37
9878592,9962488,5555,1944250,11906738,19.52
9878593,208773,38,13300,222073,6.37
9878594,9991524,3962,1386700,11378224,13.88
9878595,9979926,3698,1294300,11274226,12.97
9878596,9973198,5387,1885450,11858648,18.91
9878597,9963118,3612,1264200,11227318,12.69
9878598,9968216,3709,1298150,11266366,13.02
9878599,9967324,4219,1476650,11443974,14.81
9878601,9956721,401,140350,10097071,1.41
9878602,1665016,392,137200,1802216,8.24
9878603,9942591,4090,1431500,11374091,14.40
9878604,9952875,2388,835800,10788675,8.40
9878605,9977303,4090,1431500,11408803,14.35
9878606,9985696,4478,1567300,11552996,15.70
9878607,913303,446,156100,1069403,17.09
9878608,9955077,6629,2320150,12275227,23.31
9878609,9978341,2950,1032500,11010841,10.35
9878610,9972723,2559,895650,10868373,8.98
9878611,120709,61,21350,142059,17.69
9878612,9965975,4683,1639050,11605025,16.45
9878613,1131248,506,177100,1308348,15.66
9878614,9671984,4399,1539650,11211634,15.92
9878615,9942289,4547,1591450,11533739,16.01
9878616,9932687,2702,945700,10878387,9.52
9878618,9930467,2902,1015700,10946167,10.23
9878619,9955594,2748,961800,10917394,9.66
9878620,9961647,6582,2303700,12265347,23.13
9878621,5524930,1676,586600,6111530,10.62
9878622,9961082,4199,1469650,11430732,14.75
9878623,9945598,2771,969850,10915448,9.75
9878624,1827161,1022,357700,2184861,19.58
9878625,9929827,1205,421750,10351577,4.25
9878626,9945590,2634,921900,10867490,9.27
9878627,9945509,3017,1055950,11001459,10.62
9878628,9932335,1364,477400,10409735,4.81
9878629,9930664,2781,973350,10904014,9.80
9878630,215250,164,57400,272650,26.67
9878631,9950190,2440,854000,10804190,8.58
9878632,2287713,1406,492100,2779813,21.51
9878633,9954111,3497,1223950,11178061,12.30
9878634,9954706,1242,434700,10389406,4.37
9878635,9868004,3141,1099350,10967354,11.14
9878636,9856243,5149,1802150,11658393,18.28
9878637,9864532,3641,1274350,11138882,12.92
9878639,5026044,2020,707000,5733044,14.07
9878640,9954830,4501,1575350,11530180,15.82
9878641,9951929,3995,1398250,11350179,14.05
9878642,9979600,1395,488250,10467850,4.89
9878643,9990752,975,341250,10332002,3.42
9878644,9959254,2162,756700,10715954,7.60
9878645,9995639,4162,1456700,11452339,14.57
9878646,9976254,3453,1208550,11184804,12.11
9878647,9982998,6296,2203600,12186598,22.07
9878648,9978974,2095,733250,10712224,7.35
9878649,9980629,1860,651000,10631629,6.52
9878650,4381385,1373,480550,4861935,10.97
9878651,9976124,5739,2008650,11984774,20.13
9878652,9988520,2524,883400,10871920,8.84
9878653,9999975,3418,1196300,11196275,11.96
9878654,2787832,527,184450,2972282,6.62
9878655,2165882,1029,360150,2526032,16.63
9878656,9988339,4668,1633800,11622139,16.36
9878657,9973638,1625,568750,10542388,5.70
9878658,9558928,4707,1647450,11206378,17.23
9878659,9986313,978,342300,10328613,3.43
9878660,9985990,1883,659050,10645040,6.60
9878661,9989500,2804,981400,10970900,9.82
9878662,9997874,3567,1248450,11246324,12.49
9878665,9971457,2047,716450,10687907,7.19
9878666,9967227,2074,725900,10693127,7.28
9878667,9980323,2241,784350,10764673,7.86
9878668,9892019,4398,1539300,11431319,15.56
9878669,1202445,315,110250,1312695,9.17
9878670,9994922,4808,1682800,11677722,16.84
9878671,9981646,6072,2125200,12106846,21.29
9878672,9969996,4780,1673000,11642996,16.78
9878673,1536269,392,137200,1673469,8.93
9878674,9973533,4911,1718850,11692383,17.23
9878675,3003883,1462,511700,3515583,17.03
9878676,9974640,4479,1567650,11542290,15.72
9878677,308515,166,58100,366615,18.83
9878678,9878527,4559,1595650,11474177,16.15
9878679,1615491,92,32200,1647691,1.99
9878680,9996714,2078,727300,10724014,7.28
9878681,9982757,2787,975450,10958207,9.77
9878682,9989022,3259,1140650,11129672,11.42
9878683,9982063,225,78750,10060813,0.79
9878684,9998485,2566,898100,10896585,8.98
9878685,9984363,4077,1426950,11411313,14.29
9878686,9987607,4109,1438150,11425757,14.40
9878687,9986266,4687,1640450,11626716,16.43
9878688,887157,836,292600,1179757,32.98
9878689,663679,222,77700,741379,11.71
9878690,8969911,4386,1535100,10505011,17.11
9878691,9873955,3902,1365700,11239655,13.83
9878692,9966507,4153,1453550,11420057,14.58
9878693,9964543,4532,1586200,11550743,15.92
9878694,9718434,1882,658700,10377134,6.78
9878695,9977380,2842,994700,10972080,9.97
9878696,748162,159,55650,803812,7.44
9878697,9983332,4394,1537900,11521232,15.40
9878698,4086782,2146,751100,4837882,18.38
9878699,98197,42,14700,112897,14.97
9878700,296161,184,64400,360561,21.74
9878701,9966444,5150,1802500,11768944,18.09
9878702,9975490,2859,1000650,10976140,10.03
9878703,9951845,3893,1362550,11314395,13.69
9878704,705768,193,67550,773318,9.57
9878705,9969233,5030,1760500,11729733,17.66
9878706,464653,219,76650,541303,16.50
9878707,9943324,4557,1594950,11538274,16.04
9878708,9951104,1625,568750,10519854,5.72
9878709,9944270,1997,698950,10643220,7.03
9878710,9923189,3375,1181250,11104439,11.90
9878712,9967974,5123,1793050,11761024,17.99
9878713,9959679,4000,1400000,11359679,14.06
9878714,9983686,2906,1017100,11000786,10.19
9878715,9987818,2975,1041250,11029068,10.43
9878716,9994175,5907,2067450,12061625,20.69
9878717,9999417,5665,1982750,11982167,19.83
9878718,9981877,1968,688800,10670677,6.90
9878719,9992100,1037,362950,10355050,3.63
9878720,9998965,2370,829500,10828465,8.30
9878721,9990740,2904,1016400,11007140,10.17
9878722,699264,337,117950,817214,16.87
9878723,9998007,4977,1741950,11739957,17.42
9878724,9989238,2937,1027950,11017188,10.29
9878725,9980978,5090,1781500,11762478,17.85
9878726,646333,869,304150,950483,47.06
9878728,1626393,747,261450,1887843,16.08
9878729,9978864,4626,1619100,11597964,16.23
9878730,9978059,5206,1822100,11800159,18.26
9878731,9982093,1618,566300,10548393,5.67
9878732,9789726,1532,536200,10325926,5.48
9878734,9964529,1503,526050,10490579,5.28
9878735,701504,375,131250,832754,18.71
9878736,9935491,4761,1666350,11601841,16.77
9878737,9947503,1142,399700,10347203,4.02
9878738,2616757,927,324450,2941207,12.40
9878739,9929007,4424,1548400,11477407,15.59
9878740,9949877,4526,1584100,11533977,15.92
9878741,583103,205,71750,654853,12.30
9878742,1121955,352,123200,1245155,10.98
9878743,9934654,2150,752500,10687154,7.57
9878744,9945072,3678,1287300,11232372,12.94
9878745,9948348,1193,417550,10365898,4.20
9878746,9935384,4798,1679300,11614684,16.90
9878747,9941072,3258,1140300,11081372,11.47
9878748,9954192,1717,600950,10555142,6.04
9878749,9958634,1156,404600,10363234,4.06
9878750,9958313,2641,924350,10882663,9.28
9878751,9958479,1634,571900,10530379,5.74
9878752,9960155,4170,1459500,11419655,14.65
9878753,9965170,5272,1845200,11810370,18.52
9878754,136534,56,19600,156134,14.36
9878755,9932608,4035,1412250,11344858,14.22
9878756,7093427,2720,952000,8045427,13.42
9878757,9968519,4469,1564150,11532669,15.69
9878758,906994,240,84000,990994,9.26
9878760,9946655,6142,2149700,12096355,21.61
9878761,9958318,2106,737100,10695418,7.40
9878762,9942434,2480,868000,10810434,8.73
9878763,9957518,3808,1332800,11290318,13.38
9878764,887633,174,60900,948533,6.86
9878765,9935092,4150,1452500,11387592,14.62
9878766,1152953,475,166250,1319203,14.42
9878767,9874040,2845,995750,10869790,10.08
9878768,220924,142,49700,270624,22.50
9878769,9921253,3772,1320200,11241453,13.31
9878770,9914748,3732,1306200,11220948,13.17
9878771,687074,218,76300,763374,11.11
9878772,9927124,6500,2275000,12202124,22.92
9878773,9935490,3039,1063650,10999140,10.71
9878774,1222191,261,91350,1313541,7.47
9878775,9943897,4338,1518300,11462197,15.27
9878776,9958176,4046,1416100,11374276,14.22
9878777,9968157,4259,1490650,11458807,14.95
9878778,9973263,1419,496650,10469913,4.98
9878779,9972396,6663,2332050,12304446,23.39
9878780,9965933,4428,1549800,11515733,15.55
9878781,9966401,4359,1525650,11492051,15.31
9878782,9952882,838,293300,10246182,2.95
9878783,9961458,1661,581350,10542808,5.84
9878784,9965378,5216,1825600,11790978,18.32
9878785,9941772,1630,570500,10512272,5.74
9878786,865225,388,135800,1001025,15.70
9878787,9916116,2024,708400,10624516,7.14
9878788,9920685,3532,1236200,11156885,12.46
9878789,9945230,4268,1493800,11439030,15.02
9878790,9891794,4442,1554700,11446494,15.72
9878791,9957518,2698,944300,10901818,9.48
9878792,9955425,3075,1076250,11031675,10.81
9878793,9174465,4680,1638000,10812465,17.85
9878794,9983349,4655,1629250,11612599,16.32
9878795,98209,42,14700,112909,14.97
9878796,9977042,4365,1527750,11504792,15.31
9878797,9973284,4922,1722700,11695984,17.27
9878798,9978453,3387,1185450,11163903,11.88
9878800,3556476,1348,471800,4028276,13.27
9878801,9977571,1377,481950,10459521,4.83
9878802,9971632,4276,1496600,11468232,15.01
9878803,350189,127,44450,394639,12.69
9878804,9958780,3401,1190350,11149130,11.95
9878805,9968900,2048,716800,10685700,7.19
9878806,9979727,4452,1558200,11537927,15.61
9878807,9968006,2896,1013600,10981606,10.17
9878808,2265685,477,166950,2432635,7.37
9878809,9871164,3257,1139950,11011114,11.55
9878810,9981210,5089,1781150,11762360,17.85
9878811,9994987,4516,1580600,11575587,15.81
9878812,72273,19,6650,78923,9.20
9878813,9981882,3572,1250200,11232082,12.52
9878814,9993017,1839,643650,10636667,6.44
9878815,9999238,4452,1558200,11557438,15.58
9878816,9976640,5562,1946700,11923340,19.51
9878817,9986312,4754,1663900,11650212,16.66
9878818,9990778,5239,1833650,11824428,18.35
9878819,9976150,1955,684250,10660400,6.86
9878820,9994275,2631,920850,10915125,9.21
9878821,1246961,984,344400,1591361,27.62
9878822,6665469,3162,1106700,7772169,16.60
9878823,9978352,4709,1648150,11626502,16.52
9878824,9982658,2180,763000,10745658,7.64
9878825,1129895,160,56000,1185895,4.96
9878826,890953,270,94500,985453,10.61
9878827,9982803,5662,1981700,11964503,19.85
9878828,9979174,3888,1360800,11339974,13.64
9878829,9954518,4030,1410500,11365018,14.17
9878830,9980624,1971,689850,10670474,6.91
9878831,9968401,4783,1674050,11642451,16.79
9878832,9992926,1485,519750,10512676,5.20
9878833,9977850,2554,893900,10871750,8.96
9878834,9974500,1673,585550,10560050,5.87
9878835,9966164,4014,1404900,11371064,14.10
9878836,9990202,4267,1493450,11483652,14.95
9878837,9990262,1970,689500,10679762,6.90
9878838,9972092,4818,1686300,11658392,16.91
9878839,236166,95,33250,269416,14.08
9878840,5927170,5567,1948450,7875620,32.87
9878841,9969911,4598,1609300,11579211,16.14
9878842,9956768,3728,1304800,11261568,13.10
9878843,9980966,3774,1320900,11301866,13.23
9878844,9971418,4531,1585850,11557268,15.90
9878845,9975668,6395,2238250,12213918,22.44
9878846,9989920,1562,546700,10536620,5.47
9878847,9992492,3663,1282050,11274542,12.83
9878848,9985842,2226,779100,10764942,7.80
9878849,9993715,2831,990850,10984565,9.91
9878850,9997167,4045,1415750,11412917,14.16
9878851,9958977,4268,1493800,11452777,15.00
9878852,9986734,2467,863450,10850184,8.65
9878853,9995624,3229,1130150,11125774,11.31
9878854,9988527,6757,2364950,12353477,23.68
9878855,3013125,1435,502250,3515375,16.67
9878856,503323,220,77000,580323,15.30
9878857,9975501,3998,1399300,11374801,14.03
9878858,463975,342,119700,583675,25.80
9878859,200010,397,138950,338960,69.47
9878860,9958101,3003,1051050,11009151,10.55
9878861,1091678,400,140000,1231678,12.82
9878862,9949241,2516,880600,10829841,8.85
9878863,9956149,4591,1606850,11562999,16.14
9878865,9955106,4806,1682100,11637206,16.90
9878866,9958084,2612,914200,10872284,9.18
9878867,9932067,5307,1857450,11789517,18.70
9878868,9969523,4551,1592850,11562373,15.98
9878869,9977373,2826,989100,10966473,9.91
9878870,9986087,3412,1194200,11180287,11.96
9878871,9975703,1301,455350,10431053,4.56
9878873,9952259,5713,1999550,11951809,20.09
9878874,9966876,886,310100,10276976,3.11
9878875,1068029,905,316750,1384779,29.66
9878876,1268000,955,334250,1602250,26.36
9878877,9958331,7286,2550100,12508431,25.61
9878878,3857930,1752,613200,4471130,15.89
9878879,9934119,2880,1008000,10942119,10.15
9878880,9958335,4104,1436400,11394735,14.42
9878881,4488807,2203,771050,5259857,17.18
9878882,9972525,4943,1730050,11702575,17.35
9878883,200358,76,26600,226958,13.28
9878884,9951436,3362,1176700,11128136,11.82
9878885,9954263,2811,983850,10938113,9.88
9878886,9128147,1916,670600,9798747,7.35
9878887,9975512,4234,1481900,11457412,14.86
9878888,9976632,2263,792050,10768682,7.94
9878889,9977749,1548,541800,10519549,5.43
9878890,9575798,4220,1477000,11052798,15.42
9878891,9744857,5551,1942850,11687707,19.94
9878892,9983805,1616,565600,10549405,5.67
9878893,9960082,2122,742700,10702782,7.46
9878894,9958612,4930,1725500,11684112,17.33
9878895,9892390,5123,1793050,11685440,18.13
9878896,9977079,2558,895300,10872379,8.97
9878897,9975997,1834,641900,10617897,6.43
9878898,9994002,1582,553700,10547702,5.54
9878899,9973345,1891,661850,10635195,6.64
9878900,9980786,4826,1689100,11669886,16.92
9878901,316022,145,50750,366772,16.06
9878902,9989379,3793,1327550,11316929,13.29
9878903,9990558,4601,1610350,11600908,16.12
9878904,9993873,5701,1995350,11989223,19.97
9878905,9992676,583,204050,10196726,2.04
9878906,9971227,1101,385350,10356577,3.86
9878907,9988720,1249,437150,10425870,4.38
9878908,9994804,2389,836150,10830954,8.37
9878909,9987045,3844,1345400,11332445,13.47
9878910,2505623,1670,584500,3090123,23.33
9878911,9978762,2054,718900,10697662,7.20
9878912,9993429,3915,1370250,11363679,13.71
9878913,9993089,2152,753200,10746289,7.54
9878914,225114,44,15400,240514,6.84
9878915,9978515,5607,1962450,11940965,19.67
9878916,1405086,610,213500,1618586,15.19
9878918,9987591,3888,1360800,11348391,13.62
9878919,5446539,1302,455700,5902239,8.37
9878920,9972907,2681,938350,10911257,9.41
9878921,616908,216,75600,692508,12.25
9878922,9989235,5772,2020200,12009435,20.22
9878923,9980162,4592,1607200,11587362,16.10
9878924,499671,157,54950,554621,11.00
9878925,9979959,3133,1096550,11076509,10.99
9878926,9997469,4938,1728300,11725769,17.29
9878927,1757666,841,294350,2052016,16.75
9878928,9982642,4535,1587250,11569892,15.90
9878929,9980285,4851,1697850,11678135,17.01
9878930,976949,462,161700,1138649,16.55
9878931,2087032,1004,351400,2438432,16.84
9878932,9987201,3889,1361150,11348351,13.63
9878933,9996506,5081,1778350,11774856,17.79
9878934,9973422,7641,2674350,12647772,26.81
9878935,5192238,1887,660450,5852688,12.72
9878936,9967981,2201,770350,10738331,7.73
9878937,9962048,1835,642250,10604298,6.45
9878938,9940124,5102,1785700,11725824,17.96
9878939,9961622,3354,1173900,11135522,11.78
9878940,9965604,3627,1269450,11235054,12.74
9878941,9987598,2618,916300,10903898,9.17
9878942,9997243,2355,824250,10821493,8.24
9878943,1825282,130,45500,1870782,2.49
9878944,9986083,3677,1286950,11273033,12.89
9878945,9975144,2461,861350,10836494,8.63
9878946,9991694,4362,1526700,11518394,15.28
9878947,9968741,2822,987700,10956441,9.91
9878948,9993210,4991,1746850,11740060,17.48
9878949,9981199,4832,1691200,11672399,16.94
9878950,9986647,1801,630350,10616997,6.31
9878951,9983785,5761,2016350,12000135,20.20
9878952,9992631,4449,1557150,11549781,15.58
9878953,598217,251,87850,686067,14.69
9878954,5035348,1315,460250,5495598,9.14
9878955,9987202,4717,1650950,11638152,16.53
9878956,9923474,3354,1173900,11097374,11.83
9878957,9924887,1407,492450,10417337,4.96
9878958,9985458,1662,581700,10567158,5.83
9878959,9906236,3776,1321600,11227836,13.34
9878960,1842274,1383,484050,2326324,26.27
9878961,1696245,1463,512050,2208295,30.19
9878962,9950938,3564,1247400,11198338,12.54
9878963,9966294,4053,1418550,11384844,14.23
9878964,9958541,1081,378350,10336891,3.80
9878965,9978955,1962,686700,10665655,6.88
9878966,9978721,5173,1810550,11789271,18.14
9878967,9993751,2780,973000,10966751,9.74
9878968,9975503,4864,1702400,11677903,17.07
9878969,56209,42,14700,70909,26.15
9878970,9963950,5147,1801450,11765400,18.08
9878971,9968319,1865,652750,10621069,6.55
9878972,9952570,2147,751450,10704020,7.55
9878973,9955559,3117,1090950,11046509,10.96
9878974,5111951,1566,548100,5660051,10.72
9878975,9880629,3027,1059450,10940079,10.72
9878976,393383,165,57750,451133,14.68
9878977,9960152,5084,1779400,11739552,17.87
9878978,2347799,961,336350,2684149,14.33
9878979,9949176,4081,1428350,11377526,14.36
9878980,9401833,3534,1236900,10638733,13.16
9878981,9948715,5592,1957200,11905915,19.67
9878982,9964051,4069,1424150,11388201,14.29
9878983,9825639,3998,1399300,11224939,14.24
9878984,9963987,3953,1383550,11347537,13.89
9878985,9954859,4742,1659700,11614559,16.67
9878986,9944332,3674,1285900,11230232,12.93
9878987,1868207,493,172550,2040757,9.24
9878988,9948365,4323,1513050,11461415,15.21
9878989,9948057,1581,553350,10501407,5.56
9878990,9944073,1701,595350,10539423,5.99
9878991,9856768,3864,1352400,11209168,13.72
9878992,1482918,1031,360850,1843768,24.33
9878993,9940024,6127,2144450,12084474,21.57
9878994,9941075,3764,1317400,11258475,13.25
9878995,9948447,4688,1640800,11589247,16.49
9878996,9942964,2368,828800,10771764,8.34
9878998,9962943,3976,1391600,11354543,13.97
9878999,9965681,2192,767200,10732881,7.70
9879000,4270962,2159,755650,5026612,17.69
9879001,9990401,5740,2009000,11999401,20.11
9879002,9977461,4184,1464400,11441861,14.68
9879003,1731112,289,101150,1832262,5.84
9879004,9999796,6717,2350950,12350746,23.51
9879005,9979678,2413,844550,10824228,8.46
9879006,9992408,4524,1583400,11575808,15.85
9879007,9992794,3997,1398950,11391744,14.00
9879008,9983994,5039,1763650,11747644,17.66
9879009,9994162,4597,1608950,11603112,16.10
9879010,9969928,4399,1539650,11509578,15.44
9879011,93273,19,6650,99923,7.13
9879012,9975598,5732,2006200,11981798,20.11
9879013,9985864,663,232050,10217914,2.32
9879014,9965252,4600,1610000,11575252,16.16
9879015,9977382,2581,903350,10880732,9.05
9879016,1540505,717,250950,1791455,16.29
9879017,9968597,1725,603750,10572347,6.06
9879018,9971634,3042,1064700,11036334,10.68
9879019,9958158,4848,1696800,11654958,17.04
9879020,9952869,6209,2173150,12126019,21.83
9879021,239189,167,58450,297639,24.44
9879022,9961283,3861,1351350,11312633,13.57
9879023,9969019,1226,429100,10398119,4.30
9879025,5668954,3794,1327900,6996854,23.42
9879026,9961843,4351,1522850,11484693,15.29
9879027,1876762,985,344750,2221512,18.37
9879028,9961337,5364,1877400,11838737,18.85
9879029,9943855,4205,1471750,11415605,14.80
9879030,9964241,2906,1017100,10981341,10.21
9879031,9973511,1431,500850,10474361,5.02
9879032,9953719,3497,1223950,11177669,12.30
9879033,9955415,3717,1300950,11256365,13.07
9879034,9965508,2798,979300,10944808,9.83
9879035,9952326,4785,1674750,11627076,16.83
9879036,9960219,2454,858900,10819119,8.62
9879037,1471349,532,186200,1657549,12.66
9879038,9938898,1139,398650,10337548,4.01
9879039,9925391,2446,856100,10781491,8.63
9879040,9926960,4459,1560650,11487610,15.72
9879041,9919203,532,186200,10105403,1.88
9879042,9916868,3782,1323700,11240568,13.35
9879043,2641229,2379,832650,3473879,31.53
9879044,9941345,5867,2053450,11994795,20.66
9879045,9954706,3361,1176350,11131056,11.82
9879046,9952426,2619,916650,10869076,9.21
9879047,9966142,3596,1258600,11224742,12.63
9879048,9980854,3380,1183000,11163854,11.85
9879049,9987478,4375,1531250,11518728,15.33
9879050,9986172,3549,1242150,11228322,12.44
9879051,9981994,3313,1159550,11141544,11.62
9879052,1387869,329,115150,1503019,8.30
9879053,9948521,2582,903700,10852221,9.08
9879055,9931013,4553,1593550,11524563,16.05
9879056,9944350,4433,1551550,11495900,15.60
9879057,9958305,3830,1340500,11298805,13.46
9879058,9938288,1026,359100,10297388,3.61
9879059,9923521,2347,821450,10744971,8.28
9879060,9950484,3030,1060500,11010984,10.66
9879061,9966419,2292,802200,10768619,8.05
9879062,9984270,3816,1335600,11319870,13.38
9879063,9957902,4235,1482250,11440152,14.89
9879064,9946643,3590,1256500,11203143,12.63
9879065,9955040,2142,749700,10704740,7.53
9879066,9925256,3959,1385650,11310906,13.96
9879067,9973843,4402,1540700,11514543,15.45
9879068,9975117,4336,1517600,11492717,15.21
9879069,9980372,3525,1233750,11214122,12.36
9879070,9992138,2620,917000,10909138,9.18
9879071,9987601,5105,1786750,11774351,17.89
9879072,9988324,1546,541100,10529424,5.42
9879073,9979667,3827,1339450,11319117,13.42
9879074,9986219,4178,1462300,11448519,14.64
9879075,9969942,5185,1814750,11784692,18.20
9879076,1397872,310,108500,1506372,7.76
9879077,9960206,4595,1608250,11568456,16.15
9879078,2483517,743,260050,2743567,10.47
9879079,2699491,1424,498400,3197891,18.46
9879080,9926665,3715,1300250,11226915,13.10
9879081,7005863,4307,1507450,8513313,21.52
9879082,9951416,3710,1298500,11249916,13.05
9879083,9942220,5063,1772050,11714270,17.82
9879084,9949244,3767,1318450,11267694,13.25
9879085,1913680,803,281050,2194730,14.69
9879086,9945123,3179,1112650,11057773,11.19
9879087,9949650,4326,1514100,11463750,15.22
9879088,9962052,2517,880950,10843002,8.84
9879089,584900,255,89250,674150,15.26
9879090,9951147,5841,2044350,11995497,20.54
9879091,9955358,4037,1412950,11368308,14.19
9879092,9957305,1293,452550,10409855,4.54
9879093,9954078,4032,1411200,11365278,14.18
9879094,9965002,1310,458500,10423502,4.60
9879095,9965988,1260,441000,10406988,4.43
9879096,9974644,2360,826000,10800644,8.28
9879097,1815170,820,287000,2102170,15.81
9879098,9973087,3584,1254400,11227487,12.58
9879099,9970860,1669,584150,10555010,5.86
9879100,9958780,4789,1676150,11634930,16.83
9879101,9963373,4052,1418200,11381573,14.23
9879102,9987294,3596,1258600,11245894,12.60
9879103,9935366,4015,1405250,11340616,14.14
9879104,9971253,4391,1536850,11508103,15.41
9879105,9971871,2277,796950,10768821,7.99
9879106,9959144,2095,733250,10692394,7.36
9879107,9968176,4286,1500100,11468276,15.05
9879108,9971315,5131,1795850,11767165,18.01
9879109,9954232,1200,420000,10374232,4.22
9879110,1408966,439,153650,1562616,10.91
9879111,9971936,2580,903000,10874936,9.06
9879112,9981720,650,227500,10209220,2.28
9879113,9987599,1674,585900,10573499,5.87
9879114,9990917,3944,1380400,11371317,13.82
9879115,9992608,4066,1423100,11415708,14.24
9879116,9982005,4173,1460550,11442555,14.63
9879117,9972994,1522,532700,10505694,5.34
9879118,72273,19,6650,78923,9.20
9879119,9989077,5415,1895250,11884327,18.97
9879120,9991711,1500,525000,10516711,5.25
9879121,1626917,1666,583100,2210017,35.84
9879122,9941157,2205,771750,10712907,7.76
9879123,9975343,4136,1447600,11422943,14.51
9879124,9988645,924,323400,10312045,3.24
9879125,9977765,669,234150,10211915,2.35
9879126,9998937,3676,1286600,11285537,12.87
9879127,9976115,3398,1189300,11165415,11.92
9879128,9990757,827,289450,10280207,2.90
9879129,9978228,2238,783300,10761528,7.85
9879130,9940162,2059,720650,10660812,7.25
9879131,9961052,657,229950,10191002,2.31
9879132,9958287,2258,790300,10748587,7.94
9879133,1818866,1499,524650,2343516,28.84
9879134,9990062,4795,1678250,11668312,16.80
9879135,9994122,1542,539700,10533822,5.40
9879136,9965374,2024,708400,10673774,7.11
9879137,9991132,4036,1412600,11403732,14.14
9879138,9997026,817,285950,10282976,2.86
9879139,275064,101,35350,310414,12.85
9879140,9995914,1995,698250,10694164,6.99
9879141,9985573,2052,718200,10703773,7.19
9879142,9978969,2374,830900,10809869,8.33
9879143,9998838,5472,1915200,11914038,19.15
9879144,9986342,5313,1859550,11845892,18.62
9879145,219719,101,35350,255069,16.09
9879146,9973005,1214,424900,10397905,4.26
9879147,9988123,2351,822850,10810973,8.24
9879148,9995652,1243,435050,10430702,4.35
9879149,9986847,2509,878150,10864997,8.79
9879151,9978294,2169,759150,10737444,7.61
9879153,9964857,1858,650300,10615157,6.53
9879154,9973632,2747,961450,10935082,9.64
9879155,9988195,4044,1415400,11403595,14.17
9879156,9981594,1368,478800,10460394,4.80
9879157,9997885,2952,1033200,11031085,10.33
9879158,9983428,1776,621600,10605028,6.23
9879159,9975435,4639,1623650,11599085,16.28
9879160,9971932,4358,1525300,11497232,15.30
9879161,9985086,1915,670250,10655336,6.71
9879162,1076043,688,240800,1316843,22.38
9879163,9973872,2016,705600,10679472,7.07
9879164,9980522,4369,1529150,11509672,15.32
9879165,9895240,2151,752850,10648090,7.61
9879166,9987536,2390,836500,10824036,8.38
9879167,9985478,2308,807800,10793278,8.09
9879169,1776352,1650,577500,2353852,32.51
9879170,4482960,1201,420350,4903310,9.38
9879171,9974013,3503,1226050,11200063,12.29
9879172,9967397,1802,630700,10598097,6.33
9879173,4586532,1666,583100,5169632,12.71
9879174,1049392,389,136150,1185542,12.97
9879175,9950058,4877,1706950,11657008,17.16
9879176,9954243,3077,1076950,11031193,10.82
9879177,9938585,1372,480200,10418785,4.83
9879178,9942985,1022,357700,10300685,3.60
9879179,9963435,1480,518000,10481435,5.20
9879180,911149,440,154000,1065149,16.90
9879181,9979165,4879,1707650,11686815,17.11
9879182,9988075,84,29400,10017475,0.29
9879183,9992597,5956,2084600,12077197,20.86
9879184,221644,253,88550,310194,39.95
9879185,9963776,5153,1803550,11767326,18.10
9879186,9974230,3149,1102150,11076380,11.05
9879187,9987744,3285,1149750,11137494,11.51
9879188,1965703,974,340900,2306603,17.34
9879189,124660,77,26950,151610,21.62
9879190,9977801,3787,1325450,11303251,13.28
9879191,407800,228,79800,487600,19.57
9879192,9978154,3964,1387400,11365554,13.90
9879193,9961983,4421,1547350,11509333,15.53
9879194,2067926,939,328650,2396576,15.89
9879195,9941234,5302,1855700,11796934,18.67
9879196,893236,325,113750,1006986,12.73
9879197,333539,107,37450,370989,11.23
9879198,9989718,2894,1012900,11002618,10.14
9879199,9920685,4599,1609650,11530335,16.23
9879200,9976616,3862,1351700,11328316,13.55
9879201,9977546,3238,1133300,11110846,11.36
9879202,9970130,3636,1272600,11242730,12.76
9879203,9958546,5364,1877400,11835946,18.85
9879204,9983470,2641,924350,10907820,9.26
9879205,9975565,5118,1791300,11766865,17.96
9879206,9208294,1480,518000,9726294,5.63
9879207,9980775,4873,1705550,11686325,17.09
9879208,9997578,4232,1481200,11478778,14.82
9879209,773444,493,172550,945994,22.31
9879211,9963349,1605,561750,10525099,5.64
9879212,9977982,2140,749000,10726982,7.51
9879213,9976029,1169,409150,10385179,4.10
9879214,9980743,6147,2151450,12132193,21.56
9879215,9961801,4197,1468950,11430751,14.75
9879216,9985026,2213,774550,10759576,7.76
9879217,1137104,392,137200,1274304,12.07
9879218,9953286,3224,1128400,11081686,11.34
9879219,9963122,2499,874650,10837772,8.78
9879220,9978851,1703,596050,10574901,5.97
9879221,9969129,1478,517300,10486429,5.19
9879222,9961668,1829,640150,10601818,6.43
9879223,9974380,5635,1972250,11946630,19.77
9879224,295705,119,41650,337355,14.08
9879225,3332911,1087,380450,3713361,11.41
9879226,9982809,4175,1461250,11444059,14.64
9879227,9977776,5011,1753850,11731626,17.58
9879228,9989424,3970,1389500,11378924,13.91
9879229,9993861,3371,1179850,11173711,11.81
9879230,1984330,759,265650,2249980,13.39
9879231,9969159,2300,805000,10774159,8.07
9879232,1707020,732,256200,1963220,15.01
9879233,9946703,2397,838950,10785653,8.43
9879234,1839723,1149,402150,2241873,21.86
9879235,9937101,4171,1459850,11396951,14.69
9879236,9966695,5419,1896650,11863345,19.03
9879237,9967944,3488,1220800,11188744,12.25
9879238,3832088,2041,714350,4546438,18.64
9879239,9981100,5024,1758400,11739500,17.62
9879240,9984024,2635,922250,10906274,9.24
9879241,9994667,1800,630000,10624667,6.30
9879242,9992935,3935,1377250,11370185,13.78
9879243,9980358,2416,845600,10825958,8.47
9879244,9964160,1483,519050,10483210,5.21
9879245,9989278,4336,1517600,11506878,15.19
9879246,9984398,3415,1195250,11179648,11.97
9879247,9980667,2159,755650,10736317,7.57
9879248,51273,19,6650,57923,12.97
9879249,586733,328,114800,701533,19.57
9879250,9970584,3436,1202600,11173184,12.06
9879251,9965090,2661,931350,10896440,9.35
9879252,8977866,4162,1456700,10434566,16.23
9879253,9983120,5047,1766450,11749570,17.69
9879254,9968778,2672,935200,10903978,9.38
9879255,9989660,1463,512050,10501710,5.13
9879256,9979293,1609,563150,10542443,5.64
9879257,9995605,1309,458150,10453755,4.58
9879258,9988839,1793,627550,10616389,6.28
9879259,9981340,6800,2380000,12361340,23.84
9879260,9999013,4147,1451450,11450463,14.52
9879261,9991327,1399,489650,10480977,4.90
9879262,9993227,1385,484750,10477977,4.85
9879263,9979430,1746,611100,10590530,6.12
9879264,9986946,2720,952000,10938946,9.53
9879265,9997754,2983,1044050,11041804,10.44
9879266,9957504,1458,510300,10467804,5.12
9879267,9987315,4174,1460900,11448215,14.63
9879268,9971202,3768,1318800,11290002,13.23
9879269,9953668,4760,1666000,11619668,16.74
9879270,9994222,1287,450450,10444672,4.51
9879271,9998895,2527,884450,10883345,8.85
9879272,9982330,2882,1008700,10991030,10.10
9879273,9996859,4429,1550150,11547009,15.51
9879274,9973076,5919,2071650,12044726,20.77
9879275,9969799,2250,787500,10757299,7.90
9879276,9970693,4434,1551900,11522593,15.56
9879277,9967416,3500,1225000,11192416,12.29
9879278,8976252,3130,1095500,10071752,12.20
9879279,9974879,6642,2324700,12299579,23.31
9879280,9960986,1952,683200,10644186,6.86
9879281,9983711,1139,398650,10382361,3.99
9879282,9989016,3211,1123850,11112866,11.25
9879283,9982238,538,188300,10170538,1.89
9879284,9998626,3496,1223600,11222226,12.24
9879285,9987456,4403,1541050,11528506,15.43
9879286,9047428,1110,388500,9435928,4.29
9879287,9944082,4204,1471400,11415482,14.80
9879288,9972540,2421,847350,10819890,8.50
9879289,9989235,2111,738850,10728085,7.40
9879290,9987333,4266,1493100,11480433,14.95
9879291,364780,129,45150,409930,12.38
9879292,9995062,2842,994700,10989762,9.95
9879293,9980621,956,334600,10315221,3.35
9879294,3060292,1514,529900,3590192,17.32
9879295,9977947,6262,2191700,12169647,21.97
9879296,9990135,1014,354900,10345035,3.55
9879297,9962177,4521,1582350,11544527,15.88
9879298,9972291,3593,1257550,11229841,12.61
9879299,9997484,945,330750,10328234,3.31
9879300,9971182,1889,661150,10632332,6.63
9879301,2796952,2095,733250,3530202,26.22
9879302,1813377,1054,368900,2182277,20.34
9879303,6841053,2703,946050,7787103,13.83
9879304,9974266,3624,1268400,11242666,12.72
9879305,9965130,4533,1586550,11551680,15.92
9879306,9976682,4903,1716050,11692732,17.20
9879307,9989954,2169,759150,10749104,7.60
9879308,9983323,3049,1067150,11050473,10.69
9879309,9950158,1156,404600,10354758,4.07
9879310,159641,138,48300,207941,30.26
9879311,730635,473,165550,896185,22.66
9879312,4020412,2205,771750,4792162,19.20
9879314,9989090,4099,1434650,11423740,14.36
9879315,9987510,4243,1485050,11472560,14.87
9879316,9990207,3369,1179150,11169357,11.80
9879317,9976372,2878,1007300,10983672,10.10
9879318,797962,485,169750,967712,21.27
9879319,1990730,1032,361200,2351930,18.14
9879320,9943055,5081,1778350,11721405,17.89
9879321,9959763,1136,397600,10357363,3.99
9879322,9967788,4781,1673350,11641138,16.79
9879323,9967392,3008,1052800,11020192,10.56
9879324,9981482,4261,1491350,11472832,14.94
9879325,9980852,3184,1114400,11095252,11.17
9879326,9983957,4685,1639750,11623707,16.42
9879327,537569,166,58100,595669,10.81
9879328,1002274,460,161000,1163274,16.06
9879329,9974657,4121,1442350,11417007,14.46
9879330,9966670,2384,834400,10801070,8.37
9879331,9984716,5194,1817900,11802616,18.21
9879332,9981466,5046,1766100,11747566,17.69
9879333,111373,47,16450,127823,14.77
9879334,9960810,4925,1723750,11684560,17.31
9879335,9948034,2793,977550,10925584,9.83
9879336,9490042,3724,1303400,10793442,13.73
9879337,9939737,2784,974400,10914137,9.80
9879338,9926330,2367,828450,10754780,8.35
9879339,8931652,1737,607950,9539602,6.81
9879340,9947898,2205,771750,10719648,7.76
9879341,1274386,312,109200,1383586,8.57
9879342,9925953,3238,1133300,11059253,11.42
9879343,9932108,5295,1853250,11785358,18.66
9879344,9932439,3911,1368850,11301289,13.78
9879345,9952625,4956,1734600,11687225,17.43
9879346,3797618,1537,537950,4335568,14.17
9879347,9920643,3986,1395100,11315743,14.06
9879348,9912256,2446,856100,10768356,8.64
9879349,9923979,6967,2438450,12362429,24.57
9879350,9934517,2024,708400,10642917,7.13
9879351,471476,279,97650,569126,20.71
9879352,9911478,4685,1639750,11551228,16.54
9879353,9921740,2264,792400,10714140,7.99
9879354,9922757,833,291550,10214307,2.94
9879355,9936511,3991,1396850,11333361,14.06
9879356,9927783,3359,1175650,11103433,11.84
9879357,9938277,2460,861000,10799277,8.66
9879358,9948982,3409,1193150,11142132,11.99
9879359,9942711,1225,428750,10371461,4.31
9879360,9960003,2718,951300,10911303,9.55
9879361,9968028,3153,1103550,11071578,11.07
9879363,9607924,2592,907200,10515124,9.44
9879365,9929692,1651,577850,10507542,5.82
9879366,9946626,4658,1630300,11576926,16.39
9879367,9945566,1268,443800,10389366,4.46
9879368,9946609,4938,1728300,11674909,17.38
9879369,9965278,2351,822850,10788128,8.26
9879370,9972892,4643,1625050,11597942,16.29
9879371,9951260,3523,1233050,11184310,12.39
9879372,9956600,5700,1995000,11951600,20.04
9879373,9972049,3902,1365700,11337749,13.70
9879374,9974163,6071,2124850,12099013,21.30
9879375,9987820,4408,1542800,11530620,15.45
9879376,9973703,848,296800,10270503,2.98
9879377,9970647,1556,544600,10515247,5.46
9879378,9989007,3698,1294300,11283307,12.96
9879379,4003070,2534,886900,4889970,22.16
9879380,9979038,2068,723800,10702838,7.25
9879381,2391945,410,143500,2535445,6.00
9879382,4305832,2976,1041600,5347432,24.19
9879383,9975119,4315,1510250,11485369,15.14
9879384,9988947,2291,801850,10790797,8.03
9879385,9998364,2490,871500,10869864,8.72
9879386,9985410,964,337400,10322810,3.38
9879387,2154415,1750,612500,2766915,28.43
9879388,9980497,6402,2240700,12221197,22.45
9879389,1154517,1208,422800,1577317,36.62
9879390,9976429,4150,1452500,11428929,14.56
9879391,9964505,3158,1105300,11069805,11.09
9879392,9972668,3606,1262100,11234768,12.66
9879393,1659857,949,332150,1992007,20.01
9879394,9990761,1284,449400,10440161,4.50
9879395,9993802,963,337050,10330852,3.37
9879396,577162,142,49700,626862,8.61
9879397,9970541,4987,1745450,11715991,17.51
9879398,9976663,2592,907200,10883863,9.09
9879399,1457812,1206,422100,1879912,28.95
9879401,9956875,4590,1606500,11563375,16.13
9879402,9979768,1777,621950,10601718,6.23
9879403,9970169,5496,1923600,11893769,19.29
9879404,2525831,2305,806750,3332581,31.94
9879405,9956761,4532,1586200,11542961,15.93
9879407,9955323,1925,673750,10629073,6.77
9879408,9964841,3449,1207150,11171991,12.11
9879409,9967671,2412,844200,10811871,8.47
9879410,2201173,463,162050,2363223,7.36
9879411,9975685,2965,1037750,11013435,10.40
9879412,9957735,1477,516950,10474685,5.19
9879413,9953932,4513,1579550,11533482,15.87
9879414,9949875,618,216300,10166175,2.17
9879415,8365655,1231,430850,8796505,5.15
9879416,9952127,3775,1321250,11273377,13.28
9879417,9978167,2895,1013250,10991417,10.15
9879418,9974498,647,226450,10200948,2.27
9879419,9966809,680,238000,10204809,2.39
9879420,106753,67,23450,130203,21.97
9879421,9682165,4189,1466150,11148315,15.14
9879422,9958831,3673,1285550,11244381,12.91
9879423,1523532,1621,567350,2090882,37.24
9879424,9954889,2360,826000,10780889,8.30
9879425,9935269,3533,1236550,11171819,12.45
9879426,698633,159,55650,754283,7.97
9879427,9930235,1972,690200,10620435,6.95
9879428,9920073,1592,557200,10477273,5.62
9879429,9921060,2561,896350,10817410,9.03
9879430,9935817,5874,2055900,11991717,20.69
9879431,9930989,1354,473900,10404889,4.77
9879432,9950457,604,211400,10161857,2.12
9879433,9953677,3346,1171100,11124777,11.77
9879434,9936966,5689,1991150,11928116,20.04
9879435,9965699,3558,1245300,11210999,12.50
9879437,9969135,403,141050,10110185,1.41
9879438,9973952,493,172550,10146502,1.73
9879439,9958568,3587,1255450,11214018,12.61
9879440,9964897,4310,1508500,11473397,15.14
9879441,9962234,4152,1453200,11415434,14.59
9879442,9984304,1430,500500,10484804,5.01
9879443,3244665,1327,464450,3709115,14.31
9879444,9982682,2526,884100,10866782,8.86
9879445,9969221,3671,1284850,11254071,12.89
9879446,9981530,1179,412650,10394180,4.13
9879447,2812081,891,311850,3123931,11.09
9879448,675129,984,344400,1019529,51.01
9879449,9699628,3043,1065050,10764678,10.98
9879450,9986736,3031,1060850,11047586,10.62
9879451,9913935,4489,1571150,11485085,15.85
9879452,9979136,2439,853650,10832786,8.55
9879453,9972439,5125,1793750,11766189,17.99
9879455,9963568,4960,1736000,11699568,17.42
9879456,9978056,1925,673750,10651806,6.75
9879457,9974785,3665,1282750,11257535,12.86
9879458,9976678,2509,878150,10854828,8.80
9879459,9956675,3100,1085000,11041675,10.90
9879460,561781,331,115850,677631,20.62
9879461,9949524,1874,655900,10605424,6.59
9879462,9949704,1200,420000,10369704,4.22
9879463,9966761,5117,1790950,11757711,17.97
9879464,9971412,5398,1889300,11860712,18.95
9879465,9943967,1772,620200,10564167,6.24
9879466,9956783,3252,1138200,11094983,11.43
9879467,9971232,617,215950,10187182,2.17
9879468,9952430,2996,1048600,11001030,10.54
9879469,9966870,2008,702800,10669670,7.05
9879470,9981712,496,173600,10155312,1.74
9879471,1288171,353,123550,1411721,9.59
9879472,9973143,4074,1425900,11399043,14.30
9879473,1564644,1971,689850,2254494,44.09
9879474,9967712,2183,764050,10731762,7.67
9879475,5595151,2661,931350,6526501,16.65
9879476,2156879,740,259000,2415879,12.01
9879477,9984917,5361,1876350,11861267,18.79
9879478,9969871,3253,1138550,11108421,11.42
9879479,9970210,6272,2195200,12165410,22.02
9879480,9992117,2140,749000,10741117,7.50
9879481,9983767,3524,1233400,11217167,12.35
9879482,9992818,2962,1036700,11029518,10.37
9879483,9990446,4734,1656900,11647346,16.58
9879484,723593,427,149450,873043,20.65
9879486,9983461,3441,1204350,11187811,12.06
9879487,752542,422,147700,900242,19.63
9879488,9954039,2332,816200,10770239,8.20
9879489,9935972,4759,1665650,11601622,16.76
9879490,2291539,1913,669550,2961089,29.22
9879491,9941625,4012,1404200,11345825,14.12
9879492,9853674,2415,845250,10698924,8.58
9879493,9951794,3685,1289750,11241544,12.96
9879494,9974224,4315,1510250,11484474,15.14
9879496,9973297,4280,1498000,11471297,15.02
9879497,9978257,3083,1079050,11057307,10.81
9879498,9991610,3028,1059800,11051410,10.61
9879499,9982181,2687,940450,10922631,9.42
9879500,4728820,3220,1127000,5855820,23.83
9879501,9974174,3382,1183700,11157874,11.87
9879502,3182650,697,243950,3426600,7.66
9879503,9982676,2668,933800,10916476,9.35
9879504,9987922,1422,497700,10485622,4.98
9879506,9956718,3224,1128400,11085118,11.33
9879507,2453110,945,330750,2783860,13.48
9879508,9946170,2998,1049300,10995470,10.55
9879509,9954361,2487,870450,10824811,8.74
9879510,9955797,3598,1259300,11215097,12.65
9879511,9960913,2970,1039500,11000413,10.44
9879512,9974069,2487,870450,10844519,8.73
9879513,9961156,929,325150,10286306,3.26
9879514,9965812,5522,1932700,11898512,19.39
9879515,9973341,5064,1772400,11745741,17.77
9879516,9963287,1609,563150,10526437,5.65
9879517,1658405,1094,382900,2041305,23.09
9879518,9962823,5568,1948800,11911623,19.56
9879519,283949,93,32550,316499,11.46
9879520,4538190,3540,1239000,5777190,27.30
9879521,9929327,2013,704550,10633877,7.10
9879522,9932582,3430,1200500,11133082,12.09
9879523,9905980,2069,724150,10630130,7.31
9879524,9936008,4691,1641850,11577858,16.52
9879525,631317,279,97650,728967,15.47
9879526,9917791,4751,1662850,11580641,16.77
9879527,2650174,1229,430150,3080324,16.23
9879528,9886169,3612,1264200,11150369,12.79
9879529,9890707,1652,578200,10468907,5.85
9879530,9885634,412,144200,10029834,1.46
9879531,9905933,3618,1266300,11172233,12.78
9879532,9897586,4599,1609650,11507236,16.26
9879533,9913200,2703,946050,10859250,9.54
9879534,746130,295,103250,849380,13.84
9879535,9895669,2671,934850,10830519,9.45
9879536,9904194,4241,1484350,11388544,14.99
9879537,9909675,4336,1517600,11427275,15.31
9879538,9868755,3778,1322300,11191055,13.40
9879539,9910789,3528,1234800,11145589,12.46
9879540,9913867,2989,1046150,10960017,10.55
9879541,9922557,4358,1525300,11447857,15.37
9879542,362001,230,80500,442501,22.24
9879543,9926396,3943,1380050,11306446,13.90
9879545,9944542,3861,1351350,11295892,13.59
9879546,9944820,3505,1226750,11171570,12.34
9879547,9930782,3215,1125250,11056032,11.33
9879548,9931759,4395,1538250,11470009,15.49
9879549,9502444,4228,1479800,10982244,15.57
9879550,9925842,3466,1213100,11138942,12.22
9879551,9916177,2160,756000,10672177,7.62
9879552,9899121,4355,1524250,11423371,15.40
9879554,9915811,3217,1125950,11041761,11.36
9879556,804432,440,154000,958432,19.14
9879557,9922285,3282,1148700,11070985,11.58
9879558,9914602,5398,1889300,11803902,19.06
9879559,9935511,2512,879200,10814711,8.85
9879560,2710086,3188,1115800,3825886,41.17
9879561,9919465,5601,1960350,11879815,19.76
9879562,9893658,3197,1118950,11012608,11.31
9879563,9957348,3763,1317050,11274398,13.23
9879564,4423029,2490,871500,5294529,19.70
9879565,9966352,3139,1098650,11065002,11.02
9879566,153455,71,24850,178305,16.19
9879567,9934319,3318,1161300,11095619,11.69
9879568,541589,339,118650,660239,21.91
9879569,9925200,5303,1856050,11781250,18.70
9879570,9927344,2420,847000,10774344,8.53
9879571,9917865,3546,1241100,11158965,12.51
9879572,9922513,4382,1533700,11456213,15.46
9879573,2223323,1651,577850,2801173,25.99
9879574,1091329,313,109550,1200879,10.04
9879575,9947398,4610,1613500,11560898,16.22
9879576,9941282,739,258650,10199932,2.60
9879577,9955946,4933,1726550,11682496,17.34
9879578,9949673,2943,1030050,10979723,10.35
9879580,4513916,3492,1222200,5736116,27.08
9879581,49415,74,25900,75315,52.41
9879582,9732759,2673,935550,10668309,9.61
9879583,3691996,3485,1219750,4911746,33.04
9879584,9926806,4613,1614550,11541356,16.26
9879585,9925929,2213,774550,10700479,7.80
9879586,408033,702,245700,653733,60.22
9879587,5930609,2479,867650,6798259,14.63
9879588,399349,135,47250,446599,11.83
9879589,9915214,3314,1159900,11075114,11.70
9879590,9915235,3939,1378650,11293885,13.90
9879591,9929245,3017,1055950,10985195,10.63
9879592,9928429,1999,699650,10628079,7.05
9879593,9925587,2614,914900,10840487,9.22
9879594,9819856,2802,980700,10800556,9.99
9879596,9908811,2848,996800,10905611,10.06
9879597,9827592,3658,1280300,11107892,13.03
9879598,9921859,4396,1538600,11460459,15.51
9879599,9934267,2100,735000,10669267,7.40
9879601,9924937,3819,1336650,11261587,13.47
9879602,9907527,2994,1047900,10955427,10.58
9879603,9929494,3893,1362550,11292044,13.72
9879604,9927166,5454,1908900,11836066,19.23
9879605,9937547,1781,623350,10560897,6.27
9879606,3380352,1981,693350,4073702,20.51
9879607,623390,606,212100,835490,34.02
9879608,9902734,2981,1043350,10946084,10.54
9879609,8897878,6463,2262050,11159928,25.42
9879610,9916063,4533,1586550,11502613,16.00
9879611,9925667,3845,1345750,11271417,13.56
9879612,663282,480,168000,831282,25.33
9879613,679771,144,50400,730171,7.41
9879614,9926522,3598,1259300,11185822,12.69
9879615,9943439,4057,1419950,11363389,14.28
9879616,9951860,5372,1880200,11832060,18.89
9879617,9951705,2773,970550,10922255,9.75
9879618,9963915,6163,2157050,12120965,21.65
9879619,9972332,4238,1483300,11455632,14.87
9879620,9951239,4009,1403150,11354389,14.10
9879621,9975091,2654,928900,10903991,9.31
9879622,9978639,5132,1796200,11774839,18.00
9879623,9979616,3842,1344700,11324316,13.47
9879624,4217420,159,55650,4273070,1.32
9879625,1485088,1309,458150,1943238,30.85
9879626,1305175,1611,563850,1869025,43.20
9879627,9990933,5697,1993950,11984883,19.96
9879628,9982349,3306,1157100,11139449,11.59
9879629,9987780,1864,652400,10640180,6.53
9879630,9978239,1643,575050,10553289,5.76
9879631,9871483,5913,2069550,11941033,20.96
9879632,9978614,1496,523600,10502214,5.25
9879633,9907458,4519,1581650,11489108,15.96
9879634,9994853,4395,1538250,11533103,15.39
9879635,9972245,4135,1447250,11419495,14.51
9879636,9980765,4285,1499750,11480515,15.03
9879637,9977248,4785,1674750,11651998,16.79
9879638,9994651,5153,1803550,11798201,18.05
9879639,9993122,5383,1884050,11877172,18.85
9879640,9492815,6064,2122400,11615215,22.36
9879641,9997206,2621,917350,10914556,9.18
9879642,9981057,5743,2010050,11991107,20.14
9879643,318408,173,60550,378958,19.02
9879644,9978326,6491,2271850,12250176,22.77
9879645,9984322,4938,1728300,11712622,17.31
9879646,9981703,2217,775950,10757653,7.77
9879647,9994547,2644,925400,10919947,9.26
9879648,9971589,367,128450,10100039,1.29
9879649,9971191,3736,1307600,11278791,13.11
9879650,245233,137,47950,293183,19.55
9879651,9958151,4705,1646750,11604901,16.54
9879652,9967805,3894,1362900,11330705,13.67
9879653,9980453,4208,1472800,11453253,14.76
9879654,9978187,4182,1463700,11441887,14.67
9879655,9984967,650,227500,10212467,2.28
9879656,9967220,505,176750,10143970,1.77
9879657,9972132,1500,525000,10497132,5.26
9879658,510129,369,129150,639279,25.32
9879659,9982795,3082,1078700,11061495,10.81
9879660,9970396,4343,1520050,11490446,15.25
9879661,1745676,2154,753900,2499576,43.19
9879662,9999883,4539,1588650,11588533,15.89
9879663,9979005,2686,940100,10919105,9.42
9879664,9990383,3783,1324050,11314433,13.25
9879665,9979295,7061,2471350,12450645,24.76
9879666,9982578,2929,1025150,11007728,10.27
9879667,9976028,2787,975450,10951478,9.78
9879668,9992271,2575,901250,10893521,9.02
9879669,9973113,5319,1861650,11834763,18.67
9879670,9979768,4475,1566250,11546018,15.69
9879671,7021515,3319,1161650,8183165,16.54
9879672,9983624,5062,1771700,11755324,17.75
9879673,9984683,1015,355250,10339933,3.56
9879674,1642289,733,256550,1898839,15.62
9879675,9975194,5309,1858150,11833344,18.63
9879677,9967992,2410,843500,10811492,8.46
9879678,9985687,5428,1899800,11885487,19.03
9879679,1460279,253,88550,1548829,6.06
9879680,9978917,5317,1860950,11839867,18.65
9879681,4790031,2511,878850,5668881,18.35
9879682,9975943,6497,2273950,12249893,22.79
9879683,9995375,4001,1400350,11395725,14.01
9879684,9980575,3112,1089200,11069775,10.91
9879685,9977585,5593,1957550,11935135,19.62
9879687,9975597,5442,1904700,11880297,19.09
9879688,9995351,5150,1802500,11797851,18.03
9879689,9989934,3180,1113000,11102934,11.14
9879690,472308,317,110950,583258,23.49
9879691,9993078,4338,1518300,11511378,15.19
9879693,9978444,4579,1602650,11581094,16.06
9879694,9984487,5486,1920100,11904587,19.23
9879695,9991192,4933,1726550,11717742,17.28
9879696,2280064,1439,503650,2783714,22.09
9879697,9985183,6823,2388050,12373233,23.92
9879698,9981894,4099,1434650,11416544,14.37
9879699,2928927,1687,590450,3519377,20.16
9879700,9961067,5125,1793750,11754817,18.01
9879701,9986932,4035,1412250,11399182,14.14
9879702,9994635,7492,2622200,12616835,26.24
9879703,9985459,1230,430500,10415959,4.31
9879704,9977639,1169,409150,10386789,4.10
9879705,9985528,4718,1651300,11636828,16.54
9879706,9997981,3328,1164800,11162781,11.65
9879707,9988404,2769,969150,10957554,9.70
9879708,142254,72,25200,167454,17.71
9879709,9987882,3872,1355200,11343082,13.57
9879710,9991989,1605,561750,10553739,5.62
9879711,9970464,3746,1311100,11281564,13.15
9879712,9987216,2764,967400,10954616,9.69
9879713,9970048,371,129850,10099898,1.30
9879714,9954674,1040,364000,10318674,3.66
9879715,9992323,3121,1092350,11084673,10.93
9879716,9975596,185,64750,10040346,0.65
9879717,9999485,3209,1123150,11122635,11.23
9879718,9975355,2592,907200,10882555,9.09
9879719,9989053,3789,1326150,11315203,13.28
9879720,9985293,271,94850,10080143,0.95
9879721,9973068,2911,1018850,10991918,10.22
9879722,9977599,2321,812350,10789949,8.14
9879723,9982236,1691,591850,10574086,5.93
9879724,9994859,5377,1881950,11876809,18.83
9879725,9982135,4721,1652350,11634485,16.55
9879726,9994865,5026,1759100,11753965,17.60
9879727,412653,1036,362600,775253,87.87
9879728,1313630,572,200200,1513830,15.24
9879729,595439,446,156100,751539,26.22
9879730,4789162,1904,666400,5455562,13.91
9879732,9941331,5856,2049600,11990931,20.62
9879733,591562,372,130200,721762,22.01
9879734,9952327,6674,2335900,12288227,23.47
9879735,9945228,4891,1711850,11657078,17.21
9879736,9953462,3824,1338400,11291862,13.45
9879737,9771156,3518,1231300,11002456,12.60
9879738,9974646,5817,2035950,12010596,20.41
9879739,176025,170,59500,235525,33.80
9879740,9973641,6703,2346050,12319691,23.52
9879741,9936838,6301,2205350,12142188,22.19
9879742,123680,46,16100,139780,13.02
9879743,9969421,3262,1141700,11111121,11.45
9879744,9953164,6404,2241400,12194564,22.52
9879745,9949186,2835,992250,10941436,9.97
9879746,9970155,2849,997150,10967305,10.00
9879747,9976271,3231,1130850,11107121,11.34
9879748,8142982,2658,930300,9073282,11.42
9879749,9994896,3550,1242500,11237396,12.43
9879750,47197,42,14700,61897,31.15
9879751,1976282,717,250950,2227232,12.70
9879752,9951220,3767,1318450,11269670,13.25
9879753,9370960,4598,1609300,10980260,17.17
9879754,9948149,5297,1853950,11802099,18.64
9879755,9970626,2642,924700,10895326,9.27
9879756,9962505,2117,740950,10703455,7.44
9879757,9981438,2082,728700,10710138,7.30
9879758,9976523,2387,835450,10811973,8.37
9879759,9995655,4027,1409450,11405105,14.10
9879760,9972047,3255,1139250,11111297,11.42
9879761,9972987,3565,1247750,11220737,12.51
9879762,9944772,1172,410200,10354972,4.12
9879763,9964576,2852,998200,10962776,10.02
9879764,9967486,3118,1091300,11058786,10.95
9879765,9966595,1568,548800,10515395,5.51
9879766,9952453,3043,1065050,11017503,10.70
9879767,9943376,6598,2309300,12252676,23.22
9879768,9947681,2465,862750,10810431,8.67
9879769,9965378,2502,875700,10841078,8.79
9879770,9983884,3869,1354150,11338034,13.56
9879771,9992974,4014,1404900,11397874,14.06
9879772,9986799,3047,1066450,11053249,10.68
9879773,9985434,1155,404250,10389684,4.05
9879774,9993982,2399,839650,10833632,8.40
9879775,9978004,596,208600,10186604,2.09
9879776,9978129,428,149800,10127929,1.50
9879777,4815405,3143,1100050,5915455,22.84
9879778,9990912,1029,360150,10351062,3.60
9879779,1868422,734,256900,2125322,13.75
9879780,9983237,4642,1624700,11607937,16.27
9879781,9984061,4017,1405950,11390011,14.08
9879782,9996212,3924,1373400,11369612,13.74
9879783,9983893,3541,1239350,11223243,12.41
9879784,9986546,3536,1237600,11224146,12.39
9879785,9987407,552,193200,10180607,1.93
9879786,9988346,1243,435050,10423396,4.36
9879787,9971960,1503,526050,10498010,5.28
9879788,9986306,789,276150,10262456,2.77
9879789,9986955,4183,1464050,11451005,14.66
9879790,9974563,218,76300,10050863,0.76
9879791,9879817,64,22400,9902217,0.23
9879792,9995366,664,232400,10227766,2.33
9879793,9982658,804,281400,10264058,2.82
9879794,9998050,1042,364700,10362750,3.65
9879795,9979820,266,93100,10072920,0.93
9879796,9978792,226,79100,10057892,0.79
9879797,9969195,1529,535150,10504345,5.37
9879798,9984864,1834,641900,10626764,6.43
9879799,9960432,1819,636650,10597082,6.39
9879800,9976953,1841,644350,10621303,6.46
9879801,9987498,3588,1255800,11243298,12.57
9879802,9987285,4547,1591450,11578735,15.93
9879803,9981581,2940,1029000,11010581,10.31
9879804,9982576,3578,1252300,11234876,12.54
9879805,1547069,632,221200,1768269,14.30
9879806,9987821,3705,1296750,11284571,12.98
9879807,9958578,6448,2256800,12215378,22.66
9879808,9950582,2154,753900,10704482,7.58
9879810,9965160,4143,1450050,11415210,14.55
9879811,9981781,3216,1125600,11107381,11.28
9879812,9978325,2077,726950,10705275,7.29
9879814,1024031,238,83300,1107331,8.13
9879815,5353352,2201,770350,6123702,14.39
9879816,9972010,4351,1522850,11494860,15.27
9879817,9982265,2451,857850,10840115,8.59
9879818,434957,67,23450,458407,5.39
9879819,9978140,2588,905800,10883940,9.08
9879820,9956387,2622,917700,10874087,9.22
9879821,9939326,4381,1533350,11472676,15.43
9879822,9972674,4364,1527400,11500074,15.32
9879823,9758668,3480,1218000,10976668,12.48
9879824,9989640,6123,2143050,12132690,21.45
9879825,9997842,1230,430500,10428342,4.31
9879826,9988510,5493,1922550,11911060,19.25
9879827,9974267,734,256900,10231167,2.58
9879828,9988765,775,271250,10260015,2.72
9879829,9972829,1805,631750,10604579,6.33
9879830,9982222,2782,973700,10955922,9.75
9879831,9987070,423,148050,10135120,1.48
9879832,9964311,5835,2042250,12006561,20.50
9879833,838404,1425,498750,1337154,59.49
9879834,7865555,3809,1333150,9198705,16.95
9879835,661499,271,94850,756349,14.34
9879836,9949337,5367,1878450,11827787,18.88
9879837,9953581,3692,1292200,11245781,12.98
9879838,9970477,4200,1470000,11440477,14.74
9879839,9958300,2163,757050,10715350,7.60
9879840,9961848,595,208250,10170098,2.09
9879841,694678,406,142100,836778,20.46
9879842,9931342,1949,682150,10613492,6.87
9879843,9925366,1589,556150,10481516,5.60
9879844,9911072,4659,1630650,11541722,16.45
9879845,9933179,6510,2278500,12211679,22.94
9879846,9940739,2849,997150,10937889,10.03
9879847,9927889,4253,1488550,11416439,14.99
9879848,9946539,3603,1261050,11207589,12.68
9879849,9941764,2263,792050,10733814,7.97
9879850,9953252,3241,1134350,11087602,11.40
9879851,9958852,3020,1057000,11015852,10.61
9879852,4111830,1721,602350,4714180,14.65
9879853,9959906,2953,1033550,10993456,10.38
9879854,370526,337,117950,488476,31.83
9879855,226940,61,21350,248290,9.41
9879856,3773178,2109,738150,4511328,19.56
9879857,9977670,3368,1178800,11156470,11.81
9879858,9960322,1169,409150,10369472,4.11
9879859,839527,199,69650,909177,8.30
9879860,9984496,4962,1736700,11721196,17.39
9879861,9992234,2316,810600,10802834,8.11
9879862,9986956,7423,2598050,12585006,26.01
9879863,9978815,4492,1572200,11551015,15.76
9879864,9995164,3480,1218000,11213164,12.19
9879865,9975947,1681,588350,10564297,5.90
9879866,9980224,3080,1078000,11058224,10.80
9879867,9980819,6314,2209900,12190719,22.14
9879868,981266,1085,379750,1361016,38.70
9879869,9967059,4706,1647100,11614159,16.53
9879870,5020799,2084,729400,5750199,14.53
9879871,9958850,2552,893200,10852050,8.97
9879872,9954466,2493,872550,10827016,8.77
9879873,9944049,2413,844550,10788599,8.49
9879874,9935825,4831,1690850,11626675,17.02
9879875,9944241,4851,1697850,11642091,17.07
9879876,9946813,5705,1996750,11943563,20.07
9879878,9960430,5380,1883000,11843430,18.90
9879880,4541392,2510,878500,5419892,19.34
9879881,9978841,6362,2226700,12205541,22.31
9879882,9974225,5417,1895950,11870175,19.01
9879883,9968816,5498,1924300,11893116,19.30
9879884,2463606,420,147000,2610606,5.97
9879885,9980007,5009,1753150,11733157,17.57
9879886,9985289,5859,2050650,12035939,20.54
9879887,9818742,5585,1954750,11773492,19.91
9879888,9972878,5881,2058350,12031228,20.64
9879889,9965797,5776,2021600,11987397,20.29
9879890,9971836,3585,1254750,11226586,12.58
9879891,9976126,6268,2193800,12169926,21.99
9879892,4754974,4257,1489950,6244924,31.33
9879893,9984057,2952,1033200,11017257,10.35
9879895,9972084,1731,605850,10577934,6.08
9879896,9986812,2896,1013600,11000412,10.15
9879897,9966245,6040,2114000,12080245,21.21
9879898,2384702,1033,361550,2746252,15.16
9879899,2989483,2138,748300,3737783,25.03
9879900,9942515,5615,1965250,11907765,19.77
9879901,1850824,657,229950,2080774,12.42
9879902,9945592,5146,1801100,11746692,18.11
9879903,9953417,2303,806050,10759467,8.10
9879904,9964118,2701,945350,10909468,9.49
9879905,9951985,3179,1112650,11064635,11.18
9879906,9955044,1834,641900,10596944,6.45
9879907,9975490,2509,878150,10853640,8.80
9879908,2770990,3938,1378300,4149290,49.74
9879909,9939118,4689,1641150,11580268,16.51
9879910,5341650,3878,1357300,6698950,25.41
9879911,9980124,2507,877450,10857574,8.79
9879912,9996316,4846,1696100,11692416,16.97
9879913,1286558,1341,469350,1755908,36.48
9879914,8297706,3283,1149050,9446756,13.85
9879915,9968224,5149,1802150,11770374,18.08
9879916,9974656,7844,2745400,12720056,27.52
9879917,9988445,3250,1137500,11125945,11.39
9879918,9979393,3571,1249850,11229243,12.52
9879919,9994230,5007,1752450,11746680,17.53
9879920,9977082,4638,1623300,11600382,16.27
9879921,9983859,1327,464450,10448309,4.65
9879922,9561663,5566,1948100,11509763,20.37
9879923,9972708,3873,1355550,11328258,13.59
9879924,7419922,4742,1659700,9079622,22.37
9879925,9981670,3579,1252650,11234320,12.55
9879926,1491064,148,51800,1542864,3.47
9879927,5535517,3012,1054200,6589717,19.04
9879928,9988430,6673,2335550,12323980,23.38
9879929,9954875,7084,2479400,12434275,24.91
9879930,9986160,4827,1689450,11675610,16.92
9879931,3504404,1982,693700,4198104,19.80
9879932,9993794,4254,1488900,11482694,14.90
9879933,4355204,2860,1001000,5356204,22.98
9879934,9970609,5190,1816500,11787109,18.22
9879935,786584,396,138600,925184,17.62
9879936,715087,383,134050,849137,18.75
9879937,9965391,4186,1465100,11430491,14.70
9879938,9950321,6131,2145850,12096171,21.57
9879939,9971242,4449,1557150,11528392,15.62
9879940,9972592,4738,1658300,11630892,16.63
9879941,9987440,3388,1185800,11173240,11.87
9879942,9907002,5901,2065350,11972352,20.85
9879943,9980025,4415,1545250,11525275,15.48
9879944,9958650,3555,1244250,11202900,12.49
9879945,9954641,4445,1555750,11510391,15.63
9879946,9926863,3740,1309000,11235863,13.19
9879947,9931842,4179,1462650,11394492,14.73
9879948,3477224,2170,759500,4236724,21.84
9879949,9912849,2906,1017100,10929949,10.26
9879950,4300344,2404,841400,5141744,19.57
9879951,9915688,5477,1916950,11832638,19.33
9879952,9937049,7568,2648800,12585849,26.66
9879954,8562284,4521,1582350,10144634,18.48
9879955,9945202,3902,1365700,11310902,13.73
9879956,9937846,5766,2018100,11955946,20.31
9879957,9944207,4279,1497650,11441857,15.06
9879958,9935586,5242,1834700,11770286,18.47
9879959,9955392,5171,1809850,11765242,18.18
9879960,9956879,4642,1624700,11581579,16.32
9879961,1724825,770,269500,1994325,15.62
9879962,9901470,774,270900,10172370,2.74
9879963,9970475,881,308350,10278825,3.09
9879964,9978545,527,184450,10162995,1.85
9879965,9984233,588,205800,10190033,2.06
9879966,9995481,1564,547400,10542881,5.48
9879967,9998186,513,179550,10177736,1.80
9879968,9982433,2406,842100,10824533,8.44
9879969,9972058,3132,1096200,11068258,10.99
9879970,9987375,3596,1258600,11245975,12.60
9879971,9957803,6550,2292500,12250303,23.02
9879972,9993794,4730,1655500,11649294,16.57
9879973,1424830,1978,692300,2117130,48.59
9879974,9466556,4754,1663900,11130456,17.58
9879975,9966247,5460,1911000,11877247,19.17
9879976,9989470,4555,1594250,11583720,15.96
9879977,9983449,2588,905800,10889249,9.07
9879978,9983671,4518,1581300,11564971,15.84
9879979,9977024,5516,1930600,11907624,19.35
9879980,9976365,3695,1293250,11269615,12.96
9879981,9910332,2943,1030050,10940382,10.39
9879982,9969099,4264,1492400,11461499,14.97
9879983,9969152,5735,2007250,11976402,20.13
9879984,9989978,5469,1914150,11904128,19.16
9879985,9984119,3402,1190700,11174819,11.93
9879986,9985420,2597,908950,10894370,9.10
9879987,9972548,5880,2058000,12030548,20.64
9879988,9969733,3700,1295000,11264733,12.99
9879989,9983652,2923,1023050,11006702,10.25
9879990,4115881,2523,883050,4998931,21.45
9879991,9971893,4110,1438500,11410393,14.43
9879992,9978056,3544,1240400,11218456,12.43
9879993,9983293,1633,571550,10554843,5.73
9879994,9993767,4012,1404200,11397967,14.05
9879995,9996144,3380,1183000,11179144,11.83
9879996,1486884,987,345450,1832334,23.23
9879997,9970803,3971,1389850,11360653,13.94
9879998,9979256,6888,2410800,12390056,24.16
9879999,9965820,2415,845250,10811070,8.48
9880000,9967562,4262,1491700,11459262,14.97
9880001,1445321,732,256200,1701521,17.73
9880002,9945309,7324,2563400,12508709,25.77
9880003,9950159,4151,1452850,11403009,14.60
9880004,9968698,6074,2125900,12094598,21.33
9880005,314275,216,75600,389875,24.06
9880006,9974892,3766,1318100,11292992,13.21
9880007,9976016,5591,1956850,11932866,19.62
9880008,9982923,4230,1480500,11463423,14.83
9880009,9988270,4965,1737750,11726020,17.40
9880010,9992342,4291,1501850,11494192,15.03
9880011,9974588,4186,1465100,11439688,14.69
9880012,9983024,2181,763350,10746374,7.65
9880013,9978541,4414,1544900,11523441,15.48
9880015,9970330,3883,1359050,11329380,13.63
9880016,9967836,3177,1111950,11079786,11.16
9880017,9984448,2763,967050,10951498,9.69
9880019,1518757,1387,485450,2004207,31.96
9880020,9962473,7465,2612750,12575223,26.23
9880021,9980278,4622,1617700,11597978,16.21
9880022,1344625,867,303450,1648075,22.57
9880023,9963201,4683,1639050,11602251,16.45
9880024,9962180,5196,1818600,11780780,18.26
9880025,9983167,2990,1046500,11029667,10.48
9880026,5640915,2820,987000,6627915,17.50
9880027,3184248,629,220150,3404398,6.91
9880028,9982246,6647,2326450,12308696,23.31
9880029,9990484,2511,878850,10869334,8.80
9880030,1070985,394,137900,1208885,12.88
9880031,9962886,4335,1517250,11480136,15.23
9880032,9950470,4584,1604400,11554870,16.12
9880033,190887,88,30800,221687,16.14
9880034,9974279,2466,863100,10837379,8.65
9880035,9959115,6387,2235450,12194565,22.45
9880036,9981141,5369,1879150,11860291,18.83
9880037,9982055,2928,1024800,11006855,10.27
9880038,9979089,4528,1584800,11563889,15.88
9880039,8873249,2578,902300,9775549,10.17
9880040,9982384,3889,1361150,11343534,13.64
9880041,9990716,4496,1573600,11564316,15.75
9880042,9066844,5488,1920800,10987644,21.18
9880043,9977252,4151,1452850,11430102,14.56
9880044,8731159,751,262850,8994009,3.01
9880045,9896415,4770,1669500,11565915,16.87
9880046,1223495,552,193200,1416695,15.79
9880047,9970166,4611,1613850,11584016,16.19
9880048,9965536,5569,1949150,11914686,19.56
9880049,9969808,7007,2452450,12422258,24.60
9880050,4507775,3549,1242150,5749925,27.56
9880051,9973993,4655,1629250,11603243,16.33
9880052,9980989,3353,1173550,11154539,11.76
9880053,9967923,2819,986650,10954573,9.90
9880054,9980827,4405,1541750,11522577,15.45
9880055,3091856,944,330400,3422256,10.69
9880056,170916,106,37100,208016,21.71
9880057,8968533,5640,1974000,10942533,22.01
9880058,3752802,2352,823200,4576002,21.94
9880059,9970549,3564,1247400,11217949,12.51
9880060,9985763,4608,1612800,11598563,16.15
9880061,9997055,3347,1171450,11168505,11.72
9880062,9981804,4041,1414350,11396154,14.17
9880063,9991224,2578,902300,10893524,9.03
9880064,833982,240,84000,917982,10.07
9880065,9971002,4849,1697150,11668152,17.02
9880066,9953044,4830,1690500,11643544,16.98
9880067,9969769,4238,1483300,11453069,14.88
9880068,9977187,3524,1233400,11210587,12.36
9880069,9979730,5166,1808100,11787830,18.12
9880070,9981595,6324,2213400,12194995,22.17
9880071,1113222,480,168000,1281222,15.09
9880072,9988399,5850,2047500,12035899,20.50
9880073,9997392,4042,1414700,11412092,14.15
9880074,9985353,4175,1461250,11446603,14.63
9880075,9988156,4051,1417850,11406006,14.20
9880076,5868260,4713,1649550,7517810,28.11
9880077,9979186,4783,1674050,11653236,16.78
9880078,7579540,2806,982100,8561640,12.96
9880079,9981392,2693,942550,10923942,9.44
9880080,9979490,3398,1189300,11168790,11.92
9880081,4903877,792,277200,5181077,5.65
9880082,9975029,5644,1975400,11950429,19.80
9880083,9976508,4041,1414350,11390858,14.18
9880085,9983301,3915,1370250,11353551,13.73
9880086,9905810,4527,1584450,11490260,16.00
9880087,3291331,441,154350,3445681,4.69
9880088,9971660,3140,1099000,11070660,11.02
9880089,9968962,4600,1610000,11578962,16.15
9880090,9975906,5067,1773450,11749356,17.78
9880091,9980337,5100,1785000,11765337,17.89
9880092,9979463,2969,1039150,11018613,10.41
9880093,9980582,1323,463050,10443632,4.64
9880094,9981844,5280,1848000,11829844,18.51
9880095,4489758,2096,733600,5223358,16.34
9880096,9976630,4215,1475250,11451880,14.79
9880097,9980210,5698,1994300,11974510,19.98
9880098,9976115,1246,436100,10412215,4.37
9880099,9984477,3777,1321950,11306427,13.24
9880100,9970167,3535,1237250,11207417,12.41
9880101,9992796,4770,1669500,11662296,16.71
9880102,9471960,4403,1541050,11013010,16.27
9880103,9989641,5760,2016000,12005641,20.18
9880104,9974376,6378,2232300,12206676,22.38
9880105,9965040,5563,1947050,11912090,19.54
9880106,9971194,6329,2215150,12186344,22.22
9880107,6988862,1955,684250,7673112,9.79
9880108,9957873,4529,1585150,11543023,15.92
9880109,9972737,6409,2243150,12215887,22.49
9880110,9968540,5661,1981350,11949890,19.88
9880111,9986445,2254,788900,10775345,7.90
9880112,9994576,4717,1650950,11645526,16.52
9880113,2630735,2561,896350,3527085,34.07
9880114,3612789,1491,521850,4134639,14.44
9880115,9985847,2512,879200,10865047,8.80
9880116,9991709,4104,1436400,11428109,14.38
9880117,9977622,4549,1592150,11569772,15.96
9880118,6514390,1182,413700,6928090,6.35
9880119,9973574,6107,2137450,12111024,21.43
9880120,9969407,3658,1280300,11249707,12.84
9880122,9989162,5181,1813350,11802512,18.15
9880124,9989502,3100,1085000,11074502,10.86
9880125,9988733,3345,1170750,11159483,11.72
9880126,9990033,1941,679350,10669383,6.80
9880127,9988872,3384,1184400,11173272,11.86
9880129,9962587,7052,2468200,12430787,24.77
9880130,9969705,6075,2126250,12095955,21.33
9880131,9956011,4934,1726900,11682911,17.35
9880132,9972037,6523,2283050,12255087,22.89
9880133,9981210,4718,1651300,11632510,16.54
9880134,9970364,5534,1936900,11907264,19.43
9880135,9975420,4009,1403150,11378570,14.07
9880136,9950286,5262,1841700,11791986,18.51
9880137,9958125,6218,2176300,12134425,21.85
9880138,9977304,4359,1525650,11502954,15.29
9880139,9980835,5840,2044000,12024835,20.48
9880140,9973776,4386,1535100,11508876,15.39
9880141,9983979,7485,2619750,12603729,26.24
9880142,9978207,4989,1746150,11724357,17.50
9880143,9998007,3879,1357650,11355657,13.58
9880144,9981400,4875,1706250,11687650,17.09
9880145,9991723,5109,1788150,11779873,17.90
9880146,9987080,4056,1419600,11406680,14.21
9880147,9985772,3404,1191400,11177172,11.93
9880148,9986893,4003,1401050,11387943,14.03
9880149,9982550,8463,2962050,12944600,29.67
9880150,9983374,4294,1502900,11486274,15.05
9880151,9991447,5119,1791650,11783097,17.93
9880152,9988221,5499,1924650,11912871,19.27
9880153,9988705,5268,1843800,11832505,18.46
9880154,9972264,4749,1662150,11634414,16.67
9880155,9975143,4635,1622250,11597393,16.26
9880156,9983965,2979,1042650,11026615,10.44
9880157,9968854,4038,1413300,11382154,14.18
9880158,9959944,3209,1123150,11083094,11.28
9880159,9969790,6818,2386300,12356090,23.94
9880160,9965964,2684,939400,10905364,9.43
9880161,3211368,1861,651350,3862718,20.28
9880162,9970334,4079,1427650,11397984,14.32
9880163,9972804,3405,1191750,11164554,11.95
9880164,9955044,7491,2621850,12576894,26.34
9880165,9952078,3516,1230600,11182678,12.37
9880166,9955181,4847,1696450,11651631,17.04
9880167,9972185,3943,1380050,11352235,13.84
9880168,9953746,3633,1271550,11225296,12.77
9880169,9983363,6100,2135000,12118363,21.39
9880170,9982156,4849,1697150,11679306,17.00
9880171,5504058,2728,954800,6458858,17.35
9880172,5115025,3002,1050700,6165725,20.54
9880173,9984905,4155,1454250,11439155,14.56
9880174,9993865,4810,1683500,11677365,16.85
9880175,905365,639,223650,1129015,24.70
9880176,9205948,3091,1081850,10287798,11.75
9880177,9981399,6926,2424100,12405499,24.29
9880178,398364,488,170800,569164,42.88
9880179,1287398,705,246750,1534148,19.17
9880180,9955664,4696,1643600,11599264,16.51
9880181,9946812,6130,2145500,12092312,21.57
9880182,9967382,5286,1850100,11817482,18.56
9880184,9941064,3729,1305150,11246214,13.13
9880185,9968226,4934,1726900,11695126,17.32
9880186,7660131,6913,2419550,10079681,31.59
9880187,9976970,4950,1732500,11709470,17.36
9880188,260357,96,33600,293957,12.91
9880189,1028044,743,260050,1288094,25.30
9880190,8527041,3602,1260700,9787741,14.78
9880191,9966661,5935,2077250,12043911,20.84
9880192,3413070,1646,576100,3989170,16.88
9880193,9944528,3294,1152900,11097428,11.59
9880194,9962356,5488,1920800,11883156,19.28
9880195,9936630,4772,1670200,11606830,16.81
9880196,9952930,5314,1859900,11812830,18.69
9880197,1691773,933,326550,2018323,19.30
9880198,9964824,3786,1325100,11289924,13.30
9880199,9964346,5758,2015300,11979646,20.23
9880200,9974894,5103,1786050,11760944,17.91
9880201,9972761,3273,1145550,11118311,11.49
9880202,9968463,5653,1978550,11947013,19.85
9880203,9978738,3727,1304450,11283188,13.07
9880204,9969162,5931,2075850,12045012,20.82
9880205,9990379,2514,879900,10870279,8.81
9880206,9983232,4809,1683150,11666382,16.86
9880207,9965914,1526,534100,10500014,5.36
9880208,9985548,4528,1584800,11570348,15.87
9880209,9970218,5310,1858500,11828718,18.64
9880210,9975881,5953,2083550,12059431,20.89
9880211,9999098,3915,1370250,11369348,13.70
9880212,9984032,3716,1300600,11284632,13.03
9880213,9990762,1259,440650,10431412,4.41
9880214,6061386,5080,1778000,7839386,29.33
9880215,9977140,3756,1314600,11291740,13.18
9880216,9959242,1648,576800,10536042,5.79
9880217,9991598,5003,1751050,11742648,17.53
9880218,9991220,4803,1681050,11672270,16.83
9880219,9726485,1555,544250,10270735,5.60
9880220,9998621,1361,476350,10474971,4.76
9880221,9981307,4119,1441650,11422957,14.44
9880222,1984151,1491,521850,2506001,26.30
9880223,9990482,5656,1979600,11970082,19.81
9880224,9732360,2874,1005900,10738260,10.34
9880225,9982523,3919,1371650,11354173,13.74
9880226,1071670,631,220850,1292520,20.61
9880227,9985550,5205,1821750,11807300,18.24
9880228,9989439,5070,1774500,11763939,17.76
9880229,9995248,4305,1506750,11501998,15.07
9880230,9982669,3102,1085700,11068369,10.88
9880231,9981413,1384,484400,10465813,4.85
9880232,9994721,4669,1634150,11628871,16.35
9880233,1765499,661,231350,1996849,13.10
9880234,9981004,5610,1963500,11944504,19.67
9880235,9984714,5792,2027200,12011914,20.30
9880236,9957815,3610,1263500,11221315,12.69
9880237,917191,1048,366800,1283991,39.99
9880238,9988690,5252,1838200,11826890,18.40
9880239,9953263,3850,1347500,11300763,13.54
9880240,2977856,1135,397250,3375106,13.34
9880241,9986811,5215,1825250,11812061,18.28
9880242,9971227,710,248500,10219727,2.49
9880243,1763360,1786,625100,2388460,35.45
9880244,9979196,4918,1721300,11700496,17.25
9880245,9986478,6079,2127650,12114128,21.31
9880246,9990759,6068,2123800,12114559,21.26
9880247,1433227,620,217000,1650227,15.14
9880248,2645579,1127,394450,3040029,14.91
9880249,392910,262,91700,484610,23.34
9880250,448150,303,106050,554200,23.66
9880251,9956259,3365,1177750,11134009,11.83
9880252,9973887,5965,2087750,12061637,20.93
9880253,9963240,5797,2028950,11992190,20.36
9880254,9978686,3987,1395450,11374136,13.98
9880255,9972379,3819,1336650,11309029,13.40
9880256,7957685,3901,1365350,9323035,17.16
9880257,9971325,5485,1919750,11891075,19.25
9880258,6267543,3415,1195250,7462793,19.07
9880259,9987083,4561,1596350,11583433,15.98
9880260,9988060,5350,1872500,11860560,18.75
9880261,9985388,5954,2083900,12069288,20.87
9880262,9979270,4207,1472450,11451720,14.76
9880263,9983129,5311,1858850,11841979,18.62
9880265,9831561,3334,1166900,10998461,11.87
9880266,9962342,6641,2324350,12286692,23.33
9880267,9980129,5767,2018450,11998579,20.22
9880268,4018753,2542,889700,4908453,22.14
9880269,9952812,4101,1435350,11388162,14.42
9880270,9964474,4545,1590750,11555224,15.96
9880271,9970764,4834,1691900,11662664,16.97
9880272,9977142,8365,2927750,12904892,29.34
9880273,9976854,3148,1101800,11078654,11.04
9880274,9966283,5171,1809850,11776133,18.16
9880276,9967724,4469,1564150,11531874,15.69
9880277,1961109,2115,740250,2701359,37.75
9880278,9974204,5866,2053100,12027304,20.58
9880279,9974272,5405,1891750,11866022,18.97
9880280,9982194,5137,1797950,11780144,18.01
9880281,9986725,4440,1554000,11540725,15.56
9880282,9990649,2965,1037750,11028399,10.39
9880283,9985383,5745,2010750,11996133,20.14
9880284,9979913,4273,1495550,11475463,14.99
9880285,9973371,5065,1772750,11746121,17.77
9880286,9983397,5295,1853250,11836647,18.56
9880287,9968223,5669,1984150,11952373,19.90
9880289,9981705,4678,1637300,11619005,16.40
9880290,9983247,6043,2115050,12098297,21.19
9880291,9989195,6447,2256450,12245645,22.59
9880292,9979191,4087,1430450,11409641,14.33
9880293,9977531,4118,1441300,11418831,14.45
9880294,9984229,5603,1961050,11945279,19.64
9880295,9980436,2949,1032150,11012586,10.34
9880296,9981054,5240,1834000,11815054,18.37
9880297,9985156,2984,1044400,11029556,10.46
9880298,9983779,5693,1992550,11976329,19.96
9880299,9967388,5261,1841350,11808738,18.47
9880300,9985412,5528,1934800,11920212,19.38
9880301,9976398,5013,1754550,11730948,17.59
9880302,9970269,4459,1560650,11530919,15.65
9880303,9970153,6744,2360400,12330553,23.67
9880304,9979130,7080,2478000,12457130,24.83
9880305,9981373,3319,1161650,11143023,11.64
9880306,9976758,6736,2357600,12334358,23.63
9880307,9612490,5262,1841700,11454190,19.16
9880308,9984624,5670,1984500,11969124,19.88
9880309,1633548,1083,379050,2012598,23.20
9880310,196133,122,42700,238833,21.77
9880311,9196623,3398,1189300,10385923,12.93
9880312,9990920,5810,2033500,12024420,20.35
9880313,9968115,4128,1444800,11412915,14.49
9880314,9988027,6351,2222850,12210877,22.26
9880315,9961303,5763,2017050,11978353,20.25
9880316,3501854,1460,511000,4012854,14.59
9880317,3041217,1164,407400,3448617,13.40
9880318,9968625,5433,1901550,11870175,19.08
9880319,9953953,2382,833700,10787653,8.38
9880321,9945605,6404,2241400,12187005,22.54
9880322,3000015,1279,447650,3447665,14.92
9880323,9371771,3204,1121400,10493171,11.97
9880324,3654546,1335,467250,4121796,12.79
9880325,9936290,4432,1551200,11487490,15.61
9880326,9945337,4152,1453200,11398537,14.61
9880327,715129,265,92750,807879,12.97
9880328,9934045,3033,1061550,10995595,10.69
9880329,9946650,4625,1618750,11565400,16.27
9880330,9948306,4361,1526350,11474656,15.34
9880331,9942964,4349,1522150,11465114,15.31
9880332,9943275,8667,3033450,12976725,30.51
9880333,9926461,3538,1238300,11164761,12.47
9880334,438753,219,76650,515403,17.47
9880335,9922442,4438,1553300,11475742,15.65
9880336,9934608,4426,1549100,11483708,15.59
9880337,829266,972,340200,1169466,41.02
9880338,9934247,3715,1300250,11234497,13.09
9880339,9935481,6094,2132900,12068381,21.47
9880340,9929193,2665,932750,10861943,9.39
9880341,9948925,4455,1559250,11508175,15.67
9880342,9935713,2422,847700,10783413,8.53
9880343,9910824,6081,2128350,12039174,21.48
9880344,9930683,3711,1298850,11229533,13.08
9880345,9933984,3913,1369550,11303534,13.79
9880346,9949487,3914,1369900,11319387,13.77
9880347,9948516,3461,1211350,11159866,12.18
9880348,9944462,3666,1283100,11227562,12.90
9880349,9951000,4465,1562750,11513750,15.70
9880350,9956116,3933,1376550,11332666,13.83
9880351,9959252,4085,1429750,11389002,14.36
9880352,9969912,3465,1212750,11182662,12.16
9880353,9967618,4089,1431150,11398768,14.36
9880354,9964399,5786,2025100,11989499,20.32
9880355,1980831,741,259350,2240181,13.09
9880356,9974257,2255,789250,10763507,7.91
9880357,9980058,4022,1407700,11387758,14.11
9880358,9989022,5278,1847300,11836322,18.49
9880359,9996302,3372,1180200,11176502,11.81
9880360,9953071,2120,742000,10695071,7.45
9880361,9962437,3956,1384600,11347037,13.90
9880362,9967663,6023,2108050,12075713,21.15
9880363,9975752,1535,537250,10513002,5.39
9880364,9997958,2909,1018150,11016108,10.18
9880365,9998734,1098,384300,10383034,3.84
9880366,9979547,4721,1652350,11631897,16.56
9880367,9995711,1864,652400,10648111,6.53
9880368,9558667,3168,1108800,10667467,11.60
9880369,9984649,3789,1326150,11310799,13.28
9880370,9980107,2654,928900,10909007,9.31
9880371,9976875,2043,715050,10691925,7.17
9880372,9984811,5527,1934450,11919261,19.37
9880373,9980208,3316,1160600,11140808,11.63
9880374,9992663,4575,1601250,11593913,16.02
9880375,9986330,5484,1919400,11905730,19.22
9880376,9979116,3325,1163750,11142866,11.66
9880377,1091228,891,311850,1403078,28.58
9880378,9965362,2454,858900,10824262,8.62
9880379,9971494,5216,1825600,11797094,18.31
9880380,9942822,3617,1265950,11208772,12.73
9880381,9964779,4671,1634850,11599629,16.41
9880382,9970517,1498,524300,10494817,5.26
9880383,9982455,2467,863450,10845905,8.65
9880384,9989089,3700,1295000,11284089,12.96
9880385,4053578,2217,775950,4829528,19.14
9880386,9983135,4022,1407700,11390835,14.10
9880388,1244523,580,203000,1447523,16.31
9880389,9971740,4731,1655850,11627590,16.61
9880390,9964059,3195,1118250,11082309,11.22
9880391,9964066,4174,1460900,11424966,14.66
9880392,9971269,4359,1525650,11496919,15.30
9880393,9973142,3059,1070650,11043792,10.74
9880394,9958556,5134,1796900,11755456,18.04
9880395,9971181,2409,843150,10814331,8.46
9880396,9981654,1657,579950,10561604,5.81
9880397,9978074,2931,1025850,11003924,10.28
9880398,1023852,384,134400,1158252,13.13
9880399,9961227,1023,358050,10319277,3.59
9880400,9949332,3399,1189650,11138982,11.96
9880401,9941313,900,315000,10256313,3.17
9880402,9941442,1168,408800,10350242,4.11
9880403,9945623,4914,1719900,11665523,17.29
9880404,1274157,288,100800,1374957,7.91
9880405,3438828,3252,1138200,4577028,33.10
9880406,3718314,1572,550200,4268514,14.80
9880407,9921382,4417,1545950,11467332,15.58
9880408,9916475,5739,2008650,11925125,20.26
9880409,9913862,3808,1332800,11246662,13.44
9880410,9931659,4558,1595300,11526959,16.06
9880411,9950932,2709,948150,10899082,9.53
9880412,9926918,4424,1548400,11475318,15.60
9880413,9931907,3359,1175650,11107557,11.84
9880414,9910798,1966,688100,10598898,6.94
9880415,9918262,6105,2136750,12055012,21.54
9880417,124702,78,27300,152002,21.89
9880418,9927199,3639,1273650,11200849,12.83
9880419,7331923,3666,1283100,8615023,17.50
9880420,9945948,3859,1350650,11296598,13.58
9880421,9938721,3622,1267700,11206421,12.76
9880422,9949747,3352,1173200,11122947,11.79
9880423,9954373,3821,1337350,11291723,13.43
9880424,9941436,3427,1199450,11140886,12.07
9880425,9945289,2140,749000,10694289,7.53
9880426,9958339,3627,1269450,11227789,12.75
9880427,9981579,4598,1609300,11590879,16.12
9880428,9979523,4049,1417150,11396673,14.20
9880429,9981004,2323,813050,10794054,8.15
9880430,9964841,2719,951650,10916491,9.55
9880431,9978436,5110,1788500,11766936,17.92
9880433,9956448,1577,551950,10508398,5.54
9880434,9958632,2924,1023400,10982032,10.28
9880435,9968743,3856,1349600,11318343,13.54
9880436,9971595,3280,1148000,11119595,11.51
9880437,9971676,5658,1980300,11951976,19.86
9880438,9960468,6220,2177000,12137468,21.86
9880439,6732138,1314,459900,7192038,6.83
9880440,9989551,2985,1044750,11034301,10.46
9880441,9982898,3491,1221850,11204748,12.24
9880442,9979762,4220,1477000,11456762,14.80
9880443,9460483,3171,1109850,10570333,11.73
9880444,9981036,4227,1479450,11460486,14.82
9880445,9979305,4743,1660050,11639355,16.63
9880446,9988141,4145,1450750,11438891,14.52
9880447,9991868,5236,1832600,11824468,18.34
9880448,8869294,5082,1778700,10647994,20.05
9880450,9977605,3892,1362200,11339805,13.65
9880451,9978196,5136,1797600,11775796,18.02
9880452,9992388,5279,1847650,11840038,18.49
9880453,9980523,3888,1360800,11341323,13.63
9880454,9983555,4534,1586900,11570455,15.90
9880455,9988708,4290,1501500,11490208,15.03
9880456,9993403,4527,1584450,11577853,15.85
9880457,9999941,4707,1647450,11647391,16.47
9880458,9989693,3333,1166550,11156243,11.68
9880459,9999673,5520,1932000,11931673,19.32
9880460,9998003,3324,1163400,11161403,11.64
9880461,9974225,4047,1416450,11390675,14.20
9880462,9983029,2990,1046500,11029529,10.48
9880463,9976354,5343,1870050,11846404,18.74
9880464,9981839,5522,1932700,11914539,19.36
9880465,9982965,4948,1731800,11714765,17.35
9880466,9998106,3427,1199450,11197556,12.00
9880467,9637269,3370,1179500,10816769,12.24
9880468,9993750,3531,1235850,11229600,12.37
9880470,3841675,2039,713650,4555325,18.58
9880471,9974016,4939,1728650,11702666,17.33
9880472,9977769,4149,1452150,11429919,14.55
9880473,9965720,3863,1352050,11317770,13.57
9880475,9958143,4515,1580250,11538393,15.87
9880476,5399277,2677,936950,6336227,17.35
9880477,9940854,4572,1600200,11541054,16.10
9880478,9966189,3183,1114050,11080239,11.18
9880479,9963969,3494,1222900,11186869,12.27
9880480,9968147,4501,1575350,11543497,15.80
9880481,2175124,606,212100,2387224,9.75
9880482,9702990,3376,1181600,10884590,12.18
9880483,9989614,4143,1450050,11439664,14.52
9880484,9982965,2168,758800,10741765,7.60
9880485,9979294,4548,1591800,11571094,15.95
9880486,1728174,67,23450,1751624,1.36
9880487,9992346,2551,892850,10885196,8.94
9880488,4086822,1112,389200,4476022,9.52
9880489,9968635,3137,1097950,11066585,11.01
9880490,9972033,4810,1683500,11655533,16.88
9880491,9995226,2977,1041950,11037176,10.42
9880492,2426463,1362,476700,2903163,19.65
9880493,9974977,3466,1213100,11188077,12.16
9880495,1651662,544,190400,1842062,11.53
9880496,9998293,3574,1250900,11249193,12.51
9880497,9986175,2220,777000,10763175,7.78
9880498,9984089,4401,1540350,11524439,15.43
9880499,9996536,1927,674450,10670986,6.75
9880500,9996519,5630,1970500,11967019,19.71
9880501,9985942,5269,1844150,11830092,18.47
9880502,9998306,4134,1446900,11445206,14.47
9880503,3674787,1320,462000,4136787,12.57
9880504,9814986,3138,1098300,10913286,11.19
9880505,1833971,900,315000,2148971,17.18
9880506,9974435,3654,1278900,11253335,12.82
9880507,9974904,3736,1307600,11282504,13.11
9880508,9987759,4637,1622950,11610709,16.25
9880509,9987357,2980,1043000,11030357,10.44
9880510,9992225,3403,1191050,11183275,11.92
9880511,9999125,1751,612850,10611975,6.13
9880512,4585425,1221,427350,5012775,9.32
9880513,9981732,2850,997500,10979232,9.99
9880514,3797129,1084,379400,4176529,9.99
9880515,9980721,7927,2774450,12755171,27.80
9880516,9977674,5741,2009350,11987024,20.14
9880517,188812,42,14700,203512,7.79
9880518,9991828,3222,1127700,11119528,11.29
9880519,9992652,3981,1393350,11386002,13.94
9880520,9983447,4709,1648150,11631597,16.51
9880521,9981714,4181,1463350,11445064,14.66
9880522,9976228,3958,1385300,11361528,13.89
9880523,9985422,3366,1178100,11163522,11.80
9880524,9982526,3953,1383550,11366076,13.86
9880525,3856425,2100,735000,4591425,19.06
9880528,9976747,4200,1470000,11446747,14.73
9880529,9965625,4961,1736350,11701975,17.42
9880530,9985167,3273,1145550,11130717,11.47
9880532,9974615,3201,1120350,11094965,11.23
9880533,9977786,4062,1421700,11399486,14.25
9880534,2946148,1423,498050,3444198,16.91
9880535,9933514,5752,2013200,11946714,20.27
9880536,9968793,3088,1080800,11049593,10.84
9880537,9979058,3960,1386000,11365058,13.89
9880538,9980932,4774,1670900,11651832,16.74
9880539,9981508,4179,1462650,11444158,14.65
9880540,5687648,3903,1366050,7053698,24.02
9880541,9978564,3495,1223250,11201814,12.26
9880542,9997872,4784,1674400,11672272,16.75
9880543,9971926,4771,1669850,11641776,16.75
9880544,9990086,3005,1051750,11041836,10.53
9880545,9986373,3015,1055250,11041623,10.57
9880546,9989626,2776,971600,10961226,9.73
9880547,9981465,2315,810250,10791715,8.12
9880548,9990826,2887,1010450,11001276,10.11
9880549,9987996,4121,1442350,11430346,14.44
9880550,9713670,4095,1433250,11146920,14.75
9880551,256865,70,24500,281365,9.54
9880552,9996253,4317,1510950,11507203,15.12
9880553,9991047,3472,1215200,11206247,12.16
9880554,5451037,2029,710150,6161187,13.03
9880555,9997406,4652,1628200,11625606,16.29
9880556,3608249,952,333200,3941449,9.23
9880557,9987199,6291,2201850,12189049,22.05
9880558,9988029,3522,1232700,11220729,12.34
9880559,9992254,3165,1107750,11100004,11.09
9880561,1776519,704,246400,2022919,13.87
9880562,9989460,5468,1913800,11903260,19.16
9880563,9989908,4497,1573950,11563858,15.76
9880564,9979863,3816,1335600,11315463,13.38
9880565,9964690,4371,1529850,11494540,15.35
9880566,9993824,7660,2681000,12674824,26.83
9880567,9798393,3845,1345750,11144143,13.73
9880568,9976577,4442,1554700,11531277,15.58
9880569,1762842,554,193900,1956742,11.00
9880571,2121012,613,214550,2335562,10.12
9880572,9999687,6662,2331700,12331387,23.32
9880573,9986496,4945,1730750,11717246,17.33
9880574,9976853,2898,1014300,10991153,10.17
9880575,9983440,5700,1995000,11978440,19.98
9880576,9976732,5754,2013900,11990632,20.19
9880577,9954934,5951,2082850,12037784,20.92
9880578,9973005,6129,2145150,12118155,21.51
9880579,9969382,4287,1500450,11469832,15.05
9880580,9765810,3322,1162700,10928510,11.91
9880581,9979433,4330,1515500,11494933,15.19
9880582,9978948,3364,1177400,11156348,11.80
9880583,9984010,3821,1337350,11321360,13.39
9880584,9973557,5217,1825950,11799507,18.31
9880585,6780529,1162,406700,7187229,6.00
9880586,9943771,4762,1666700,11610471,16.76
9880587,9974256,3396,1188600,11162856,11.92
9880588,9994905,1415,495250,10490155,4.96
9880589,9974481,2383,834050,10808531,8.36
9880590,9973664,6559,2295650,12269314,23.02
9880591,1781383,1320,462000,2243383,25.93
9880592,9958215,3052,1068200,11026415,10.73
9880593,9966438,5766,2018100,11984538,20.25
9880594,9972135,5317,1860950,11833085,18.66
9880595,9993112,3707,1297450,11290562,12.98
9880596,4621859,2421,847350,5469209,18.33
9880597,9984167,4293,1502550,11486717,15.05
9880598,900540,399,139650,1040190,15.51
9880599,9964802,5235,1832250,11797052,18.39
9880601,9987069,5700,1995000,11982069,19.98
9880602,9994374,1995,698250,10692624,6.99
9880603,9977341,3897,1363950,11341291,13.67
9880604,3852473,2455,859250,4711723,22.30
9880605,9964390,5822,2037700,12002090,20.45
9880606,9981040,5482,1918700,11899740,19.22
9880607,9986528,4418,1546300,11532828,15.48
9880608,9985506,4441,1554350,11539856,15.57
9880609,9986050,4401,1540350,11526400,15.43
9880610,9989982,7506,2627100,12617082,26.30
9880611,9994874,3040,1064000,11058874,10.65
9880612,2962930,1527,534450,3497380,18.04
9880613,9964844,3862,1351700,11316544,13.56
9880614,9974637,3917,1370950,11345587,13.74
9880615,1692334,445,155750,1848084,9.20
9880616,9992184,4955,1734250,11726434,17.36
9880617,9985670,4859,1700650,11686320,17.03
9880618,9993300,5119,1791650,11784950,17.93
9880619,9980190,3100,1085000,11065190,10.87
9880620,9984176,4214,1474900,11459076,14.77
9880621,9988241,6224,2178400,12166641,21.81
9880622,9986906,4365,1527750,11514656,15.30
9880623,9986599,3188,1115800,11102399,11.17
9880624,9988828,4692,1642200,11631028,16.44
9880625,250286,228,79800,330086,31.88
9880626,9978142,7751,2712850,12690992,27.19
9880628,9976957,4043,1415050,11392007,14.18
9880629,9982134,2920,1022000,11004134,10.24
9880630,9975119,1466,513100,10488219,5.14
9880631,9981484,2556,894600,10876084,8.96
9880633,9951752,4383,1534050,11485802,15.41
9880634,8386868,3228,1129800,9516668,13.47
9880635,9973430,4755,1664250,11637680,16.69
9880636,9961392,4846,1696100,11657492,17.03
9880637,9938722,3206,1122100,11060822,11.29
9880638,9946625,3438,1203300,11149925,12.10
9880639,3390639,1508,527800,3918439,15.57
9880640,9922270,2083,729050,10651320,7.35
9880641,9904419,4711,1648850,11553269,16.65
9880642,9941678,2887,1010450,10952128,10.16
9880643,9942301,3238,1133300,11075601,11.40
9880644,9932611,4046,1416100,11348711,14.26
9880645,9932151,6220,2177000,12109151,21.92
9880646,3459072,2164,757400,4216472,21.90
9880647,9935774,3689,1291150,11226924,12.99
9880648,9931570,4776,1671600,11603170,16.83
9880649,9945842,5574,1950900,11896742,19.62
9880650,9587179,3978,1392300,10979479,14.52
9880652,9916971,2458,860300,10777271,8.68
9880653,9923320,4412,1544200,11467520,15.56
9880654,9936077,3343,1170050,11106127,11.78
9880655,9940956,3356,1174600,11115556,11.82
9880656,9952338,5673,1985550,11937888,19.95
9880657,9945213,3509,1228150,11173363,12.35
9880658,4591462,1778,622300,5213762,13.55
9880659,933546,855,299250,1232796,32.06
9880660,9951139,1427,499450,10450589,5.02
9880661,9961137,3914,1369900,11331037,13.75
9880662,9940902,4061,1421350,11362252,14.30
9880663,9962472,6001,2100350,12062822,21.08
9880664,9981721,3680,1288000,11269721,12.90
9880665,2025683,849,297150,2322833,14.67
9880666,9964491,2689,941150,10905641,9.45
9880667,9894099,3339,1168650,11062749,11.81
9880668,2782068,1311,458850,3240918,16.49
9880669,9986837,4428,1549800,11536637,15.52
9880670,9977539,3519,1231650,11209189,12.34
9880671,9994517,5336,1867600,11862117,18.69
9880672,9990010,3951,1382850,11372860,13.84
9880673,9990823,1760,616000,10606823,6.17
9880674,9983257,2092,732200,10715457,7.33
9880675,9974853,4092,1432200,11407053,14.36
9880676,9993460,4870,1704500,11697960,17.06
9880677,9982743,3671,1284850,11267593,12.87
9880678,1986000,279,97650,2083650,4.92
9880679,4515167,1509,528150,5043317,11.70
9880680,9984463,4985,1744750,11729213,17.47
9880681,7048878,1437,502950,7551828,7.14
9880682,9991364,5974,2090900,12082264,20.93
9880683,9976956,2805,981750,10958706,9.84
9880684,9984454,4237,1482950,11467404,14.85
9880685,9994808,5832,2041200,12036008,20.42
9880686,9986682,2078,727300,10713982,7.28
9880687,9964001,4026,1409100,11373101,14.14
9880688,9965115,3700,1295000,11260115,13.00
9880689,9972498,2632,921200,10893698,9.24
9880690,9949176,2486,870100,10819276,8.75
9880691,9953404,3911,1368850,11322254,13.75
9880692,9894344,2180,763000,10657344,7.71
9880693,9954325,4230,1480500,11434825,14.87
9880694,9954305,3082,1078700,11033005,10.84
9880695,9965076,4443,1555050,11520126,15.60
9880696,9953560,3537,1237950,11191510,12.44
9880697,9944106,1520,532000,10476106,5.35
9880698,9942934,2558,895300,10838234,9.00
9880699,9951301,2083,729050,10680351,7.33
9880700,9963649,3037,1062950,11026599,10.67
9880701,9962589,2582,903700,10866289,9.07
9880702,9960219,4361,1526350,11486569,15.32
9880703,9660415,2759,965650,10626065,10.00
9880704,9963832,4991,1746850,11710682,17.53
9880706,9945909,3138,1098300,11044209,11.04
9880707,9943695,2382,833700,10777395,8.38
9880708,9954457,3073,1075550,11030007,10.80
9880709,9940029,2897,1013950,10953979,10.20
9880710,1549869,799,279650,1829519,18.04
9880711,8919221,2711,948850,9868071,10.64
9880712,9899562,6314,2209900,12109462,22.32
9880713,535000,130,45500,580500,8.50
9880714,2129511,758,265300,2394811,12.46
9880715,9922726,3915,1370250,11292976,13.81
9880716,9911990,5040,1764000,11675990,17.80
9880717,9931805,2720,952000,10883805,9.59
9880718,9942785,3504,1226400,11169185,12.33
9880719,4396558,1356,474600,4871158,10.79
9880720,8674585,2078,727300,9401885,8.38
9880721,9962959,2513,879550,10842509,8.83
9880722,9690650,4351,1522850,11213500,15.71
9880723,9967969,3943,1380050,11348019,13.84
9880724,9967381,4288,1500800,11468181,15.06
9880725,9978774,4262,1491700,11470474,14.95
9880726,9982699,2544,890400,10873099,8.92
9880727,2212401,749,262150,2474551,11.85
9880728,9967820,3194,1117900,11085720,11.22
9880729,9970336,2305,806750,10777086,8.09
9880730,9962404,5064,1772400,11734804,17.79
9880731,9926157,4007,1402450,11328607,14.13
9880732,4498044,2089,731150,5229194,16.25
9880733,9963441,2775,971250,10934691,9.75
9880734,9946251,3666,1283100,11229351,12.90
9880735,9958321,4146,1451100,11409421,14.57
9880736,2499207,425,148750,2647957,5.95
9880737,9974330,3916,1370600,11344930,13.74
9880738,9982068,4385,1534750,11516818,15.38
9880739,9984405,3349,1172150,11156555,11.74
9880740,9989888,4129,1445150,11435038,14.47
9880741,9763089,3393,1187550,10950639,12.16
9880742,9983274,1893,662550,10645824,6.64
9880743,9998783,2229,780150,10778933,7.80
9880744,9970176,2253,788550,10758726,7.91
9880746,9991120,3329,1165150,11156270,11.66
9880747,9998593,4498,1574300,11572893,15.75
9880748,5108468,687,240450,5348918,4.71
9880749,9966427,3485,1219750,11186177,12.24
9880750,688130,182,63700,751830,9.26
9880751,9354709,4109,1438150,10792859,15.37
9880752,9949334,2993,1047550,10996884,10.53
9880753,9955223,2801,980350,10935573,9.85
9880754,9917527,2970,1039500,10957027,10.48
9880755,9924140,4025,1408750,11332890,14.20
9880756,9970260,3918,1371300,11341560,13.75
9880757,9959413,4393,1537550,11496963,15.44
9880758,9455621,3760,1316000,10771621,13.92
9880759,9979205,3313,1159550,11138755,11.62
9880760,9990985,1818,636300,10627285,6.37
9880761,2347820,1384,484400,2832220,20.63
9880762,9977705,5228,1829800,11807505,18.34
9880763,9972256,3904,1366400,11338656,13.70
9880764,9986007,4414,1544900,11530907,15.47
9880765,9979326,3590,1256500,11235826,12.59
9880766,9992951,3498,1224300,11217251,12.25
9880767,9993239,4197,1468950,11462189,14.70
9880768,9975098,7168,2508800,12483898,25.15
9880769,9994720,1942,679700,10674420,6.80
9880770,9981988,1972,690200,10672188,6.91
9880771,8985912,1919,671650,9657562,7.47
9880772,9966657,4049,1417150,11383807,14.22
9880773,9969604,3274,1145900,11115504,11.49
9880775,9935902,3028,1059800,10995702,10.67
9880776,9950171,3773,1320550,11270721,13.27
9880777,9944390,4149,1452150,11396540,14.60
9880778,9724023,5897,2063950,11787973,21.23
9880779,9956260,3702,1295700,11251960,13.01
9880780,9974886,3318,1161300,11136186,11.64
9880781,9958680,2216,775600,10734280,7.79
9880782,9944869,2725,953750,10898619,9.59
9880783,3909681,864,302400,4212081,7.73
9880784,8638571,3255,1139250,9777821,13.19
9880785,5110779,2393,837550,5948329,16.39
9880787,9742563,3140,1099000,10841563,11.28
9880788,2221999,1105,386750,2608749,17.41
9880789,9965345,2308,807800,10773145,8.11
9880790,9946201,3873,1355550,11301751,13.63
9880791,3145445,1516,530600,3676045,16.87
9880792,4377381,1207,422450,4799831,9.65
9880793,9969287,3826,1339100,11308387,13.43
9880794,9975726,4225,1478750,11454476,14.82
9880795,9976510,4032,1411200,11387710,14.15
9880796,9975362,3715,1300250,11275612,13.03
9880797,3407602,1740,609000,4016602,17.87
9880798,9987644,3412,1194200,11181844,11.96
9880799,9990097,3036,1062600,11052697,10.64
9880800,6192002,1312,459200,6651202,7.42
9880801,9975140,5431,1900850,11875990,19.06
9880802,501972,297,103950,605922,20.71
9880803,9960110,4679,1637650,11597760,16.44
9880804,9930712,3552,1243200,11173912,12.52
9880805,9968727,5170,1809500,11778227,18.15
9880806,9966097,2590,906500,10872597,9.10
9880807,9977076,2995,1048250,11025326,10.51
9880809,4335344,6073,2125550,6460894,49.03
9880810,9745811,5026,1759100,11504911,18.05
9880811,9987756,3320,1162000,11149756,11.63
9880812,9980178,5083,1779050,11759228,17.83
9880813,5830348,3049,1067150,6897498,18.30
9880815,9982933,3834,1341900,11324833,13.44
9880816,9974370,5153,1803550,11777920,18.08
9880817,9981483,3064,1072400,11053883,10.74
9880818,9988080,3015,1055250,11043330,10.57
9880819,3167072,2865,1002750,4169822,31.66
9880820,9992646,5338,1868300,11860946,18.70
9880821,9970902,2661,931350,10902252,9.34
9880822,9985836,4874,1705900,11691736,17.08
9880823,9972774,3825,1338750,11311524,13.42
9880824,9993533,6456,2259600,12253133,22.61
9880825,9984037,5548,1941800,11925837,19.45
9880826,9964972,4058,1420300,11385272,14.25
9880827,9996253,4271,1494850,11491103,14.95
9880828,7815733,4200,1470000,9285733,18.81
9880829,9974072,2623,918050,10892122,9.20
9880830,9983558,5407,1892450,11876008,18.96
9880832,9971300,2508,877800,10849100,8.80
9880833,9977206,6005,2101750,12078956,21.07
9880834,9986497,3858,1350300,11336797,13.52
9880835,9984725,4733,1656550,11641275,16.59
9880836,9986361,6413,2244550,12230911,22.48
9880837,9980528,2272,795200,10775728,7.97
9880838,9983700,4700,1645000,11628700,16.48
9880839,9983561,2636,922600,10906161,9.24
9880840,9983905,4273,1495550,11479455,14.98
9880841,9981671,3420,1197000,11178671,11.99
9880843,9993692,4795,1678250,11671942,16.79
9880844,9979812,2613,914550,10894362,9.16
9880845,9983282,4857,1699950,11683232,17.03
9880846,9987441,4241,1484350,11471791,14.86
9880847,9994642,2320,812000,10806642,8.12
9880848,9981983,2519,881650,10863633,8.83
9880849,9991379,1441,504350,10495729,5.05
9880850,353015,164,57400,410415,16.26
9880851,9977670,4167,1458450,11436120,14.62
9880852,9953114,2989,1046150,10999264,10.51
9880853,9955791,5228,1829800,11785591,18.38
9880854,9975685,3096,1083600,11059285,10.86
9880855,9983013,5219,1826650,11809663,18.30
9880856,9958533,2586,905100,10863633,9.09
9880857,9988156,4514,1579900,11568056,15.82
9880858,9979797,2560,896000,10875797,8.98
9880859,9264619,2097,733950,9998569,7.92
9880860,9966904,2431,850850,10817754,8.54
9880861,9956418,3342,1169700,11126118,11.75
9880862,6384444,3683,1289050,7673494,20.19
9880863,2554925,1341,469350,3024275,18.37
9880864,9971183,4887,1710450,11681633,17.15
9880865,9991115,4587,1605450,11596565,16.07
9880867,9966671,3009,1053150,11019821,10.57
9880868,9965708,8057,2819950,12785658,28.30
9880869,9978690,3758,1315300,11293990,13.18
9880870,9967050,4979,1742650,11709700,17.48
9880871,9993614,3106,1087100,11080714,10.88
9880872,9969690,4252,1488200,11457890,14.93
9880873,9983602,4857,1699950,11683552,17.03
9880874,9989987,4540,1589000,11578987,15.91
9880875,9973070,4166,1458100,11431170,14.62
9880876,9984226,1916,670600,10654826,6.72
9880877,9999137,2422,847700,10846837,8.48
9880878,9981899,3971,1389850,11371749,13.92
9880879,9992486,1817,635950,10628436,6.36
9880880,9982055,4213,1474550,11456605,14.77
9880881,9977088,4687,1640450,11617538,16.44
9880882,9995179,5936,2077600,12072779,20.79
9880883,9980434,4006,1402100,11382534,14.05
9880884,9978739,3002,1050700,11029439,10.53
9880885,9983304,5048,1766800,11750104,17.70
9880886,9978188,3698,1294300,11272488,12.97
9880887,9980859,3764,1317400,11298259,13.20
9880888,9997749,4997,1748950,11746699,17.49
9880889,9972944,4716,1650600,11623544,16.55
9880890,9982385,4043,1415050,11397435,14.18
9880891,9988880,2996,1048600,11037480,10.50
9880892,9976323,3943,1380050,11356373,13.83
9880893,9967464,4577,1601950,11569414,16.07
9880894,9984102,6579,2302650,12286752,23.06
9880896,9976318,4305,1506750,11483068,15.10
9880897,9365808,2323,813050,10178858,8.68
9880898,7000790,2541,889350,7890140,12.70
9880899,9996726,4932,1726200,11722926,17.27
9880901,9989656,4847,1696450,11686106,16.98
9880902,5267369,1228,429800,5697169,8.16
9880903,4951293,1572,550200,5501493,11.11
9880904,9990551,3735,1307250,11297801,13.08
9880905,2431101,836,292600,2723701,12.04
9880906,9989196,2834,991900,10981096,9.93
9880907,9979593,3404,1191400,11170993,11.94
9880908,9981610,4828,1689800,11671410,16.93
9880909,9995575,1111,388850,10384425,3.89
9880910,9983159,4867,1703450,11686609,17.06
9880911,9991218,3621,1267350,11258568,12.68
9880912,9997887,5464,1912400,11910287,19.13
9880913,9981638,2161,756350,10737988,7.58
9880914,9985847,4011,1403850,11389697,14.06
9880915,9995069,2559,895650,10890719,8.96
9880916,9978011,3225,1128750,11106761,11.31
9880918,5642280,2824,988400,6630680,17.52
9880919,9950673,3122,1092700,11043373,10.98
9880921,7011646,3103,1086050,8097696,15.49
9880922,9957741,3920,1372000,11329741,13.78
9880923,9936836,2490,871500,10808336,8.77
9880924,9939777,4874,1705900,11645677,17.16
9880926,9955630,81,28350,9983980,0.28
9880927,9967272,2878,1007300,10974572,10.11
9880928,9984444,3013,1054550,11038994,10.56
9880929,9922878,3093,1082550,11005428,10.91
9880930,9921081,3174,1110900,11031981,11.20
9880931,9995868,4068,1423800,11419668,14.24
9880932,9997288,3524,1233400,11230688,12.34
9880933,9970810,3669,1284150,11254960,12.88
9880934,9988320,3899,1364650,11352970,13.66
9880935,9975425,3222,1127700,11103125,11.30
9880936,9977071,5951,2082850,12059921,20.88
9880937,9989940,4230,1480500,11470440,14.82
9880938,9973596,3646,1276100,11249696,12.79
9880939,9984896,3573,1250550,11235446,12.52
9880940,9992827,3933,1376550,11369377,13.78
9880941,9993914,6309,2208150,12202064,22.09
9880942,9952843,72,25200,9978043,0.25
9880943,9989422,3243,1135050,11124472,11.36
9880944,9991613,3859,1350650,11342263,13.52
9880945,9989232,3165,1107750,11096982,11.09
9880946,9974707,3559,1245650,11220357,12.49
9880947,9991565,2189,766150,10757715,7.67
9880948,9965183,2789,976150,10941333,9.80
9880949,9980842,4936,1727600,11708442,17.31
9880950,4299232,601,210350,4509582,4.89
9880951,2653573,795,278250,2931823,10.49
9880952,9987142,3590,1256500,11243642,12.58
9880953,9989030,5253,1838550,11827580,18.41
9880954,9994523,3219,1126650,11121173,11.27
9880955,9998143,2888,1010800,11008943,10.11
9880956,9987336,2933,1026550,11013886,10.28
9880957,1893169,447,156450,2049619,8.26
9880958,9842416,42,14700,9857116,0.15
9880959,9974910,2855,999250,10974160,10.02
9880961,2168165,564,197400,2365565,9.10
9880962,9985163,3078,1077300,11062463,10.79
9880963,9988155,2825,988750,10976905,9.90
9880964,7087177,3230,1130500,8217677,15.95
9880965,9974964,3197,1118950,11093914,11.22
9880966,9983091,2828,989800,10972891,9.91
9880967,9992179,2698,944300,10936479,9.45
9880968,9994801,4429,1550150,11544951,15.51
9880969,2130338,499,174650,2304988,8.20
9880970,9554041,2832,991200,10545241,10.37
9880971,9984318,2460,861000,10845318,8.62
9880972,9979233,3840,1344000,11323233,13.47
9880973,9977463,4361,1526350,11503813,15.30
9880974,9989639,2016,705600,10695239,7.06
9880975,9985510,4576,1601600,11587110,16.04
9880976,9984489,3188,1115800,11100289,11.18
9880977,9979680,2546,891100,10870780,8.93
9880978,9988938,4330,1515500,11504438,15.17
9880979,6686410,1552,543200,7229610,8.12
9880980,9978383,5207,1822450,11800833,18.26
9880981,9987070,5225,1828750,11815820,18.31
9880982,9989667,3500,1225000,11214667,12.26
9880983,9983669,4282,1498700,11482369,15.01
9880984,9982072,4069,1424150,11406222,14.27
9880985,9904540,143,50050,9954590,0.51
9880986,9990964,2823,988050,10979014,9.89
9880987,9996956,4838,1693300,11690256,16.94
9880988,9984548,3953,1383550,11368098,13.86
9880989,9975999,4618,1616300,11592299,16.20
9880991,9956984,3806,1332100,11289084,13.38
9880992,9744694,3058,1070300,10814994,10.98
9880993,9957935,3876,1356600,11314535,13.62
9880994,9986935,3701,1295350,11282285,12.97
9880995,9992669,5660,1981000,11973669,19.82
9880996,3266475,172,60200,3326675,1.84
9880997,9972680,2639,923650,10896330,9.26
9880998,9988018,4363,1527050,11515068,15.29
9880999,9985312,3746,1311100,11296412,13.13
9881000,8872708,1429,500150,9372858,5.64
9881002,9566611,1917,670950,10237561,7.01
9881003,9989078,3469,1214150,11203228,12.15
9881004,9991831,2632,921200,10913031,9.22
9881005,9983711,5766,2018100,12001811,20.21
9881006,7718142,240,84000,7802142,1.09
9881007,9979848,3565,1247750,11227598,12.50
9881008,9981362,3318,1161300,11142662,11.63
9881009,9985107,2992,1047200,11032307,10.49
9881010,9971569,2956,1034600,11006169,10.38
9881011,9994487,4373,1530550,11525037,15.31
9881012,9986744,4476,1566600,11553344,15.69
9881013,9997688,1953,683550,10681238,6.84
9881014,9980681,3886,1360100,11340781,13.63
9881015,9988380,2187,765450,10753830,7.66
9881016,9978599,2714,949900,10928499,9.52
9881017,5665033,1736,607600,6272633,10.73
9881018,9979279,3389,1186150,11165429,11.89
9881019,9984876,3899,1364650,11349526,13.67
9881020,9980522,3601,1260350,11240872,12.63
9881021,9984923,3353,1173550,11158473,11.75
9881022,9995705,1596,558600,10554305,5.59
9881023,9970431,3770,1319500,11289931,13.23
9881024,9983494,3049,1067150,11050644,10.69
9881025,9979439,5410,1893500,11872939,18.97
9881026,9961492,4046,1416100,11377592,14.22
9881027,8561863,2328,814800,9376663,9.52
9881028,9982837,6080,2128000,12110837,21.32
9881029,9982501,3652,1278200,11260701,12.80
9881030,9971211,3027,1059450,11030661,10.63
9881031,9973783,2892,1012200,10985983,10.15
9881032,9962980,5237,1832950,11795930,18.40
9881033,9954360,4865,1702750,11657110,17.11
9881034,9943486,3697,1293950,11237436,13.01
9881035,2364064,1437,502950,2867014,21.27
9881036,9948629,4558,1595300,11543929,16.04
9881037,846743,317,110950,957693,13.10
9881038,9951218,1683,589050,10540268,5.92
9881039,9955605,5595,1958250,11913855,19.67
9881040,9954306,5359,1875650,11829956,18.84
9881042,9942472,4023,1408050,11350522,14.16
9881043,9959337,3437,1202950,11162287,12.08
9881044,9943982,4544,1590400,11534382,15.99
9881045,3092987,1230,430500,3523487,13.92
9881046,9924127,4423,1548050,11472177,15.60
9881047,9937170,2947,1031450,10968620,10.38
9881048,9946215,3057,1069950,11016165,10.76
9881049,9936113,2996,1048600,10984713,10.55
9881050,9942757,3135,1097250,11040007,11.04
9881051,9059845,2676,936600,9996445,10.34
9881052,9958360,4957,1734950,11693310,17.42
9881053,9974144,2916,1020600,10994744,10.23
9881054,9973990,3371,1179850,11153840,11.83
9881055,9993979,3961,1386350,11380329,13.87
9881056,9981449,2820,987000,10968449,9.89
9881057,9996980,2653,928550,10925530,9.29
9881058,9992016,4613,1614550,11606566,16.16
9881059,9976426,2596,908600,10885026,9.11
9881060,9985725,4226,1479100,11464825,14.81
9881061,9988024,3878,1357300,11345324,13.59
9881062,9977709,2004,701400,10679109,7.03
9881063,9993054,5797,2028950,12022004,20.30
9881064,9989366,3515,1230250,11219616,12.32
9881065,9350598,1489,521150,9871748,5.57
9881066,9987219,2268,793800,10781019,7.95
9881067,9803308,4143,1450050,11253358,14.79
9881068,9991929,4930,1725500,11717429,17.27
9881069,9992026,3986,1395100,11387126,13.96
9881071,9991577,3775,1321250,11312827,13.22
9881072,9985515,5857,2049950,12035465,20.53
9881074,9990295,3041,1064350,11054645,10.65
9881075,9978072,4099,1434650,11412722,14.38
9881076,7672772,2907,1017450,8690222,13.26
9881077,4844807,3198,1119300,5964107,23.10
9881078,3090796,881,308350,3399146,9.98
9881080,9963874,2391,836850,10800724,8.40
9881081,9959292,4047,1416450,11375742,14.22
9881082,9962541,3131,1095850,11058391,11.00
9881083,9977043,3465,1212750,11189793,12.16
9881084,9980016,3876,1356600,11336616,13.59
9881085,9981410,1711,598850,10580260,6.00
9881086,9980150,2334,816900,10797050,8.19
9881087,9984715,4382,1533700,11518415,15.36
9881089,9978781,3071,1074850,11053631,10.77
9881090,9980344,4182,1463700,11444044,14.67
9881091,1696729,492,172200,1868929,10.15
9881092,9960444,3896,1363600,11324044,13.69
9881093,9958014,4063,1422050,11380064,14.28
9881094,9964245,3113,1089550,11053795,10.93
9881095,9974834,4351,1522850,11497684,15.27
9881096,9988032,4506,1577100,11565132,15.79
9881097,9972897,4936,1727600,11700497,17.32
9881098,9978366,2655,929250,10907616,9.31
9881099,1636543,1066,373100,2009643,22.80
9881100,9974871,3127,1094450,11069321,10.97
9881101,9987510,4058,1420300,11407810,14.22
9881102,9974262,3682,1288700,11262962,12.92
9881103,9964732,4380,1533000,11497732,15.38
9881104,9973284,4081,1428350,11401634,14.32
9881105,9024484,4668,1633800,10658284,18.10
9881106,9998335,4986,1745100,11743435,17.45
9881107,9982192,3279,1147650,11129842,11.50
9881109,9993934,1586,555100,10549034,5.55
9881110,9990201,1959,685650,10675851,6.86
9881111,9980733,1658,580300,10561033,5.81
9881112,9973648,2396,838600,10812248,8.41
9881113,9989425,5160,1806000,11795425,18.08
9881114,8515542,3255,1139250,9654792,13.38
9881115,8979455,2773,970550,9950005,10.81
9881116,9967829,3979,1392650,11360479,13.97
9881117,9975570,2770,969500,10945070,9.72
9881118,9978114,5559,1945650,11923764,19.50
9881119,9978644,3011,1053850,11032494,10.56
9881120,9974317,4740,1659000,11633317,16.63
9881121,9988810,4185,1464750,11453560,14.66
9881122,1312822,527,184450,1497272,14.05
9881123,9982039,3047,1066450,11048489,10.68
9881124,9991395,6012,2104200,12095595,21.06
9881125,9994863,4015,1405250,11400113,14.06
9881126,9982268,2566,898100,10880368,9.00
9881127,9981271,2707,947450,10928721,9.49
9881128,9988228,3341,1169350,11157578,11.71
9881129,9942453,2438,853300,10795753,8.58
9881130,9996345,2420,847000,10843345,8.47
9881131,9983916,3403,1191050,11174966,11.93
9881132,9968637,1438,503300,10471937,5.05
9881133,6525095,1777,621950,7147045,9.53
9881134,9941270,2124,743400,10684670,7.48
9881136,9957920,4058,1420300,11378220,14.26
9881137,9966151,1942,679700,10645851,6.82
9881138,3740838,1203,421050,4161888,11.26
9881139,9961367,2821,987350,10948717,9.91
9881140,4486201,1072,375200,4861401,8.36
9881141,9966012,2321,812350,10778362,8.15
9881142,9960928,5146,1801100,11762028,18.08
9881143,9968738,4269,1494150,11462888,14.99
9881144,9977727,3992,1397200,11374927,14.00
9881145,1745731,556,194600,1940331,11.15
9881146,9981430,5893,2062550,12043980,20.66
9881147,4364285,1108,387800,4752085,8.89
9881148,1759535,579,202650,1962185,11.52
9881149,9986781,1892,662200,10648981,6.63
9881150,9986098,5392,1887200,11873298,18.90
9881151,9403123,2419,846650,10249773,9.00
9881152,9979170,3194,1117900,11097070,11.20
9881153,9873567,1108,387800,10261367,3.93
9881154,9985540,5974,2090900,12076440,20.94
9881155,5200195,1810,633500,5833695,12.18
9881156,9981929,3161,1106350,11088279,11.08
9881157,9966094,2980,1043000,11009094,10.47
9881158,9970107,2744,960400,10930507,9.63
9881159,9889726,2396,838600,10728326,8.48
9881160,9974986,3999,1399650,11374636,14.03
9881161,9969218,3619,1266650,11235868,12.71
9881162,9990758,1190,416500,10407258,4.17
9881163,9975266,3322,1162700,11137966,11.66
9881164,9978478,4625,1618750,11597228,16.22
9881165,9971319,4217,1475950,11447269,14.80
9881166,9984899,4040,1414000,11398899,14.16
9881167,9998293,3245,1135750,11134043,11.36
9881168,9959018,4230,1480500,11439518,14.87
9881170,9970868,4201,1470350,11441218,14.75
9881171,9981784,3468,1213800,11195584,12.16
9881172,9986356,3468,1213800,11200156,12.15
9881173,9433705,4325,1513750,10947455,16.05
9881174,9964709,3802,1330700,11295409,13.35
9881175,9974409,2829,990150,10964559,9.93
9881176,9976723,2783,974050,10950773,9.76
9881177,9998726,3295,1153250,11151976,11.53
9881178,9991325,2780,973000,10964325,9.74
9881179,9736268,3979,1392650,11128918,14.30
9881182,9965493,2960,1036000,11001493,10.40
9881184,9941527,3613,1264550,11206077,12.72
9881185,9931903,4922,1722700,11654603,17.35
9881186,9947340,4598,1609300,11556640,16.18
9881187,9938989,4214,1474900,11413889,14.84
9881188,9896092,3255,1139250,11035342,11.51
9881189,9904354,3885,1359750,11264104,13.73
9881190,9925617,3072,1075200,11000817,10.83
9881191,9918625,1850,647500,10566125,6.53
9881192,9921974,4215,1475250,11397224,14.87
9881193,9919228,3529,1235150,11154378,12.45
9881194,9935314,4581,1603350,11538664,16.14
9881195,9927525,3176,1111600,11039125,11.20
9881197,9933016,3924,1373400,11306416,13.83
9881198,9899383,3833,1341550,11240933,13.55
9881199,9440454,2773,970550,10411004,10.28
9881200,9940468,2812,984200,10924668,9.90
9881201,9956697,4001,1400350,11357047,14.06
9881202,9958096,3151,1102850,11060946,11.07
9881204,9977812,3473,1215550,11193362,12.18
9881205,9989029,5821,2037350,12026379,20.40
9881206,9998769,2385,834750,10833519,8.35
9881207,9982505,1980,693000,10675505,6.94
9881208,2996994,1136,397600,3394594,13.27
9881209,9983259,4008,1402800,11386059,14.05
9881210,9983844,1933,676550,10660394,6.78
9881211,9975147,3293,1152550,11127697,11.55
9881212,9987139,3804,1331400,11318539,13.33
9881213,9985993,3483,1219050,11205043,12.21
9881214,9995296,2675,936250,10931546,9.37
9881215,9972149,5415,1895250,11867399,19.01
9881216,9993382,4170,1459500,11452882,14.60
9881217,9976842,5186,1815100,11791942,18.19
9881218,909408,342,119700,1029108,13.16
9881220,1152781,928,324800,1477581,28.18
9881221,9966700,3527,1234450,11201150,12.39
9881222,9973371,4007,1402450,11375821,14.06
9881223,9969132,2414,844900,10814032,8.48
9881224,9934240,2844,995400,10929640,10.02
9881225,9968043,3211,1123850,11091893,11.27
9881226,9963005,2934,1026900,10989905,10.31
9881227,9967731,3158,1105300,11073031,11.09
9881228,9960766,4815,1685250,11646016,16.92
9881229,9955948,2309,808150,10764098,8.12
9881230,9968011,2219,776650,10744661,7.79
9881232,9962644,3038,1063300,11025944,10.67
9881233,9955953,4624,1618400,11574353,16.26
9881234,9865295,4943,1730050,11595345,17.54
9881235,9945821,4964,1737400,11683221,17.47
9881236,9939259,3546,1241100,11180359,12.49
9881237,9939307,5606,1962100,11901407,19.74
9881238,9937494,3388,1185800,11123294,11.93
9881239,8489471,2326,814100,9303571,9.59
9881240,9944121,5977,2091950,12036071,21.04
9881241,9924224,1879,657650,10581874,6.63
9881242,9936435,2771,969850,10906285,9.76
9881243,9939183,2874,1005900,10945083,10.12
9881244,9953040,3342,1169700,11122740,11.75
9881245,9958966,4465,1562750,11521716,15.69
9881246,9452845,4910,1718500,11171345,18.18
9881247,9966335,5731,2005850,11972185,20.13
9881248,9966424,2572,900200,10866624,9.03
9881249,9976208,2830,990500,10966708,9.93
9881250,9974830,2014,704900,10679730,7.07
9881251,9959501,4547,1591450,11550951,15.98
9881252,9974380,5020,1757000,11731380,17.62
9881253,9988945,4346,1521100,11510045,15.23
9881254,9999345,3136,1097600,11096945,10.98
9881255,9986296,6190,2166500,12152796,21.69
9881256,9970851,3987,1395450,11366301,14.00
9881257,9974470,3435,1202250,11176720,12.05
9881258,9974645,957,334950,10309595,3.36
9881259,9977239,3309,1158150,11135389,11.61
9881260,9990267,3572,1250200,11240467,12.51
9881261,9969464,4171,1459850,11429314,14.64
9881262,9975275,3139,1098650,11073925,11.01
9881263,380549,61,21350,401899,5.61
9881264,5417269,1304,456400,5873669,8.42
9881265,9987147,3907,1367450,11354597,13.69
9881266,9997837,3021,1057350,11055187,10.58
9881267,9981927,2720,952000,10933927,9.54
9881268,9975064,3645,1275750,11250814,12.79
9881269,9987513,4538,1588300,11575813,15.90
9881270,9987571,2842,994700,10982271,9.96
9881271,2083390,628,219800,2303190,10.55
9881272,9973053,3343,1170050,11143103,11.73
9881273,330909,216,75600,406509,22.85
9881274,9982310,3638,1273300,11255610,12.76
9881275,608088,276,96600,704688,15.89
9881276,9978164,2722,952700,10930864,9.55
9881277,9979815,5855,2049250,12029065,20.53
9881278,9996193,4348,1521800,11517993,15.22
9881279,9994874,4464,1562400,11557274,15.63
9881280,9360863,2728,954800,10315663,10.20
9881281,9989772,3758,1315300,11305072,13.17
9881282,9996006,3974,1390900,11386906,13.91
9881283,333665,329,115150,448815,34.51
9881284,4095880,1129,395150,4491030,9.65
9881285,9968535,1838,643300,10611835,6.45
9881286,9971598,4568,1598800,11570398,16.03
9881287,9981350,4781,1673350,11654700,16.76
9881288,9989044,3338,1168300,11157344,11.70
9881289,9986633,3435,1202250,11188883,12.04
9881290,9983733,5150,1802500,11786233,18.05
9881291,9979477,5035,1762250,11741727,17.66
9881292,4819165,2776,971600,5790765,20.16
9881294,9990539,3269,1144150,11134689,11.45
9881295,1948042,1065,372750,2320792,19.13
9881296,9965614,3025,1058750,11024364,10.62
9881298,9964078,4459,1560650,11524728,15.66
9881299,9645693,2198,769300,10414993,7.98
9881300,9801424,5665,1982750,11784174,20.23
9881301,9972113,3917,1370950,11343063,13.75
9881303,9971910,2264,792400,10764310,7.95
9881304,9982916,3637,1272950,11255866,12.75
9881305,1268577,590,206500,1475077,16.28
9881306,9962942,5501,1925350,11888292,19.33
9881307,9958288,1501,525350,10483638,5.28
9881309,7108317,1437,502950,7611267,7.08
9881310,9978869,4218,1476300,11455169,14.79
9881311,9981355,4450,1557500,11538855,15.60
9881312,9998361,1918,671300,10669661,6.71
9881313,9986625,2693,942550,10929175,9.44
9881314,9978162,1202,420700,10398862,4.22
9881315,9995936,3705,1296750,11292686,12.97
9881316,9980444,3583,1254050,11234494,12.57
9881317,9633420,1777,621950,10255370,6.46
9881318,4910684,960,336000,5246684,6.84
9881319,9908324,1910,668500,10576824,6.75
9881320,9984100,3051,1067850,11051950,10.70
9881321,9979858,4697,1643950,11623808,16.47
9881322,3178266,2128,744800,3923066,23.43
9881323,9978910,2026,709100,10688010,7.11
9881324,9976568,4304,1506400,11482968,15.10
9881325,9992935,2268,793800,10786735,7.94
9881326,9997319,3874,1355900,11353219,13.56
9881327,9999307,3748,1311800,11311107,13.12
9881328,9991385,2908,1017800,11009185,10.19
9881329,9984422,3647,1276450,11260872,12.78
9881330,9996254,4342,1519700,11515954,15.20
9881331,9973676,2217,775950,10749626,7.78
9881332,3977212,1964,687400,4664612,17.28
9881333,4027631,1704,596400,4624031,14.81
9881334,9948657,3842,1344700,11293357,13.52
9881335,9968454,2881,1008350,10976804,10.12
9881336,611856,200,70000,681856,11.44
9881337,9966772,3770,1319500,11286272,13.24
9881338,9975903,3608,1262800,11238703,12.66
9881339,9981256,2683,939050,10920306,9.41
9881340,9973636,3179,1112650,11086286,11.16
9881341,9995959,3943,1380050,11376009,13.81
9881342,9993008,2964,1037400,11030408,10.38
9881343,9992335,7648,2676800,12669135,26.79
9881344,9983553,4645,1625750,11609303,16.28
9881345,9983302,3716,1300600,11283902,13.03
9881346,9984612,3548,1241800,11226412,12.44
9881347,9986361,4816,1685600,11671961,16.88
9881348,9977776,3694,1292900,11270676,12.96
9881350,9962203,3639,1273650,11235853,12.78
9881351,1887555,558,195300,2082855,10.35
9881352,9974716,2877,1006950,10981666,10.10
9881353,8924587,1891,661850,9586437,7.42
9881354,645041,454,158900,803941,24.63
9881355,2794694,1333,466550,3261244,16.69
9881356,9956400,4308,1507800,11464200,15.14
9881359,9851461,4522,1582700,11434161,16.07
9881360,9961515,6020,2107000,12068515,21.15
9881361,9975012,3396,1188600,11163612,11.92
9881362,9956600,2665,932750,10889350,9.37
9881363,9952774,2105,736750,10689524,7.40
9881364,9762328,3020,1057000,10819328,10.83
9881365,464691,94,32900,497591,7.08
9881366,9947606,4003,1401050,11348656,14.08
9881367,5792587,962,336700,6129287,5.81
9881368,9917903,5654,1978900,11896803,19.95
9881369,9939002,4145,1450750,11389752,14.60
9881370,9952861,2228,779800,10732661,7.83
9881371,9962760,2472,865200,10827960,8.68
9881372,9974219,2339,818650,10792869,8.21
9881373,6183496,1790,626500,6809996,10.13
9881374,9963102,6181,2163350,12126452,21.71
9881375,9978554,4370,1529500,11508054,15.33
9881376,9997002,2379,832650,10829652,8.33
9881377,9977339,4878,1707300,11684639,17.11
9881378,9968450,3223,1128050,11096500,11.32
9881379,9979758,3408,1192800,11172558,11.95
9881380,932035,851,297850,1229885,31.96
9881381,9990408,3218,1126300,11116708,11.27
9881382,8998430,2488,870800,9869230,9.68
9881383,8980942,2373,830550,9811492,9.25
9881384,9998317,6212,2174200,12172517,21.75
9881385,9970686,5916,2070600,12041286,20.77
9881386,9982181,4324,1513400,11495581,15.16
9881387,9987328,2564,897400,10884728,8.99
9881388,1228175,336,117600,1345775,9.58
9881389,1534029,422,147700,1681729,9.63
9881390,9961361,2830,990500,10951861,9.94
9881391,9961171,3547,1241450,11202621,12.46
9881392,9962616,3886,1360100,11322716,13.65
9881394,9968015,2961,1036350,11004365,10.40
9881395,249326,89,31150,280476,12.49
9881396,9197671,4341,1519350,10717021,16.52
9881397,9980488,2581,903350,10883838,9.05
9881398,9971998,4181,1463350,11435348,14.67
9881399,9966678,2172,760200,10726878,7.63
9881400,9981302,3127,1094450,11075752,10.97
9881401,9974089,3476,1216600,11190689,12.20
9881402,9914311,2984,1044400,10958711,10.53
9881403,6126946,4219,1476650,7603596,24.10
9881404,9964958,2261,791350,10756308,7.94
9881406,9980354,3164,1107400,11087754,11.10
9881407,9989469,2120,742000,10731469,7.43
9881408,831461,220,77000,908461,9.26
9881409,9963143,3211,1123850,11086993,11.28
9881410,9918509,2940,1029000,10947509,10.37
9881411,5525091,2107,737450,6262541,13.35
9881412,9961684,3382,1183700,11145384,11.88
9881413,2272595,799,279650,2552245,12.31
9881415,9954614,3046,1066100,11020714,10.71
9881416,2030954,780,273000,2303954,13.44
9881418,9943496,4986,1745100,11688596,17.55
9881419,9956712,1754,613900,10570612,6.17
9881420,5063903,2372,830200,5894103,16.39
9881421,9952274,3301,1155350,11107624,11.61
9881422,9970227,3293,1152550,11122777,11.56
9881423,9964976,5479,1917650,11882626,19.24
9881424,9983808,2559,895650,10879458,8.97
9881425,9984854,4826,1689100,11673954,16.92
9881426,9999939,3630,1270500,11270439,12.71
9881427,9999619,4389,1536150,11535769,15.36
9881428,9989776,2725,953750,10943526,9.55
9881429,9995973,3311,1158850,11154823,11.59
9881430,9975053,5166,1808100,11783153,18.13
9881431,9977266,2602,910700,10887966,9.13
9881432,9963112,2968,1038800,11001912,10.43
9881433,9959117,2624,918400,10877517,9.22
9881434,9950020,4951,1732850,11682870,17.42
9881435,9963979,2500,875000,10838979,8.78
9881436,9970095,4542,1589700,11559795,15.94
9881437,9974653,2735,957250,10931903,9.60
9881438,9984941,4329,1515150,11500091,15.17
9881439,9980159,2341,819350,10799509,8.21
9881440,9961238,2030,710500,10671738,7.13
9881441,9976484,3031,1060850,11037334,10.63
9881442,9980969,1294,452900,10433869,4.54
9881443,9979694,1320,462000,10441694,4.63
9881444,2875013,676,236600,3111613,8.23
9881445,9976668,2256,789600,10766268,7.91
9881446,9969545,3157,1104950,11074495,11.08
9881447,9981419,2242,784700,10766119,7.86
9881448,9959962,3487,1220450,11180412,12.25
9881449,9979219,2629,920150,10899369,9.22
9881450,9973635,4300,1505000,11478635,15.09
9881451,9962330,4864,1702400,11664730,17.09
9881452,9233031,4791,1676850,10909881,18.16
9881453,9979147,4809,1683150,11662297,16.87
9881454,9980700,4193,1467550,11448250,14.70
9881455,9986734,1175,411250,10397984,4.12
9881456,1946408,2679,937650,2884058,48.17
9881458,9973545,5748,2011800,11985345,20.17
9881459,9969712,4082,1428700,11398412,14.33
9881460,9964021,5161,1806350,11770371,18.13
9881461,9970895,3553,1243550,11214445,12.47
9881462,9956787,5037,1762950,11719737,17.71
9881463,8691484,3600,1260000,9951484,14.50
9881464,9096228,3539,1238650,10334878,13.62
9881465,9983313,4300,1505000,11488313,15.08
9881466,9990397,3340,1169000,11159397,11.70
9881467,9979806,1108,387800,10367606,3.89
9881468,9982806,2857,999950,10982756,10.02
9881469,9996327,3527,1234450,11230777,12.35
9881470,9964216,3119,1091650,11055866,10.96
9881471,1217636,859,300650,1518286,24.69
9881472,9962939,2202,770700,10733639,7.74
9881473,9986127,3625,1268750,11254877,12.71
9881474,9974058,1354,473900,10447958,4.75
9881475,9981807,2275,796250,10778057,7.98
9881476,9979643,2679,937650,10917293,9.40
9881478,9972656,1569,549150,10521806,5.51
9881479,1734671,688,240800,1975471,13.88
9881480,9962750,3727,1304450,11267200,13.09
9881481,9733285,3605,1261750,10995035,12.96
9881482,9935303,4586,1605100,11540403,16.16
9881483,9941435,2025,708750,10650185,7.13
9881484,9963444,6384,2234400,12197844,22.43
9881485,9943914,6692,2342200,12286114,23.55
9881486,7656454,3766,1318100,8974554,17.22
9881487,9974547,3722,1302700,11277247,13.06
9881488,9968948,2860,1001000,10969948,10.04
9881489,9978298,4025,1408750,11387048,14.12
9881490,9994412,2476,866600,10861012,8.67
9881491,9971316,2962,1036700,11008016,10.40
9881492,9972171,4080,1428000,11400171,14.32
9881493,9979697,4927,1724450,11704147,17.28
9881494,9883444,2465,862750,10746194,8.73
9881495,9992113,1813,634550,10626663,6.35
9881496,515021,545,190750,705771,37.04
9881497,9958627,2076,726600,10685227,7.30
9881498,9946584,4081,1428350,11374934,14.36
9881499,9981367,3149,1102150,11083517,11.04
9881500,9999245,3292,1152200,11151445,11.52
9881501,9991899,2622,917700,10909599,9.18
9881502,9982371,2236,782600,10764971,7.84
9881503,9973460,2881,1008350,10981810,10.11
9881504,9988505,2527,884450,10872955,8.85
9881505,9982789,2481,868350,10851139,8.70
9881506,9982427,3908,1367800,11350227,13.70
9881507,9985669,2961,1036350,11022019,10.38
9881508,9986539,3635,1272250,11258789,12.74
9881509,7117129,3312,1159200,8276329,16.29
9881510,9989174,3423,1198050,11187224,11.99
9881511,9992532,4091,1431850,11424382,14.33
9881512,9966437,2643,925050,10891487,9.28
9881513,9973655,3505,1226750,11200405,12.30
9881514,9977689,4377,1531950,11509639,15.35
9881515,9982969,2436,852600,10835569,8.54
9881516,9969730,2685,939750,10909480,9.43
9881517,9961296,4791,1676850,11638146,16.83
9881518,9978247,2148,751800,10730047,7.53
9881519,8982559,1997,698950,9681509,7.78
9881520,9989125,2726,954100,10943225,9.55
9881521,9984804,4484,1569400,11554204,15.72
9881522,9984965,5086,1780100,11765065,17.83
9881523,9993030,3857,1349950,11342980,13.51
9881524,8771660,3315,1160250,9931910,13.23
9881525,9954751,4457,1559950,11514701,15.67
9881526,9977316,2693,942550,10919866,9.45
9881527,9972984,2987,1045450,11018434,10.48
9881528,9959361,2005,701750,10661111,7.05
9881529,9984941,3648,1276800,11261741,12.79
9881530,9994929,5260,1841000,11835929,18.42
9881531,2415278,1057,369950,2785228,15.32
9881532,9975353,2364,827400,10802753,8.29
9881533,9984987,2194,767900,10752887,7.69
9881534,9975015,4332,1516200,11491215,15.20
9881535,9979504,3585,1254750,11234254,12.57
9881536,9987283,2866,1003100,10990383,10.04
9881537,9989316,3083,1079050,11068366,10.80
9881538,9987606,3569,1249150,11236756,12.51
9881539,9982472,4695,1643250,11625722,16.46
9881540,9963008,1112,389200,10352208,3.91
9881541,7579421,425,148750,7728171,1.96
9881542,9947393,1267,443450,10390843,4.46
9881543,9961569,2162,756700,10718269,7.60
9881544,9945014,4597,1608950,11553964,16.18
9881545,4434776,1469,514150,4948926,11.59
9881546,6483602,2070,724500,7208102,11.17
9881548,9956993,2500,875000,10831993,8.79
9881549,9959675,5432,1901200,11860875,19.09
9881550,9971700,5900,2065000,12036700,20.71
9881551,9976343,3448,1206800,11183143,12.10
9881552,2471249,190,66500,2537749,2.69
9881553,9996787,3267,1143450,11140237,11.44
9881554,3923736,1374,480900,4404636,12.26
9881555,3744564,2151,752850,4497414,20.11
9881556,9978290,3620,1267000,11245290,12.70
9881557,9982812,3008,1052800,11035612,10.55
9881558,9912441,3692,1292200,11204641,13.04
9881560,9976180,4673,1635550,11611730,16.39
9881561,9981674,2767,968450,10950124,9.70
9881562,9989536,3720,1302000,11291536,13.03
9881563,9979648,3962,1386700,11366348,13.90
9881564,9989673,2883,1009050,10998723,10.10
9881565,9994566,4951,1732850,11727416,17.34
9881566,6995688,6791,2376850,9372538,33.98
9881567,8186149,1948,681800,8867949,8.33
9881569,9980525,5249,1837150,11817675,18.41
9881570,9968650,3641,1274350,11243000,12.78
9881571,9971338,3364,1177400,11148738,11.81
9881572,9980732,4631,1620850,11601582,16.24
9881573,9969559,5980,2093000,12062559,20.99
9881574,9985099,4602,1610700,11595799,16.13
9881575,9990356,4205,1471750,11462106,14.73
9881576,9997733,3922,1372700,11370433,13.73
9881577,9992217,4191,1466850,11459067,14.68
9881578,9987595,3892,1362200,11349795,13.64
9881579,9989634,5941,2079350,12068984,20.82
9881580,9994041,3994,1397900,11391941,13.99
9881581,9977896,2504,876400,10854296,8.78
9881582,9987096,3314,1159900,11146996,11.61
9881583,9991259,3884,1359400,11350659,13.61
9881584,9969356,5042,1764700,11734056,17.70
9881585,9984944,5370,1879500,11864444,18.82
9881586,9994859,4166,1458100,11452959,14.59
9881587,9965536,4527,1584450,11549986,15.90
9881588,9996920,4565,1597750,11594670,15.98
9881589,9973572,3362,1176700,11150272,11.80
9881590,8139893,2092,732200,8872093,9.00
9881591,9988700,3636,1272600,11261300,12.74
9881592,9979898,3992,1397200,11377098,14.00
9881593,9986554,5733,2006550,11993104,20.09
9881594,9985185,4254,1488900,11474085,14.91
9881595,9981903,2659,930650,10912553,9.32
9881596,7160289,3299,1154650,8314939,16.13
9881597,9970193,2395,838250,10808443,8.41
9881598,6923835,1750,612500,7536335,8.85
9881599,9521229,3752,1313200,10834429,13.79
9881600,9985968,5294,1852900,11838868,18.56
9881601,1389308,111,38850,1428158,2.80
9881602,9984411,2794,977900,10962311,9.79
9881603,9978848,2561,896350,10875198,8.98
9881604,9968171,3748,1311800,11279971,13.16
9881605,9989483,7938,2778300,12767783,27.81
9881606,9991190,2786,975100,10966290,9.76
9881607,3082950,671,234850,3317800,7.62
9881608,9974749,3757,1314950,11289699,13.18
9881609,9981089,5511,1928850,11909939,19.33
9881610,9968018,1866,653100,10621118,6.55
9881611,9978171,3024,1058400,11036571,10.61
9881612,9988937,5826,2039100,12028037,20.41
9881613,9984442,3234,1131900,11116342,11.34
9881614,9976911,3885,1359750,11336661,13.63
9881615,9973573,1271,444850,10418423,4.46
9881616,8955594,2705,946750,9902344,10.57
9881617,8932148,1767,618450,9550598,6.92
9881618,9972606,8673,3035550,13008156,30.44
9881619,9976664,1607,562450,10539114,5.64
9881620,9986006,6209,2173150,12159156,21.76
9881621,9969259,3076,1076600,11045859,10.80
9881622,9964031,3075,1076250,11040281,10.80
9881623,2948059,854,298900,3246959,10.14
9881624,9979590,2983,1044050,11023640,10.46
9881625,9972187,4280,1498000,11470187,15.02
9881626,9972996,4362,1526700,11499696,15.31
9881628,9942208,5364,1877400,11819608,18.88
9881629,9980846,3226,1129100,11109946,11.31
9881630,9977752,3878,1357300,11335052,13.60
9881631,9994516,3105,1086750,11081266,10.87
9881632,9981984,3911,1368850,11350834,13.71
9881633,9992323,4745,1660750,11653073,16.62
9881634,9998632,1953,683550,10682182,6.84
9881635,9987363,3590,1256500,11243863,12.58
9881636,1766186,347,121450,1887636,6.88
9881638,9982070,4234,1481900,11463970,14.85
9881639,9997743,4401,1540350,11538093,15.41
9881640,9731303,2042,714700,10446003,7.34
9881641,6085588,1282,448700,6534288,7.37
9881644,1806490,842,294700,2101190,16.31
9881645,9981696,4321,1512350,11494046,15.15
9881646,9965795,4274,1495900,11461695,15.01
9881647,9953995,2891,1011850,10965845,10.17
9881648,9975432,3346,1171100,11146532,11.74
9881649,4324894,1810,633500,4958394,14.65
9881650,9944953,5370,1879500,11824453,18.90
9881651,9964108,2674,935900,10900008,9.39
9881652,9962673,2776,971600,10934273,9.75
9881653,9968693,2209,773150,10741843,7.76
9881654,6173635,1417,495950,6669585,8.03
9881655,9950846,4204,1471400,11422246,14.79
9881656,9950333,3239,1133650,11083983,11.39
9881657,9964096,6233,2181550,12145646,21.89
9881658,9965619,2760,966000,10931619,9.69
9881659,9959015,4874,1705900,11664915,17.13
9881660,9953897,3296,1153600,11107497,11.59
9881661,8707924,992,347200,9055124,3.99
9881662,9930569,235,82250,10012819,0.83
9881663,9939357,4037,1412950,11352307,14.22
9881664,9944007,2442,854700,10798707,8.60
9881665,9971249,5340,1869000,11840249,18.74
9881666,2430181,717,250950,2681131,10.33
9881667,9976655,2746,961100,10937755,9.63
9881668,686369,391,136850,823219,19.94
9881669,9365508,2687,940450,10305958,10.04
9881670,9978293,3406,1192100,11170393,11.95
9881671,9882910,3471,1214850,11097760,12.29
9881672,9981855,4948,1731800,11713655,17.35
9881673,9985960,3580,1253000,11238960,12.55
9881674,9624319,5131,1795850,11420169,18.66
9881675,9179476,6126,2144100,11323576,23.36
9881676,9971182,2845,995750,10966932,9.99
9881677,9967716,4823,1688050,11655766,16.94
9881678,9957302,3716,1300600,11257902,13.06
9881679,760139,934,326900,1087039,43.01
9881680,9981865,498,174300,10156165,1.75
9881681,6829282,3343,1170050,7999332,17.13
9881682,9971695,1682,588700,10560395,5.90
9881683,9978467,1185,414750,10393217,4.16
9881684,9960406,3066,1073100,11033506,10.77
9881685,9950835,1078,377300,10328135,3.79
9881686,9956201,1226,429100,10385301,4.31
9881687,9956309,1832,641200,10597509,6.44
9881688,9947229,2796,978600,10925829,9.84
9881689,9959973,4541,1589350,11549323,15.96
9881691,9931501,3474,1215900,11147401,12.24
9881692,9917561,3774,1320900,11238461,13.32
9881693,3113642,463,162050,3275692,5.20
9881694,9922423,3117,1090950,11013373,10.99
9881695,9935689,2601,910350,10846039,9.16
9881696,9936769,2966,1038100,10974869,10.45
9881697,9920229,3296,1153600,11073829,11.63
9881698,9913778,1928,674800,10588578,6.81
9881699,9927378,2302,805700,10733078,8.12
9881700,9923174,2776,971600,10894774,9.79
9881701,9946034,4900,1715000,11661034,17.24
9881702,9929268,5411,1893850,11823118,19.07
9881703,9598558,4461,1561350,11159908,16.27
9881704,8919993,4078,1427300,10347293,16.00
9881705,6773202,1766,618100,7391302,9.13
9881706,9876847,2975,1041250,10918097,10.54
9881707,3401617,866,303100,3704717,8.91
9881708,9917381,4760,1666000,11583381,16.80
9881709,9918036,4129,1445150,11363186,14.57
9881710,9909552,1099,384650,10294202,3.88
9881711,9920991,3236,1132600,11053591,11.42
9881712,809308,406,142100,951408,17.56
9881713,9906597,2772,970200,10876797,9.79
9881714,9901017,3100,1085000,10986017,10.96
9881715,9899052,3081,1078350,10977402,10.89
9881716,4930150,2483,869050,5799200,17.63
9881717,9916552,3332,1166200,11082752,11.76
9881718,9911775,3710,1298500,11210275,13.10
9881719,8935031,1707,597450,9532481,6.69
9881720,9227117,2215,775250,10002367,8.40
9881721,9952238,2578,902300,10854538,9.07
9881722,9932899,3327,1164450,11097349,11.72
9881723,9933282,3542,1239700,11172982,12.48
9881724,9954074,3852,1348200,11302274,13.54
9881725,9932081,4486,1570100,11502181,15.81
9881726,9956293,4386,1535100,11491393,15.42
9881727,9944008,888,310800,10254808,3.13
9881728,9760000,4491,1571850,11331850,16.11
9881729,2378929,1147,401450,2780379,16.88
9881730,5474016,4032,1411200,6885216,25.78
9881731,9930145,3067,1073450,11003595,10.81
9881732,9931780,2240,784000,10715780,7.89
9881733,9941741,2072,725200,10666941,7.29
9881734,9936029,2662,931700,10867729,9.38
9881735,9956266,2940,1029000,10985266,10.34
9881736,9964662,4894,1712900,11677562,17.19
9881737,9967473,829,290150,10257623,2.91
9881738,9979975,1151,402850,10382825,4.04
9881739,9978275,2008,702800,10681075,7.04
9881740,1089445,468,163800,1253245,15.04
9881741,187695,89,31150,218845,16.60
9881742,9980660,1042,364700,10345360,3.65
9881743,7620767,877,306950,7927717,4.03
9881744,9954990,3778,1322300,11277290,13.28
9881745,9956349,2755,964250,10920599,9.68
9881746,9973849,2084,729400,10703249,7.31
9881747,9981774,2460,861000,10842774,8.63
9881748,9978108,2915,1020250,10998358,10.22
9881749,9985769,2272,795200,10780969,7.96
9881750,9971296,3281,1148350,11119646,11.52
9881751,9986035,1797,628950,10614985,6.30
9881752,9987278,2969,1039150,11026428,10.40
9881753,9976236,4098,1434300,11410536,14.38
9881754,9976533,2707,947450,10923983,9.50
9881755,9975876,3499,1224650,11200526,12.28
9881756,9972783,5044,1765400,11738183,17.70
9881757,520725,83,29050,549775,5.58
9881758,9601574,5491,1921850,11523424,20.02
9881759,9965067,5213,1824550,11789617,18.31
9881760,9980507,6112,2139200,12119707,21.43
9881761,9981082,4229,1480150,11461232,14.83
9881763,9979978,2926,1024100,11004078,10.26
9881764,9988547,2414,844900,10833447,8.46
9881765,9982826,3996,1398600,11381426,14.01
9881767,9957247,1472,515200,10472447,5.17
9881768,9515359,2797,978950,10494309,10.29
9881769,9965481,4087,1430450,11395931,14.35
9881770,9976644,4826,1689100,11665744,16.93
9881771,4913355,1304,456400,5369755,9.29
9881772,9629595,2773,970550,10600145,10.08
9881773,9408339,4023,1408050,10816389,14.97
9881774,9987131,3266,1143100,11130231,11.45
9881775,9961556,3087,1080450,11042006,10.85
9881776,9971895,3405,1191750,11163645,11.95
9881777,9976358,2045,715750,10692108,7.17
9881778,4856971,1341,469350,5326321,9.66
9881779,809047,369,129150,938197,15.96
9881780,9945016,3554,1243900,11188916,12.51
9881781,9939645,2298,804300,10743945,8.09
9881782,9961071,2687,940450,10901521,9.44
9881783,9961201,4981,1743350,11704551,17.50
9881784,9958183,2370,829500,10787683,8.33
9881785,9953647,4300,1505000,11458647,15.12
9881786,9957519,4881,1708350,11665869,17.16
9881788,9965573,3478,1217300,11182873,12.22
9881789,9977677,6093,2132550,12110227,21.37
9881791,1958246,1590,556500,2514746,28.42
9881792,1964140,1112,389200,2353340,19.82
9881793,8000053,3473,1215550,9215603,15.19
9881794,1383997,309,108150,1492147,7.81
9881795,5854316,3921,1372350,7226666,23.44
9881796,9945693,3315,1160250,11105943,11.67
9881797,9968612,5080,1778000,11746612,17.84
9881798,9965621,6011,2103850,12069471,21.11
9881799,1944611,808,282800,2227411,14.54
9881800,9967839,4249,1487150,11454989,14.92
9881801,9959283,4376,1531600,11490883,15.38
9881802,9971837,4735,1657250,11629087,16.62
9881803,9974982,8080,2828000,12802982,28.35
9881804,9970990,4395,1538250,11509240,15.43
9881805,9980608,3447,1206450,11187058,12.09
9881806,4697236,2516,880600,5577836,18.75
9881807,5684866,1057,369950,6054816,6.51
9881808,9974991,4507,1577450,11552441,15.81
9881809,9981855,5247,1836450,11818305,18.40
9881810,9591893,4208,1472800,11064693,15.35
9881811,9980864,2801,980350,10961214,9.82
9881812,9973408,4023,1408050,11381458,14.12
9881813,9858059,5776,2021600,11879659,20.51
9881814,9952902,2521,882350,10835252,8.87
9881815,9956924,1210,423500,10380424,4.25
9881816,9957354,6052,2118200,12075554,21.27
9881817,6544755,3167,1108450,7653205,16.94
9881818,4286848,1414,494900,4781748,11.54
9881819,9959357,3082,1078700,11038057,10.83
9881820,9953696,2109,738150,10691846,7.42
9881821,5211321,2521,882350,6093671,16.93
9881822,9944254,3973,1390550,11334804,13.98
9881823,9938892,6027,2109450,12048342,21.22
9881824,9929110,1668,583800,10512910,5.88
9881825,9951711,2984,1044400,10996111,10.49
9881826,9941618,1440,504000,10445618,5.07
9881827,9954835,3604,1261400,11216235,12.67
9881828,6565779,2546,891100,7456879,13.57
9881829,2527011,1436,502600,3029611,19.89
9881830,9930981,5460,1911000,11841981,19.24
9881831,3185170,1772,620200,3805370,19.47
9881832,9944882,6155,2154250,12099132,21.66
9881833,9946216,4831,1690850,11637066,17.00
9881834,9962824,6731,2355850,12318674,23.65
9881835,9972438,1761,616350,10588788,6.18
9881836,9977895,4426,1549100,11526995,15.53
9881837,9986910,2039,713650,10700560,7.15
9881838,1287039,1022,357700,1644739,27.79
9881839,9964156,2582,903700,10867856,9.07
9881840,9941831,3513,1229550,11171381,12.37
9881841,9941853,4772,1670200,11612053,16.80
9881842,9924878,6187,2165450,12090328,21.82
9881843,9895993,4289,1501150,11397143,15.17
9881844,8427988,2077,726950,9154938,8.63
9881845,9938054,4368,1528800,11466854,15.38
9881846,9923742,5414,1894900,11818642,19.09
9881847,9913325,5722,2002700,11916025,20.20
9881848,9929714,5897,2063950,11993664,20.79
9881849,9934510,5311,1858850,11793360,18.71
9881850,9934622,4264,1492400,11427022,15.02
9881851,9938348,5442,1904700,11843048,19.17
9881852,1122267,515,180250,1302517,16.06
9881853,9952136,3271,1144850,11096986,11.50
9881854,9945450,2071,724850,10670300,7.29
9881855,9944495,5435,1902250,11846745,19.13
9881856,9949704,4596,1608600,11558304,16.17
9881857,9958745,6381,2233350,12192095,22.43
9881858,5554742,2675,936250,6490992,16.85
9881859,6284740,3519,1231650,7516390,19.60
9881860,9955147,3272,1145200,11100347,11.50
9881862,9952132,6774,2370900,12323032,23.82
9881863,6547312,3371,1179850,7727162,18.02
9881864,9950647,5208,1822800,11773447,18.32
9881865,9960411,1922,672700,10633111,6.75
9881866,9972436,3854,1348900,11321336,13.53
9881867,9984483,6944,2430400,12414883,24.34
9881868,8991151,4582,1603700,10594851,17.84
9881869,9970162,3873,1355550,11325712,13.60
9881870,9175750,4701,1645350,10821100,17.93
9881871,9988986,6276,2196600,12185586,21.99
9881872,9976065,6040,2114000,12090065,21.19
9881873,9982773,5074,1775900,11758673,17.79
9881874,9990097,3551,1242850,11232947,12.44
9881875,9990225,6518,2281300,12271525,22.84
9881876,9982644,4311,1508850,11491494,15.11
9881877,9357912,3423,1198050,10555962,12.80
9881878,9924992,1058,370300,10295292,3.73
9881879,9961157,3648,1276800,11237957,12.82
9881880,9966659,5786,2025100,11991759,20.32
9881881,9964889,4124,1443400,11408289,14.48
9881882,9946689,6688,2340800,12287489,23.53
9881883,9901503,2689,941150,10842653,9.51
9881884,740384,197,68950,809334,9.31
9881885,9926033,5036,1762600,11688633,17.76
9881886,9943100,3926,1374100,11317200,13.82
9881887,9944069,1835,642250,10586319,6.46
9881888,9942580,4171,1459850,11402430,14.68
9881889,9934258,3763,1317050,11251308,13.26
9881890,9936437,7068,2473800,12410237,24.90
9881891,1642265,464,162400,1804665,9.89
9881892,9944816,3991,1396850,11341666,14.05
9881893,7672789,2485,869750,8542539,11.34
9881894,9618203,4477,1566950,11185153,16.29
9881895,9970776,5612,1964200,11934976,19.70
9881896,9995569,8232,2881200,12876769,28.82
9881897,9962000,6407,2242450,12204450,22.51
9881898,9977352,2239,783650,10761002,7.85
9881900,9973456,6850,2397500,12370956,24.04
9881901,9985586,3366,1178100,11163686,11.80
9881902,9994306,3983,1394050,11388356,13.95
9881903,7209009,2789,976150,8185159,13.54
9881904,1431456,416,145600,1577056,10.17
9881905,8642019,1211,423850,9065869,4.90
9881906,2274973,518,181300,2456273,7.97
9881907,1776793,595,208250,1985043,11.72
9881908,9965433,6750,2362500,12327933,23.71
9881909,9969564,5456,1909600,11879164,19.15
9881910,9985495,3392,1187200,11172695,11.89
9881911,9968116,3092,1082200,11050316,10.86
9881912,9989783,6893,2412550,12402333,24.15
9881913,9996643,5464,1912400,11909043,19.13
9881914,9973634,4079,1427650,11401284,14.31
9881915,9967853,5494,1922900,11890753,19.29
9881916,9970394,4004,1401400,11371794,14.06
9881917,4827251,1687,590450,5417701,12.23
9881918,9968166,5754,2013900,11982066,20.20
9881919,9977339,3822,1337700,11315039,13.41
9881920,9966463,5200,1820000,11786463,18.26
9881921,9999888,2434,851900,10851788,8.52
9881922,9984909,3073,1075550,11060459,10.77
9881923,9977704,3821,1337350,11315054,13.40
9881924,3277465,869,304150,3581615,9.28
9881925,9971179,1467,513450,10484629,5.15
9881926,9955895,1638,573300,10529195,5.76
9881927,9974097,2047,716450,10690547,7.18
9881928,9977182,5010,1753500,11730682,17.58
9881929,9960396,2800,980000,10940396,9.84
9881930,9969714,4181,1463350,11433064,14.68
9881931,9969719,2439,853650,10823369,8.56
9881932,9971547,4128,1444800,11416347,14.49
9881933,9961625,4258,1490300,11451925,14.96
9881934,9962663,3030,1060500,11023163,10.64
9881935,9952338,4001,1400350,11352688,14.07
9881936,9956140,5366,1878100,11834240,18.86
9881937,9953007,5823,2038050,11991057,20.48
9881938,9959629,3086,1080100,11039729,10.84
9881939,5420552,1925,673750,6094302,12.43
9881940,9966277,3773,1320550,11286827,13.25
9881941,9980605,2012,704200,10684805,7.06
9881943,9972458,3466,1213100,11185558,12.16
9881944,9989022,3170,1109500,11098522,11.11
9881945,9981052,3422,1197700,11178752,12.00
9881946,9989520,4858,1700300,11689820,17.02
9881947,543516,276,96600,640116,17.77
9881948,9983891,4199,1469650,11453541,14.72
9881949,9979211,2264,792400,10771611,7.94
9881950,9981245,4730,1655500,11636745,16.59
9881951,9979823,2186,765100,10744923,7.67
9881952,9980454,5780,2023000,12003454,20.27
9881953,9991281,2924,1023400,11014681,10.24
9881954,9972844,2379,832650,10805494,8.35
9881955,9961973,3213,1124550,11086523,11.29
9881956,9951852,5250,1837500,11789352,18.46
9881957,9947467,5251,1837850,11785317,18.48
9881958,9937357,2004,701400,10638757,7.06
9881959,9938529,2075,726250,10664779,7.31
9881960,9941736,2309,808150,10749886,8.13
9881961,9923976,4004,1401400,11325376,14.12
9881962,9934730,3719,1301650,11236380,13.10
9881964,9925751,3379,1182650,11108401,11.91
9881965,9943260,5150,1802500,11745760,18.13
9881966,2581569,1595,558250,3139819,21.62
9881967,9957521,2236,782600,10740121,7.86
9881968,9958123,4254,1488900,11447023,14.95
9881969,9954903,3243,1135050,11089953,11.40
9881970,9917325,4360,1526000,11443325,15.39
9881971,9925241,3575,1251250,11176491,12.61
9881972,6576211,970,339500,6915711,5.16
9881973,1768178,930,325500,2093678,18.41
9881974,6385046,2937,1027950,7412996,16.10
9881975,9902897,3868,1353800,11256697,13.67
9881976,9911304,3809,1333150,11244454,13.45
9881977,8099320,3164,1107400,9206720,13.67
9881978,9920478,2560,896000,10816478,9.03
9881979,9917545,8055,2819250,12736795,28.43
9881980,9940129,2017,705950,10646079,7.10
9881981,9946573,1229,430150,10376723,4.32
9881982,3215982,1026,359100,3575082,11.17
9881983,9938953,3301,1155350,11094303,11.62
9881984,9942801,1490,521500,10464301,5.25
9881985,9924074,2884,1009400,10933474,10.17
9881986,9908574,3399,1189650,11098224,12.01
9881987,9924104,2888,1010800,10934904,10.19
9881988,9910741,3939,1378650,11289391,13.91
9881989,9925965,4040,1414000,11339965,14.25
9881990,9918615,1940,679000,10597615,6.85
9881991,9933445,3294,1152900,11086345,11.61
9881992,9945229,3238,1133300,11078529,11.40
9881993,9963798,1009,353150,10316948,3.54
9881994,9963908,2062,721700,10685608,7.24
9881995,9977706,3921,1372350,11350056,13.75
9881996,9952177,2915,1020250,10972427,10.25
9881997,9974816,3714,1299900,11274716,13.03
9881998,9973626,3183,1114050,11087676,11.17
9881999,9968584,2831,990850,10959434,9.94
9882002,3903158,1839,643650,4546808,16.49
9882003,9967114,3297,1153950,11121064,11.58
9882004,9966226,2629,920150,10886376,9.23
9882005,9994961,3335,1167250,11162211,11.68
9882006,9989793,3061,1071350,11061143,10.72
9882007,9985582,4381,1533350,11518932,15.36
9882008,9977180,2278,797300,10774480,7.99
9882009,9979388,1967,688450,10667838,6.90
9882010,9989490,2821,987350,10976840,9.88
9882011,9981434,2845,995750,10977184,9.98
9882012,9983343,3348,1171800,11155143,11.74
9882013,9968648,4396,1538600,11507248,15.43
9882014,9980990,3925,1373750,11354740,13.76
9882016,9976180,5803,2031050,12007230,20.36
9882017,9980898,4233,1481550,11462448,14.84
9882018,9990391,3584,1254400,11244791,12.56
9882019,9970026,3892,1362200,11332226,13.66
9882020,9988492,5215,1825250,11813742,18.27
9882021,9981599,5170,1809500,11791099,18.13
9882022,9993629,3538,1238300,11231929,12.39
9882023,9983891,4976,1741600,11725491,17.44
9882024,9983709,4476,1566600,11550309,15.69
9882025,9988620,3986,1395100,11383720,13.97
9882026,9968208,4292,1502200,11470408,15.07
9882027,9985019,5985,2094750,12079769,20.98
9882028,9996155,4296,1503600,11499755,15.04
9882029,9981912,5204,1821400,11803312,18.25
9882030,9971066,5473,1915550,11886616,19.21
9882031,9986473,3686,1290100,11276573,12.92
9882032,9977159,2937,1027950,11005109,10.30
9882033,9991139,5179,1812650,11803789,18.14
9882034,9987258,4313,1509550,11496808,15.11
9882035,9980884,2672,935200,10916084,9.37
9882036,9968938,6218,2176300,12145238,21.83
9882037,9972859,4648,1626800,11599659,16.31
9882038,9962345,4762,1666700,11629045,16.73
9882039,9983326,4513,1579550,11562876,15.82
9882040,9493550,4920,1722000,11215550,18.14
9882041,9980221,3319,1161650,11141871,11.64
9882042,9979751,4500,1575000,11554751,15.78
9882043,9980733,4542,1589700,11570433,15.93
9882044,9987319,4077,1426950,11414269,14.29
9882045,9988607,4499,1574650,11563257,15.76
9882046,9992554,1522,532700,10525254,5.33
9882047,9978279,3619,1266650,11244929,12.69
9882048,9979487,6733,2356550,12336037,23.61
9882049,9980870,4596,1608600,11589470,16.12
9882050,9974951,5326,1864100,11839051,18.69
9882051,9993407,5967,2088450,12081857,20.90
9882052,9995389,5265,1842750,11838139,18.44
9882053,9979680,5790,2026500,12006180,20.31
9882054,9551395,5414,1894900,11446295,19.84
9882055,9986481,3067,1073450,11059931,10.75
9882056,9989247,6868,2403800,12393047,24.06
9882057,9988536,4391,1536850,11525386,15.39
9882058,9984239,4507,1577450,11561689,15.80
9882059,9986959,3928,1374800,11361759,13.77
9882060,9971050,5987,2095450,12066500,21.02
9882061,9959369,4387,1535450,11494819,15.42
9882062,9959477,2807,982450,10941927,9.86
9882063,9977720,5689,1991150,11968870,19.96
9882064,9955824,6220,2177000,12132824,21.87
9882065,9980382,3979,1392650,11373032,13.95
9882066,9978085,2675,936250,10914335,9.38
9882068,9983034,3879,1357650,11340684,13.60
9882069,9975311,4277,1496950,11472261,15.01
9882070,9978723,4576,1601600,11580323,16.05
9882071,9983320,4230,1480500,11463820,14.83
9882072,9987556,6466,2263100,12250656,22.66
9882073,9984899,3470,1214500,11199399,12.16
9882074,9987494,4195,1468250,11455744,14.70
9882075,9973160,4084,1429400,11402560,14.33
9882076,9965512,4209,1473150,11438662,14.78
9882077,9976001,3635,1272250,11248251,12.75
9882078,9987141,3947,1381450,11368591,13.83
9882079,9982585,4021,1407350,11389935,14.10
9882080,9992057,6229,2180150,12172207,21.82
9882081,9977572,7732,2706200,12683772,27.12
9882082,7011034,3662,1281700,8292734,18.28
9882083,9972614,5600,1960000,11932614,19.65
9882084,9961873,4511,1578850,11540723,15.85
9882085,9978994,4520,1582000,11560994,15.85
9882086,9970624,4909,1718150,11688774,17.23
9882087,9978637,8571,2999850,12978487,30.06
9882088,9958285,7069,2474150,12432435,24.85
9882089,9976749,5636,1972600,11949349,19.77
9882090,9983818,4463,1562050,11545868,15.65
9882092,9984538,4236,1482600,11467138,14.85
9882093,9987240,5704,1996400,11983640,19.99
9882094,9987296,3709,1298150,11285446,13.00
9882095,9988617,6188,2165800,12154417,21.68
9882096,9988855,3063,1072050,11060905,10.73
9882097,9976809,4185,1464750,11441559,14.68
9882098,9974105,4587,1605450,11579555,16.10
9882099,9978608,6940,2429000,12407608,24.34
9882100,9983987,3979,1392650,11376637,13.95
9882101,9985254,4095,1433250,11418504,14.35
9882102,9985858,3632,1271200,11257058,12.73
9882103,9987941,2660,931000,10918941,9.32
9882104,9996191,4693,1642550,11638741,16.43
9882105,9983559,4961,1736350,11719909,17.39
9882106,9979570,4204,1471400,11450970,14.74
9882107,9994899,4899,1714650,11709549,17.16
9882108,9988281,4469,1564150,11552431,15.66
9882109,9972924,2968,1038800,11011724,10.42
9882110,9989244,2962,1036700,11025944,10.38
9882111,9997268,4900,1715000,11712268,17.15
9882112,9983187,5613,1964550,11947737,19.68
9882113,9996907,5120,1792000,11788907,17.93
9882114,9999844,3711,1298850,11298694,12.99
9882115,9990006,4708,1647800,11637806,16.49
9882116,9960966,1815,635250,10596216,6.38
9882117,9976475,3092,1082200,11058675,10.85
9882118,9975433,5349,1872150,11847583,18.77
9882119,9983807,5660,1981000,11964807,19.84
9882120,9992488,6392,2237200,12229688,22.39
9882121,9977574,5147,1801450,11779024,18.05
9882122,9987722,6641,2324350,12312072,23.27
9882123,9985074,5415,1895250,11880324,18.98
9882124,9988563,5717,2000950,11989513,20.03
9882125,9975027,4383,1534050,11509077,15.38
9882126,9998022,5958,2085300,12083322,20.86
9882127,9985168,1726,604100,10589268,6.05
9882128,9983603,4242,1484700,11468303,14.87
9882129,9991410,5285,1849750,11841160,18.51
9882130,9986569,5933,2076550,12063119,20.79
9882132,9986809,4863,1702050,11688859,17.04
9882133,9977736,5249,1837150,11814886,18.41
9882134,9984240,4126,1444100,11428340,14.46
9882135,9997960,5267,1843450,11841410,18.44
9882136,9802944,5840,2044000,11846944,20.85
9882137,9814301,5215,1825250,11639551,18.60
9882138,9969823,3733,1306550,11276373,13.11
9882139,9984894,4241,1484350,11469244,14.87
9882140,9976033,3038,1063300,11039333,10.66
9882141,9960298,4172,1460200,11420498,14.66
9882142,9964370,7016,2455600,12419970,24.64
9882143,9957862,7198,2519300,12477162,25.30
9882144,9945565,5221,1827350,11772915,18.37
9882145,9950354,5506,1927100,11877454,19.37
9882146,9958997,1946,681100,10640097,6.84
9882147,9951088,5656,1979600,11930688,19.89
9882148,9965464,6484,2269400,12234864,22.77
9882149,9954997,6313,2209550,12164547,22.20
9882150,9969568,7401,2590350,12559918,25.98
9882151,9976553,4383,1534050,11510603,15.38
9882152,9968050,5304,1856400,11824450,18.62
9882153,9960861,3993,1397550,11358411,14.03
9882154,9960547,5772,2020200,11980747,20.28
9882155,9964631,3140,1099000,11063631,11.03
9882157,9955007,3429,1200150,11155157,12.06
9882158,9958279,3824,1338400,11296679,13.44
9882159,9966152,3052,1068200,11034352,10.72
9882160,9972144,5180,1813000,11785144,18.18
9882161,9971699,4004,1401400,11373099,14.05
9882162,9968889,4812,1684200,11653089,16.89
9882163,9973242,2352,823200,10796442,8.25
9882165,9487208,4736,1657600,11144808,17.47
9882166,9990273,4198,1469300,11459573,14.71
9882167,9171631,6052,2118200,11289831,23.10
9882168,9959992,4626,1619100,11579092,16.26
9882169,9966489,7141,2499350,12465839,25.08
9882170,9968455,6172,2160200,12128655,21.67
9882171,9967619,3630,1270500,11238119,12.75
9882172,9963214,4505,1576750,11539964,15.83
9882173,9962509,4501,1575350,11537859,15.81
9882174,9966273,4144,1450400,11416673,14.55
9882175,9974342,3281,1148350,11122692,11.51
9882176,9966114,3718,1301300,11267414,13.06
9882177,9977153,2776,971600,10948753,9.74
9882178,9964330,3933,1376550,11340880,13.81
9882179,6394572,3473,1215550,7610122,19.01
9882180,9969959,3925,1373750,11343709,13.78
9882181,9761599,3564,1247400,11008999,12.78
9882182,9987231,4171,1459850,11447081,14.62
9882183,9975481,3670,1284500,11259981,12.88
9882184,9982597,4269,1494150,11476747,14.97
9882185,9990472,4234,1481900,11472372,14.83
9882186,9984378,4935,1727250,11711628,17.30
9882187,9987576,7181,2513350,12500926,25.16
9882188,9266236,3977,1391950,10658186,15.02
9882189,9992813,4671,1634850,11627663,16.36
9882190,9308786,4055,1419250,10728036,15.25
9882191,9986142,4963,1737050,11723192,17.39
9882192,9991672,3024,1058400,11050072,10.59
9882193,9973111,5408,1892800,11865911,18.98
9882194,9988767,3794,1327900,11316667,13.29
9882195,9998498,3243,1135050,11133548,11.35
9882196,9969550,4853,1698550,11668100,17.04
9882197,9973101,6348,2221800,12194901,22.28
9882198,9977170,5047,1766450,11743620,17.70
9882199,9974924,4708,1647800,11622724,16.52
9882200,9964785,5053,1768550,11733335,17.75
9882201,9986577,4909,1718150,11704727,17.20
9882202,9992010,4756,1664600,11656610,16.66
9882203,9985701,2862,1001700,10987401,10.03
9882204,9995381,5732,2006200,12001581,20.07
9882205,9979621,4379,1532650,11512271,15.36
9882206,9973352,6575,2301250,12274602,23.07
9882207,9908220,4769,1669150,11577370,16.85
9882208,9959952,2296,803600,10763552,8.07
9882209,9930358,1141,399350,10329708,4.02
9882210,9955917,1029,360150,10316067,3.62
9882211,9902458,3547,1241450,11143908,12.54
9882212,9972872,4629,1620150,11593022,16.25
9882213,9978639,2440,854000,10832639,8.56
9882214,9995466,3700,1295000,11290466,12.96
9882215,9983810,398,139300,10123110,1.40
9882216,9990675,2591,906850,10897525,9.08
9882217,9979443,3518,1231300,11210743,12.34
9882218,9981583,5199,1819650,11801233,18.23
9882219,9978141,5593,1957550,11935691,19.62
9882220,9985568,4316,1510600,11496168,15.13
9882221,9970063,2946,1031100,11001163,10.34
9882222,9977396,3478,1217300,11194696,12.20
9882223,9980793,5058,1770300,11751093,17.74
9882224,9986152,5882,2058700,12044852,20.62
9882225,9989796,5530,1935500,11925296,19.37
9882226,9975855,4552,1593200,11569055,15.97
9882227,9986725,6117,2140950,12127675,21.44
9882228,9981227,3415,1195250,11176477,11.97
9882229,9980918,7352,2573200,12554118,25.78
9882230,9989164,4162,1456700,11445864,14.58
9882231,9974504,5263,1842050,11816554,18.47
9882232,9989057,4763,1667050,11656107,16.69
9882233,9978581,4433,1551550,11530131,15.55
9882234,9983708,6847,2396450,12380158,24.00
9882235,9997939,7267,2543450,12541389,25.44
9882236,9999715,3670,1284500,11284215,12.85
9882237,9982277,6474,2265900,12248177,22.70
9882239,9963270,2954,1033900,10997170,10.38
9882240,9968176,1904,666400,10634576,6.69
9882241,9974469,5846,2046100,12020569,20.51
9882242,9983717,5096,1783600,11767317,17.87
9882243,9947471,3384,1184400,11131871,11.91
9882244,9969127,3123,1093050,11062177,10.96
9882245,9979139,4851,1697850,11676989,17.01
9882246,9975808,1902,665700,10641508,6.67
9882247,9999690,1074,375900,10375590,3.76
9882248,9723819,3721,1302350,11026169,13.39
9882249,9977642,2983,1044050,11021692,10.46
9882250,9976282,1018,356300,10332582,3.57
9882251,9973706,3047,1066450,11040156,10.69
9882252,9975319,5535,1937250,11912569,19.42
9882253,9968811,4663,1632050,11600861,16.37
9882254,9955551,7389,2586150,12541701,25.98
9882255,9950586,3904,1366400,11316986,13.73
9882256,9941276,6701,2345350,12286626,23.59
9882257,9966967,4927,1724450,11691417,17.30
9882258,9934227,3309,1158150,11092377,11.66
9882259,9961896,4094,1432900,11394796,14.38
9882260,9989967,3534,1236900,11226867,12.38
9882261,9903340,2078,727300,10630640,7.34
9882262,9964839,3738,1308300,11273139,13.13
9882263,9964907,2815,985250,10950157,9.89
9882264,9970332,3237,1132950,11103282,11.36
9882265,9979909,5911,2068850,12048759,20.73
9882266,9890471,4517,1580950,11471421,15.98
9882267,9993080,2955,1034250,11027330,10.35
9882268,9986951,4257,1489950,11476901,14.92
9882269,9991032,3359,1175650,11166682,11.77
9882270,9981411,4669,1634150,11615561,16.37
9882271,9972445,6338,2218300,12190745,22.24
9882272,9969736,197,68950,10038686,0.69
9882273,9959440,4773,1670550,11629990,16.77
9882274,9956236,3982,1393700,11349936,14.00
9882275,9971776,5100,1785000,11756776,17.90
9882276,9977859,4874,1705900,11683759,17.10
9882277,9984305,3121,1092350,11076655,10.94
9882278,9973191,3304,1156400,11129591,11.60
9882279,9983008,3463,1212050,11195058,12.14
9882280,9989177,2538,888300,10877477,8.89
9882281,9971625,4686,1640100,11611725,16.45
9882282,9983120,3759,1315650,11298770,13.18
9882283,9986329,1938,678300,10664629,6.79
9882284,9993693,3926,1374100,11367793,13.75
9882286,9963817,3771,1319850,11283667,13.25
9882287,9989437,2451,857850,10847287,8.59
9882288,9989295,3504,1226400,11215695,12.28
9882289,9988866,3523,1233050,11221916,12.34
9882290,9995425,3739,1308650,11304075,13.09
9882291,9975747,4364,1527400,11503147,15.31
9882292,9983313,3633,1271550,11254863,12.74
9882293,9998203,6663,2332050,12330253,23.32
9882294,9970063,4060,1421000,11391063,14.25
9882295,9999873,3306,1157100,11156973,11.57
9882296,9986024,3746,1311100,11297124,13.13
9882297,9975877,3152,1103200,11079077,11.06
9882298,9968273,4283,1499050,11467323,15.04
9882299,9983267,4602,1610700,11593967,16.13
9882300,9989665,667,233450,10223115,2.34
9882301,9986579,5004,1751400,11737979,17.54
9882302,9983480,2418,846300,10829780,8.48
9882303,9977732,3818,1336300,11314032,13.39
9882304,9959836,2524,883400,10843236,8.87
9882305,9963863,6579,2302650,12266513,23.11
9882306,9962827,4506,1577100,11539927,15.83
9882307,9960074,2805,981750,10941824,9.86
9882308,9965257,3726,1304100,11269357,13.09
9882309,9980697,2670,934500,10915197,9.36
9882310,9987649,3866,1353100,11340749,13.55
9882311,9983714,4200,1470000,11453714,14.72
9882312,9994791,5088,1780800,11775591,17.82
9882313,9981626,2040,714000,10695626,7.15
9882314,9980434,4529,1585150,11565584,15.88
9882315,9973364,3093,1082550,11055914,10.85
9882316,9969699,3638,1273300,11242999,12.77
9882317,9994231,4752,1663200,11657431,16.64
9882318,9983727,2449,857150,10840877,8.59
9882319,9969698,3046,1066100,11035798,10.69
9882320,9983904,3878,1357300,11341204,13.59
9882321,9981067,4765,1667750,11648817,16.71
9882322,9995763,5945,2080750,12076513,20.82
9882323,9977813,4406,1542100,11519913,15.46
9882324,9979541,1029,360150,10339691,3.61
9882325,9984322,4047,1416450,11400772,14.19
9882326,9975647,3165,1107750,11083397,11.10
9882327,9979126,3813,1334550,11313676,13.37
9882328,9993616,5061,1771350,11764966,17.72
9882329,9996947,6470,2264500,12261447,22.65
9882330,9984576,4790,1676500,11661076,16.79
9882331,9996241,4241,1484350,11480591,14.85
9882332,9979979,4288,1500800,11480779,15.04
9882333,9910064,4736,1657600,11567664,16.73
9882335,9997247,4186,1465100,11462347,14.66
9882336,2217301,934,326900,2544201,14.74
9882337,9970139,3886,1360100,11330239,13.64
9882338,9976857,5683,1989050,11965907,19.94
9882339,9989529,2680,938000,10927529,9.39
9882340,9984060,3464,1212400,11196460,12.14
9882341,9966980,4253,1488550,11455530,14.93
9882342,8977451,3777,1321950,10299401,14.73
9882343,9961436,4206,1472100,11433536,14.78
9882344,9975597,3273,1145550,11121147,11.48
9882345,9976520,3846,1346100,11322620,13.49
9882346,9958923,2260,791000,10749923,7.94
9882347,9978115,2031,710850,10688965,7.12
9882348,9972668,1250,437500,10410168,4.39
9882349,9899607,3545,1240750,11140357,12.53
9882350,8987384,1204,421400,9408784,4.69
9882351,8987003,1658,580300,9567303,6.46
9882352,9981537,699,244650,10226187,2.45
9882353,9974740,3467,1213450,11188190,12.17
9882354,9990617,1586,555100,10545717,5.56
9882356,9991766,4345,1520750,11512516,15.22
9882357,9982969,3826,1339100,11322069,13.41
9882358,9984666,3305,1156750,11141416,11.59
9882359,9974532,5369,1879150,11853682,18.84
9882360,9988960,2691,941850,10930810,9.43
9882361,9968945,3064,1072400,11041345,10.76
9882362,9983052,4413,1544550,11527602,15.47
9882363,9854351,2813,984550,10838901,9.99
9882364,9952809,5999,2099650,12052459,21.10
9882365,9967301,2209,773150,10740451,7.76
9882366,9980432,3908,1367800,11348232,13.70
9882367,9967517,3261,1141350,11108867,11.45
9882368,9956391,3876,1356600,11312991,13.63
9882370,9964740,4466,1563100,11527840,15.69
9882371,9960613,2835,992250,10952863,9.96
9882372,9958014,5215,1825250,11783264,18.33
9882373,9941465,4193,1467550,11409015,14.76
9882374,9943466,5066,1773100,11716566,17.83
9882375,9969946,3642,1274700,11244646,12.79
9882376,9969881,7056,2469600,12439481,24.77
9882377,9972883,4628,1619800,11592683,16.24
9882378,9978559,6075,2126250,12104809,21.31
9882380,9980212,5756,2014600,11994812,20.19
9882381,9985856,3907,1367450,11353306,13.69
9882382,9989462,6336,2217600,12207062,22.20
9882383,9984752,5604,1961400,11946152,19.64
9882384,9985982,6973,2440550,12426532,24.44
9882385,9999659,4114,1439900,11439559,14.40
9882386,9987438,4947,1731450,11718888,17.34
9882387,9969281,6880,2408000,12377281,24.15
9882388,9726891,5042,1764700,11491591,18.14
9882389,9987969,6148,2151800,12139769,21.54
9882390,9980479,6096,2133600,12114079,21.38
9882391,9984624,7399,2589650,12574274,25.94
9882392,9989783,4858,1700300,11690083,17.02
9882393,9991727,3743,1310050,11301777,13.11
9882394,9983190,4863,1702050,11685240,17.05
9882395,9969799,5553,1943550,11913349,19.49
9882396,9972163,4415,1545250,11517413,15.50
9882397,9986248,3922,1372700,11358948,13.75
9882398,9980461,5350,1872500,11852961,18.76
9882399,9963162,8076,2826600,12789762,28.37
9882400,9973927,4879,1707650,11681577,17.12
9882401,9982420,4242,1484700,11467120,14.87
9882402,9982832,4658,1630300,11613132,16.33
9882403,9982810,4589,1606150,11588960,16.09
9882404,9975096,3998,1399300,11374396,14.03
9882405,9964265,3923,1373050,11337315,13.78
9882406,9983421,3324,1163400,11146821,11.65
9882407,9972178,3004,1051400,11023578,10.54
9882408,9984510,5257,1839950,11824460,18.43
9882409,9970547,4292,1502200,11472747,15.07
9882410,9966667,4934,1726900,11693567,17.33
9882411,9976567,3623,1268050,11244617,12.71
9882412,9992745,4896,1713600,11706345,17.15
9882414,9984450,4415,1545250,11529700,15.48
9882415,9977476,5996,2098600,12076076,21.03
9882416,9978076,6899,2414650,12392726,24.20
9882417,9977158,4532,1586200,11563358,15.90
9882419,9978378,6009,2103150,12081528,21.08
9882420,9969491,2425,848750,10818241,8.51
9882421,9986055,5215,1825250,11811305,18.28
9882422,9988096,5113,1789550,11777646,17.92
9882423,9991542,4784,1674400,11665942,16.76
9882424,9972188,5198,1819300,11791488,18.24
9882425,9928469,4117,1440950,11369419,14.51
9882426,9924305,4898,1714300,11638605,17.27
9882427,9989645,6118,2141300,12130945,21.44
9882428,9981245,7293,2552550,12533795,25.57
9882429,9992633,3690,1291500,11284133,12.92
9882430,9982027,5029,1760150,11742177,17.63
9882431,9990959,6727,2354450,12345409,23.57
9882432,9980698,5737,2007950,11988648,20.12
9882433,9984320,5421,1897350,11881670,19.00
9882434,9982861,4809,1683150,11666011,16.86
9882436,9965896,5564,1947400,11913296,19.54
9882437,9956274,4820,1687000,11643274,16.94
9882438,9956333,4972,1740200,11696533,17.48
9882439,9963277,5777,2021950,11985227,20.29
9882440,9971698,5612,1964200,11935898,19.70
9882441,9979644,4288,1500800,11480444,15.04
9882442,9975957,5582,1953700,11929657,19.58
9882443,9977947,6083,2129050,12106997,21.34
9882444,9979582,3970,1389500,11369082,13.92
9882445,9972385,6034,2111900,12084285,21.18
9882446,9998577,3813,1334550,11333127,13.35
9882447,9981904,5773,2020550,12002454,20.24
9882448,9988175,6503,2276050,12264225,22.79
9882449,9984242,5329,1865150,11849392,18.68
9882450,9980480,4063,1422050,11402530,14.25
9882451,9989350,3819,1336650,11326000,13.38
9882452,9998800,3716,1300600,11299400,13.01
9882453,9990646,4805,1681750,11672396,16.83
9882454,9978365,5450,1907500,11885865,19.12
9882455,9980227,4221,1477350,11457577,14.80
9882456,9967918,4162,1456700,11424618,14.61
9882457,9980473,6575,2301250,12281723,23.06
9882459,9973852,4359,1525650,11499502,15.30
9882460,9963772,6046,2116100,12079872,21.24
9882461,9970055,4273,1495550,11465605,15.00
9882462,9958999,6657,2329950,12288949,23.40
9882463,9967429,3605,1261750,11229179,12.66
9882464,9968036,5563,1947050,11915086,19.53
9882465,9817388,4849,1697150,11514538,17.29
9882467,9955746,5039,1763650,11719396,17.71
9882468,9954811,4980,1743000,11697811,17.51
9882469,9960775,7430,2600500,12561275,26.11
9882470,9976466,4944,1730400,11706866,17.34
9882471,9992217,6792,2377200,12369417,23.79
9882472,9987835,3573,1250550,11238385,12.52
9882473,9999440,5150,1802500,11801940,18.03
9882474,9975782,5304,1856400,11832182,18.61
9882475,9995050,5448,1906800,11901850,19.08
9882476,9979652,4806,1682100,11661752,16.86
9882477,9985214,3315,1160250,11145464,11.62
9882478,9984488,2843,995050,10979538,9.97
9882479,9995021,5669,1984150,11979171,19.85
9882480,9998072,5917,2070950,12069022,20.71
9882481,9998318,4885,1709750,11708068,17.10
9882482,9247055,6233,2181550,11428605,23.59
9882483,9961936,4753,1663550,11625486,16.70
9882484,9953960,2828,989800,10943760,9.94
9882485,8973132,2573,900550,9873682,10.04
9882486,9957654,5563,1947050,11904704,19.55
9882487,9958584,7418,2596300,12554884,26.07
9882488,9869371,5435,1902250,11771621,19.27
9882489,9949171,3492,1222200,11171371,12.28
9882490,9953945,5488,1920800,11874745,19.30
9882491,9968300,5178,1812300,11780600,18.18
9882492,9979707,4740,1659000,11638707,16.62
9882493,9967256,4823,1688050,11655306,16.94
9882494,9961705,4789,1676150,11637855,16.83
9882495,9957955,6359,2225650,12183605,22.35
9882496,9979814,5780,2023000,12002814,20.27
9882497,9949542,5675,1986250,11935792,19.96
9882498,9880246,5039,1763650,11643896,17.85
9882499,9973969,5417,1895950,11869919,19.01
9882500,9822607,6862,2401700,12224307,24.45
9882501,9988198,6208,2172800,12160998,21.75
9882502,9968804,7330,2565500,12534304,25.74
9882503,9963564,4281,1498350,11461914,15.04
9882504,9984109,6675,2336250,12320359,23.40
9882505,9981809,6360,2226000,12207809,22.30
9882506,9979087,5053,1768550,11747637,17.72
9882507,9971957,3940,1379000,11350957,13.83
9882508,9966665,4408,1542800,11509465,15.48
9882509,9982850,2786,975100,10957950,9.77
9882510,9993016,4672,1635200,11628216,16.36
9882511,9982271,5965,2087750,12070021,20.91
9882512,9979559,3146,1101100,11080659,11.03
9882513,9983105,6453,2258550,12241655,22.62
9882514,9983034,3061,1071350,11054384,10.73
9882515,9210185,2804,981400,10191585,10.66
9882516,9997727,3840,1344000,11341727,13.44
9882518,9973455,3182,1113700,11087155,11.17
9882519,9988638,6044,2115400,12104038,21.18
9882520,9987092,4284,1499400,11486492,15.01
9882521,9980607,4444,1555400,11536007,15.58
9882522,9966102,3632,1271200,11237302,12.76
9882524,9941633,4515,1580250,11521883,15.90
9882525,9958101,3443,1205050,11163151,12.10
9882526,9968917,5386,1885100,11854017,18.91
9882527,9955359,4028,1409800,11365159,14.16
9882528,9966376,5303,1856050,11822426,18.62
9882529,9951407,5678,1987300,11938707,19.97
9882530,9958546,6131,2145850,12104396,21.55
9882531,9950912,5813,2034550,11985462,20.45
9882532,9957243,4305,1506750,11463993,15.13
9882533,8954027,2841,994350,9948377,11.11
9882534,8355285,3121,1092350,9447635,13.07
9882535,9966699,4637,1622950,11589649,16.28
9882536,9979329,1997,698950,10678279,7.00
9882537,9974674,5599,1959650,11934324,19.65
9882539,9957132,3007,1052450,11009582,10.57
9882540,9945923,3953,1383550,11329473,13.91
9882541,9948616,5991,2096850,12045466,21.08
9882542,9974516,4391,1536850,11511366,15.41
9882543,9933076,4686,1640100,11573176,16.51
9882544,9946339,4079,1427650,11373989,14.35
9882545,9969917,3836,1342600,11312517,13.47
9882547,9978271,3018,1056300,11034571,10.59
9882548,9738291,4496,1573600,11311891,16.16
9882549,9979736,4447,1556450,11536186,15.60
9882550,9975499,4826,1689100,11664599,16.93
9882551,9960082,6005,2101750,12061832,21.10
9882552,9971245,4612,1614200,11585445,16.19
9882553,9970162,3708,1297800,11267962,13.02
9882554,9961426,5245,1835750,11797176,18.43
9882555,9977976,6238,2183300,12161276,21.88
9882556,9966370,6903,2416050,12382420,24.24
9882557,8962163,4827,1689450,10651613,18.85
9882558,9963212,3730,1305500,11268712,13.10
9882559,9955145,3236,1132600,11087745,11.38
9882560,9985909,5610,1963500,11949409,19.66
9882561,9989364,6352,2223200,12212564,22.26
9882563,9851826,5360,1876000,11727826,19.04
9882564,9976329,2772,970200,10946529,9.73
9882565,9985441,4890,1711500,11696941,17.14
9882567,9662462,2925,1023750,10686212,10.60
9882569,8956982,3289,1151150,10108132,12.85
9882570,9972380,4676,1636600,11608980,16.41
9882571,9975207,5495,1923250,11898457,19.28
9882572,9987320,5450,1907500,11894820,19.10
9882573,9966800,4656,1629600,11596400,16.35
9882574,9978229,4188,1465800,11444029,14.69
9882575,9984570,3413,1194550,11179120,11.96
9882576,9972537,5198,1819300,11791837,18.24
9882577,9976089,5420,1897000,11873089,19.02
9882578,9974108,5065,1772750,11746858,17.77
9882579,9982177,4047,1416450,11398627,14.19
9882580,9968752,3560,1246000,11214752,12.50
9882581,9980897,3190,1116500,11097397,11.19
9882582,9978335,4037,1412950,11391285,14.16
9882583,9980539,4402,1540700,11521239,15.44
9882584,9970695,6555,2294250,12264945,23.01
9882585,9956387,5079,1777650,11734037,17.85
9882586,9963223,6606,2312100,12275323,23.21
9882587,9957395,3770,1319500,11276895,13.25
9882588,9963534,5238,1833300,11796834,18.40
9882589,9953521,4088,1430800,11384321,14.37
9882590,9955797,4016,1405600,11361397,14.12
9882591,9959129,5743,2010050,11969179,20.18
9882592,9972410,5070,1774500,11746910,17.79
9882593,9946067,5885,2059750,12005817,20.71
9882595,9952698,5306,1857100,11809798,18.66
9882596,9946209,6230,2180500,12126709,21.92
9882597,9952226,5996,2098600,12050826,21.09
9882598,9976088,4671,1634850,11610938,16.39
9882599,9957041,6460,2261000,12218041,22.71
9882600,9984677,4412,1544200,11528877,15.47
9882601,9981433,4544,1590400,11571833,15.93
9882602,8859404,3908,1367800,10227204,15.44
9882603,9970987,6801,2380350,12351337,23.87
9882604,9972413,4781,1673350,11645763,16.78
9882605,9980963,4710,1648500,11629463,16.52
9882606,9971217,2985,1044750,11015967,10.48
9882607,9987665,4438,1553300,11540965,15.55
9882608,9997802,3407,1192450,11190252,11.93
9882609,9970852,2157,754950,10725802,7.57
9882610,9974423,4429,1550150,11524573,15.54
9882611,9981218,4964,1737400,11718618,17.41
9882612,9968727,4845,1695750,11664477,17.01
9882613,9969571,4232,1481200,11450771,14.86
9882614,9908790,5844,2045400,11954190,20.64
9882615,9953525,3659,1280650,11234175,12.87
9882616,9988194,3819,1336650,11324844,13.38
9882617,9973740,3753,1313550,11287290,13.17
9882618,9980233,5012,1754200,11734433,17.58
9882619,9977273,5263,1842050,11819323,18.46
9882620,9976976,5727,2004450,11981426,20.09
9882621,9979729,4633,1621550,11601279,16.25
9882622,9982385,4820,1687000,11669385,16.90
9882623,9983607,5074,1775900,11759507,17.79
9882624,9983081,5804,2031400,12014481,20.35
9882625,9987327,5465,1912750,11900077,19.15
9882626,9977495,3086,1080100,11057595,10.83
9882628,9938438,4038,1413300,11351738,14.22
9882629,7948866,3924,1373400,9322266,17.28
9882630,9895825,4316,1510600,11406425,15.27
9882631,9965427,4748,1661800,11627227,16.68
9882632,9978605,3405,1191750,11170355,11.94
9882633,9967934,5399,1889650,11857584,18.96
9882634,9989687,5612,1964200,11953887,19.66
9882635,9999807,4624,1618400,11618207,16.18
9882636,9987230,2969,1039150,11026380,10.40
9882637,9995314,4302,1505700,11501014,15.06
9882638,9985919,6396,2238600,12224519,22.42
9882639,9965012,4068,1423800,11388812,14.29
9882640,9984994,5021,1757350,11742344,17.60
9882641,9910521,4011,1403850,11314371,14.17
9882643,9989497,2061,721350,10710847,7.22
9882644,9986204,4216,1475600,11461804,14.78
9882646,9955528,4342,1519700,11475228,15.26
9882647,9964839,5329,1865150,11829989,18.72
9882648,9984092,2307,807450,10791542,8.09
9882649,9981186,4945,1730750,11711936,17.34
9882650,9994360,5125,1793750,11788110,17.95
9882651,9973646,5420,1897000,11870646,19.02
9882652,9985393,5939,2078650,12064043,20.82
9882653,9986633,6112,2139200,12125833,21.42
9882654,9979118,4997,1748950,11728068,17.53
9882655,9907290,5120,1792000,11699290,18.09
9882656,9995470,3961,1386350,11381820,13.87
9882657,9986349,4968,1738800,11725149,17.41
9882658,9994154,3752,1313200,11307354,13.14
9882659,9198788,5112,1789200,10987988,19.45
9882660,9991237,4726,1654100,11645337,16.56
9882661,9982630,3004,1051400,11034030,10.53
9882662,9982590,4212,1474200,11456790,14.77
9882663,9989239,5526,1934100,11923339,19.36
9882664,1125837,182,63700,1189537,5.66
9882665,9895324,3010,1053500,10948824,10.65
9882667,9970855,2633,921550,10892405,9.24
9882668,9966675,4182,1463700,11430375,14.69
9882669,9964785,5045,1765750,11730535,17.72
9882670,9979926,5891,2061850,12041776,20.66
9882671,9977551,5293,1852550,11830101,18.57
9882672,9954816,4874,1705900,11660716,17.14
9882673,9987691,7165,2507750,12495441,25.11
9882674,9959933,3748,1311800,11271733,13.17
9882676,9969290,2611,913850,10883140,9.17
9882677,9971675,7377,2581950,12553625,25.89
9882678,9990476,4281,1498350,11488826,15.00
9882679,9989712,4080,1428000,11417712,14.29
9882680,9951813,2956,1034600,10986413,10.40
9882682,9969234,5996,2098600,12067834,21.05
9882683,9915200,4566,1598100,11513300,16.12
9882684,9980324,4234,1481900,11462224,14.85
9882685,9991498,7586,2655100,12646598,26.57
9882686,9982744,3525,1233750,11216494,12.36
9882687,9964490,3465,1212750,11177240,12.17
9882688,9978417,4706,1647100,11625517,16.51
9882690,9959282,3620,1267000,11226282,12.72
9882691,9970266,6295,2203250,12173516,22.10
9882692,9983584,3592,1257200,11240784,12.59
9882693,9991530,4964,1737400,11728930,17.39
9882694,9471633,4415,1545250,11016883,16.31
9882695,9958636,4515,1580250,11538886,15.87
9882696,9974301,3012,1054200,11028501,10.57
9882697,9981717,2812,984200,10965917,9.86
9882698,9928348,3145,1100750,11029098,11.09
9882699,9975315,3483,1219050,11194365,12.22
9882700,9971179,4368,1528800,11499979,15.33
9882701,9983316,2682,938700,10922016,9.40
9882702,9999868,5033,1761550,11761418,17.62
9882703,9985498,3168,1108800,11094298,11.10
9882704,9764914,3601,1260350,11025264,12.91
9882705,9998799,4367,1528450,11527249,15.29
9882706,9955169,2987,1045450,11000619,10.50
9882707,9989981,5011,1753850,11743831,17.56
9882708,9993700,5718,2001300,11995000,20.03
9882709,9989126,2298,804300,10793426,8.05
9882711,9990435,3911,1368850,11359285,13.70
9882712,9976972,2971,1039850,11016822,10.42
9882713,9982927,5127,1794450,11777377,17.98
9882714,9979655,3257,1139950,11119605,11.42
9882715,9989511,3818,1336300,11325811,13.38
9882716,9913291,3162,1106700,11019991,11.16
9882717,9968434,4328,1514800,11483234,15.20
9882718,9993753,4655,1629250,11623003,16.30
9882719,9983447,2846,996100,10979547,9.98
9882720,9980201,5061,1771350,11751551,17.75
9882721,9971470,5574,1950900,11922370,19.56
9882722,9956905,2782,973700,10930605,9.78
9882723,9961042,2780,973000,10934042,9.77
9882724,9968659,2468,863800,10832459,8.67
9882725,9980436,3012,1054200,11034636,10.56
9882726,9978162,3290,1151500,11129662,11.54
9882727,9924677,3730,1305500,11230177,13.15
9882728,9904550,3870,1354500,11259050,13.68
9882729,9980359,2198,769300,10749659,7.71
9882730,9896784,4037,1412950,11309734,14.28
9882731,9993672,4021,1407350,11401022,14.08
9882732,9984314,4056,1419600,11403914,14.22
9882733,9998027,2656,929600,10927627,9.30
9882734,9991069,2763,967050,10958119,9.68
9882735,9979811,3933,1376550,11356361,13.79
9882736,9976482,3886,1360100,11336582,13.63
9882737,9998420,2887,1010450,11008870,10.11
9882738,9988888,3559,1245650,11234538,12.47
9882739,9997800,5769,2019150,12016950,20.20
9882740,9976121,2723,953050,10929171,9.55
9882741,9932101,3346,1171100,11103201,11.79
9882742,9982355,4574,1600900,11583255,16.04
9882743,2071342,216,75600,2146942,3.65
9882744,9972973,2913,1019550,10992523,10.22
9882745,9971800,5106,1787100,11758900,17.92
9882746,9966301,2118,741300,10707601,7.44
9882747,9975287,3864,1352400,11327687,13.56
9882748,9975787,4619,1616650,11592437,16.21
9882749,9991008,3392,1187200,11178208,11.88
9882750,9986851,5249,1837150,11824001,18.40
9882751,9979915,3510,1228500,11208415,12.31
9882752,9570091,4382,1533700,11103791,16.03
9882753,9988134,3750,1312500,11300634,13.14
9882754,9965299,3245,1135750,11101049,11.40
9882755,9965662,3107,1087450,11053112,10.91
9882756,9978965,5922,2072700,12051665,20.77
9882757,9972898,1785,624750,10597648,6.26
9882758,9978719,6059,2120650,12099369,21.25
9882759,9986964,3482,1218700,11205664,12.20
9882760,9999419,3117,1090950,11090369,10.91
9882761,9986758,4243,1485050,11471808,14.87
9882762,9960221,3537,1237950,11198171,12.43
9882763,9981093,5574,1950900,11931993,19.55
9882764,9957897,5092,1782200,11740097,17.90
9882765,9977099,1636,572600,10549699,5.74
9882766,9981174,4423,1548050,11529224,15.51
9882767,9989111,4006,1402100,11391211,14.04
9882768,9974343,5575,1951250,11925593,19.56
9882769,9970839,3985,1394750,11365589,13.99
9882770,9907407,2048,716800,10624207,7.23
9882771,9980682,3562,1246700,11227382,12.49
9882772,1053832,252,88200,1142032,8.37
9882773,9957158,4193,1467550,11424708,14.74
9882774,9953411,3034,1061900,11015311,10.67
9882776,9862175,3869,1354150,11216325,13.73
9882777,9954038,3050,1067500,11021538,10.72
9882778,9954942,1942,679700,10634642,6.83
9882779,9938178,5170,1809500,11747678,18.21
9882780,9940814,4016,1405600,11346414,14.14
9882781,9949489,4663,1632050,11581539,16.40
9882782,8955699,3807,1332450,10288149,14.88
9882783,9960346,1426,499100,10459446,5.01
9882784,9959815,3728,1304800,11264615,13.10
9882785,9974751,3329,1165150,11139901,11.68
9882786,9543402,1262,441700,9985102,4.63
9882787,9967501,4994,1747900,11715401,17.54
9882788,9976633,3728,1304800,11281433,13.08
9882789,9959436,1464,512400,10471836,5.14
9882790,9625261,4841,1694350,11319611,17.60
9882791,9972607,3285,1149750,11122357,11.53
9882792,9972787,3166,1108100,11080887,11.11
9882793,9963932,5050,1767500,11731432,17.74
9882794,9991013,5150,1802500,11793513,18.04
9882795,9993296,4037,1412950,11406246,14.14
9882796,9969316,3557,1244950,11214266,12.49
9882797,9757873,2172,760200,10518073,7.79
9882798,9971608,6680,2338000,12309608,23.45
9882799,9966462,4683,1639050,11605512,16.45
9882800,9988261,2155,754250,10742511,7.55
9882801,9983494,4620,1617000,11600494,16.20
9882802,9980683,2693,942550,10923233,9.44
9882803,9985371,4200,1470000,11455371,14.72
9882804,9982327,3346,1171100,11153427,11.73
9882805,9990610,1722,602700,10593310,6.03
9882806,9970918,7283,2549050,12519968,25.56
9882807,9953770,4696,1643600,11597370,16.51
9882808,9971702,2857,999950,10971652,10.03
9882809,9983886,3669,1284150,11268036,12.86
9882810,9975661,4758,1665300,11640961,16.69
9882811,9959851,4913,1719550,11679401,17.26
9882812,9966340,4764,1667400,11633740,16.73
9882813,9970277,3104,1086400,11056677,10.90
9882814,9963374,2953,1033550,10996924,10.37
9882815,9968649,5078,1777300,11745949,17.83
9882816,9960252,1839,643650,10603902,6.46
9882817,9976590,5086,1780100,11756690,17.84
9882818,9968284,2889,1011150,10979434,10.14
9882819,9675960,3654,1278900,10954860,13.22
9882820,9985534,3565,1247750,11233284,12.50
9882821,9965494,4402,1540700,11506194,15.46
9882822,9971867,5294,1852900,11824767,18.58
9882823,9966308,4737,1657950,11624258,16.64
9882824,9970223,3739,1308650,11278873,13.13
9882825,9979962,4641,1624350,11604312,16.28
9882826,9980387,2304,806400,10786787,8.08
9882827,9961578,3206,1122100,11083678,11.26
9882828,9968182,3847,1346450,11314632,13.51
9882829,9969184,3900,1365000,11334184,13.69
9882830,9962066,2888,1010800,10972866,10.15
9882831,9963184,2006,702100,10665284,7.05
9882832,9099773,1863,652050,9751823,7.17
9882833,9964871,3920,1372000,11336871,13.77
9882834,9898007,4253,1488550,11386557,15.04
9882835,9982961,3625,1268750,11251711,12.71
9882836,9989808,2322,812700,10802508,8.14
9882837,9987565,6170,2159500,12147065,21.62
9882838,9987764,3616,1265600,11253364,12.67
9882839,9994955,4236,1482600,11477555,14.83
9882840,9971040,4724,1653400,11624440,16.58
9882841,9974160,5428,1899800,11873960,19.05
9882844,9999412,4288,1500800,11500212,15.01
9882845,9976631,6057,2119950,12096581,21.25
9882846,9960960,3953,1383550,11344510,13.89
9882847,9956201,2689,941150,10897351,9.45
9882848,9970902,2676,936600,10907502,9.39
9882849,9974538,3608,1262800,11237338,12.66
9882850,9970701,3852,1348200,11318901,13.52
9882852,9983442,3314,1159900,11143342,11.62
9882853,9985606,3976,1391600,11377206,13.94
9882855,9981278,1991,696850,10678128,6.98
9882856,9990509,3225,1128750,11119259,11.30
9882857,9989387,3385,1184750,11174137,11.86
9882858,9983247,3241,1134350,11117597,11.36
9882859,9985128,3601,1260350,11245478,12.62
9882860,9977133,4200,1470000,11447133,14.73
9882861,9980885,4178,1462300,11443185,14.65
9882862,9972283,3873,1355550,11327833,13.59
9882863,9981439,2872,1005200,10986639,10.07
9882864,9989784,2373,830550,10820334,8.31
9882865,9970759,1909,668150,10638909,6.70
9882866,9962251,4458,1560300,11522551,15.66
9882867,9985297,4331,1515850,11501147,15.18
9882868,9978053,4156,1454600,11432653,14.58
9882869,9979988,2377,831950,10811938,8.34
9882870,9985539,4228,1479800,11465339,14.82
9882871,9986910,3833,1341550,11328460,13.43
9882872,9979896,3135,1097250,11077146,10.99
9882874,9968528,4750,1662500,11631028,16.68
9882875,9967681,3586,1255100,11222781,12.59
9882876,9983162,3550,1242500,11225662,12.45
9882877,9989330,4097,1433950,11423280,14.35
9882878,9968893,3732,1306200,11275093,13.10
9882879,9747583,2616,915600,10663183,9.39
9882880,9990793,4680,1638000,11628793,16.40
9882881,9981743,2865,1002750,10984493,10.05
9882882,9978812,4361,1526350,11505162,15.30
9882883,9994832,5195,1818250,11813082,18.19
9882884,9996324,4002,1400700,11397024,14.01
9882885,9990710,2690,941500,10932210,9.42
9882886,9973721,4324,1513400,11487121,15.17
9882887,9998151,3163,1107050,11105201,11.07
9882888,9990461,7279,2547650,12538111,25.50
9882889,9982882,3247,1136450,11119332,11.38
9882890,9961838,5021,1757350,11719188,17.64
9882891,9986187,3962,1386700,11372887,13.89
9882892,9826492,2878,1007300,10833792,10.25
9882893,9992197,2632,921200,10913397,9.22
9882894,9979624,6187,2165450,12145074,21.70
9882895,9984861,2377,831950,10816811,8.33
9882896,9981104,4647,1626450,11607554,16.30
9882897,9992748,1845,645750,10638498,6.46
9882898,7463979,3496,1223600,8687579,16.39
9882899,9993044,6299,2204650,12197694,22.06
9882901,9966221,2407,842450,10808671,8.45
9882902,9969763,4987,1745450,11715213,17.51
9882903,9964295,3194,1117900,11082195,11.22
9882904,9944046,1835,642250,10586296,6.46
9882905,1331411,278,97300,1428711,7.31
9882906,9967998,6304,2206400,12174398,22.13
9882907,9983587,4408,1542800,11526387,15.45
9882908,9995491,4637,1622950,11618441,16.24
9882909,9978804,2349,822150,10800954,8.24
9882910,9976121,1261,441350,10417471,4.42
9882911,9941346,4105,1436750,11378096,14.45
9882912,9988997,4475,1566250,11555247,15.68
9882913,9990243,3864,1352400,11342643,13.54
9882914,9970593,6956,2434600,12405193,24.42
9882915,9970666,4852,1698200,11668866,17.03
9882916,9472336,3089,1081150,10553486,11.41
9882917,9715913,4268,1493800,11209713,15.37
9882918,9903235,2970,1039500,10942735,10.50
9882920,9984054,4818,1686300,11670354,16.89
9882921,9964729,4762,1666700,11631429,16.73
9882922,9978305,4011,1403850,11382155,14.07
9882923,9961351,5516,1930600,11891951,19.38
9882924,9976489,3064,1072400,11048889,10.75
9882925,9974295,4058,1420300,11394595,14.24
9882926,9993056,4052,1418200,11411256,14.19
9882927,9893884,5334,1866900,11760784,18.87
9882928,9994490,3511,1228850,11223340,12.30
9882929,9983713,3268,1143800,11127513,11.46
9882930,9983787,4008,1402800,11386587,14.05
9882931,9999024,5137,1797950,11796974,17.98
9882932,7994911,4332,1516200,9511111,18.96
9882933,9970718,4535,1587250,11557968,15.92
9882934,9965087,3977,1391950,11357037,13.97
9882935,9958124,4272,1495200,11453324,15.01
9882936,9964611,3756,1314600,11279211,13.19
9882937,9478950,3920,1372000,10850950,14.47
9882938,9815061,4309,1508150,11323211,15.37
9882939,9980357,4179,1462650,11443007,14.66
9882940,9970371,5574,1950900,11921271,19.57
9882941,9950979,6027,2109450,12060429,21.20
9882942,9977368,6103,2136050,12113418,21.41
9882943,9960603,6086,2130100,12090703,21.39
9882944,9978561,6576,2301600,12280161,23.07
9882945,9567658,6403,2241050,11808708,23.42
9882946,9972826,2969,1039150,11011976,10.42
9882947,9984407,4209,1473150,11457557,14.75
9882948,9993287,2317,810950,10804237,8.11
9882949,9482046,3485,1219750,10701796,12.86
9882950,9986525,5902,2065700,12052225,20.68
9882951,9971128,4697,1643950,11615078,16.49
9882952,9979699,2308,807800,10787499,8.09
9882953,9974151,5376,1881600,11855751,18.86
9882954,9951843,3174,1110900,11062743,11.16
9882955,9562568,6565,2297750,11860318,24.03
9882956,9975535,3480,1218000,11193535,12.21
9882957,9970467,3652,1278200,11248667,12.82
9882958,9905185,3547,1241450,11146635,12.53
9882959,9993180,5776,2021600,12014780,20.23
9882960,9979689,5687,1990450,11970139,19.95
9882961,7351229,4323,1513050,8864279,20.58
9882962,9997107,4667,1633450,11630557,16.34
9882963,9984216,2543,890050,10874266,8.91
9882964,9979108,2545,890750,10869858,8.93
9882965,9971104,3880,1358000,11329104,13.62
9882966,9728098,2821,987350,10715448,10.15
9882967,9953862,6214,2174900,12128762,21.85
9882968,9959489,3684,1289400,11248889,12.95
9882969,9944929,4226,1479100,11424029,14.87
9882970,9941679,5290,1851500,11793179,18.62
9882971,9950989,4201,1470350,11421339,14.78
9882972,9938646,5429,1900150,11838796,19.12
9882973,854197,655,229250,1083447,26.84
9882975,9935053,4409,1543150,11478203,15.53
9882976,9940637,3936,1377600,11318237,13.86
9882977,9951044,3766,1318100,11269144,13.25
9882978,9948252,4654,1628900,11577152,16.37
9882979,9845316,3278,1147300,10992616,11.65
9882980,9963289,3843,1345050,11308339,13.50
9882981,9955101,3407,1192450,11147551,11.98
9882982,9914026,4530,1585500,11499526,15.99
9882983,9929512,4007,1402450,11331962,14.12
9882984,9943279,2776,971600,10914879,9.77
9882985,9935783,4121,1442350,11378133,14.52
9882987,9911927,4179,1462650,11374577,14.76
9882988,9932978,4909,1718150,11651128,17.30
9882989,6371448,1109,388150,6759598,6.09
9882990,9953458,3638,1273300,11226758,12.79
9882991,9725364,3807,1332450,11057814,13.70
9882992,9970839,3540,1239000,11209839,12.43
9882993,9976828,3552,1243200,11220028,12.46
9882994,9960742,2670,934500,10895242,9.38
9882995,9798670,4885,1709750,11508420,17.45
9882996,9946757,2240,784000,10730757,7.88
9882997,9957710,5844,2045400,12003110,20.54
9882998,9936726,3415,1195250,11131976,12.03
9882999,9908892,6391,2236850,12145742,22.57
9883000,9941515,6448,2256800,12198315,22.70
9883001,9940477,5297,1853950,11794427,18.65
9883002,5394692,2967,1038450,6433142,19.25
9883003,9951382,4040,1414000,11365382,14.21
9883004,9888527,3670,1284500,11173027,12.99
9883005,9977677,6452,2258200,12235877,22.63
9883006,9952782,5667,1983450,11936232,19.93
9883007,6750124,3549,1242150,7992274,18.40
9883008,9898103,4381,1533350,11431453,15.49
9883009,9994218,4520,1582000,11576218,15.83
9883010,9987590,4387,1535450,11523040,15.37
9883011,9980074,4872,1705200,11685274,17.09
9883012,9990042,4715,1650250,11640292,16.52
9883013,9973020,5256,1839600,11812620,18.45
9883014,9963187,4221,1477350,11440537,14.83
9883015,9977306,4255,1489250,11466556,14.93
9883016,9963729,5596,1958600,11922329,19.66
9883017,9805529,4020,1407000,11212529,14.35
9883018,9957039,3151,1102850,11059889,11.08
9883019,9974824,4196,1468600,11443424,14.72
9883020,9989068,5128,1794800,11783868,17.97
9883021,9972396,4948,1731800,11704196,17.37
9883022,9991710,3798,1329300,11321010,13.30
9883023,9973262,4888,1710800,11684062,17.15
9883024,9981899,4532,1586200,11568099,15.89
9883025,9984922,3610,1263500,11248422,12.65
9883026,9978021,4159,1455650,11433671,14.59
9883027,9486019,5550,1942500,11428519,20.48
9883028,9977952,6330,2215500,12193452,22.20
9883029,9994684,5460,1911000,11905684,19.12
9883030,9788477,4497,1573950,11362427,16.08
9883031,9981622,3623,1268050,11249672,12.70
9883032,9983377,7105,2486750,12470127,24.91
9883033,9995630,5642,1974700,11970330,19.76
9883034,9971456,6639,2323650,12295106,23.30
9883035,9995046,4860,1701000,11696046,17.02
9883036,9965910,4986,1745100,11711010,17.51
9883037,9970333,4370,1529500,11499833,15.34
9883038,9885365,5661,1981350,11866715,20.04
9883039,9992401,4898,1714300,11706701,17.16
9883040,9980246,4475,1566250,11546496,15.69
9883041,9975497,6525,2283750,12259247,22.89
9883042,9990739,3672,1285200,11275939,12.86
9883043,9997122,4687,1640450,11637572,16.41
9883044,9998933,6327,2214450,12213383,22.15
9883045,9975694,3582,1253700,11229394,12.57
9883046,9982113,4666,1633100,11615213,16.36
9883047,9980609,4691,1641850,11622459,16.45
9883048,9985092,5075,1776250,11761342,17.79
9883049,9981392,3411,1193850,11175242,11.96
9883050,9982062,3712,1299200,11281262,13.02
9883051,9977784,7900,2765000,12742784,27.71
9883052,9968100,4158,1455300,11423400,14.60
9883053,9968365,3280,1148000,11116365,11.52
9883054,9974467,6688,2340800,12315267,23.47
9883055,8980457,5832,2041200,11021657,22.73
9883056,9987988,6196,2168600,12156588,21.71
9883057,9984314,3921,1372350,11356664,13.75
9883058,9990325,6275,2196250,12186575,21.98
9883059,8939049,4589,1606150,10545199,17.97
9883060,8986111,4216,1475600,10461711,16.42
9883061,9987158,5347,1871450,11858608,18.74
9883062,9975545,3897,1363950,11339495,13.67
9883063,9998973,4779,1672650,11671623,16.73
9883064,9977711,5930,2075500,12053211,20.80
9883065,5597935,3456,1209600,6807535,21.61
9883066,9984402,6106,2137100,12121502,21.40
9883067,9979769,4298,1504300,11484069,15.07
9883068,9454808,3351,1172850,10627658,12.40
9883069,9969846,4391,1536850,11506696,15.41
9883070,9966243,2213,774550,10740793,7.77
9883072,9971769,3853,1348550,11320319,13.52
9883073,9973930,4549,1592150,11566080,15.96
9883074,9984699,1342,469700,10454399,4.70
9883075,9987172,3393,1187550,11174722,11.89
9883076,9979411,4347,1521450,11500861,15.25
9883077,9983250,3707,1297450,11280700,13.00
9883079,9973242,3028,1059800,11033042,10.63
9883080,9976897,4251,1487850,11464747,14.91
9883081,9991887,4519,1581650,11573537,15.83
9883083,9812377,2932,1026200,10838577,10.46
9883084,9987796,4649,1627150,11614946,16.29
9883085,9983202,4226,1479100,11462302,14.82
9883086,9985970,2286,800100,10786070,8.01
9883087,9991866,5819,2036650,12028516,20.38
9883089,9980262,3166,1108100,11088362,11.10
9883090,9209190,2714,949900,10159090,10.31
9883091,9900343,4264,1492400,11392743,15.07
9883092,9951141,2963,1037050,10988191,10.42
9883093,9965171,3556,1244600,11209771,12.49
9883094,9960251,4497,1573950,11534201,15.80
9883095,9933415,3602,1260700,11194115,12.69
9883096,9945008,2717,950950,10895958,9.56
9883097,9965692,4452,1558200,11523892,15.64
9883098,9967302,3961,1386350,11353652,13.91
9883099,9967793,1600,560000,10527793,5.62
9883100,4954530,2447,856450,5810980,17.29
9883101,9968059,3835,1342250,11310309,13.47
9883102,9983411,3407,1192450,11175861,11.94
9883103,5796859,1408,492800,6289659,8.50
9883104,9991969,3485,1219750,11211719,12.21
9883106,9980519,3797,1328950,11309469,13.32
9883107,9975731,5693,1992550,11968281,19.97
9883108,9982889,4691,1641850,11624739,16.45
9883109,9971475,4594,1607900,11579375,16.12
9883110,9959597,3607,1262450,11222047,12.68
9883111,9966288,3326,1164100,11130388,11.68
9883112,9970346,5258,1840300,11810646,18.46
9883113,9973364,2374,830900,10804264,8.33
9883114,9977565,3576,1251600,11229165,12.54
9883115,9994680,3364,1177400,11172080,11.78
9883116,9969942,3196,1118600,11088542,11.22
9883117,9977533,4161,1456350,11433883,14.60
9883118,9979889,4062,1421700,11401589,14.25
9883119,9979636,3241,1134350,11113986,11.37
9883120,9424748,3274,1145900,10570648,12.16
9883121,9991441,3408,1192800,11184241,11.94
9883122,9999534,2575,901250,10900784,9.01
9883123,9997091,2152,753200,10750291,7.53
9883124,9981092,3180,1113000,11094092,11.15
9883126,9989569,2631,920850,10910419,9.22
9883127,9979634,3197,1118950,11098584,11.21
9883128,9947792,3969,1389150,11336942,13.96
9883129,9986433,3193,1117550,11103983,11.19
9883130,9980138,3907,1367450,11347588,13.70
9883131,9987592,3725,1303750,11291342,13.05
9883132,8804768,3090,1081500,9886268,12.28
9883133,9745579,4720,1652000,11397579,16.95
9883134,9764417,2333,816550,10580967,8.36
9883136,9975100,4174,1460900,11436000,14.65
9883137,9961902,3958,1385300,11347202,13.91
9883138,9979839,4621,1617350,11597189,16.21
9883139,9980077,3936,1377600,11357677,13.80
9883140,9979096,6150,2152500,12131596,21.57
9883141,9991869,3201,1120350,11112219,11.21
9883142,9985788,3016,1055600,11041388,10.57
9883143,9989597,3733,1306550,11296147,13.08
9883144,9979045,3618,1266300,11245345,12.69
9883145,9991775,4183,1464050,11455825,14.65
9883146,9981523,3478,1217300,11198823,12.20
9883147,9990222,3569,1249150,11239372,12.50
9883148,9991306,3787,1325450,11316756,13.27
9883149,9991687,2836,992600,10984287,9.93
9883150,9976666,4542,1589700,11566366,15.93
9883151,9994088,4017,1405950,11400038,14.07
9883152,9978924,3835,1342250,11321174,13.45
9883153,9978227,5014,1754900,11733127,17.59
9883154,9970592,4030,1410500,11381092,14.15
9883155,9963420,3513,1229550,11192970,12.34
9883156,9964234,4502,1575700,11539934,15.81
9883157,9966440,5210,1823500,11789940,18.30
9883158,9970718,3816,1335600,11306318,13.40
9883159,9986344,5063,1772050,11758394,17.74
9883160,9984585,6612,2314200,12298785,23.18
9883161,9980671,5561,1946350,11927021,19.50
9883162,9982397,8074,2825900,12808297,28.31
9883163,9994319,4269,1494150,11488469,14.95
9883164,9991301,3164,1107400,11098701,11.08
9883165,7963536,4263,1492050,9455586,18.74
9883166,8954843,4633,1621550,10576393,18.11
9883168,9966553,3160,1106000,11072553,11.10
9883169,9968081,5734,2006900,11974981,20.13
9883170,9973573,3744,1310400,11283973,13.14
9883171,9993727,3434,1201900,11195627,12.03
9883172,9995882,4917,1720950,11716832,17.22
9883174,9973884,4867,1703450,11677334,17.08
9883175,9981978,5922,2072700,12054678,20.76
9883176,9987797,5915,2070250,12058047,20.73
9883177,9998386,4147,1451450,11449836,14.52
9883178,9985799,2992,1047200,11032999,10.49
9883179,9970959,1924,673400,10644359,6.75
9883180,9991720,2025,708750,10700470,7.09
9883181,9911694,3828,1339800,11251494,13.52
9883182,9997495,4187,1465450,11462945,14.66
9883183,9995893,6275,2196250,12192143,21.97
9883184,9980618,2844,995400,10976018,9.97
9883185,9981654,4080,1428000,11409654,14.31
9883186,9991815,5036,1762600,11754415,17.64
9883187,9995608,3752,1313200,11308808,13.14
9883188,9982423,4516,1580600,11563023,15.83
9883189,9981548,4281,1498350,11479898,15.01
9883190,9986148,4334,1516900,11503048,15.19
9883191,9980769,3633,1271550,11252319,12.74
9883192,9975201,3796,1328600,11303801,13.32
9883193,9990030,2554,893900,10883930,8.95
9883194,9984118,3080,1078000,11062118,10.80
9883195,9994034,5897,2063950,12057984,20.65
9883196,9994819,2976,1041600,11036419,10.42
9883197,9969291,2139,748650,10717941,7.51
9883198,9743467,3096,1083600,10827067,11.12
9883199,9992948,2817,985950,10978898,9.87
9883200,9991104,4031,1410850,11401954,14.12
9883201,9990082,2776,971600,10961682,9.73
9883202,9980672,5081,1778350,11759022,17.82
9883203,9982473,3837,1342950,11325423,13.45
9883204,9988690,3916,1370600,11359290,13.72
9883205,9994120,3478,1217300,11211420,12.18
9883206,9995619,4073,1425550,11421169,14.26
9883207,9969902,3643,1275050,11244952,12.79
9883208,9990253,4805,1681750,11672003,16.83
9883209,9984078,2213,774550,10758628,7.76
9883210,9994705,1714,599900,10594605,6.00
9883211,9982207,4337,1517950,11500157,15.21
9883212,9972637,3993,1397550,11370187,14.01
9883214,9966227,4120,1442000,11408227,14.47
9883215,9961249,4173,1460550,11421799,14.66
9883216,9950398,5164,1807400,11757798,18.16
9883217,9922155,5223,1828050,11750205,18.42
9883218,9948930,2226,779100,10728030,7.83
9883219,9922223,4507,1577450,11499673,15.90
9883220,9935081,4145,1450750,11385831,14.60
9883221,9931345,2608,912800,10844145,9.19
9883222,9931991,3348,1171800,11103791,11.80
9883223,9936602,5717,2000950,11937552,20.14
9883224,9944755,3070,1074500,11019255,10.80
9883225,9932285,6166,2158100,12090385,21.73
9883226,9938904,2994,1047900,10986804,10.54
9883227,5885440,2311,808850,6694290,13.74
9883228,9960838,5063,1772050,11732888,17.79
9883229,9701227,3206,1122100,10823327,11.57
9883230,9959419,2033,711550,10670969,7.14
9883231,9469165,1369,479150,9948315,5.06
9883232,9946597,2497,873950,10820547,8.79
9883233,2157498,778,272300,2429798,12.62
9883234,9920039,3100,1085000,11005039,10.94
9883235,9932876,2667,933450,10866326,9.40
9883236,9947971,4108,1437800,11385771,14.45
9883237,9702008,4920,1722000,11424008,17.75
9883238,9961519,6259,2190650,12152169,21.99
9883239,9963477,4433,1551550,11515027,15.57
9883240,9963262,4511,1578850,11542112,15.85
9883242,9957920,4349,1522150,11480070,15.29
9883243,8462801,854,298900,8761701,3.53
9883244,9962182,3984,1394400,11356582,14.00
9883245,9970131,6738,2358300,12328431,23.65
9883246,9964466,1690,591500,10555966,5.94
9883247,9967954,4338,1518300,11486254,15.23
9883248,9980249,3989,1396150,11376399,13.99
9883249,9992424,3027,1059450,11051874,10.60
9883250,9976422,4317,1510950,11487372,15.15
9883251,9992214,5924,2073400,12065614,20.75
9883252,9974613,5282,1848700,11823313,18.53
9883253,9989522,4908,1717800,11707322,17.20
9883255,6360729,3433,1201550,7562279,18.89
9883256,9972916,4554,1593900,11566816,15.98
9883257,9994736,2004,701400,10696136,7.02
9883258,9976660,5600,1960000,11936660,19.65
9883259,9960993,2249,787150,10748143,7.90
9883260,9956812,2317,810950,10767762,8.14
9883261,9973827,1483,519050,10492877,5.20
9883262,9963217,4250,1487500,11450717,14.93
9883263,9979797,3019,1056650,11036447,10.59
9883264,9793728,2935,1027250,10820978,10.49
9883265,9966478,3268,1143800,11110278,11.48
9883266,9769905,5252,1838200,11608105,18.81
9883268,9932121,3714,1299900,11232021,13.09
9883269,9948268,3113,1089550,11037818,10.95
9883270,9962870,1932,676200,10639070,6.79
9883271,9643105,3400,1190000,10833105,12.34
9883272,9960730,3791,1326850,11287580,13.32
9883273,9971517,4606,1612100,11583617,16.17
9883274,9968150,4779,1672650,11640800,16.78
9883275,7958292,3551,1242850,9201142,15.62
9883276,9987745,6095,2133250,12120995,21.36
9883277,9981063,6197,2168950,12150013,21.73
9883278,9979593,5445,1905750,11885343,19.10
9883279,9965361,5993,2097550,12062911,21.05
9883280,9967241,3930,1375500,11342741,13.80
9883281,9942584,4116,1440600,11383184,14.49
9883282,9958128,4619,1616650,11574778,16.23
9883283,7136465,3410,1193500,8329965,16.72
9883284,9965023,4346,1521100,11486123,15.26
9883285,1209031,486,170100,1379131,14.07
9883286,9939589,2185,764750,10704339,7.69
9883287,9937849,2722,952700,10890549,9.59
9883289,9925437,4024,1408400,11333837,14.19
9883290,9948688,4440,1554000,11502688,15.62
9883291,9927636,1268,443800,10371436,4.47
9883292,9929669,4267,1493450,11423119,15.04
9883293,9938198,3572,1250200,11188398,12.58
9883294,9952382,2663,932050,10884432,9.37
9883295,9954884,1959,685650,10640534,6.89
9883296,9882697,3691,1291850,11174547,13.07
9883297,9947498,3886,1360100,11307598,13.67
9883298,9948280,3433,1201550,11149830,12.08
9883299,9941377,3037,1062950,11004327,10.69
9883300,9935626,4672,1635200,11570826,16.46
9883301,9931478,4413,1544550,11476028,15.55
9883302,9935225,7296,2553600,12488825,25.70
9883303,9935355,3948,1381800,11317155,13.91
9883305,9930991,5163,1807050,11738041,18.20
9883306,9924930,3256,1139600,11064530,11.48
9883307,9893866,6348,2221800,12115666,22.46
9883308,8938796,4442,1554700,10493496,17.39
9883309,7915256,3625,1268750,9184006,16.03
9883310,9938374,4672,1635200,11573574,16.45
9883311,2985724,2347,821450,3807174,27.51
9883312,9926141,6097,2133950,12060091,21.50
9883313,9913773,4104,1436400,11350173,14.49
9883314,9090466,2097,733950,9824416,8.07
9883315,9936795,1831,640850,10577645,6.45
9883317,9947941,2088,730800,10678741,7.35
9883318,9952505,4211,1473850,11426355,14.81
9883319,9954615,5077,1776950,11731565,17.85
9883320,9960172,3807,1332450,11292622,13.38
9883321,9960898,4638,1623300,11584198,16.30
9883322,9985788,4001,1400350,11386138,14.02
9883323,9974383,3162,1106700,11081083,11.10
9883324,9974835,4259,1490650,11465485,14.94
9883326,9954430,3877,1356950,11311380,13.63
9883327,9953140,3781,1323350,11276490,13.30
9883328,9957700,4562,1596700,11554400,16.03
9883329,9974192,3817,1335950,11310142,13.39
9883330,9977921,4354,1523900,11501821,15.27
9883331,9968591,3254,1138900,11107491,11.42
9883332,9971566,2747,961450,10933016,9.64
9883333,9979087,5814,2034900,12013987,20.39
9883334,9977943,4012,1404200,11382143,14.07
9883335,9960524,3722,1302700,11263224,13.08
9883336,9982306,2603,911050,10893356,9.13
9883337,9571882,2488,870800,10442682,9.10
9883338,9989528,2963,1037050,11026578,10.38
9883339,9798465,3743,1310050,11108515,13.37
9883340,9977771,1670,584500,10562271,5.86
9883341,9977902,3238,1133300,11111202,11.36
9883342,9990896,4593,1607550,11598446,16.09
9883343,9988342,4439,1553650,11541992,15.55
9883344,9960508,2635,922250,10882758,9.26
9883345,9980096,4816,1685600,11665696,16.89
9883346,9986829,3972,1390200,11377029,13.92
9883347,7451346,4097,1433950,8885296,19.24
9883348,9996688,5892,2062200,12058888,20.63
9883349,9970555,3746,1311100,11281655,13.15
9883350,9967990,3611,1263850,11231840,12.68
9883351,9964441,5888,2060800,12025241,20.68
9883352,9237783,5421,1897350,11135133,20.54
9883353,9952312,5226,1829100,11781412,18.38
9883354,9966106,3399,1189650,11155756,11.94
9883355,9960560,5791,2026850,11987410,20.35
9883356,9911416,3688,1290800,11202216,13.02
9883357,9956769,3806,1332100,11288869,13.38
9883358,9948694,2805,981750,10930444,9.87
9883359,9209119,4049,1417150,10626269,15.39
9883360,9688377,4055,1419250,11107627,14.65
9883362,9444172,3789,1326150,10770322,14.04
9883363,9946215,3037,1062950,11009165,10.69
9883364,9946604,3405,1191750,11138354,11.98
9883365,9951567,3899,1364650,11316217,13.71
9883366,9888491,6427,2249450,12137941,22.75
9883367,9945660,3269,1144150,11089810,11.50
9883368,9966323,4263,1492050,11458373,14.97
9883369,9983657,3529,1235150,11218807,12.37
9883370,9979638,5395,1888250,11867888,18.92
9883371,9990932,5143,1800050,11790982,18.02
9883372,9903408,3613,1264550,11167958,12.77
9883373,9996056,2780,973000,10969056,9.73
9883374,9976821,1496,523600,10500421,5.25
9883375,9975835,4924,1723400,11699235,17.28
9883376,9988150,3288,1150800,11138950,11.52
9883377,9986393,3694,1292900,11279293,12.95
9883378,9984185,5148,1801800,11785985,18.05
9883379,9996908,6031,2110850,12107758,21.12
9883380,9982086,6625,2318750,12300836,23.23
9883381,9972244,6284,2199400,12171644,22.06
9883382,9992146,3869,1354150,11346296,13.55
9883383,9977084,1928,674800,10651884,6.76
9883384,9982587,5386,1885100,11867687,18.88
9883385,9985504,4242,1484700,11470204,14.87
9883386,9992613,2939,1028650,11021263,10.29
9883387,9992935,4027,1409450,11402385,14.10
9883388,9982391,4313,1509550,11491941,15.12
9883389,9745494,3871,1354850,11100344,13.90
9883390,9984534,5024,1758400,11742934,17.61
9883391,9997876,5453,1908550,11906426,19.09
9883392,9984771,3327,1164450,11149221,11.66
9883393,9969857,3752,1313200,11283057,13.17
9883394,9984260,3921,1372350,11356610,13.75
9883395,9981818,5086,1780100,11761918,17.83
9883396,9975522,3934,1376900,11352422,13.80
9883397,9966904,4956,1734600,11701504,17.40
9883398,9952491,4099,1434650,11387141,14.41
9883399,9970557,4534,1586900,11557457,15.92
9883400,9979277,4592,1607200,11586477,16.11
9883401,9978745,5019,1756650,11735395,17.60
9883402,9991937,2049,717150,10709087,7.18
9883403,9932961,3244,1135400,11068361,11.43
9883404,9979946,3621,1267350,11247296,12.70
9883405,7980994,4072,1425200,9406194,17.86
9883406,9986562,4709,1648150,11634712,16.50
9883407,9999520,3715,1300250,11299770,13.00
9883408,9987928,3905,1366750,11354678,13.68
9883409,9988898,3653,1278550,11267448,12.80
9883410,9949376,4539,1588650,11538026,15.97
9883411,9993819,3913,1369550,11363369,13.70
9883412,9997525,4819,1686650,11684175,16.87
9883413,9973529,3432,1201200,11174729,12.04
9883414,9990062,3712,1299200,11289262,13.00
9883415,9986515,3343,1170050,11156565,11.72
9883416,9690319,4477,1566950,11257269,16.17
9883417,9712753,2418,846300,10559053,8.71
9883418,9989820,4581,1603350,11593170,16.05
9883419,9976113,3837,1342950,11319063,13.46
9883420,9968050,3742,1309700,11277750,13.14
9883421,9990848,3506,1227100,11217948,12.28
9883422,9967213,3394,1187900,11155113,11.92
9883423,9971735,6521,2282350,12254085,22.89
9883424,9962358,4624,1618400,11580758,16.25
9883425,9973940,2564,897400,10871340,9.00
9883426,9737300,4933,1726550,11463850,17.73
9883427,9996256,4965,1737750,11734006,17.38
9883428,9989107,4888,1710800,11699907,17.13
9883429,9990574,4203,1471050,11461624,14.72
9883430,9988048,4995,1748250,11736298,17.50
9883431,9978798,3821,1337350,11316148,13.40
9883432,9981837,4944,1730400,11712237,17.34
9883433,7559499,4831,1690850,9250349,22.37
9883434,9986850,6574,2300900,12287750,23.04
9883435,9984655,4400,1540000,11524655,15.42
9883436,9980715,6000,2100000,12080715,21.04
9883437,9989861,4616,1615600,11605461,16.17
9883438,9994567,4867,1703450,11698017,17.04
9883439,9974494,3353,1173550,11148044,11.77
9883440,9976122,4189,1466150,11442272,14.70
9883441,3382367,2948,1031800,4414167,30.51
9883442,9961280,6164,2157400,12118680,21.66
9883443,9896939,4757,1664950,11561889,16.82
9883444,9958584,3741,1309350,11267934,13.15
9883445,9979264,2484,869400,10848664,8.71
9883446,9978572,4303,1506050,11484622,15.09
9883447,9976792,1122,392700,10369492,3.94
9883448,9988559,6277,2196950,12185509,21.99
9883449,9973320,6530,2285500,12258820,22.92
9883450,8976440,6000,2100000,11076440,23.39
9883451,7964933,3437,1202950,9167883,15.10
9883452,9970709,3517,1230950,11201659,12.35
9883453,9970080,4855,1699250,11669330,17.04
9883454,9964092,4735,1657250,11621342,16.63
9883455,9968960,4338,1518300,11487260,15.23
9883456,9978177,4777,1671950,11650127,16.76
9883457,9992645,4468,1563800,11556445,15.65
9883458,9971653,6227,2179450,12151103,21.86
9883459,9968691,7005,2451750,12420441,24.59
9883460,9968204,5362,1876700,11844904,18.83
9883461,9974744,6500,2275000,12249744,22.81
9883462,9968564,4569,1599150,11567714,16.04
9883463,9975379,3858,1350300,11325679,13.54
9883464,9976707,5869,2054150,12030857,20.59
9883466,9994655,3412,1194200,11188855,11.95
9883467,9976641,3771,1319850,11296491,13.23
9883468,9991345,3249,1137150,11128495,11.38
9883469,9974800,2649,927150,10901950,9.29
9883470,9980953,4641,1624350,11605303,16.27
9883471,9984447,2106,737100,10721547,7.38
9883472,9968842,5992,2097200,12066042,21.04
9883473,9904187,2764,967400,10871587,9.77
9883474,9974725,3708,1297800,11272525,13.01
9883475,9978990,4096,1433600,11412590,14.37
9883476,9988984,3906,1367100,11356084,13.69
9883478,9976621,3058,1070300,11046921,10.73
9883479,9992518,2047,716450,10708968,7.17
9883481,7500066,1024,358400,7858466,4.78
9883482,9977592,3571,1249850,11227442,12.53
9883483,9972015,3764,1317400,11289415,13.21
9883484,9981223,2982,1043700,11024923,10.46
9883485,9977494,4687,1640450,11617944,16.44
9883486,9972177,1792,627200,10599377,6.29
9883487,9200669,2174,760900,9961569,8.27
9883488,9955800,2445,855750,10811550,8.60
9883489,9982918,2681,938350,10921268,9.40
9883490,9984430,3754,1313900,11298330,13.16
9883491,9971517,5000,1750000,11721517,17.55
9883492,9979843,4311,1508850,11488693,15.12
9883493,9980934,6630,2320500,12301434,23.25
9883494,9676432,2836,992600,10669032,10.26
9883495,7871604,4380,1533000,9404604,19.48
9883496,9984336,2408,842800,10827136,8.44
9883497,9974728,4217,1475950,11450678,14.80
9883499,9992174,3277,1146950,11139124,11.48
9883500,9980448,3242,1134700,11115148,11.37
9883501,9973770,3382,1183700,11157470,11.87
9883502,9961237,2004,701400,10662637,7.04
9883503,9959397,4797,1678950,11638347,16.86
9883504,5966459,3041,1064350,7030809,17.84
9883505,9945897,2986,1045100,10990997,10.51
9883506,9951081,4417,1545950,11497031,15.54
9883507,8938227,4521,1582350,10520577,17.70
9883508,9904459,4888,1710800,11615259,17.27
9883509,9982027,3590,1256500,11238527,12.59
9883510,9981099,4478,1567300,11548399,15.70
9883511,9987459,1166,408100,10395559,4.09
9883512,9615270,3282,1148700,10763970,11.95
9883513,9974138,4566,1598100,11572238,16.02
9883514,9948752,2191,766850,10715602,7.71
9883515,4132393,2943,1030050,5162443,24.93
9883516,9978204,3208,1122800,11101004,11.25
9883517,9973158,4112,1439200,11412358,14.43
9883518,9972347,3914,1369900,11342247,13.74
9883519,9990837,7021,2457350,12448187,24.60
9883520,9996181,6766,2368100,12364281,23.69
9883521,9976711,6583,2304050,12280761,23.09
9883522,9984244,3005,1051750,11035994,10.53
9883523,9985173,2458,860300,10845473,8.62
9883524,9984215,4832,1691200,11675415,16.94
9883525,9977553,3249,1137150,11114703,11.40
9883526,9992574,4872,1705200,11697774,17.06
9883527,9956324,1649,577150,10533474,5.80
9883529,9962611,3951,1382850,11345461,13.88
9883530,9971411,3934,1376900,11348311,13.81
9883531,9998716,2289,801150,10799866,8.01
9883532,9987276,4561,1596350,11583626,15.98
9883533,9978653,5213,1824550,11803203,18.28
9883534,9992382,4727,1654450,11646832,16.56
9883535,9991478,3043,1065050,11056528,10.66
9883536,9994869,3333,1166550,11161419,11.67
9883537,9971014,5099,1784650,11755664,17.90
9883538,9997214,3079,1077650,11074864,10.78
9883539,9994856,3523,1233050,11227906,12.34
9883540,1280355,733,256550,1536905,20.04
9883541,9971249,2842,994700,10965949,9.98
9883542,9970100,3491,1221850,11191950,12.26
9883543,9974157,3104,1086400,11060557,10.89
9883544,9994335,4251,1487850,11482185,14.89
9883545,9986708,2362,826700,10813408,8.28
9883546,9959555,4176,1461600,11421155,14.68
9883547,9976231,3685,1289750,11265981,12.93
9883548,9980771,2139,748650,10729421,7.50
9883549,9986080,4046,1416100,11402180,14.18
9883550,9883801,3268,1143800,11027601,11.57
9883551,9997550,3449,1207150,11204700,12.07
9883552,9994043,3668,1283800,11277843,12.85
9883553,9998920,2943,1030050,11028970,10.30
9883554,9987155,3252,1138200,11125355,11.40
9883555,9978862,4017,1405950,11384812,14.09
9883556,9990320,5378,1882300,11872620,18.84
9883557,9984975,3393,1187550,11172525,11.89
9883558,9993318,4301,1505350,11498668,15.06
9883559,9993091,5547,1941450,11934541,19.43
9883560,9987008,3709,1298150,11285158,13.00
9883561,9980955,2976,1041600,11022555,10.44
9883562,9796128,2158,755300,10551428,7.71
9883563,9979998,2689,941150,10921148,9.43
9883564,9991720,2929,1025150,11016870,10.26
9883565,9943677,4468,1563800,11507477,15.73
9883566,9388465,2405,841750,10230215,8.97
9883567,9993687,3133,1096550,11090237,10.97
9883568,9977151,1832,641200,10618351,6.43
9883569,9972422,4460,1561000,11533422,15.65
9883570,9968403,3873,1355550,11323953,13.60
9883571,9982531,4664,1632400,11614931,16.35
9883572,9971551,3327,1164450,11136001,11.68
9883573,9971003,4560,1596000,11567003,16.01
9883574,9949376,4933,1726550,11675926,17.35
9883575,9971797,2548,891800,10863597,8.94
9883576,9985167,4371,1529850,11515017,15.32
9883577,9973146,5437,1902950,11876096,19.08
9883578,9985159,2516,880600,10865759,8.82
9883579,9986544,3472,1215200,11201744,12.17
9883580,9994421,5121,1792350,11786771,17.93
9883582,9997566,2764,967400,10964966,9.68
9883583,9996243,4301,1505350,11501593,15.06
9883584,9995544,2182,763700,10759244,7.64
9883585,9988617,2028,709800,10698417,7.11
9883586,9987670,4767,1668450,11656120,16.71
9883587,9987115,5213,1824550,11811665,18.27
9883588,9163221,3894,1362900,10526121,14.87
9883589,9970325,4346,1521100,11491425,15.26
9883590,9972067,2026,709100,10681167,7.11
9883591,9605770,2616,915600,10521370,9.53
9883592,8864634,1455,509250,9373884,5.74
9883593,9607315,2936,1027600,10634915,10.70
9883594,8266065,1513,529550,8795615,6.41
9883595,9721910,4506,1577100,11299010,16.22
9883596,9576985,5821,2037350,11614335,21.27
9883597,9974480,5434,1901900,11876380,19.07
9883598,9981186,3792,1327200,11308386,13.30
9883599,9942865,4655,1629250,11572115,16.39
9883600,9993591,5427,1899450,11893041,19.01
9883601,9981946,5473,1915550,11897496,19.19
9883602,5060857,3548,1241800,6302657,24.54
9883603,9985914,3757,1314950,11300864,13.17
9883604,9990288,4880,1708000,11698288,17.10
9883605,9982627,5012,1754200,11736827,17.57
9883606,9976558,6525,2283750,12260308,22.89
9883607,4805248,2054,718900,5524148,14.96
9883608,9954168,4606,1612100,11566268,16.20
9883609,701619,1050,367500,1069119,52.38
9883610,9622766,6198,2169300,11792066,22.54
9883611,9949667,3240,1134000,11083667,11.40
9883612,9654424,2855,999250,10653674,10.35
9883613,9608441,1282,448700,10057141,4.67
9883614,9846559,2976,1041600,10888159,10.58
9883615,9673805,3202,1120700,10794505,11.58
9883616,9979538,6924,2423400,12402938,24.28
9883617,9990430,5163,1807050,11797480,18.09
9883618,9969171,5132,1796200,11765371,18.02
9883619,9980709,3917,1370950,11351659,13.74
9883620,9972591,4298,1504300,11476891,15.08
9883621,9988692,5546,1941100,11929792,19.43
9883622,9980670,4225,1478750,11459420,14.82
9883623,9985290,6078,2127300,12112590,21.30
9883624,9961579,4150,1452500,11414079,14.58
9883625,9970449,3676,1286600,11257049,12.90
9883626,9951955,6395,2238250,12190205,22.49
9883627,9980835,5415,1895250,11876085,18.99
9883628,9492374,7598,2659300,12151674,28.02
9883629,9971227,5158,1805300,11776527,18.11
9883630,9989103,5722,2002700,11991803,20.05
9883631,9914429,3360,1176000,11090429,11.86
9883632,9971065,5353,1873550,11844615,18.79
9883633,9967383,4835,1692250,11659633,16.98
9883634,9978950,6348,2221800,12200750,22.26
9883636,9965664,2936,1027600,10993264,10.31
9883637,9902065,4111,1438850,11340915,14.53
9883638,9971828,3692,1292200,11264028,12.96
9883639,9982319,7585,2654750,12637069,26.59
9883640,9975990,4037,1412950,11388940,14.16
9883641,9989231,3991,1396850,11386081,13.98
9883642,9977891,4467,1563450,11541341,15.67
9883645,9971975,3375,1181250,11153225,11.85
9883646,9972099,3166,1108100,11080199,11.11
9883647,9976466,3595,1258250,11234716,12.61
9883648,9975913,6327,2214450,12190363,22.20
9883649,9993701,3447,1206450,11200151,12.07
9883650,9982506,4582,1603700,11586206,16.07
9883651,9981278,4531,1585850,11567128,15.89
9883652,9981164,3717,1300950,11282114,13.03
9883653,9976131,4242,1484700,11460831,14.88
9883654,9978496,5282,1848700,11827196,18.53
9883655,9976287,4268,1493800,11470087,14.97
9883656,9955758,4371,1529850,11485608,15.37
9883657,9970127,4192,1467200,11437327,14.72
9883658,9977043,2761,966350,10943393,9.69
9883659,9903766,3029,1060150,10963916,10.70
9883660,9820194,3368,1178800,10998994,12.00
9883661,9996129,3849,1347150,11343279,13.48
9883662,9974712,7741,2709350,12684062,27.16
9883663,9982898,3835,1342250,11325148,13.45
9883664,9974193,3351,1172850,11147043,11.76
9883665,9981636,2405,841750,10823386,8.43
9883666,9995942,4814,1684900,11680842,16.86
9883667,9990547,4858,1700300,11690847,17.02
9883668,9242793,2295,803250,10046043,8.69
9883669,9999542,2557,894950,10894492,8.95
9883670,9986041,4424,1548400,11534441,15.51
9883671,9986551,2847,996450,10983001,9.98
9883672,9835193,6668,2333800,12168993,23.73
9883673,9282645,4153,1453550,10736195,15.66
9883674,9992537,5301,1855350,11847887,18.57
9883675,9993975,4596,1608600,11602575,16.10
9883677,9989788,3365,1177750,11167538,11.79
9883678,9960801,5970,2089500,12050301,20.98
9883679,9954763,5561,1946350,11901113,19.55
9883680,9949766,2853,998550,10948316,10.04
9883681,9950558,3563,1247050,11197608,12.53
9883682,9929971,4290,1501500,11431471,15.12
9883683,9944710,5131,1795850,11740560,18.06
9883684,9950611,6103,2136050,12086661,21.47
9883685,9946169,4500,1575000,11521169,15.84
9883686,9628286,3586,1255100,10883386,13.04
9883687,8869772,4118,1441300,10311072,16.25
9883688,9919134,5676,1986600,11905734,20.03
9883689,9914996,3795,1328250,11243246,13.40
9883690,7881846,2433,851550,8733396,10.80
9883691,8926331,3879,1357650,10283981,15.21
9883692,9921703,3477,1216950,11138653,12.27
9883693,9913392,3967,1388450,11301842,14.01
9883694,9915040,5068,1773800,11688840,17.89
9883695,9891525,5523,1933050,11824575,19.54
9883696,9898146,3537,1237950,11136096,12.51
9883697,8894964,3054,1068900,9963864,12.02
9883698,9906865,3773,1320550,11227415,13.33
9883699,9919685,4928,1724800,11644485,17.39
9883700,9817254,6662,2331700,12148954,23.75
9883702,9906479,5463,1912050,11818529,19.30
9883703,9916547,4083,1429050,11345597,14.41
9883704,9164004,4209,1473150,10637154,16.08
9883705,9895342,1684,589400,10484742,5.96
9883706,9910944,2538,888300,10799244,8.96
9883707,9927608,2756,964600,10892208,9.72
9883708,9932918,5392,1887200,11820118,19.00
9883709,9958187,4774,1670900,11629087,16.78
9883710,9967751,3858,1350300,11318051,13.55
9883711,9959368,6660,2331000,12290368,23.41
9883712,9959703,3019,1056650,11016353,10.61
9883713,9983217,1893,662550,10645767,6.64
9883714,4158170,1672,585200,4743370,14.07
9883715,9956388,4777,1671950,11628338,16.79
9883716,9963605,4693,1642550,11606155,16.49
9883717,9870564,3324,1163400,11033964,11.79
9883718,9962153,2481,868350,10830503,8.72
9883719,9966529,3012,1054200,11020729,10.58
9883720,9975360,5631,1970850,11946210,19.76
9883721,339885,152,53200,393085,15.65
9883722,9978136,3210,1123500,11101636,11.26
9883723,9954441,2908,1017800,10972241,10.22
9883724,167350,71,24850,192200,14.85
9883725,9937143,3780,1323000,11260143,13.31
9883726,9945151,2129,745150,10690301,7.49
9883728,9939012,5835,2042250,11981262,20.55
9883729,9946498,3468,1213800,11160298,12.20
9883730,9955449,2770,969500,10924949,9.74
9883731,9975712,4658,1630300,11606012,16.34
9883732,9974780,4900,1715000,11689780,17.19
9883733,8887281,2955,1034250,9921531,11.64
9883734,9999045,5420,1897000,11896045,18.97
9883735,9986817,6749,2362150,12348967,23.65
9883736,9954263,5159,1805650,11759913,18.14
9883737,9999297,4562,1596700,11595997,15.97
9883738,9970133,4829,1690150,11660283,16.95
9883739,9986255,5902,2065700,12051955,20.69
9883740,9992675,5164,1807400,11800075,18.09
9883742,7977311,2764,967400,8944711,12.13
9883744,9971611,6346,2221100,12192711,22.27
9883745,9983954,4629,1620150,11604104,16.23
9883746,9743431,4749,1662150,11405581,17.06
9883747,9981789,3939,1378650,11360439,13.81
9883748,9975274,3728,1304800,11280074,13.08
9883749,9972109,6294,2202900,12175009,22.09
9883750,9969652,3683,1289050,11258702,12.93
9883751,9945394,4997,1748950,11694344,17.59
9883752,9977483,5390,1886500,11863983,18.91
9883753,9981345,3436,1202600,11183945,12.05
9883754,9980094,4626,1619100,11599194,16.22
9883755,9979867,4034,1411900,11391767,14.15
9883756,9974910,5197,1818950,11793860,18.24
9883757,9990376,4603,1611050,11601426,16.13
9883758,9955524,4383,1534050,11489574,15.41
9883759,9996194,3764,1317400,11313594,13.18
9883760,9589951,3499,1224650,10814601,12.77
9883761,9979418,2495,873250,10852668,8.75
9883762,9962427,1639,573650,10536077,5.76
9883763,9990238,4173,1460550,11450788,14.62
9883764,9992610,5791,2026850,12019460,20.28
9883765,9977204,4894,1712900,11690104,17.17
9883766,9994776,6141,2149350,12144126,21.50
9883767,9993230,3919,1371650,11364880,13.73
9883768,9984300,5863,2052050,12036350,20.55
9883769,9983084,4957,1734950,11718034,17.38
9883770,9980116,4034,1411900,11392016,14.15
9883771,9998359,4300,1505000,11503359,15.05
9883772,9983761,4900,1715000,11698761,17.18
9883773,9964234,5348,1871800,11836034,18.79
9883774,9953642,2558,895300,10848942,8.99
9883775,9974151,3461,1211350,11185501,12.14
9883776,9979438,4132,1446200,11425638,14.49
9883777,9985755,5253,1838550,11824305,18.41
9883778,2860678,1352,473200,3333878,16.54
9883779,9967017,4192,1467200,11434217,14.72
9883780,9955893,3612,1264200,11220093,12.70
9883781,9958610,3332,1166200,11124810,11.71
9883783,9948912,4426,1549100,11498012,15.57
9883784,9621232,4194,1467900,11089132,15.26
9883785,9920876,5514,1929900,11850776,19.45
9883786,9506856,3392,1187200,10694056,12.49
9883787,9934395,3759,1315650,11250045,13.24
9883788,9937285,5459,1910650,11847935,19.23
9883789,9940190,2771,969850,10910040,9.76
9883790,9955230,5617,1965950,11921180,19.75
9883791,3732867,1235,432250,4165117,11.58
9883792,9967319,3577,1251950,11219269,12.56
9883794,9891955,3654,1278900,11170855,12.93
9883795,9972258,2686,940100,10912358,9.43
9883796,9981612,6673,2335550,12317162,23.40
9883797,8384136,1974,690900,9075036,8.24
9883798,9976911,5627,1969450,11946361,19.74
9883800,8984227,3153,1103550,10087777,12.28
9883801,9954868,5190,1816500,11771368,18.25
9883802,9984024,3490,1221500,11205524,12.23
9883803,9983424,3329,1165150,11148574,11.67
9883804,8991912,4031,1410850,10402762,15.69
9883805,9990037,6273,2195550,12185587,21.98
9883806,9992753,4372,1530200,11522953,15.31
9883807,9986361,1870,654500,10640861,6.55
9883809,9954191,4301,1505350,11459541,15.12
9883810,9967700,4257,1489950,11457650,14.95
9883811,9986864,5014,1754900,11741764,17.57
9883812,9998275,3867,1353450,11351725,13.54
9883813,9989049,3871,1354850,11343899,13.56
9883814,9823422,1544,540400,10363822,5.50
9883815,9968568,4666,1633100,11601668,16.38
9883816,9962460,3076,1076600,11039060,10.81
9883817,9622225,3481,1218350,10840575,12.66
9883818,9982622,6592,2307200,12289822,23.11
9883819,9966057,5312,1859200,11825257,18.66
9883820,2743751,837,292950,3036701,10.68
9883822,4712046,1295,453250,5165296,9.62
9883823,9967393,4596,1608600,11575993,16.14
9883824,9949831,6259,2190650,12140481,22.02
9883825,9943359,6148,2151800,12095159,21.64
9883826,9945782,5217,1825950,11771732,18.36
9883827,9957407,3658,1280300,11237707,12.86
9883828,8126766,7257,2539950,10666716,31.25
9883829,9969534,7060,2471000,12440534,24.79
9883831,9953928,6970,2439500,12393428,24.51
9883832,9965457,5410,1893500,11858957,19.00
9883834,9975306,4379,1532650,11507956,15.36
9883835,9987030,5058,1770300,11757330,17.73
9883838,9957789,4228,1479800,11437589,14.86
9883840,9954056,3319,1161650,11115706,11.67
9883841,9192611,5823,2038050,11230661,22.17
9883842,9970335,4290,1501500,11471835,15.06
9883843,9966915,3817,1335950,11302865,13.40
9883844,9972290,5953,2083550,12055840,20.89
9883845,9969523,4001,1400350,11369873,14.05
9883846,9952044,2926,1024100,10976144,10.29
9883847,9475182,3278,1147300,10622482,12.11
9883848,2123082,1325,463750,2586832,21.84
9883849,9978082,3121,1092350,11070432,10.95
9883850,8978928,5598,1959300,10938228,21.82
9883851,9989731,4217,1475950,11465681,14.77
9883852,9280206,2835,992250,10272456,10.69
9883853,9331161,2918,1021300,10352461,10.95
9883854,9987974,4473,1565550,11553524,15.67
9883855,9983068,4707,1647450,11630518,16.50
9883856,9964832,5439,1903650,11868482,19.10
9883857,9976802,5489,1921150,11897952,19.26
9883858,9966423,4577,1601950,11568373,16.07
9883859,9807870,5798,2029300,11837170,20.69
9883860,9976287,4536,1587600,11563887,15.91
9883862,9972071,5465,1912750,11884821,19.18
9883863,9972657,4134,1446900,11419557,14.51
9883864,9977879,3861,1351350,11329229,13.54
9883865,9990314,4186,1465100,11455414,14.67
9883866,9889436,4590,1606500,11495936,16.24
9883867,9977264,5247,1836450,11813714,18.41
9883868,9970004,4931,1725850,11695854,17.31
9883869,9983173,3787,1325450,11308623,13.28
9883870,9992111,5394,1887900,11880011,18.89
9883871,3363267,2471,864850,4228117,25.71
9883872,9965897,5157,1804950,11770847,18.11
9883873,9578447,3392,1187200,10765647,12.39
9883874,9978679,6611,2313850,12292529,23.19
9883875,9471631,5731,2005850,11477481,21.18
9883876,9989818,3551,1242850,11232668,12.44
9883877,9643427,5598,1959300,11602727,20.32
9883878,9645769,1969,689150,10334919,7.14
9883879,858941,930,325500,1184441,37.90
9883880,9984017,4400,1540000,11524017,15.42
9883881,9982699,6601,2310350,12293049,23.14
9883882,8990267,4146,1451100,10441367,16.14
9883883,9988659,4398,1539300,11527959,15.41
9883884,9981774,6018,2106300,12088074,21.10
9883885,9991034,3773,1320550,11311584,13.22
9883886,9984265,4739,1658650,11642915,16.61
9883887,9983325,4703,1646050,11629375,16.49
9883888,9967187,4447,1556450,11523637,15.62
9883889,8987971,5100,1785000,10772971,19.86
9883890,9486556,3755,1314250,10800806,13.85
9883891,9809643,4140,1449000,11258643,14.77
9883893,9979853,3428,1199800,11179653,12.02
9883894,9321014,7012,2454200,11775214,26.33
9883895,9969273,4951,1732850,11702123,17.38
9883896,9915561,3582,1253700,11169261,12.64
9883897,9989208,5796,2028600,12017808,20.31
9883898,9991589,5125,1793750,11785339,17.95
9883899,9987919,3694,1292900,11280819,12.94
9883900,9964989,5154,1803900,11768889,18.10
9883901,9960789,7473,2615550,12576339,26.26
9883902,9980249,4336,1517600,11497849,15.21
9883903,9960063,2680,938000,10898063,9.42
9883905,9958645,4222,1477700,11436345,14.84
9883906,9950450,5622,1967700,11918150,19.77
9883907,9967733,4509,1578150,11545883,15.83
9883908,9974689,5005,1751750,11726439,17.56
9883909,9986194,4447,1556450,11542644,15.59
9883910,9971001,3515,1230250,11201251,12.34
9883911,9738497,4018,1406300,11144797,14.44
9883912,9997882,4222,1477700,11475582,14.78
9883913,9722718,5617,1965950,11688668,20.22
9883914,9960913,5458,1910300,11871213,19.18
9883915,9964282,3701,1295350,11259632,13.00
9883916,9980821,4097,1433950,11414771,14.37
9883917,9981925,5449,1907150,11889075,19.11
9883918,9977835,6273,2195550,12173385,22.00
9883919,9996277,5216,1825600,11821877,18.26
9883920,9998477,3628,1269800,11268277,12.70
9883921,9981333,4801,1680350,11661683,16.83
9883922,7820386,5255,1839250,9659636,23.52
9883923,9986617,2536,887600,10874217,8.89
9883924,9962918,3431,1200850,11163768,12.05
9883925,9973096,4485,1569750,11542846,15.74
9883926,9975005,2416,845600,10820605,8.48
9883927,9993756,4894,1712900,11706656,17.14
9883928,9981825,6582,2303700,12285525,23.08
9883929,9978551,3397,1188950,11167501,11.92
9883930,9950796,3803,1331050,11281846,13.38
9883931,9959220,4281,1498350,11457570,15.04
9883932,9974717,4737,1657950,11632667,16.62
9883933,9986765,3936,1377600,11364365,13.79
9883934,9978077,5525,1933750,11911827,19.38
9883935,9995920,5401,1890350,11886270,18.91
9883936,9977866,4495,1573250,11551116,15.77
9883937,9706432,4247,1486450,11192882,15.31
9883938,8759053,3315,1160250,9919303,13.25
9883939,9971466,3618,1266300,11237766,12.70
9883940,9905233,2784,974400,10879633,9.84
9883941,8972309,4867,1703450,10675759,18.99
9883942,9977358,6348,2221800,12199158,22.27
9883943,9980011,3798,1329300,11309311,13.32
9883944,9977689,4752,1663200,11640889,16.67
9883945,9994994,4139,1448650,11443644,14.49
9883946,9833827,3960,1386000,11219827,14.09
9883947,9966001,2876,1006600,10972601,10.10
9883948,9955149,4082,1428700,11383849,14.35
9883950,9958310,3561,1246350,11204660,12.52
9883951,9945741,3831,1340850,11286591,13.48
9883952,9954616,2886,1010100,10964716,10.15
9883954,9950500,4316,1510600,11461100,15.18
9883956,8953304,5222,1827700,10781004,20.41
9883957,9935332,4865,1702750,11638082,17.14
9883958,9941517,4750,1662500,11604017,16.72
9883959,9939840,4320,1512000,11451840,15.21
9883960,9931570,4671,1634850,11566420,16.46
9883961,9949801,6704,2346400,12296201,23.58
9883962,9951254,3039,1063650,11014904,10.69
9883963,9955753,2740,959000,10914753,9.63
9883964,9963455,2493,872550,10836005,8.76
9883965,9974534,4767,1668450,11642984,16.73
9883966,9967405,9180,3213000,13180405,32.24
9883967,9957520,3402,1190700,11148220,11.96
9883968,9975027,4067,1423450,11398477,14.27
9883969,9900619,4871,1704850,11605469,17.22
9883971,9971828,5787,2025450,11997278,20.31
9883972,9994881,2652,928200,10923081,9.29
9883973,9976547,2814,984900,10961447,9.87
9883974,9973267,3853,1348550,11321817,13.52
9883975,9961449,3485,1219750,11181199,12.24
9883976,9981376,5468,1913800,11895176,19.17
9883977,9994674,3319,1161650,11156324,11.62
9883978,9979885,5786,2025100,12004985,20.29
9883979,9979672,4081,1428350,11408022,14.31
9883980,9977368,3757,1314950,11292318,13.18
9883981,8361914,2733,956550,9318464,11.44
9883982,9640986,5113,1789550,11430536,18.56
9883983,9628039,5502,1925700,11553739,20.00
9883984,9995316,5137,1797950,11793266,17.99
9883985,9958500,6537,2287950,12246450,22.97
9883986,9995143,2618,916300,10911443,9.17
9883987,9985279,3525,1233750,11219029,12.36
9883988,9971546,3568,1248800,11220346,12.52
9883989,9975684,5367,1878450,11854134,18.83
9883990,9969726,6638,2323300,12293026,23.30
9883991,7482123,4303,1506050,8988173,20.13
9883992,9972769,3316,1160600,11133369,11.64
9883993,9976227,956,334600,10310827,3.35
9883994,9990207,3990,1396500,11386707,13.98
9883995,9986020,4058,1420300,11406320,14.22
9883996,9984211,3665,1282750,11266961,12.85
9883997,8061335,3479,1217650,9278985,15.10
9883998,9987540,3818,1336300,11323840,13.38
9883999,9980534,2298,804300,10784834,8.06
9884000,9968776,5384,1884400,11853176,18.90
9884001,9960710,3393,1187550,11148260,11.92
9884002,611985,280,98000,709985,16.01
9884003,9969429,4032,1411200,11380629,14.16
9884004,4861544,1592,557200,5418744,11.46
9884005,9965962,5056,1769600,11735562,17.76
9884006,9949643,2320,812000,10761643,8.16
9884007,9962853,6291,2201850,12164703,22.10
9884008,9719151,3367,1178450,10897601,12.13
9884009,7861065,3669,1284150,9145215,16.34
9884010,5279814,1464,512400,5792214,9.70
9884012,9962723,4458,1560300,11523023,15.66
9884013,9942544,4571,1599850,11542394,16.09
9884014,9951282,3645,1275750,11227032,12.82
9884015,9951387,4996,1748600,11699987,17.57
9884016,9036159,2319,811650,9847809,8.98
9884017,9977163,4858,1700300,11677463,17.04
9884018,9890688,3344,1170400,11061088,11.83
9884019,8828099,2172,760200,9588299,8.61
9884020,8965464,2547,891450,9856914,9.94
9884021,9961989,2211,773850,10735839,7.77
9884022,3424300,738,258300,3682600,7.54
9884023,9951205,247,86450,10037655,0.87
9884024,1277492,544,190400,1467892,14.90
9884025,9736481,3752,1313200,11049681,13.49
9884026,9942503,3235,1132250,11074753,11.39
9884027,9963855,4154,1453900,11417755,14.59
9884028,9956091,3733,1306550,11262641,13.12
9884029,9968226,4104,1436400,11404626,14.41
9884030,9980033,4569,1599150,11579183,16.02
9884031,9979953,5626,1969100,11949053,19.73
9884032,9963828,4528,1584800,11548628,15.91
9884033,3629212,1677,586950,4216162,16.17
9884034,9966354,5086,1780100,11746454,17.86
9884035,9979487,4805,1681750,11661237,16.85
9884036,9478906,3429,1200150,10679056,12.66
9884037,9963330,4063,1422050,11385380,14.27
9884038,9969534,5634,1971900,11941434,19.78
9884041,9951691,3561,1246350,11198041,12.52
9884043,9962683,4666,1633100,11595783,16.39
9884044,9952695,4347,1521450,11474145,15.29
9884045,9937431,5311,1858850,11796281,18.71
9884046,9941319,4784,1674400,11615719,16.84
9884047,9949291,4223,1478050,11427341,14.86
9884048,9933033,4241,1484350,11417383,14.94
9884049,9948963,4815,1685250,11634213,16.94
9884050,9944286,5231,1830850,11775136,18.41
9884051,9949052,5397,1888950,11838002,18.99
9884052,9950443,4269,1494150,11444593,15.02
9884053,9973525,3755,1314250,11287775,13.18
9884054,9975505,2858,1000300,10975805,10.03
9884055,9983532,4678,1637300,11620832,16.40
9884056,9989157,4215,1475250,11464407,14.77
9884057,9994207,3682,1288700,11282907,12.89
9884058,9987047,3917,1370950,11357997,13.73
9884059,9979472,6774,2370900,12350372,23.76
9884060,9999065,3195,1118250,11117315,11.18
9884061,9983490,3856,1349600,11333090,13.52
9884062,9989811,5863,2052050,12041861,20.54
9884063,9969182,6878,2407300,12376482,24.15
9884064,9966665,5278,1847300,11813965,18.53
9884065,9989730,5019,1756650,11746380,17.58
9884066,9984063,1131,395850,10379913,3.96
9884067,9992797,3075,1076250,11069047,10.77
9884068,9980965,6645,2325750,12306715,23.30
9884069,9998748,5640,1974000,11972748,19.74
9884070,9985876,1883,659050,10644926,6.60
9884071,9996833,3382,1183700,11180533,11.84
9884072,9982834,2722,952700,10935534,9.54
9884073,9989662,2493,872550,10862212,8.73
9884074,9706055,2441,854350,10560405,8.80
9884075,9231523,3318,1161300,10392823,12.58
9884077,9985767,4419,1546650,11532417,15.49
9884078,9969214,3226,1129100,11098314,11.33
9884079,9969138,950,332500,10301638,3.34
9884080,9977751,3078,1077300,11055051,10.80
9884081,9977441,2638,923300,10900741,9.25
9884082,8788874,4260,1491000,10279874,16.96
9884083,9982266,3177,1111950,11094216,11.14
9884084,9992048,3556,1244600,11236648,12.46
9884085,9988081,3604,1261400,11249481,12.63
9884086,9965256,1680,588000,10553256,5.90
9884087,9965250,4464,1562400,11527650,15.68
9884088,9982270,4077,1426950,11409220,14.29
9884089,9979815,5958,2085300,12065115,20.90
9884090,9988957,3873,1355550,11344507,13.57
9884091,9731225,3938,1378300,11109525,14.16
9884092,9990307,3901,1365350,11355657,13.67
9884093,9981928,3065,1072750,11054678,10.75
9884094,9974863,4759,1665650,11640513,16.70
9884095,6801276,3172,1110200,7911476,16.32
9884096,9968603,4835,1692250,11660853,16.98
9884097,9968566,3184,1114400,11082966,11.18
9884099,9949677,2635,922250,10871927,9.27
9884100,9950105,4243,1485050,11435155,14.92
9884101,9983151,4170,1459500,11442651,14.62
9884102,9980290,4478,1567300,11547590,15.70
9884103,9965528,2602,910700,10876228,9.14
9884104,9975773,3004,1051400,11027173,10.54
9884105,9954107,4656,1629600,11583707,16.37
9884106,9986288,3136,1097600,11083888,10.99
9884107,9242012,5316,1860600,11102612,20.13
9884108,9818120,3720,1302000,11120120,13.26
9884109,5194926,1725,603750,5798676,11.62
9884110,9979249,3073,1075550,11054799,10.78
9884111,9965780,6028,2109800,12075580,21.17
9884112,9455029,3550,1242500,10697529,13.14
9884113,9970287,3039,1063650,11033937,10.67
9884114,9963967,2921,1022350,10986317,10.26
9884115,9960695,4195,1468250,11428945,14.74
9884116,9959167,2469,864150,10823317,8.68
9884117,9980379,5378,1882300,11862679,18.86
9884118,9986212,2508,877800,10864012,8.79
9884119,9967775,3640,1274000,11241775,12.78
9884120,5872852,3711,1298850,7171702,22.12
9884121,9970908,3604,1261400,11232308,12.65
9884122,9976434,2511,878850,10855284,8.81
9884123,9977525,1472,515200,10492725,5.16
9884124,9975359,2489,871150,10846509,8.73
9884125,9481105,2527,884450,10365555,9.33
9884126,9968301,3014,1054900,11023201,10.58
9884127,9979046,3752,1313200,11292246,13.16
9884128,9998252,5116,1790600,11788852,17.91
9884129,9972050,3512,1229200,11201250,12.33
9884130,9978164,4976,1741600,11719764,17.45
9884131,9989810,2877,1006950,10996760,10.08
9884132,9999560,2272,795200,10794760,7.95
9884133,9969297,4292,1502200,11471497,15.07
9884134,9961349,3504,1226400,11187749,12.31
9884136,9955018,3195,1118250,11073268,11.23
9884137,9741520,4002,1400700,11142220,14.38
9884138,9606032,3048,1066800,10672832,11.11
9884139,9966398,3046,1066100,11032498,10.70
9884140,9983678,4217,1475950,11459628,14.78
9884141,9959734,2664,932400,10892134,9.36
9884143,9972897,2801,980350,10953247,9.83
9884144,9983336,3044,1065400,11048736,10.67
9884145,9970867,2390,836500,10807367,8.39
9884146,9995590,4563,1597050,11592640,15.98
9884147,9975358,2987,1045450,11020808,10.48
9884148,9998732,4967,1738450,11737182,17.39
9884149,9976226,3571,1249850,11226076,12.53
9884150,9985356,4134,1446900,11432256,14.49
9884151,9975875,5014,1754900,11730775,17.59
9884152,9971008,4624,1618400,11589408,16.23
9884153,9969499,6170,2159500,12128999,21.66
9884154,9455264,1362,476700,9931964,5.04
9884155,9986906,3060,1071000,11057906,10.72
9884156,1921285,797,278950,2200235,14.52
9884157,9969993,2798,979300,10949293,9.82
9884158,9910365,3063,1072050,10982415,10.82
9884159,9984466,4162,1456700,11441166,14.59
9884160,9980906,3602,1260700,11241606,12.63
9884161,9969184,1505,526750,10495934,5.28
9884162,6141703,2459,860650,7002353,14.01
9884163,9989015,1047,366450,10355465,3.67
9884164,9973215,1597,558950,10532165,5.60
9884165,9985038,5180,1813000,11798038,18.16
9884166,9973124,4532,1586200,11559324,15.90
9884167,9966974,1908,667800,10634774,6.70
9884168,9976874,4571,1599850,11576724,16.04
9884169,9990130,2899,1014650,11004780,10.16
9884170,9905965,5428,1899800,11805765,19.18
9884171,9977122,4317,1510950,11488072,15.14
9884172,9969585,5217,1825950,11795535,18.32
9884173,9955005,5107,1787450,11742455,17.96
9884174,9962679,3026,1059100,11021779,10.63
9884175,9967310,4028,1409800,11377110,14.14
9884176,9969719,4676,1636600,11606319,16.42
9884177,9990477,2141,749350,10739827,7.50
9884178,9982635,2964,1037400,11020035,10.39
9884179,9991504,3810,1333500,11325004,13.35
9884180,9982166,4765,1667750,11649916,16.71
9884181,9979273,3526,1234100,11213373,12.37
9884182,9994601,4655,1629250,11623851,16.30
9884183,9968171,3897,1363950,11332121,13.68
9884184,9958551,3370,1179500,11138051,11.84
9884185,9948019,3889,1361150,11309169,13.68
9884186,9964894,3161,1106350,11071244,11.10
9884187,9943865,4402,1540700,11484565,15.49
9884188,9932764,2444,855400,10788164,8.61
9884189,9950133,4040,1414000,11364133,14.21
9884190,9957181,2322,812700,10769881,8.16
9884191,7513531,2269,794150,8307681,10.57
9884192,9965386,4011,1403850,11369236,14.09
9884193,9959015,3353,1173550,11132565,11.78
9884194,9943587,2819,986650,10930237,9.92
9884196,9937998,3101,1085350,11023348,10.92
9884197,9923225,2891,1011850,10935075,10.20
9884198,9918748,5548,1941800,11860548,19.58
9884199,9940034,3543,1240050,11180084,12.48
9884200,9814608,3603,1261050,11075658,12.85
9884201,9955714,1785,624750,10580464,6.28
9884202,9942283,3913,1369550,11311833,13.78
9884203,9953751,2421,847350,10801101,8.51
9884204,9951977,4723,1653050,11605027,16.61
9884205,9962668,2761,966350,10929018,9.70
9884206,9975140,3451,1207850,11182990,12.11
9884207,9995120,2377,831950,10827070,8.32
9884208,9989219,3579,1252650,11241869,12.54
9884209,5059447,1266,443100,5502547,8.76
9884210,9483610,4456,1559600,11043210,16.45
9884211,9951032,3467,1213450,11164482,12.19
9884212,9981445,2872,1005200,10986645,10.07
9884213,9966241,3512,1229200,11195441,12.33
9884214,9995980,2895,1013250,11009230,10.14
9884215,9988093,2840,994000,10982093,9.95
9884216,9976666,6178,2162300,12138966,21.67
9884217,9971993,2905,1016750,10988743,10.20
9884218,1343547,516,180600,1524147,13.44
9884219,9746007,3031,1060850,10806857,10.88
9884220,9982406,4138,1448300,11430706,14.51
9884221,9977929,2958,1035300,11013229,10.38
9884222,9965161,4047,1416450,11381611,14.21
9884223,9972920,2152,753200,10726120,7.55
9884224,9972665,2517,880950,10853615,8.83
9884225,9974538,4608,1612800,11587338,16.17
9884226,9917408,3159,1105650,11023058,11.15
9884227,9734412,4172,1460200,11194612,15.00
9884228,9997213,2310,808500,10805713,8.09
9884229,9988069,5498,1924300,11912369,19.27
9884230,9964607,5133,1796550,11761157,18.03
9884231,9976646,2737,957950,10934596,9.60
9884232,9971801,4984,1744400,11716201,17.49
9884233,9987578,2927,1024450,11012028,10.26
9884234,9992118,5497,1923950,11916068,19.25
9884235,9982422,4600,1610000,11592422,16.13
9884236,9990985,4029,1410150,11401135,14.11
9884237,9971742,3144,1100400,11072142,11.04
9884238,9993014,3178,1112300,11105314,11.13
9884239,9986206,7643,2675050,12661256,26.79
9884240,9979171,2939,1028650,11007821,10.31
9884241,9967853,4960,1736000,11703853,17.42
9884242,9975681,5316,1860600,11836281,18.65
9884243,9984314,2354,823900,10808214,8.25
9884244,9984700,2940,1029000,11013700,10.31
9884245,8466734,2947,1031450,9498184,12.18
9884246,9989407,2031,710850,10700257,7.12
9884247,9984011,2837,992950,10976961,9.95
9884248,9722068,5619,1966650,11688718,20.23
9884249,9993629,4235,1482250,11475879,14.83
9884250,9985170,3567,1248450,11233620,12.50
9884251,9993265,5780,2023000,12016265,20.24
9884252,9984075,4639,1623650,11607725,16.26
9884253,9978121,2234,781900,10760021,7.84
9884254,9963154,6792,2377200,12340354,23.86
9884255,9973937,3516,1230600,11204537,12.34
9884256,9983177,4825,1688750,11671927,16.92
9884257,9991144,3755,1314250,11305394,13.15
9884258,9989042,3914,1369900,11358942,13.71
9884259,9982571,4117,1440950,11423521,14.43
9884260,9995000,3375,1181250,11176250,11.82
9884261,9979566,4343,1520050,11499616,15.23
9884262,9868883,5187,1815450,11684333,18.40
9884263,9959765,4621,1617350,11577115,16.24
9884264,9975857,6902,2415700,12391557,24.22
9884265,9956400,4244,1485400,11441800,14.92
9884266,9949970,2013,704550,10654520,7.08
9884267,9955844,5224,1828400,11784244,18.37
9884268,9886875,2713,949550,10836425,9.60
9884269,9946871,2634,921900,10868771,9.27
9884270,9961036,4363,1527050,11488086,15.33
9884271,9961887,4513,1579550,11541437,15.86
9884273,9959168,2846,996100,10955268,10.00
9884274,9960161,3463,1212050,11172211,12.17
9884275,9967846,4056,1419600,11387446,14.24
9884276,9969238,3774,1320900,11290138,13.25
9884277,9956770,3693,1292550,11249320,12.98
9884278,9959169,1566,548100,10507269,5.50
9884279,9948387,4644,1625400,11573787,16.34
9884280,9160696,4431,1550850,10711546,16.93
9884281,9177602,3623,1268050,10445652,13.82
9884282,9958992,4308,1507800,11466792,15.14
9884283,9951220,4724,1653400,11604620,16.62
9884284,9937272,1680,588000,10525272,5.92
9884285,9951136,3941,1379350,11330486,13.86
9884286,9936691,3926,1374100,11310791,13.83
9884287,8948603,3740,1309000,10257603,14.63
9884288,9946496,3519,1231650,11178146,12.38
9884289,9939739,2580,903000,10842739,9.08
9884290,9947217,3733,1306550,11253767,13.13
9884292,9961643,2983,1044050,11005693,10.48
9884293,9960488,3297,1153950,11114438,11.59
9884294,9972318,4379,1532650,11504968,15.37
9884295,9982432,6596,2308600,12291032,23.13
9884296,9983424,5887,2060450,12043874,20.64
9884297,4585156,1267,443450,5028606,9.67
9884298,9974815,2878,1007300,10982115,10.10
9884299,9962301,3588,1255800,11218101,12.61
9884300,9967959,3053,1068550,11036509,10.72
9884301,9947636,5256,1839600,11787236,18.49
9884302,9984644,3857,1349950,11334594,13.52
9884303,9976948,2735,957250,10934198,9.59
9884305,9986830,3168,1108800,11095630,11.10
9884306,9990850,3754,1313900,11304750,13.15
9884307,9974096,3022,1057700,11031796,10.60
9884308,9989752,3009,1053150,11042902,10.54
9884309,9979324,4844,1695400,11674724,16.99
9884310,9978087,4342,1519700,11497787,15.23
9884311,9983819,5640,1974000,11957819,19.77
9884312,9979519,2580,903000,10882519,9.05
9884313,9960720,4716,1650600,11611320,16.57
9884314,9979146,4423,1548050,11527196,15.51
9884315,9993051,6816,2385600,12378651,23.87
9884316,9997344,3940,1379000,11376344,13.79
9884317,9981157,4913,1719550,11700707,17.23
9884318,9993848,3935,1377250,11371098,13.78
9884319,9992323,3494,1222900,11215223,12.24
9884320,9982846,4541,1589350,11572196,15.92
9884321,9961998,3522,1232700,11194698,12.37
9884322,9955742,1672,585200,10540942,5.88
9884323,9988651,2436,852600,10841251,8.54
9884324,9995690,3250,1137500,11133190,11.38
9884325,9992196,4536,1587600,11579796,15.89
9884326,6636744,781,273350,6910094,4.12
9884327,9668501,3123,1093050,10761551,11.31
9884328,9533171,2543,890050,10423221,9.34
9884329,9901064,2734,956900,10857964,9.66
9884330,8735379,3516,1230600,9965979,14.09
9884331,9977195,2794,977900,10955095,9.80
9884332,9675003,3870,1354500,11029503,14.00
9884333,9996046,3035,1062250,11058296,10.63
9884334,9997355,2757,964950,10962305,9.65
9884335,9670523,2406,842100,10512623,8.71
9884336,9980573,2868,1003800,10984373,10.06
9884337,9983787,6160,2156000,12139787,21.60
9884338,9982098,5162,1806700,11788798,18.10
9884339,9983617,3564,1247400,11231017,12.49
9884340,9950767,2472,865200,10815967,8.69
9884341,9962040,2786,975100,10937140,9.79
9884342,9794917,4498,1574300,11369217,16.07
9884343,9976933,2827,989450,10966383,9.92
9884344,6420643,2877,1006950,7427593,15.68
9884345,9996940,4859,1700650,11697590,17.01
9884346,9972303,7114,2489900,12462203,24.97
9884347,9977132,3694,1292900,11270032,12.96
9884348,9951968,4830,1690500,11642468,16.99
9884349,9975189,3596,1258600,11233789,12.62
9884350,9962161,5533,1936550,11898711,19.44
9884351,9947131,5233,1831550,11778681,18.41
9884352,9948379,3928,1374800,11323179,13.82
9884353,9933357,3566,1248100,11181457,12.56
9884354,9313892,4632,1621200,10935092,17.41
9884355,9857187,5104,1786400,11643587,18.12
9884356,9652831,3288,1150800,10803631,11.92
9884357,8286362,5231,1830850,10117212,22.09
9884358,9678747,5340,1869000,11547747,19.31
9884359,9960929,5947,2081450,12042379,20.90
9884360,9963936,5672,1985200,11949136,19.92
9884361,9981023,4020,1407000,11388023,14.10
9884362,9881742,4564,1597400,11479142,16.17
9884363,9820842,3350,1172500,10993342,11.94
9884364,9977123,3890,1361500,11338623,13.65
9884365,9982073,4553,1593550,11575623,15.96
9884366,9990207,3664,1282400,11272607,12.84
9884367,9985024,2463,862050,10847074,8.63
9884368,9977126,3890,1361500,11338626,13.65
9884369,9985071,4173,1460550,11445621,14.63
9884370,9982600,4017,1405950,11388550,14.08
9884371,9982801,5989,2096150,12078951,21.00
9884372,9998005,1144,400400,10398405,4.00
9884373,9965290,4180,1463000,11428290,14.68
9884374,9084763,3872,1355200,10439963,14.92
9884375,9974364,5744,2010400,11984764,20.16
9884376,9935389,4090,1431500,11366889,14.41
9884377,9647122,3770,1319500,10966622,13.68
9884378,1539041,296,103600,1642641,6.73
9884379,9985282,4316,1510600,11495882,15.13
9884380,9982586,6593,2307550,12290136,23.12
9884381,9983400,3393,1187550,11170950,11.90
9884382,9991271,4587,1605450,11596721,16.07
9884383,9997437,2005,701750,10699187,7.02
9884384,9991218,2513,879550,10870768,8.80
9884385,9994113,5610,1963500,11957613,19.65
9884386,1002015,484,169400,1171415,16.91
9884387,9964761,4556,1594600,11559361,16.00
9884388,9988121,1930,675500,10663621,6.76
9884389,9998949,2547,891450,10890399,8.92
9884390,9954729,4721,1652350,11607079,16.60
9884391,9752401,3054,1068900,10821301,10.96
9884392,9972051,4962,1736700,11708751,17.42
9884393,9984583,5338,1868300,11852883,18.71
9884394,9982257,5924,2073400,12055657,20.77
9884395,9992967,6268,2193800,12186767,21.95
9884396,9991808,5440,1904000,11895808,19.06
9884397,9991460,2891,1011850,11003310,10.13
9884398,9982556,4963,1737050,11719606,17.40
9884399,9975631,2244,785400,10761031,7.87
9884400,9985489,3748,1311800,11297289,13.14
9884401,9970871,6186,2165100,12135971,21.71
9884402,9938273,4807,1682450,11620723,16.93
9884403,9968414,3184,1114400,11082814,11.18
9884404,9985609,3500,1225000,11210609,12.27
9884405,9979621,4245,1485750,11465371,14.89
9884406,3540775,1023,358050,3898825,10.11
9884407,9984640,4740,1659000,11643640,16.62
9884408,9974166,5048,1766800,11740966,17.71
9884409,9988979,4805,1681750,11670729,16.84
9884410,9976400,3858,1350300,11326700,13.53
9884411,9985188,4129,1445150,11430338,14.47
9884412,8154558,4224,1478400,9632958,18.13
9884413,9974707,4157,1454950,11429657,14.59
9884414,9987736,3827,1339450,11327186,13.41
9884415,9984037,6502,2275700,12259737,22.79
9884416,9640839,3237,1132950,10773789,11.75
9884417,9978583,6431,2250850,12229433,22.56
9884419,9181252,4660,1631000,10812252,17.76
9884420,9981676,3490,1221500,11203176,12.24
9884421,9995164,3309,1158150,11153314,11.59
9884422,9974637,3294,1152900,11127537,11.56
9884423,9990764,6383,2234050,12224814,22.36
9884424,9898468,3829,1340150,11238618,13.54
9884425,1468889,764,267400,1736289,18.20
9884426,9971946,5110,1788500,11760446,17.94
9884427,4340792,825,288750,4629542,6.65
9884428,889061,337,117950,1007011,13.27
9884429,9927883,4455,1559250,11487133,15.71
9884430,9965151,4751,1662850,11628001,16.69
9884431,9964095,4696,1643600,11607695,16.50
9884432,9958964,8793,3077550,13036514,30.90
9884433,9975033,3214,1124900,11099933,11.28
9884434,9970181,7089,2481150,12451331,24.89
9884435,9726096,4285,1499750,11225846,15.42
9884436,9762932,3457,1209950,10972882,12.39
9884437,9967394,2929,1025150,10992544,10.29
9884438,789639,490,171500,961139,21.72
9884439,8887748,4280,1498000,10385748,16.85
9884440,9970508,4098,1434300,11404808,14.39
9884441,2176382,1293,452550,2628932,20.79
9884442,9951815,3922,1372700,11324515,13.79
9884443,2982720,1860,651000,3633720,21.83
9884444,9259983,2778,972300,10232283,10.50
9884445,9964894,4569,1599150,11564044,16.05
9884446,9956078,2940,1029000,10985078,10.34
9884447,9907058,3686,1290100,11197158,13.02
9884448,9971577,3926,1374100,11345677,13.78
9884449,9984984,4843,1695050,11680034,16.98
9884450,1695896,1212,424200,2120096,25.01
9884451,9966908,4207,1472450,11439358,14.77
9884452,9962492,5263,1842050,11804542,18.49
9884454,9980607,5934,2076900,12057507,20.81
9884455,9979170,4545,1590750,11569920,15.94
9884456,9981533,3264,1142400,11123933,11.45
9884458,9954262,4425,1548750,11503012,15.56
9884459,9925954,4708,1647800,11573754,16.60
9884460,9938620,4591,1606850,11545470,16.17
9884461,9948429,4542,1589700,11538129,15.98
9884462,9940379,7456,2609600,12549979,26.25
9884463,9933684,4418,1546300,11479984,15.57
9884464,9927727,5653,1978550,11906277,19.93
9884465,9934575,4027,1409450,11344025,14.19
9884466,9945177,4709,1648150,11593327,16.57
9884467,9946977,5114,1789900,11736877,17.99
9884468,9968858,5240,1834000,11802858,18.40
9884469,8956256,4825,1688750,10645006,18.86
9884470,9955285,5846,2046100,12001385,20.55
9884472,9950200,3252,1138200,11088400,11.44
9884473,9946859,283,99050,10045909,1.00
9884474,9948004,2192,767200,10715204,7.71
9884475,9959807,6844,2395400,12355207,24.05
9884476,9963342,2991,1046850,11010192,10.51
9884477,9983265,4745,1660750,11644015,16.64
9884478,9975993,4526,1584100,11560093,15.88
9884479,9994608,5264,1842400,11837008,18.43
9884480,9989826,5697,1993950,11983776,19.96
9884481,9193646,5625,1968750,11162396,21.41
9884482,9977716,5579,1952650,11930366,19.57
9884483,9900381,4586,1605100,11505481,16.21
9884484,9980646,2099,734650,10715296,7.36
9884487,9965532,4084,1429400,11394932,14.34
9884488,9693036,3955,1384250,11077286,14.28
9884489,9166976,3030,1060500,10227476,11.57
9884490,9434710,2699,944650,10379360,10.01
9884491,9995489,3804,1331400,11326889,13.32
9884492,9999262,5239,1833650,11832912,18.34
9884494,7792217,4631,1620850,9413067,20.80
9884495,9990455,1485,519750,10510205,5.20
9884496,9916197,4005,1401750,11317947,14.14
9884497,9970178,5906,2067100,12037278,20.73
9884498,9993960,4965,1737750,11731710,17.39
9884499,8985130,4930,1725500,10710630,19.20
9884500,9944964,6243,2185050,12130014,21.97
9884501,9983444,2577,901950,10885394,9.03
9884503,9963634,6707,2347450,12311084,23.56
9884504,9176056,3956,1384600,10560656,15.09
9884505,9960021,3807,1332450,11292471,13.38
9884506,9964766,4319,1511650,11476416,15.17
9884507,9269854,3059,1070650,10340504,11.55
9884508,9999818,3660,1281000,11280818,12.81
9884509,9885560,3519,1231650,11117210,12.46
9884510,9979624,3227,1129450,11109074,11.32
9884511,9972110,2199,769650,10741760,7.72
9884512,9858573,5031,1760850,11619423,17.86
9884513,9973155,2599,909650,10882805,9.12
9884514,9962381,3737,1307950,11270331,13.13
9884515,9940815,2577,901950,10842765,9.07
9884516,9982050,6010,2103500,12085550,21.07
9884517,9987358,2337,817950,10805308,8.19
9884518,9966662,1104,386400,10353062,3.88
9884519,9971504,1842,644700,10616204,6.47
9884520,9994208,3591,1256850,11251058,12.58
9884521,9983804,2298,804300,10788104,8.06
9884522,9051135,681,238350,9289485,2.63
9884523,9960636,3960,1386000,11346636,13.91
9884524,9966747,3165,1107750,11074497,11.11
9884525,2064727,990,346500,2411227,16.78
9884526,9967000,3941,1379350,11346350,13.84
9884527,9974577,4057,1419950,11394527,14.24
9884528,9977478,6576,2301600,12279078,23.07
9884529,9980339,1347,471450,10451789,4.72
9884530,9994129,4217,1475950,11470079,14.77
9884531,9023834,2784,974400,9998234,10.80
9884532,9959271,2276,796600,10755871,8.00
9884533,8394908,2672,935200,9330108,11.14
9884534,9320891,4927,1724450,11045341,18.50
9884535,4315294,2089,731150,5046444,16.94
9884536,9948755,2763,967050,10915805,9.72
9884537,9976602,6045,2115750,12092352,21.21
9884538,9984112,4032,1411200,11395312,14.13
9884539,9977839,6246,2186100,12163939,21.91
9884540,9983682,2164,757400,10741082,7.59
9884541,9972873,4767,1668450,11641323,16.73
9884542,9963212,6027,2109450,12072662,21.17
9884543,9638073,2410,843500,10481573,8.75
9884544,9949635,4750,1662500,11612135,16.71
9884545,9960630,5514,1929900,11890530,19.38
9884546,9966531,4090,1431500,11398031,14.36
9884547,9976400,4353,1523550,11499950,15.27
9884548,9522088,4313,1509550,11031638,15.85
9884549,9982280,4726,1654100,11636380,16.57
9884550,9980752,6714,2349900,12330652,23.54
9884551,9990012,6493,2272550,12262562,22.75
9884552,9980928,3553,1243550,11224478,12.46
9884553,9987177,3909,1368150,11355327,13.70
9884554,9977358,2977,1041950,11019308,10.44
9884555,9990171,7849,2747150,12737321,27.50
9884556,9973504,6321,2212350,12185854,22.18
9884557,9966334,3219,1126650,11092984,11.30
9884558,9967333,3685,1289750,11257083,12.94
9884559,9713206,5742,2009700,11722906,20.69
9884561,9981793,2705,946750,10928543,9.48
9884562,9973886,4387,1535450,11509336,15.39
9884563,9975807,4311,1508850,11484657,15.13
9884564,9968905,3756,1314600,11283505,13.19
9884565,9985278,3512,1229200,11214478,12.31
9884566,9961267,3286,1150100,11111367,11.55
9884567,9977099,5138,1798300,11775399,18.02
9884568,9988976,4577,1601950,11590926,16.04
9884569,9993580,4172,1460200,11453780,14.61
9884570,9988462,3181,1113350,11101812,11.15
9884571,9965730,4847,1696450,11662180,17.02
9884572,9948518,3344,1170400,11118918,11.76
9884573,9744543,4463,1562050,11306593,16.03
9884574,9946252,5571,1949850,11896102,19.60
9884575,9961229,5610,1963500,11924729,19.71
9884576,4290999,3667,1283450,5574449,29.91
9884577,9962716,4000,1400000,11362716,14.05
9884578,9978758,3522,1232700,11211458,12.35
9884579,9893910,4311,1508850,11402760,15.25
9884580,6013593,2912,1019200,7032793,16.95
9884581,9983819,4197,1468950,11452769,14.71
9884582,9992744,3656,1279600,11272344,12.81
9884583,9997699,4625,1618750,11616449,16.19
9884584,9987109,4574,1600900,11588009,16.03
9884585,9993825,4309,1508150,11501975,15.09
9884586,9971970,3771,1319850,11291820,13.24
9884587,9959685,3780,1323000,11282685,13.28
9884588,9984933,1883,659050,10643983,6.60
9884589,9999671,469,164150,10163821,1.64
9884590,9987085,3401,1190350,11177435,11.92
9884591,9973198,1083,379050,10352248,3.80
9884592,9962229,1414,494900,10457129,4.97
9884593,9945747,3596,1258600,11204347,12.65
9884594,9966161,2727,954450,10920611,9.58
9884595,9956026,3673,1285550,11241576,12.91
9884596,9958764,4837,1692950,11651714,17.00
9884597,9950705,5300,1855000,11805705,18.64
9884598,9944894,5633,1971550,11916444,19.82
9884599,9942672,5101,1785350,11728022,17.96
9884600,9960335,3748,1311800,11272135,13.17
9884601,9969620,4339,1518650,11488270,15.23
9884602,9977023,4631,1620850,11597873,16.25
9884603,9970285,5978,2092300,12062585,20.99
9884604,9980884,3235,1132250,11113134,11.34
9884606,9990132,3323,1163050,11153182,11.64
9884607,9975340,5462,1911700,11887040,19.16
9884608,9991223,2949,1032150,11023373,10.33
9884609,9997234,5083,1779050,11776284,17.80
9884611,4843713,1990,696500,5540213,14.38
9884612,9992547,7257,2539950,12532497,25.42
9884613,9996522,1810,633500,10630022,6.34
9884614,9983964,5056,1769600,11753564,17.72
9884615,9987729,3839,1343650,11331379,13.45
9884616,9844048,2070,724500,10568548,7.36
9884617,9993526,1665,582750,10576276,5.83
9884618,9971369,2052,718200,10689569,7.20
9884619,9979608,2625,918750,10898358,9.21
9884620,9954321,5685,1989750,11944071,19.99
9884621,9975036,2305,806750,10781786,8.09
9884622,9979444,3094,1082900,11062344,10.85
9884623,9984338,3107,1087450,11071788,10.89
9884624,5511763,3254,1138900,6650663,20.66
9884625,9970128,2663,932050,10902178,9.35
9884626,9971219,3625,1268750,11239969,12.72
9884627,9956178,4409,1543150,11499328,15.50
9884628,9953254,3692,1292200,11245454,12.98
9884629,9952579,4625,1618750,11571329,16.26
9884630,9949090,6434,2251900,12200990,22.63
9884631,9975823,3965,1387750,11363573,13.91
9884632,9964809,922,322700,10287509,3.24
9884633,9948782,4536,1587600,11536382,15.96
9884635,8484250,2653,928550,9412800,10.94
9884636,9940606,3961,1386350,11326956,13.95
9884637,2074924,1210,423500,2498424,20.41
9884638,1409495,174,60900,1470395,4.32
9884639,9969300,3477,1216950,11186250,12.21
9884640,9960122,2145,750750,10710872,7.54
9884641,2836509,1917,670950,3507459,23.65
9884642,9957470,6019,2106650,12064120,21.16
9884643,9973645,4545,1590750,11564395,15.95
9884644,9963257,2935,1027250,10990507,10.31
9884645,9981310,5762,2016700,11998010,20.20
9884646,6818819,3147,1101450,7920269,16.15
9884647,9985989,3336,1167600,11153589,11.69
9884648,9430455,4886,1710100,11140555,18.13
9884649,7785212,660,231000,8016212,2.97
9884650,9978177,4840,1694000,11672177,16.98
9884651,9698798,4761,1666350,11365148,17.18
9884652,9938793,4574,1600900,11539693,16.11
9884653,1303135,145,50750,1353885,3.89
9884654,9957822,1485,519750,10477572,5.22
9884655,8949967,2560,896000,9845967,10.01
9884656,7326431,4428,1549800,8876231,21.15
9884657,9987413,4425,1548750,11536163,15.51
9884658,9248509,4158,1455300,10703809,15.74
9884659,9839390,4912,1719200,11558590,17.47
9884660,9985395,3179,1112650,11098045,11.14
9884661,9985926,4034,1411900,11397826,14.14
9884662,9734195,2873,1005550,10739745,10.33
9884664,9975209,2283,799050,10774259,8.01
9884665,9982885,3392,1187200,11170085,11.89
9884666,8969461,3973,1390550,10360011,15.50
9884667,9672949,3281,1148350,10821299,11.87
9884668,9557545,2686,940100,10497645,9.84
9884669,9993513,3698,1294300,11287813,12.95
9884670,9972703,157,54950,10027653,0.55
9884671,9897045,3508,1227800,11124845,12.41
9884673,9972957,5521,1932350,11905307,19.38
9884674,9976385,2656,929600,10905985,9.32
9884675,9967403,2600,910000,10877403,9.13
9884676,9977234,1129,395150,10372384,3.96
9884677,9982974,2983,1044050,11027024,10.46
9884680,9956024,4604,1611400,11567424,16.19
9884681,9975400,3362,1176700,11152100,11.80
9884682,9964070,3766,1318100,11282170,13.23
9884683,9986987,3755,1314250,11301237,13.16
9884684,9790509,6159,2155650,11946159,22.02
9884685,4531306,1802,630700,5162006,13.92
9884686,9987602,4477,1566950,11554552,15.69
9884687,9975037,2719,951650,10926687,9.54
9884688,8174865,5215,1825250,10000115,22.33
9884689,9979535,2276,796600,10776135,7.98
9884690,6361217,1580,553000,6914217,8.69
9884691,9983502,6295,2203250,12186752,22.07
9884692,9981748,3093,1082550,11064298,10.85
9884693,9988940,4507,1577450,11566390,15.79
9884694,4144699,454,158900,4303599,3.83
9884695,9961396,2162,756700,10718096,7.60
9884696,9879979,5201,1820350,11700329,18.42
9884697,9868385,3336,1167600,11035985,11.83
9884698,9969568,5786,2025100,11994668,20.31
9884699,9966225,4699,1644650,11610875,16.50
9884700,9970498,3939,1378650,11349148,13.83
9884701,9986990,4517,1580950,11567940,15.83
9884702,9981293,5263,1842050,11823343,18.46
9884703,7763714,1427,499450,8263164,6.43
9884704,7283318,2715,950250,8233568,13.05
9884705,9959031,3187,1115450,11074481,11.20
9884706,9448211,3047,1066450,10514661,11.29
9884707,9809012,4277,1496950,11305962,15.26
9884708,9265194,2259,790650,10055844,8.53
9884709,9952927,4134,1446900,11399827,14.54
9884711,9946523,2382,833700,10780223,8.38
9884712,9957039,1739,608650,10565689,6.11
9884713,9961225,2897,1013950,10975175,10.18
9884714,9972192,5003,1751050,11723242,17.56
9884715,9958344,2811,983850,10942194,9.88
9884716,9935345,2800,980000,10915345,9.86
9884717,9936399,3386,1185100,11121499,11.93
9884718,9936936,4423,1548050,11484986,15.58
9884719,9936134,2486,870100,10806234,8.76
9884720,9940946,2407,842450,10783396,8.47
9884721,9955890,6029,2110150,12066040,21.19
9884722,9947691,2932,1026200,10973891,10.32
9884723,9952149,3682,1288700,11240849,12.95
9884724,7447834,898,314300,7762134,4.22
9884725,9965792,483,169050,10134842,1.70
9884726,5190258,2918,1021300,6211558,19.68
9884727,9950707,3879,1357650,11308357,13.64
9884728,9944889,2418,846300,10791189,8.51
9884729,9960322,2567,898450,10858772,9.02
9884730,9955454,3775,1321250,11276704,13.27
9884732,9950503,2952,1033200,10983703,10.38
9884733,675791,401,140350,816141,20.77
9884734,9948278,3642,1274700,11222978,12.81
9884735,9946632,2070,724500,10671132,7.28
9884737,9925539,4103,1436050,11361589,14.47
9884738,9939226,2187,765450,10704676,7.70
9884739,9924573,2715,950250,10874823,9.57
9884740,9945759,2363,827050,10772809,8.32
9884741,9940857,3456,1209600,11150457,12.17
9884742,9947172,3543,1240050,11187222,12.47
9884743,6570813,418,146300,6717113,2.23
9884744,9934564,2900,1015000,10949564,10.22
9884745,973000,1310,458500,1431500,47.12
9884746,9904075,4045,1415750,11319825,14.29
9884747,2850006,1096,383600,3233606,13.46
9884748,9915279,2387,835450,10750729,8.43
9884749,9909099,3613,1264550,11173649,12.76
9884750,9909521,5913,2069550,11979071,20.88
9884751,9886542,2542,889700,10776242,9.00
9884752,8892964,2077,726950,9619914,8.17
9884753,8909572,1982,693700,9603272,7.79
9884754,9660944,2898,1014300,10675244,10.50
9884755,9810899,4118,1441300,11252199,14.69
9884756,9570111,1945,680750,10250861,7.11
9884757,9916291,3396,1188600,11104891,11.99
9884758,9944192,4744,1660400,11604592,16.70
9884759,9945222,2195,768250,10713472,7.72
9884760,9960213,4474,1565900,11526113,15.72
9884761,9956351,4646,1626100,11582451,16.33
9884762,9946244,3155,1104250,11050494,11.10
9884763,9950174,4147,1451450,11401624,14.59
9884764,9952303,4219,1476650,11428953,14.84
9884765,9947899,4894,1712900,11660799,17.22
9884766,9930854,2684,939400,10870254,9.46
9884767,9967978,1936,677600,10645578,6.80
9884768,9943564,2863,1002050,10945614,10.08
9884769,9957507,1548,541800,10499307,5.44
9884770,9961371,4458,1560300,11521671,15.66
9884771,258017,120,42000,300017,16.28
9884772,9964784,3455,1209250,11174034,12.14
9884773,9973202,1601,560350,10533552,5.62
9884774,9963209,6410,2243500,12206709,22.52
9884775,9936914,4798,1679300,11616214,16.90
9884776,9947916,3768,1318800,11266716,13.26
9884778,9958285,3105,1086750,11045035,10.91
9884779,9946121,3139,1098650,11044771,11.05
9884780,7808114,743,260050,8068164,3.33
9884781,9950823,2153,753550,10704373,7.57
9884782,9870269,3263,1142050,11012319,11.57
9884783,9971761,5174,1810900,11782661,18.16
9884784,9254801,1838,643300,9898101,6.95
9884785,9971210,3548,1241800,11213010,12.45
9884786,9201015,3420,1197000,10398015,13.01
9884787,9961351,5036,1762600,11723951,17.69
9884788,7122246,811,283850,7406096,3.99
9884789,9954214,1513,529550,10483764,5.32
9884790,9963058,5794,2027900,11990958,20.35
9884791,9967921,2777,971950,10939871,9.75
9884792,1450451,532,186200,1636651,12.84
9884793,9979235,3619,1266650,11245885,12.69
9884794,7598752,2261,791350,8390102,10.41
9884795,4432437,3824,1338400,5770837,30.20
9884796,9945676,4480,1568000,11513676,15.77
9884797,9953440,4394,1537900,11491340,15.45
9884798,9964226,4023,1408050,11372276,14.13
9884799,9960929,4541,1589350,11550279,15.96
9884800,8431759,3081,1078350,9510109,12.79
9884801,9941839,4124,1443400,11385239,14.52
9884802,9963731,3072,1075200,11038931,10.79
9884803,9967878,3164,1107400,11075278,11.11
9884804,9966861,4174,1460900,11427761,14.66
9884805,9974645,4170,1459500,11434145,14.63
9884806,9972189,4606,1612100,11584289,16.17
9884807,9984941,5537,1937950,11922891,19.41
9884808,9982222,3975,1391250,11373472,13.94
9884809,9963581,1516,530600,10494181,5.33
9884810,9972324,3395,1188250,11160574,11.92
9884811,9987956,2356,824600,10812556,8.26
9884812,6592764,1963,687050,7279814,10.42
9884813,9976116,3937,1377950,11354066,13.81
9884814,9991201,1625,568750,10559951,5.69
9884815,9487458,3126,1094100,10581558,11.53
9884816,9970525,3879,1357650,11328175,13.62
9884817,9980873,5902,2065700,12046573,20.70
9884818,9996866,3294,1152900,11149766,11.53
9884819,9982456,4243,1485050,11467506,14.88
9884820,9991387,2279,797650,10789037,7.98
9884821,9987986,2302,805700,10793686,8.07
9884822,9997613,2590,906500,10904113,9.07
9884823,9980746,4596,1608600,11589346,16.12
9884824,6749753,493,172550,6922303,2.56
9884825,9982385,4124,1443400,11425785,14.46
9884826,9954568,4404,1541400,11495968,15.48
9884827,2302188,1515,530250,2832438,23.03
9884828,4816588,1542,539700,5356288,11.21
9884829,9950283,5498,1924300,11874583,19.34
9884830,9194371,3404,1191400,10385771,12.96
9884831,9957289,5039,1763650,11720939,17.71
9884832,9956809,4758,1665300,11622109,16.73
9884833,9933543,2918,1021300,10954843,10.28
9884834,9939936,3172,1110200,11050136,11.17
9884835,9870050,1936,677600,10547650,6.87
9884836,737788,352,123200,860988,16.70
9884837,9941603,3038,1063300,11004903,10.70
9884838,9943948,5416,1895600,11839548,19.06
9884839,9951878,4057,1419950,11371828,14.27
9884841,9945917,3813,1334550,11280467,13.42
9884842,9951660,4482,1568700,11520360,15.76
9884843,9956048,5718,2001300,11957348,20.10
9884844,9797112,3603,1261050,11058162,12.87
9884845,9180401,2726,954100,10134501,10.39
9884846,7871807,398,139300,8011107,1.77
9884847,9958170,2573,900550,10858720,9.04
9884848,7020151,512,179200,7199351,2.55
9884849,9962728,2386,835100,10797828,8.38
9884850,9968818,2647,926450,10895268,9.29
9884851,7248309,3770,1319500,8567809,18.20
9884852,9938070,2004,701400,10639470,7.06
9884853,9925395,4811,1683850,11609245,16.97
9884855,9851705,5475,1916250,11767955,19.45
9884856,6969464,696,243600,7213064,3.50
9884857,8846926,2361,826350,9673276,9.34
9884858,9920754,4251,1487850,11408604,15.00
9884859,9924417,4087,1430450,11354867,14.41
9884860,9894085,3912,1369200,11263285,13.84
9884861,9937991,3821,1337350,11275341,13.46
9884862,9948495,5010,1753500,11701995,17.63
9884864,1975012,694,242900,2217912,12.30
9884865,9945588,3479,1217650,11163238,12.24
9884866,9950544,3735,1307250,11257794,13.14
9884867,3568810,701,245350,3814160,6.87
9884868,9629240,4500,1575000,11204240,16.36
9884869,9947176,2114,739900,10687076,7.44
9884870,9954049,3938,1378300,11332349,13.85
9884871,9932938,3790,1326500,11259438,13.35
9884872,9952739,4371,1529850,11482589,15.37
9884873,9956099,2662,931700,10887799,9.36
9884875,9164382,4462,1561700,10726082,17.04
9884876,9939298,3025,1058750,10998048,10.65
9884877,9946283,2656,929600,10875883,9.35
9884878,9950551,4354,1523900,11474451,15.31
9884879,9964498,6120,2142000,12106498,21.50
9884880,9982183,2180,763000,10745183,7.64
9884881,3554877,880,308000,3862877,8.66
9884882,9974615,2013,704550,10679165,7.06
9884883,9972623,1130,395500,10368123,3.97
9884884,7140647,2238,783300,7923947,10.97
9884885,9942402,3208,1122800,11065202,11.29
9884886,9946856,3456,1209600,11156456,12.16
9884887,9957752,6284,2199400,12157152,22.09
9884888,9944724,3077,1076950,11021674,10.83
9884889,9942524,3137,1097950,11040474,11.04
9884890,9942439,4827,1689450,11631889,16.99
9884891,992388,525,183750,1176138,18.52
9884892,9963730,4759,1665650,11629380,16.72
9884893,9939415,4819,1686650,11626065,16.97
9884894,9957063,4001,1400350,11357413,14.06
9884895,9948392,2608,912800,10861192,9.18
9884896,9948176,4088,1430800,11378976,14.38
9884897,9951343,4403,1541050,11492393,15.49
9884898,3939804,1136,397600,4337404,10.09
9884899,9942005,5082,1778700,11720705,17.89
9884900,9923294,4413,1544550,11467844,15.56
9884901,4399811,3472,1215200,5615011,27.62
9884902,9909846,2916,1020600,10930446,10.30
9884903,9891868,2412,844200,10736068,8.53
9884904,9934418,4369,1529150,11463568,15.39
9884905,9925934,2555,894250,10820184,9.01
9884906,9949339,3677,1286950,11236289,12.94
9884907,9953215,3710,1298500,11251715,13.05
9884908,9901324,3276,1146600,11047924,11.58
9884909,9949972,4110,1438500,11388472,14.46
9884910,9924510,4983,1744050,11668560,17.57
9884911,9934294,3310,1158500,11092794,11.66
9884912,9943068,4085,1429750,11372818,14.38
9884913,9941996,1457,509950,10451946,5.13
9884914,9918174,3713,1299550,11217724,13.10
9884915,9919798,5148,1801800,11721598,18.16
9884916,9946421,1292,452200,10398621,4.55
9884917,9972880,1466,513100,10485980,5.14
9884918,6921847,1861,651350,7573197,9.41
9884920,9453353,3345,1170750,10624103,12.38
9884921,9928100,2634,921900,10850000,9.29
9884922,9952385,1830,640500,10592885,6.44
9884923,9964133,4639,1623650,11587783,16.29
9884924,9975848,5601,1960350,11936198,19.65
9884925,9964166,2007,702450,10666616,7.05
9884926,6077097,1835,642250,6719347,10.57
9884927,9703857,2430,850500,10554357,8.76
9884928,8959565,2480,868000,9827565,9.69
9884929,9968891,2762,966700,10935591,9.70
9884930,9974282,4065,1422750,11397032,14.26
9884931,5237329,517,180950,5418279,3.46
9884932,9958666,3703,1296050,11254716,13.01
9884933,9966224,2444,855400,10821624,8.58
9884934,9961149,680,238000,10199149,2.39
9884935,9968394,3207,1122450,11090844,11.26
9884936,9989023,4064,1422400,11411423,14.24
9884937,9978048,5017,1755950,11733998,17.60
9884938,9980180,1497,523950,10504130,5.25
9884939,9979260,1662,581700,10560960,5.83
9884940,8094644,2969,1039150,9133794,12.84
9884941,9968881,1103,386050,10354931,3.87
9884942,9734085,1828,639800,10373885,6.57
9884943,9740085,1476,516600,10256685,5.30
9884944,9980963,1742,609700,10590663,6.11
9884946,2489440,1037,362950,2852390,14.58
9884947,9993688,4657,1629950,11623638,16.31
9884948,1738880,459,160650,1899530,9.24
9884949,9296969,4358,1525300,10822269,16.41
9884950,9979425,3551,1242850,11222275,12.45
9884951,9980681,1331,465850,10446531,4.67
9884952,2467397,501,175350,2642747,7.11
9884953,9986259,3342,1169700,11155959,11.71
9884955,3782929,805,281750,4064679,7.45
9884956,9985665,6052,2118200,12103865,21.21
9884957,7584290,2431,850850,8435140,11.22
9884958,9980225,3977,1391950,11372175,13.95
9884960,8302851,3611,1263850,9566701,15.22
9884961,9437990,3486,1220100,10658090,12.93
9884962,8336937,2155,754250,9091187,9.05
9884963,9907106,3306,1157100,11064206,11.68
9884964,1565399,638,223300,1788699,14.26
9884965,9444441,3826,1339100,10783541,14.18
9884966,5247096,2768,968800,6215896,18.46
9884967,2737411,1498,524300,3261711,19.15
9884968,9670749,5213,1824550,11495299,18.87
9884969,9991669,5638,1973300,11964969,19.75
9884970,787761,233,81550,869311,10.35
9884971,9985473,5663,1982050,11967523,19.85
9884972,9985508,4843,1695050,11680558,16.98
9884973,9582130,2899,1014650,10596780,10.59
9884974,9752136,2767,968450,10720586,9.93
9884975,79956,79,27650,107606,34.58
9884976,2087456,571,199850,2287306,9.57
9884977,133608,80,28000,161608,20.96
9884978,9976519,4937,1727950,11704469,17.32
9884980,9338629,2040,714000,10052629,7.65
9884981,9987170,3604,1261400,11248570,12.63
9884982,9973756,2261,791350,10765106,7.93
9884983,9955852,3497,1223950,11179802,12.29
9884984,9957513,3787,1325450,11282963,13.31
9884985,9944441,1978,692300,10636741,6.96
9884986,9970890,2229,780150,10751040,7.82
9884987,9963423,3774,1320900,11284323,13.26
9884988,7866352,2038,713300,8579652,9.07
9884989,9975835,1861,651350,10627185,6.53
9884990,9999611,3915,1370250,11369861,13.70
9884991,9989206,2465,862750,10851956,8.64
9884992,9990208,4091,1431850,11422058,14.33
9884993,9968576,4513,1579550,11548126,15.85
9884994,9973153,1471,514850,10488003,5.16
9884995,9993371,1959,685650,10679021,6.86
9884996,1054831,357,124950,1179781,11.85
9884997,9958028,4576,1601600,11559628,16.08
9884998,9987958,4103,1436050,11424008,14.38
9884999,9823406,4149,1452150,11275556,14.78
9885000,2667333,1243,435050,3102383,16.31
9885001,9981780,5749,2012150,11993930,20.16
9885002,9984103,1714,599900,10584003,6.01
9885003,9993450,4407,1542450,11535900,15.43
9885004,9988751,636,222600,10211351,2.23
9885005,3855520,1398,489300,4344820,12.69
9885006,9968779,4234,1481900,11450679,14.87
9885007,9510489,6066,2123100,11633589,22.32
9885008,9427120,1713,599550,10026670,6.36
9885009,9964785,3691,1291850,11256635,12.96
9885010,8457849,2988,1045800,9503649,12.36
9885011,9969467,4688,1640800,11610267,16.46
9885012,4260540,1357,474950,4735490,11.15
9885013,9969699,3510,1228500,11198199,12.32
9885014,9946829,4550,1592500,11539329,16.01
9885015,9976324,3739,1308650,11284974,13.12
9885016,9975578,3687,1290450,11266028,12.94
9885017,9993253,6109,2138150,12131403,21.40
9885018,9968058,3424,1198400,11166458,12.02
9885019,9983138,4607,1612450,11595588,16.15
9885020,9970636,3437,1202950,11173586,12.06
9885021,9959752,2139,748650,10708402,7.52
9885022,9810490,1299,454650,10265140,4.63
9885023,9977238,2651,927850,10905088,9.30
9885024,9987498,3710,1298500,11285998,13.00
9885025,9985812,749,262150,10247962,2.63
9885026,9734046,3108,1087800,10821846,11.18
9885027,9976464,1120,392000,10368464,3.93
9885028,9974471,2432,851200,10825671,8.53
9885029,9982741,877,306950,10289691,3.07
9885030,9966770,2552,893200,10859970,8.96
9885031,9903340,3635,1272250,11175590,12.85
9885032,9985726,2951,1032850,11018576,10.34
9885033,9973545,4016,1405600,11379145,14.09
9885034,9978546,4652,1628200,11606746,16.32
9885035,2925667,1363,477050,3402717,16.31
9885036,9988847,3783,1324050,11312897,13.26
9885037,9987632,2918,1021300,11008932,10.23
9885038,9206813,5163,1807050,11013863,19.63
9885039,9639247,1645,575750,10214997,5.97
9885040,9970458,2609,913150,10883608,9.16
9885041,9792232,3246,1136100,10928332,11.60
9885042,9960742,5242,1834700,11795442,18.42
9885043,9030698,1973,690550,9721248,7.65
9885044,9542332,4366,1528100,11070432,16.01
9885045,9931319,5696,1993600,11924919,20.07
9885046,9952077,4696,1643600,11595677,16.52
9885047,3845860,1270,444500,4290360,11.56
9885048,3153702,1201,420350,3574052,13.33
9885049,9852156,4806,1682100,11534256,17.07
9885051,9919546,5448,1906800,11826346,19.22
9885052,9925978,2674,935900,10861878,9.43
9885053,8166105,2464,862400,9028505,10.56
9885054,290117,263,92050,382167,31.73
9885055,9933771,4785,1674750,11608521,16.86
9885056,9908026,8614,3014900,12922926,30.43
9885057,9450146,4386,1535100,10985246,16.24
9885058,9613680,4763,1667050,11280730,17.34
9885059,9965138,4830,1690500,11655638,16.96
9885060,9904796,6064,2122400,12027196,21.43
9885061,2305401,1701,595350,2900751,25.82
9885062,9928034,2199,769650,10697684,7.75
9885063,9942663,5868,2053800,11996463,20.66
9885064,9960869,3525,1233750,11194619,12.39
9885065,1083086,1013,354550,1437636,32.74
9885066,6072727,3326,1164100,7236827,19.17
9885067,9930067,3880,1358000,11288067,13.68
9885068,9931036,5451,1907850,11838886,19.21
9885069,9829645,2927,1024450,10854095,10.42
9885070,9947362,1581,553350,10500712,5.56
9885071,9693841,3273,1145550,10839391,11.82
9885072,9951390,5148,1801800,11753190,18.11
9885073,9956934,2257,789950,10746884,7.93
9885074,9968837,2780,973000,10941837,9.76
9885075,9952754,3598,1259300,11212054,12.65
9885076,9972791,4915,1720250,11693041,17.25
9885077,9967743,3572,1250200,11217943,12.54
9885078,5228342,3187,1115450,6343792,21.33
9885079,3890302,1512,529200,4419502,13.60
9885080,9978175,1728,604800,10582975,6.06
9885081,9982038,670,234500,10216538,2.35
9885082,9959940,3751,1312850,11272790,13.18
9885083,9949185,6523,2283050,12232235,22.95
9885084,9974495,6225,2178750,12153245,21.84
9885085,9967293,2463,862050,10829343,8.65
9885086,9934351,3791,1326850,11261201,13.36
9885087,1266332,412,144200,1410532,11.39
9885089,9941068,1598,559300,10500368,5.63
9885090,9411527,3816,1335600,10747127,14.19
9885092,2443536,877,306950,2750486,12.56
9885093,9898072,4413,1544550,11442622,15.60
9885094,9953730,3119,1091650,11045380,10.97
9885095,9945861,5541,1939350,11885211,19.50
9885096,9960741,3892,1362200,11322941,13.68
9885097,9055390,1408,492800,9548190,5.44
9885098,9968376,4147,1451450,11419826,14.56
9885099,9982638,3341,1169350,11151988,11.71
9885100,9978488,4160,1456000,11434488,14.59
9885101,8878627,3221,1127350,10005977,12.70
9885102,9976612,5983,2094050,12070662,20.99
9885103,6663399,2858,1000300,7663699,15.01
9885104,9982009,2731,955850,10937859,9.58
9885105,9993229,4109,1438150,11431379,14.39
9885106,9982495,4690,1641500,11623995,16.44
9885107,9964474,3899,1364650,11329124,13.70
9885108,9944885,4513,1579550,11524435,15.88
9885109,9929452,588,205800,10135252,2.07
9885110,9946077,4102,1435700,11381777,14.43
9885111,9950881,3538,1238300,11189181,12.44
9885113,2799339,972,340200,3139539,12.15
9885114,9940335,5099,1784650,11724985,17.95
9885115,9921560,3718,1301300,11222860,13.12
9885116,9930130,6097,2133950,12064080,21.49
9885117,9925680,1205,421750,10347430,4.25
9885118,9931307,4762,1666700,11598007,16.78
9885119,9924197,3593,1257550,11181747,12.67
9885120,432690,217,75950,508640,17.55
9885121,9920634,4885,1709750,11630384,17.23
9885122,2164800,878,307300,2472100,14.20
9885123,4082512,632,221200,4303712,5.42
9885124,9687425,4940,1729000,11416425,17.85
9885125,9521699,3878,1357300,10878999,14.25
9885126,2239596,645,225750,2465346,10.08
9885127,9948734,5193,1817550,11766284,18.27
9885128,9945612,6554,2293900,12239512,23.06
9885129,9948634,5952,2083200,12031834,20.94
9885130,9856266,4369,1529150,11385416,15.51
9885131,9956851,4358,1525300,11482151,15.32
9885132,1209228,17,5950,1215178,0.49
9885133,196634,98,34300,230934,17.44
9885134,8724837,3549,1242150,9966987,14.24
9885135,8733426,5740,2009000,10742426,23.00
9885136,9945561,4077,1426950,11372511,14.35
9885137,9653966,3650,1277500,10931466,13.23
9885138,9949189,4360,1526000,11475189,15.34
9885139,4799662,1071,374850,5174512,7.81
9885140,8755305,4228,1479800,10235105,16.90
9885141,9954210,3278,1147300,11101510,11.53
9885142,672752,259,90650,763402,13.47
9885143,9459616,4744,1660400,11120016,17.55
9885144,9961723,1137,397950,10359673,3.99
9885145,9959575,4749,1662150,11621725,16.69
9885146,9973361,4011,1403850,11377211,14.08
9885147,1440638,916,320600,1761238,22.25
9885148,9986979,6950,2432500,12419479,24.36
9885149,9999483,4579,1602650,11602133,16.03
9885150,8925814,4817,1685950,10611764,18.89
9885151,9537214,4922,1722700,11259914,18.06
9885152,9983682,5583,1954050,11937732,19.57
9885153,9982330,4371,1529850,11512180,15.33
9885154,9983641,2602,910700,10894341,9.12
9885155,282273,19,6650,288923,2.36
9885156,750922,245,85750,836672,11.42
9885157,9969665,3221,1127350,11097015,11.31
9885158,2973938,1808,632800,3606738,21.28
9885159,9979147,5127,1794450,11773597,17.98
9885160,9972542,1196,418600,10391142,4.20
9885161,9987493,5027,1759450,11746943,17.62
9885162,9382528,4179,1462650,10845178,15.59
9885163,9981065,3874,1355900,11336965,13.58
9885164,9980447,4988,1745800,11726247,17.49
9885165,840459,968,338800,1179259,40.31
9885166,9973502,5463,1912050,11885552,19.17
9885167,9960834,4335,1517250,11478084,15.23
9885168,8978511,4315,1510250,10488761,16.82
9885169,9971058,901,315350,10286408,3.16
9885171,9978082,3052,1068200,11046282,10.71
9885172,2745587,862,301700,3047287,10.99
9885173,256726,133,46550,303276,18.13
9885174,9975365,4435,1552250,11527615,15.56
9885175,1068532,374,130900,1199432,12.25
9885177,3928284,2413,844550,4772834,21.50
9885178,9968058,4155,1454250,11422308,14.59
9885179,9960603,5527,1934450,11895053,19.42
9885180,9970986,4928,1724800,11695786,17.30
9885181,756696,510,178500,935196,23.59
9885182,9969584,4634,1621900,11591484,16.27
9885183,9986246,3212,1124200,11110446,11.26
9885185,8331186,2187,765450,9096636,9.19
9885186,279953,253,88550,368503,31.63
9885187,9979135,351,122850,10101985,1.23
9885188,9982954,5300,1855000,11837954,18.58
9885189,9830089,6054,2118900,11948989,21.56
9885190,9970095,1951,682850,10652945,6.85
9885191,9985082,3514,1229900,11214982,12.32
9885192,9991866,1091,381850,10373716,3.82
9885193,976002,682,238700,1214702,24.46
9885194,9964212,3055,1069250,11033462,10.73
9885195,4907782,1664,582400,5490182,11.87
9885196,9965938,6417,2245950,12211888,22.54
9885197,9974371,5274,1845900,11820271,18.51
9885198,9967858,3908,1367800,11335658,13.72
9885199,5940412,2383,834050,6774462,14.04
9885200,9990941,4110,1438500,11429441,14.40
9885201,9959767,3235,1132250,11092017,11.37
9885202,1008768,612,214200,1222968,21.23
9885203,9966917,1425,498750,10465667,5.00
9885204,9940557,5342,1869700,11810257,18.81
9885205,9989289,5739,2008650,11997939,20.11
9885206,9985516,3689,1291150,11276666,12.93
9885207,9988443,3787,1325450,11313893,13.27
9885208,9968878,2686,940100,10908978,9.43
9885209,9984555,2017,705950,10690505,7.07
9885210,9988878,2367,828450,10817328,8.29
9885212,2946848,1105,386750,3333598,13.12
9885213,9963766,917,320950,10284716,3.22
9885214,9684359,3662,1281700,10966059,13.23
9885215,9950188,880,308000,10258188,3.10
9885216,9956486,1425,498750,10455236,5.01
9885218,9950977,3890,1361500,11312477,13.68
9885219,9943178,2362,826700,10769878,8.31
9885220,9940209,4716,1650600,11590809,16.61
9885221,9953647,3416,1195600,11149247,12.01
9885222,9950984,2411,843850,10794834,8.48
9885223,9957619,4723,1653050,11610669,16.60
9885224,6139472,3377,1181950,7321422,19.25
9885225,9970671,3639,1273650,11244321,12.77
9885226,9973678,5470,1914500,11888178,19.20
9885227,9966543,1726,604100,10570643,6.06
9885228,9952003,4568,1598800,11550803,16.07
9885229,1655637,518,181300,1836937,10.95
9885230,237274,110,38500,275774,16.23
9885231,9955724,4638,1623300,11579024,16.31
9885232,9960056,4395,1538250,11498306,15.44
9885233,9959461,2391,836850,10796311,8.40
9885234,9972152,4477,1566950,11539102,15.71
9885235,9878854,3554,1243900,11122754,12.59
9885236,2821279,680,238000,3059279,8.44
9885237,9974354,6482,2268700,12243054,22.75
9885238,9976344,4266,1493100,11469444,14.97
9885239,9992033,1671,584850,10576883,5.85
9885240,9996863,2822,987700,10984563,9.88
9885241,9980673,4825,1688750,11669423,16.92
9885242,9960864,1883,659050,10619914,6.62
9885243,9976914,3319,1161650,11138564,11.64
9885244,9987821,2651,927850,10915671,9.29
9885245,9996952,5486,1920100,11917052,19.21
9885246,9996196,4912,1719200,11715396,17.20
9885247,9974917,2700,945000,10919917,9.47
9885248,9977296,3352,1173200,11150496,11.76
9885249,9998055,4229,1480150,11478205,14.80
9885250,1014849,235,82250,1097099,8.10
9885251,9968893,4022,1407700,11376593,14.12
9885252,4737204,1411,493850,5231054,10.42
9885253,3162787,715,250250,3413037,7.91
9885254,9983964,3874,1355900,11339864,13.58
9885256,9731611,1767,618450,10350061,6.36
9885257,9980059,4012,1404200,11384259,14.07
9885258,9980758,1455,509250,10490008,5.10
9885259,9975601,4669,1634150,11609751,16.38
9885260,9979756,1621,567350,10547106,5.69
9885261,282014,161,56350,338364,19.98
9885262,9981816,817,285950,10267766,2.86
9885263,9993235,2876,1006600,10999835,10.07
9885264,9249881,2203,771050,10020931,8.34
9885265,9983082,1633,571550,10554632,5.73
9885266,9979366,5145,1800750,11780116,18.04
9885267,9988466,2303,806050,10794516,8.07
9885268,9984840,2853,998550,10983390,10.00
9885269,9977879,5052,1768200,11746079,17.72
9885270,9984381,5104,1786400,11770781,17.89
9885271,9694562,2358,825300,10519862,8.51
9885272,9387617,1774,620900,10008517,6.61
9885273,9981842,2962,1036700,11018542,10.39
9885274,9629371,4124,1443400,11072771,14.99
9885275,9621288,1007,352450,9973738,3.66
9885276,9975075,1390,486500,10461575,4.88
9885277,9977854,4201,1470350,11448204,14.74
9885278,9966592,1571,549850,10516442,5.52
9885279,9969839,3584,1254400,11224239,12.58
9885280,9990097,3163,1107050,11097147,11.08
9885281,9990695,1600,560000,10550695,5.61
9885282,9981542,1791,626850,10608392,6.28
9885283,9984573,3477,1216950,11201523,12.19
9885284,2850277,1201,420350,3270627,14.75
9885285,9967381,2567,898450,10865831,9.01
9885286,9970564,4846,1696100,11666664,17.01
9885287,9976962,3929,1375150,11352112,13.78
9885288,9968125,2445,855750,10823875,8.58
9885289,9976053,4717,1650950,11627003,16.55
9885290,9982011,995,348250,10330261,3.49
9885291,9993707,1623,568050,10561757,5.68
9885292,9998989,5510,1928500,11927489,19.29
9885293,9987117,1460,511000,10498117,5.12
9885294,9982644,3343,1170050,11152694,11.72
9885295,1712861,727,254450,1967311,14.86
9885296,9998438,3455,1209250,11207688,12.09
9885297,9993457,920,322000,10315457,3.22
9885298,9970965,5229,1830150,11801115,18.35
9885299,9994593,3500,1225000,11219593,12.26
9885300,9995868,4578,1602300,11598168,16.03
9885301,9978992,5761,2016350,11995342,20.21
9885302,9979891,1345,470750,10450641,4.72
9885304,9985067,4027,1409450,11394517,14.12
9885305,9977107,1362,476700,10453807,4.78
9885306,9980409,3638,1273300,11253709,12.76
9885307,9993043,2689,941150,10934193,9.42
9885308,9982941,2023,708050,10690991,7.09
9885309,9988753,1020,357000,10345753,3.57
9885311,9989177,2280,798000,10787177,7.99
9885312,9983207,3706,1297100,11280307,12.99
9885313,9973183,2985,1044750,11017933,10.48
9885314,9984845,4429,1550150,11534995,15.53
9885315,8670973,4974,1740900,10411873,20.08
9885316,5894897,2266,793100,6687997,13.45
9885317,9852412,4251,1487850,11340262,15.10
9885318,9969838,4409,1543150,11512988,15.48
9885320,9988112,2448,856800,10844912,8.58
9885321,980186,574,200900,1181086,20.50
9885322,9964334,3961,1386350,11350684,13.91
9885323,9984007,3170,1109500,11093507,11.11
9885324,9963731,4816,1685600,11649331,16.92
9885325,9980674,1133,396550,10377224,3.97
9885326,9985819,4894,1712900,11698719,17.15
9885327,9980080,5431,1900850,11880930,19.05
9885329,9980996,4945,1730750,11711746,17.34
9885330,9974964,681,238350,10213314,2.39
9885331,9987821,2104,736400,10724221,7.37
9885332,9980096,4770,1669500,11649596,16.73
9885333,9988602,1297,453950,10442552,4.54
9885334,926510,571,199850,1126360,21.57
9885335,9986421,3271,1144850,11131271,11.46
9885336,1961578,834,291900,2253478,14.88
9885338,9964568,5129,1795150,11759718,18.02
9885339,1642054,735,257250,1899304,15.67
9885340,9971902,1944,680400,10652302,6.82
9885341,9949214,1033,361550,10310764,3.63
9885342,9958046,6431,2250850,12208896,22.60
9885343,8410847,1183,414050,8824897,4.92
9885344,8954642,3587,1255450,10210092,14.02
9885345,9970986,4727,1654450,11625436,16.59
9885346,9963172,1326,464100,10427272,4.66
9885347,9984663,1245,435750,10420413,4.36
9885348,9970000,2497,873950,10843950,8.77
9885349,9978520,6259,2190650,12169170,21.95
9885350,9967943,4222,1477700,11445643,14.82
9885351,9982194,2667,933450,10915644,9.35
9885352,9954704,5474,1915900,11870604,19.25
9885353,9969617,3865,1352750,11322367,13.57
9885354,9964909,4195,1468250,11433159,14.73
9885355,9978532,4717,1650950,11629482,16.55
9885356,9980585,2650,927500,10908085,9.29
9885357,9956489,4130,1445500,11401989,14.52
9885358,599026,268,93800,692826,15.66
9885360,9935237,1578,552300,10487537,5.56
9885361,9932442,4265,1492750,11425192,15.03
9885362,9910120,2764,967400,10877520,9.76
9885363,370933,237,82950,453883,22.36
9885364,9947233,4315,1510250,11457483,15.18
9885365,9937907,4062,1421700,11359607,14.31
9885366,9939172,3561,1246350,11185522,12.54
9885367,9708512,1430,500500,10209012,5.16
9885368,9917599,1858,650300,10567899,6.56
9885369,9904500,4065,1422750,11327250,14.36
9885370,9913089,3448,1206800,11119889,12.17
9885371,9920226,2449,857150,10777376,8.64
9885373,9919877,7456,2609600,12529477,26.31
9885374,9901117,4089,1431150,11332267,14.45
9885375,9936028,5460,1911000,11847028,19.23
9885377,9915498,5270,1844500,11759998,18.60
9885378,9400296,1582,553700,9953996,5.89
9885380,9921729,3577,1251950,11173679,12.62
9885381,9923727,1086,380100,10303827,3.83
9885382,9920509,1560,546000,10466509,5.50
9885383,9937730,1160,406000,10343730,4.09
9885384,9931402,1692,592200,10523602,5.96
9885385,9946472,1199,419650,10366122,4.22
9885386,9950373,4842,1694700,11645073,17.03
9885387,9961313,2355,824250,10785563,8.27
9885388,9959711,2360,826000,10785711,8.29
9885389,9968741,2296,803600,10772341,8.06
9885390,9964686,5991,2096850,12061536,21.04
9885391,9971750,1209,423150,10394900,4.24
9885392,9988039,4211,1473850,11461889,14.76
9885393,9990323,1130,395500,10385823,3.96
9885394,9778553,3923,1373050,11151603,14.04
9885395,9847516,3360,1176000,11023516,11.94
9885397,783284,352,123200,906484,15.73
9885398,9378526,3160,1106000,10484526,11.79
9885399,2238275,1014,354900,2593175,15.86
9885400,2986347,943,330050,3316397,11.05
9885401,9975445,4297,1503950,11479395,15.08
9885402,9970341,2896,1013600,10983941,10.17
9885403,9984666,7189,2516150,12500816,25.20
9885404,9984502,807,282450,10266952,2.83
9885405,277034,66,23100,300134,8.34
9885406,9920954,5206,1822100,11743054,18.37
9885407,9933449,1306,457100,10390549,4.60
9885408,9974902,2134,746900,10721802,7.49
9885409,9979915,5026,1759100,11739015,17.63
9885410,9975119,1079,377650,10352769,3.79
9885411,988736,279,97650,1086386,9.88
9885412,387237,95,33250,420487,8.59
9885413,9982953,6665,2332750,12315703,23.37
9885414,9998946,1806,632100,10631046,6.32
9885415,9979580,4993,1747550,11727130,17.51
9885416,9934821,4254,1488900,11423721,14.99
9885417,9925152,1557,544950,10470102,5.49
9885418,9982090,2422,847700,10829790,8.49
9885419,1795581,769,269150,2064731,14.99
9885420,9964907,6175,2161250,12126157,21.69
9885421,3035291,1571,549850,3585141,18.12
9885422,9969192,2156,754600,10723792,7.57
9885423,9984363,2032,711200,10695563,7.12
9885424,9989127,4152,1453200,11442327,14.55
9885425,9977692,1272,445200,10422892,4.46
9885426,9982522,2591,906850,10889372,9.08
9885427,9985163,2256,789600,10774763,7.91
9885428,9992970,4920,1722000,11714970,17.23
9885429,9986096,4852,1698200,11684296,17.01
9885430,1233137,206,72100,1305237,5.85
9885431,6417800,1943,680050,7097850,10.60
9885432,9969680,2176,761600,10731280,7.64
9885433,9977659,5239,1833650,11811309,18.38
9885435,9954291,5249,1837150,11791441,18.46
9885436,9972164,4177,1461950,11434114,14.66
9885437,9972760,2146,751100,10723860,7.53
9885438,9973030,3715,1300250,11273280,13.04
9885439,9970722,1063,372050,10342772,3.73
9885440,9983856,3852,1348200,11332056,13.50
9885441,9983936,2152,753200,10737136,7.54
9885442,9980881,1685,589750,10570631,5.91
9885443,9993155,3166,1108100,11101255,11.09
9885444,1343995,1025,358750,1702745,26.69
9885445,9989649,3894,1362900,11352549,13.64
9885446,1365441,567,198450,1563891,14.53
9885447,9987509,2188,765800,10753309,7.67
9885448,9979737,3907,1367450,11347187,13.70
9885449,2635729,1510,528500,3164229,20.05
9885450,9999417,5404,1891400,11890817,18.92
9885451,9987698,966,338100,10325798,3.39
9885452,9984921,1788,625800,10610721,6.27
9885453,9980053,1144,400400,10380453,4.01
9885454,5467938,4304,1506400,6974338,27.55
9885455,9975962,3633,1271550,11247512,12.75
9885456,9065158,2265,792750,9857908,8.75
9885457,9993314,4312,1509200,11502514,15.10
9885458,1265110,259,90650,1355760,7.17
9885459,9967375,5395,1888250,11855625,18.94
9885460,9961082,4859,1700650,11661732,17.07
9885461,9960010,1833,641550,10601560,6.44
9885462,1501422,1372,480200,1981622,31.98
9885463,9955192,2085,729750,10684942,7.33
9885464,4351201,2613,914550,5265751,21.02
9885465,9953688,4107,1437450,11391138,14.44
9885466,9951781,7093,2482550,12434331,24.95
9885467,175936,93,32550,208486,18.50
9885468,9951065,6962,2436700,12387765,24.49
9885469,4109714,1756,614600,4724314,14.95
9885470,9874390,9224,3228400,13102790,32.69
9885471,9971555,5477,1916950,11888505,19.22
9885472,9975507,4379,1532650,11508157,15.36
9885473,1373082,945,330750,1703832,24.09
9885474,9972384,4672,1635200,11607584,16.40
9885475,9963884,1507,527450,10491334,5.29
9885476,9803094,5213,1824550,11627644,18.61
9885477,9709593,4992,1747200,11456793,17.99
9885478,9956690,2475,866250,10822940,8.70
9885479,9963345,5082,1778700,11742045,17.85
9885480,267401,76,26600,294001,9.95
9885481,9955958,4091,1431850,11387808,14.38
9885482,9966486,6689,2341150,12307636,23.49
9885483,9980763,4260,1491000,11471763,14.94
9885484,9971158,1759,615650,10586808,6.17
9885485,9977038,5634,1971900,11948938,19.76
9885486,9963454,6223,2178050,12141504,21.86
9885487,9983262,1359,475650,10458912,4.76
9885488,9986571,6653,2328550,12315121,23.32
9885490,9981493,7806,2732100,12713593,27.37
9885491,9989701,5547,1941450,11931151,19.43
9885492,2724239,1067,373450,3097689,13.71
9885493,2737199,1609,563150,3300349,20.57
9885494,9969558,4594,1607900,11577458,16.13
9885495,5889095,2691,941850,6830945,15.99
9885496,9955855,5764,2017400,11973255,20.26
9885497,9902313,4930,1725500,11627813,17.43
9885498,9971450,1025,358750,10330200,3.60
9885499,9984930,5130,1795500,11780430,17.98
9885500,9991489,1004,351400,10342889,3.52
9885501,1797675,597,208950,2006625,11.62
9885502,9998696,2700,945000,10943696,9.45
9885503,9988289,1257,439950,10428239,4.40
9885504,9986105,2362,826700,10812805,8.28
9885505,9992657,1629,570150,10562807,5.71
9885506,9995955,4714,1649900,11645855,16.51
9885507,3366588,2076,726600,4093188,21.58
9885508,9980368,1997,698950,10679318,7.00
9885509,9985682,1556,544600,10530282,5.45
9885510,9967782,3122,1092700,11060482,10.96
9885511,9966503,1968,688800,10655303,6.91
9885512,9724943,4971,1739850,11464793,17.89
9885513,9978134,2257,789950,10768084,7.92
9885514,9973066,1256,439600,10412666,4.41
9885515,9999401,1529,535150,10534551,5.35
9885516,9983198,2050,717500,10700698,7.19
9885517,9989439,3167,1108450,11097889,11.10
9885518,3122301,643,225050,3347351,7.21
9885519,2723683,934,326900,3050583,12.00
9885520,9963725,2391,836850,10800575,8.40
9885521,9979243,5719,2001650,11980893,20.06
9885522,2385348,1438,503300,2888648,21.10
9885523,9972329,5752,2013200,11985529,20.19
9885524,9992555,2016,705600,10698155,7.06
9885525,9981269,3996,1398600,11379869,14.01
9885526,9996044,3341,1169350,11165394,11.70
9885527,9999585,3136,1097600,11097185,10.98
9885528,9972902,3698,1294300,11267202,12.98
9885529,9977855,3705,1296750,11274605,13.00
9885530,9986368,4542,1589700,11576068,15.92
9885531,9740548,2795,978250,10718798,10.04
9885532,9494512,6021,2107350,11601862,22.20
9885533,722252,855,299250,1021502,41.43
9885534,9979296,4065,1422750,11402046,14.26
9885535,4564394,3648,1276800,5841194,27.97
9885536,9987391,4089,1431150,11418541,14.33
9885537,9701571,3775,1321250,11022821,13.62
9885538,9956097,3821,1337350,11293447,13.43
9885539,9889289,3974,1390900,11280189,14.06
9885540,9956924,2956,1034600,10991524,10.39
9885541,9972733,1897,663950,10636683,6.66
9885542,9972376,4361,1526350,11498726,15.31
9885543,9800532,5846,2046100,11846632,20.88
9885544,9994485,4186,1465100,11459585,14.66
9885545,9981976,3872,1355200,11337176,13.58
9885546,1560912,689,241150,1802062,15.45
9885547,9975926,2501,875350,10851276,8.77
9885548,9967455,3893,1362550,11330005,13.67
9885549,9979168,4763,1667050,11646218,16.71
9885550,9971857,1957,684950,10656807,6.87
9885551,9978734,1261,441350,10420084,4.42
9885552,1212758,539,188650,1401408,15.56
9885553,1335008,1362,476700,1811708,35.71
9885554,9952137,3871,1354850,11306987,13.61
9885555,9971615,3040,1064000,11035615,10.67
9885557,9988747,6473,2265550,12254297,22.68
9885558,9972963,975,341250,10314213,3.42
9885559,2948800,1607,562450,3511250,19.07
9885560,9419014,4150,1452500,10871514,15.42
9885561,9950962,1276,446600,10397562,4.49
9885562,9975727,6103,2136050,12111777,21.41
9885563,719760,54,18900,738660,2.63
9885564,705927,365,127750,833677,18.10
9885565,9967837,4123,1443050,11410887,14.48
9885566,9946670,2073,725550,10672220,7.29
9885567,9964993,1047,366450,10331443,3.68
9885568,643716,976,341600,985316,53.07
9885569,9936016,2395,838250,10774266,8.44
9885570,2235971,804,281400,2517371,12.59
9885571,9932059,5468,1913800,11845859,19.27
9885572,9937392,4371,1529850,11467242,15.39
9885573,4331107,1047,366450,4697557,8.46
9885574,9915139,4641,1624350,11539489,16.38
9885575,9916213,6160,2156000,12072213,21.74
9885576,9916517,1846,646100,10562617,6.52
9885577,6468491,2923,1023050,7491541,15.82
9885578,9926045,6838,2393300,12319345,24.11
9885579,3973860,1277,446950,4420810,11.25
9885580,9945326,6195,2168250,12113576,21.80
9885581,9934440,866,303100,10237540,3.05
9885582,9944776,2659,930650,10875426,9.36
9885583,9599631,1402,490700,10090331,5.11
9885584,9941485,5735,2007250,11948735,20.19
9885585,9935882,2215,775250,10711132,7.80
9885586,5471405,1555,544250,6015655,9.95
9885587,5046605,1902,665700,5712305,13.19
9885588,9916173,5920,2072000,11988173,20.90
9885589,9903129,5760,2016000,11919129,20.36
9885590,9914053,1288,450800,10364853,4.55
9885591,9912810,1546,541100,10453910,5.46
9885592,9914272,5799,2029650,11943922,20.47
9885593,3199040,2069,724150,3923190,22.64
9885595,9917123,3255,1139250,11056373,11.49
9885596,9889984,1010,353500,10243484,3.57
9885597,9919948,6674,2335900,12255848,23.55
9885598,9934113,5302,1855700,11789813,18.68
9885599,9913038,5153,1803550,11716588,18.19
9885600,9935928,2487,870450,10806378,8.76
9885601,9926263,2179,762650,10688913,7.68
9885602,9919418,2646,926100,10845518,9.34
9885603,9940472,5268,1843800,11784272,18.55
9885604,9949925,1876,656600,10606525,6.60
9885605,141347,54,18900,160247,13.37
9885606,9933539,1329,465150,10398689,4.68
9885607,9955262,2083,729050,10684312,7.32
9885608,9963682,1029,360150,10323832,3.61
9885609,582320,380,133000,715320,22.84
9885610,9962340,5360,1876000,11838340,18.83
9885611,9967811,1947,681450,10649261,6.84
9885613,9958401,3152,1103200,11061601,11.08
9885614,2609236,1244,435400,3044636,16.69
9885615,8942186,1438,503300,9445486,5.63
9885616,9321089,2643,925050,10246139,9.92
9885617,9698426,2595,908250,10606676,9.36
9885618,9946386,3383,1184050,11130436,11.90
9885619,9978802,1674,585900,10564702,5.87
9885620,9993035,3071,1074850,11067885,10.76
9885621,9971768,6563,2297050,12268818,23.04
9885622,9986889,1983,694050,10680939,6.95
9885623,9255327,1679,587650,9842977,6.35
9885624,9981823,4395,1538250,11520073,15.41
9885625,303337,233,81550,384887,26.88
9885626,9962537,5883,2059050,12021587,20.67
9885627,9970468,3338,1168300,11138768,11.72
9885628,9980514,5375,1881250,11861764,18.85
9885629,5521571,2208,772800,6294371,14.00
9885630,9977968,6535,2287250,12265218,22.92
9885631,9997422,2350,822500,10819922,8.23
9885632,9981716,3234,1131900,11113616,11.34
9885633,9965496,1369,479150,10444646,4.81
9885634,3700757,777,271950,3972707,7.35
9885635,9980015,5003,1751050,11731065,17.55
9885636,8370956,907,317450,8688406,3.79
9885637,1634456,729,255150,1889606,15.61
9885638,9940239,5577,1951950,11892189,19.64
9885639,9945827,1010,353500,10299327,3.55
9885640,9934946,3037,1062950,10997896,10.70
9885641,9940486,1675,586250,10526736,5.90
9885642,9953510,3801,1330350,11283860,13.37
9885643,9948850,3052,1068200,11017050,10.74
9885644,9962255,2572,900200,10862455,9.04
9885645,9973170,4820,1687000,11660170,16.92
9885646,9979699,4133,1446550,11426249,14.49
9885648,9502268,2549,892150,10394418,9.39
9885649,4805012,2086,730100,5535112,15.19
9885651,9948739,3554,1243900,11192639,12.50
9885652,9944126,3254,1138900,11083026,11.45
9885653,9960159,3691,1291850,11252009,12.97
9885655,9978483,814,284900,10263383,2.86
9885656,9981258,1103,386050,10367308,3.87
9885657,9977846,3015,1055250,11033096,10.58
9885658,9995530,3114,1089900,11085430,10.90
9885659,9966645,1179,412650,10379295,4.14
9885660,2346936,1334,466900,2813836,19.89
9885661,9987122,2552,893200,10880322,8.94
9885662,9975852,2275,796250,10772102,7.98
9885663,9966025,5021,1757350,11723375,17.63
9885664,9987732,3915,1370250,11357982,13.72
9885665,9982678,2742,959700,10942378,9.61
9885666,9989671,8170,2859500,12849171,28.62
9885667,9984401,2975,1041250,11025651,10.43
9885668,1202504,543,190050,1392554,15.80
9885669,9993178,3819,1336650,11329828,13.38
9885670,9984038,5492,1922200,11906238,19.25
9885671,4241799,2083,729050,4970849,17.19
9885672,1405895,1041,364350,1770245,25.92
9885673,3395778,1420,497000,3892778,14.64
9885674,9980197,3979,1392650,11372847,13.95
9885675,9887546,4031,1410850,11298396,14.27
9885677,377199,253,88550,465749,23.48
9885678,9974496,2041,714350,10688846,7.16
9885679,9973658,4776,1671600,11645258,16.76
9885680,9985403,2707,947450,10932853,9.49
9885681,9976940,2751,962850,10939790,9.65
9885682,9980913,4010,1403500,11384413,14.06
9885683,2958656,1830,640500,3599156,21.65
9885684,9982099,5395,1888250,11870349,18.92
9885685,9957294,6301,2205350,12162644,22.15
9885686,420175,365,127750,547925,30.40
9885687,9958170,6623,2318050,12276220,23.28
9885688,9977802,3692,1292200,11270002,12.95
9885689,9984541,2438,853300,10837841,8.55
9885690,3833346,2274,795900,4629246,20.76
9885691,9970866,4525,1583750,11554616,15.88
9885692,9967383,4691,1641850,11609233,16.47
9885693,9981731,2914,1019900,11001631,10.22
9885694,9988134,4329,1515150,11503284,15.17
9885695,9983530,3168,1108800,11092330,11.11
9885696,9673831,2997,1048950,10722781,10.84
9885697,9733839,5290,1851500,11585339,19.02
9885698,1941669,975,341250,2282919,17.58
9885699,9977820,4846,1696100,11673920,17.00
9885700,391748,200,70000,461748,17.87
9885701,9990184,4995,1748250,11738434,17.50
9885702,9997276,5611,1963850,11961126,19.64
9885703,9981976,3857,1349950,11331926,13.52
9885704,9981481,2533,886550,10868031,8.88
9885705,9971324,2600,910000,10881324,9.13
9885706,9993975,1735,607250,10601225,6.08
9885707,9973939,3391,1186850,11160789,11.90
9885708,9960144,3284,1149400,11109544,11.54
9885709,9969913,2378,832300,10802213,8.35
9885710,9975642,4323,1513050,11488692,15.17
9885711,7457850,2816,985600,8443450,13.22
9885712,9968264,5903,2066050,12034314,20.73
9885713,9966041,5783,2024050,11990091,20.31
9885714,9971616,3440,1204000,11175616,12.07
9885715,901872,719,251650,1153522,27.90
9885716,9976282,5871,2054850,12031132,20.60
9885717,8422374,4608,1612800,10035174,19.15
9885718,9415357,5101,1785350,11200707,18.96
9885719,9978701,2480,868000,10846701,8.70
9885720,9993307,2023,708050,10701357,7.09
9885721,3500594,504,176400,3676994,5.04
9885722,8354291,4759,1665650,10019941,19.94
9885723,9987352,3842,1344700,11332052,13.46
9885724,9923721,5207,1822450,11746171,18.36
9885725,9758003,4373,1530550,11288553,15.69
9885726,9997468,6961,2436350,12433818,24.37
9885727,242150,79,27650,269800,11.42
9885728,9977204,4057,1419950,11397154,14.23
9885729,9971733,2187,765450,10737183,7.68
9885730,9960248,2969,1039150,10999398,10.43
9885731,9948285,3934,1376900,11325185,13.84
9885732,247841,184,64400,312241,25.98
9885733,9973563,5135,1797250,11770813,18.02
9885734,9975608,6372,2230200,12205808,22.36
9885735,3907862,187,65450,3973312,1.67
9885736,2811459,1343,470050,3281509,16.72
9885737,5464932,3006,1052100,6517032,19.25
9885738,9974855,6062,2121700,12096555,21.27
9885739,150519,80,28000,178519,18.60
9885740,9953606,4161,1456350,11409956,14.63
9885741,9962194,1237,432950,10395144,4.35
9885742,531662,363,127050,658712,23.90
9885743,9926303,2507,877450,10803753,8.84
9885744,9943866,5995,2098250,12042116,21.10
9885745,9956265,2522,882700,10838965,8.87
9885746,9932141,5315,1860250,11792391,18.73
9885747,9947470,2773,970550,10918020,9.76
9885748,9943425,1473,515550,10458975,5.18
9885749,9962508,1884,659400,10621908,6.62
9885750,340462,248,86800,427262,25.49
9885751,1939754,1486,520100,2459854,26.81
9885752,9966620,4261,1491350,11457970,14.96
9885753,9953033,1896,663600,10616633,6.67
9885754,9956599,1376,481600,10438199,4.84
9885755,2554545,1761,616350,3170895,24.13
9885756,9966159,3713,1299550,11265709,13.04
9885757,420208,239,83650,503858,19.91
9885758,9857795,5228,1829800,11687595,18.56
9885759,9962956,2618,916300,10879256,9.20
9885760,9967255,1436,502600,10469855,5.04
9885762,9960243,2232,781200,10741443,7.84
9885763,9970016,4345,1520750,11490766,15.25
9885764,9988727,1810,633500,10622227,6.34
9885765,9982819,240,84000,10066819,0.84
9885766,1316611,721,252350,1568961,19.17
9885767,9718965,4659,1630650,11349615,16.78
9885768,9967924,6272,2195200,12163124,22.02
9885769,1036518,1507,527450,1563968,50.89
9885770,9952441,3389,1186150,11138591,11.92
9885772,9952011,2148,751800,10703811,7.55
9885773,9953580,2819,986650,10940230,9.91
9885774,9455603,1932,676200,10131803,7.15
9885775,9285938,2287,800450,10086388,8.62
9885776,9206013,2600,910000,10116013,9.88
9885777,9968455,5836,2042600,12011055,20.49
9885778,9991810,2482,868700,10860510,8.69
9885779,9979686,3454,1208900,11188586,12.11
9885780,9928295,5318,1861300,11789595,18.75
9885781,9978312,3248,1136800,11115112,11.39
9885782,9957244,609,213150,10170394,2.14
9885783,9960283,3954,1383900,11344183,13.89
9885784,1611027,188,65800,1676827,4.08
9885785,9963808,3870,1354500,11318308,13.59
9885786,9966151,3478,1217300,11183451,12.21
9885787,9878104,5744,2010400,11888504,20.35
9885788,9957970,4528,1584800,11542770,15.91
9885789,9939962,1780,623000,10562962,6.27
9885790,9938058,2495,873250,10811308,8.79
9885791,9935444,4678,1637300,11572744,16.48
9885792,9743297,2756,964600,10707897,9.90
9885793,9942393,1048,366800,10309193,3.69
9885794,9940377,2917,1020950,10961327,10.27
9885795,5778328,4223,1478050,7256378,25.58
9885796,667258,347,121450,788708,18.20
9885797,9925177,5912,2069200,11994377,20.85
9885798,9925248,4692,1642200,11567448,16.55
9885799,9940499,1691,591850,10532349,5.95
9885800,9932639,3105,1086750,11019389,10.94
9885801,9742597,4531,1585850,11328447,16.28
9885802,9892134,4347,1521450,11413584,15.38
9885803,9935917,4013,1404550,11340467,14.14
9885804,9936703,505,176750,10113453,1.78
9885806,345306,240,84000,429306,24.33
9885807,9932070,2949,1032150,10964220,10.39
9885808,9909573,3152,1103200,11012773,11.13
9885809,9808964,842,294700,10103664,3.00
9885810,9954224,8586,3005100,12959324,30.19
9885811,9948513,653,228550,10177063,2.30
9885812,9956160,1276,446600,10402760,4.49
9885813,9946251,3073,1075550,11021801,10.81
9885814,9962817,1251,437850,10400667,4.39
9885815,768122,342,119700,887822,15.58
9885816,531252,588,205800,737052,38.74
9885817,9957543,4327,1514450,11471993,15.21
9885818,9948886,4286,1500100,11448986,15.08
9885819,9942722,4187,1465450,11408172,14.74
9885820,7814360,2255,789250,8603610,10.10
9885821,9951020,5756,2014600,11965620,20.25
9885822,3171435,1177,411950,3583385,12.99
9885823,9520199,2521,882350,10402549,9.27
9885824,9021409,4043,1415050,10436459,15.69
9885826,5059646,1841,644350,5703996,12.74
9885827,9970126,4206,1472100,11442226,14.77
9885828,9972093,2847,996450,10968543,9.99
9885829,9963702,1907,667450,10631152,6.70
9885830,8877556,2975,1041250,9918806,11.73
9885831,9982927,4458,1560300,11543227,15.63
9885832,9970444,3562,1246700,11217144,12.50
9885833,848925,388,135800,984725,16.00
9885834,2063845,958,335300,2399145,16.25
9885835,9956376,4702,1645700,11602076,16.53
9885836,26197,42,14700,40897,56.11
9885837,9934422,5929,2075150,12009572,20.89
9885838,9928955,2423,848050,10777005,8.54
9885839,9947464,2926,1024100,10971564,10.30
9885840,9941979,1474,515900,10457879,5.19
9885841,9773809,4809,1683150,11456959,17.22
9885842,9957569,3864,1352400,11309969,13.58
9885843,9964707,7238,2533300,12498007,25.42
9885844,3282144,1897,663950,3946094,20.23
9885845,9971722,4582,1603700,11575422,16.08
9885846,9978383,2016,705600,10683983,7.07
9885847,9991228,1311,458850,10450078,4.59
9885848,9978868,1578,552300,10531168,5.53
9885849,577843,629,220150,797993,38.10
9885850,9967548,3111,1088850,11056398,10.92
9885852,9945339,4326,1514100,11459439,15.22
9885853,9949345,3227,1129450,11078795,11.35
9885854,9941653,5054,1768900,11710553,17.79
9885855,9947083,2974,1040900,10987983,10.46
9885856,9951539,4040,1414000,11365539,14.21
9885857,9960330,3484,1219400,11179730,12.24
9885858,9952961,5191,1816850,11769811,18.25
9885859,249738,169,59150,308888,23.68
9885860,9949220,3411,1193850,11143070,12.00
9885861,9944200,3311,1158850,11103050,11.65
9885862,9963683,4126,1444100,11407783,14.49
9885863,9978120,5946,2081100,12059220,20.86
9885864,9973683,4312,1509200,11482883,15.13
9885865,9996170,4596,1608600,11604770,16.09
9885866,9995656,2541,889350,10885006,8.90
9885868,1866005,426,149100,2015105,7.99
9885869,9987047,6153,2153550,12140597,21.56
9885870,9986120,4491,1571850,11557970,15.74
9885871,9963240,6171,2159850,12123090,21.68
9885872,2319704,1278,447300,2767004,19.28
9885873,9963823,5652,1978200,11942023,19.85
9885874,9969944,4800,1680000,11649944,16.85
9885875,765396,120,42000,807396,5.49
9885876,9963908,3950,1382500,11346408,13.88
9885877,9976373,2893,1012550,10988923,10.15
9885878,2148619,567,198450,2347069,9.24
9885879,9980509,4241,1484350,11464859,14.87
9885880,9984161,4868,1703800,11687961,17.07
9885881,1359082,472,165200,1524282,12.16
9885882,3441592,747,261450,3703042,7.60
9885883,9976234,2904,1016400,10992634,10.19
9885885,9988948,5290,1851500,11840448,18.54
9885886,9981028,4488,1570800,11551828,15.74
9885887,9986293,407,142450,10128743,1.43
9885888,9975410,2601,910350,10885760,9.13
9885889,9975447,7062,2471700,12447147,24.78
9885890,2953492,2147,751450,3704942,25.44
9885891,9959878,3281,1148350,11108228,11.53
9885894,9928347,5126,1794100,11722447,18.07
9885895,6260643,3158,1105300,7365943,17.65
9885896,9910213,7630,2670500,12580713,26.95
9885897,9933730,2181,763350,10697080,7.68
9885898,1735350,1070,374500,2109850,21.58
9885899,9938158,2155,754250,10692408,7.59
9885900,9954573,1156,404600,10359173,4.06
9885901,1086203,518,181300,1267503,16.69
9885902,9951908,2353,823550,10775458,8.28
9885903,9937531,4787,1675450,11612981,16.86
9885904,9939705,2215,775250,10714955,7.80
9885905,9921985,6472,2265200,12187185,22.83
9885906,72273,19,6650,78923,9.20
9885907,9917419,5865,2052750,11970169,20.70
9885908,1427416,320,112000,1539416,7.85
9885909,9915104,5967,2088450,12003554,21.06
9885910,9910924,5152,1803200,11714124,18.19
9885911,907202,623,218050,1125252,24.04
9885912,9906527,4267,1493450,11399977,15.08
9885913,9915503,4293,1502550,11418053,15.15
9885914,9906070,3023,1058050,10964120,10.68
9885915,1528776,1745,610750,2139526,39.95
9885916,9934403,3956,1384600,11319003,13.94
9885917,1129790,187,65450,1195240,5.79
9885918,9908138,6128,2144800,12052938,21.65
9885919,943948,864,302400,1246348,32.04
9885920,9894983,3557,1244950,11139933,12.58
9885921,9898990,4482,1568700,11467690,15.85
9885922,9899228,4841,1694350,11593578,17.12
9885923,9925552,3758,1315300,11240852,13.25
9885924,9913895,5075,1776250,11690145,17.92
9885926,9911330,5933,2076550,11987880,20.95
9885927,1574399,1121,392350,1966749,24.92
9885928,8793475,4989,1746150,10539625,19.86
9885929,1282382,371,129850,1412232,10.13
9885930,2606368,1157,404950,3011318,15.54
9885931,9947660,5450,1907500,11855160,19.18
9885932,9947666,4026,1409100,11356766,14.17
9885933,9941255,4222,1477700,11418955,14.86
9885934,9952457,4620,1617000,11569457,16.25
9885935,4110235,1590,556500,4666735,13.54
9885936,9973427,4491,1571850,11545277,15.76
9885937,9981874,4963,1737050,11718924,17.40
9885938,9977887,3026,1059100,11036987,10.61
9885939,9994296,4174,1460900,11455196,14.62
9885940,957552,394,137900,1095452,14.40
9885941,9977262,5128,1794800,11772062,17.99
9885943,9961079,5601,1960350,11921429,19.68
9885944,2653254,349,122150,2775404,4.60
9885945,9968046,2756,964600,10932646,9.68
9885946,9981665,2028,709800,10691465,7.11
9885947,9989533,4996,1748600,11738133,17.50
9885948,9993467,1467,513450,10506917,5.14
9885949,9980540,2691,941850,10922390,9.44
9885950,9989428,1802,630700,10620128,6.31
9885951,9985228,888,310800,10296028,3.11
9885952,9795484,4088,1430800,11226284,14.61
9885953,2539106,776,271600,2810706,10.70
9885954,9967523,2526,884100,10851623,8.87
9885955,1957142,619,216650,2173792,11.07
9885956,9985336,4071,1424850,11410186,14.27
9885957,773394,655,229250,1002644,29.64
9885958,9969953,2793,977550,10947503,9.80
9885959,9972895,4634,1621900,11594795,16.26
9885960,9951590,2180,763000,10714590,7.67
9885961,9939998,5010,1753500,11693498,17.64
9885962,5503150,3978,1392300,6895450,25.30
9885963,9933114,2969,1039150,10972264,10.46
9885964,9950452,5347,1871450,11821902,18.81
9885965,259871,79,27650,287521,10.64
9885966,1281296,1943,680050,1961346,53.08
9885967,9944007,5335,1867250,11811257,18.78
9885968,9946805,4603,1611050,11557855,16.20
9885969,486016,196,68600,554616,14.11
9885970,9913335,5422,1897700,11811035,19.14
9885971,9922132,4758,1665300,11587432,16.78
9885972,9929026,5557,1944950,11873976,19.59
9885973,1396709,2038,713300,2110009,51.07
9885974,6066684,3175,1111250,7177934,18.32
9885975,9933356,3340,1169000,11102356,11.77
9885976,2073265,1999,699650,2772915,33.75
9885977,9909959,2282,798700,10708659,8.06
9885978,130418,42,14700,145118,11.27
9885979,9941766,2311,808850,10750616,8.14
9885980,9932058,2576,901600,10833658,9.08
9885982,9932801,2065,722750,10655551,7.28
9885983,9943617,3135,1097250,11040867,11.03
9885984,1189421,360,126000,1315421,10.59
9885985,3786486,1908,667800,4454286,17.64
9885986,9949382,3702,1295700,11245082,13.02
9885987,9958287,2049,717150,10675437,7.20
9885989,9964198,6262,2191700,12155898,22.00
9885990,9957748,281,98350,10056098,0.99
9885991,9929477,3462,1211700,11141177,12.20
9885992,9973155,1145,400750,10373905,4.02
9885993,9966481,6358,2225300,12191781,22.33
9885994,9989828,2607,912450,10902278,9.13
9885995,9992379,2571,899850,10892229,9.01
9885996,9970937,2250,787500,10758437,7.90
9885997,9977261,1991,696850,10674111,6.98
9885998,9984326,7514,2629900,12614226,26.34
9885999,9965797,2098,734300,10700097,7.37
9886000,9960823,3288,1150800,11111623,11.55
9886001,430593,104,36400,466993,8.45
9886002,9947963,7265,2542750,12490713,25.56
9886003,9973988,5382,1883700,11857688,18.89
9886004,9951038,4025,1408750,11359788,14.16
9886005,9957514,5960,2086000,12043514,20.95
9886006,9970599,2483,869050,10839649,8.72
9886007,9685480,1805,631750,10317230,6.52
9886008,9905353,4398,1539300,11444653,15.54
9886009,9972299,4137,1447950,11420249,14.52
9886010,2809318,2790,976500,3785818,34.76
9886011,9710226,5096,1783600,11493826,18.37
9886012,9968361,6673,2335550,12303911,23.43
9886013,9968732,4643,1625050,11593782,16.30
9886014,9961525,3464,1212400,11173925,12.17
9886015,9893438,2090,731500,10624938,7.39
9886016,9977524,2284,799400,10776924,8.01
9886017,831611,271,94850,926461,11.41
9886018,1462261,798,279300,1741561,19.10
9886019,9998511,5065,1772750,11771261,17.73
9886020,3422460,2227,779450,4201910,22.77
9886021,9960883,3484,1219400,11180283,12.24
9886022,164230,76,26600,190830,16.20
9886023,9977252,2723,953050,10930302,9.55
9886024,9947233,2130,745500,10692733,7.49
9886025,9960596,393,137550,10098146,1.38
9886028,9941032,4879,1707650,11648682,17.18
9886029,4401618,1438,503300,4904918,11.43
9886030,3538468,3371,1179850,4718318,33.34
9886031,197450,61,21350,218800,10.81
9886032,9923959,4235,1482250,11406209,14.94
9886033,4412247,1643,575050,4987297,13.03
9886034,9902328,1259,440650,10342978,4.45
9886035,9901035,4217,1475950,11376985,14.91
9886036,9907819,1354,473900,10381719,4.78
9886037,9886992,2843,995050,10882042,10.06
9886038,5884465,4582,1603700,7488165,27.25
9886039,9904166,4851,1697850,11602016,17.14
9886040,9925812,2310,808500,10734312,8.15
9886042,9906850,1217,425950,10332800,4.30
9886043,9908978,6237,2182950,12091928,22.03
9886044,9925347,3483,1219050,11144397,12.28
9886045,9913441,5243,1835050,11748491,18.51
9886046,9931387,6865,2402750,12334137,24.19
9886047,1988173,2261,791350,2779523,39.80
9886048,9934122,4479,1567650,11501772,15.78
9886049,9918421,3998,1399300,11317721,14.11
9886050,76391,74,25900,102291,33.90
9886051,9939605,4882,1708700,11648305,17.19
9886052,9944617,3656,1279600,11224217,12.87
9886053,535622,275,96250,631872,17.97
9886054,9939370,7086,2480100,12419470,24.95
9886055,9753930,2599,909650,10663580,9.33
9886056,9946251,5553,1943550,11889801,19.54
9886057,9935067,7452,2608200,12543267,26.25
9886058,4419495,2548,891800,5311295,20.18
9886059,9955225,5385,1884750,11839975,18.93
9886060,9972893,6242,2184700,12157593,21.91
9886061,9958977,4536,1587600,11546577,15.94
9886062,9972652,6023,2108050,12080702,21.14
9886063,9955442,3369,1179150,11134592,11.84
9886064,9958347,2799,979650,10937997,9.84
9886065,4067481,2916,1020600,5088081,25.09
9886066,9953070,5632,1971200,11924270,19.80
9886067,9684213,4191,1466850,11151063,15.15
9886068,9962940,3158,1105300,11068240,11.09
9886069,9966095,4061,1421350,11387445,14.26
9886070,9968497,7301,2555350,12523847,25.63
9886072,2161775,974,340900,2502675,15.77
9886073,9985325,5412,1894200,11879525,18.97
9886074,9989234,3659,1280650,11269884,12.82
9886075,2479764,909,318150,2797914,12.83
9886076,9984103,4213,1474550,11458653,14.77
9886077,9944022,6142,2149700,12093722,21.62
9886078,9959482,4117,1440950,11400432,14.47
9886080,9976372,4969,1739150,11715522,17.43
9886081,9966690,5187,1815450,11782140,18.22
9886082,9988350,5344,1870400,11858750,18.73
9886083,9973608,4789,1676150,11649758,16.81
9886084,9981020,4812,1684200,11665220,16.87
9886085,9988752,2731,955850,10944602,9.57
9886086,9988184,2622,917700,10905884,9.19
9886087,9055533,3310,1158500,10214033,12.79
9886088,9963086,6005,2101750,12064836,21.10
9886089,9955527,2193,767550,10723077,7.71
9886090,9954658,5767,2018450,11973108,20.28
9886091,9894816,6595,2308250,12203066,23.33
9886092,9919776,6765,2367750,12287526,23.87
9886093,1994435,672,235200,2229635,11.79
9886094,9968399,5899,2064650,12033049,20.71
9886095,9966213,4192,1467200,11433413,14.72
9886096,9977385,5675,1986250,11963635,19.91
9886097,9974766,4440,1554000,11528766,15.58
9886098,9984655,6485,2269750,12254405,22.73
9886099,9997341,7145,2500750,12498091,25.01
9886100,9979436,3895,1363250,11342686,13.66
9886101,7327722,3292,1152200,8479922,15.72
9886102,9974611,5006,1752100,11726711,17.57
9886103,9974155,5993,2097550,12071705,21.03
9886104,9917604,5779,2022650,11940254,20.39
9886105,9970936,4439,1553650,11524586,15.58
9886106,9964434,2847,996450,10960884,10.00
9886107,9966813,6303,2206050,12172863,22.13
9886108,9106222,537,187950,9294172,2.06
9886109,9981248,6083,2129050,12110298,21.33
9886110,1704913,963,337050,2041963,19.77
9886111,9964715,4094,1432900,11397615,14.38
9886112,9982125,2985,1044750,11026875,10.47
9886113,9985790,4254,1488900,11474690,14.91
9886114,9963501,4344,1520400,11483901,15.26
9886115,9975617,3777,1321950,11297567,13.25
9886116,9985147,4847,1696450,11681597,16.99
9886117,9975470,4156,1454600,11430070,14.58
9886118,9988629,3024,1058400,11047029,10.60
9886119,8488391,4599,1609650,10098041,18.96
9886120,9958197,4870,1704500,11662697,17.12
9886122,9970423,3790,1326500,11296923,13.30
9886124,9969706,5908,2067800,12037506,20.74
9886125,9974348,5564,1947400,11921748,19.52
9886126,9956941,6030,2110500,12067441,21.20
9886127,9957678,4869,1704150,11661828,17.11
9886128,8965307,3543,1240050,10205357,13.83
9886129,9976970,7693,2692550,12669520,26.99
9886130,9970530,5988,2095800,12066330,21.02
9886131,9979087,4036,1412600,11391687,14.16
9886132,9996984,7518,2631300,12628284,26.32
9886133,9989586,3846,1346100,11335686,13.48
9886134,6503353,4027,1409450,7912803,21.67
9886135,9979910,4805,1681750,11661660,16.85
9886136,9966675,5505,1926750,11893425,19.33
9886137,1223018,645,225750,1448768,18.46
9886138,9968127,6565,2297750,12265877,23.05
9886139,2582939,617,215950,2798889,8.36
9886140,9979490,5686,1990100,11969590,19.94
9886141,412566,202,70700,483266,17.14
9886142,1454674,496,173600,1628274,11.93
9886143,9980171,4670,1634500,11614671,16.38
9886144,9981797,3568,1248800,11230597,12.51
9886145,9983634,3281,1148350,11131984,11.50
9886146,9979779,4846,1696100,11675879,17.00
9886147,9979811,4437,1552950,11532761,15.56
9886148,2295178,710,248500,2543678,10.83
9886149,9972651,3097,1083950,11056601,10.87
9886150,3919887,1241,434350,4354237,11.08
9886151,541130,134,46900,588030,8.67
9886152,9983568,4766,1668100,11651668,16.71
9886153,9971086,1985,694750,10665836,6.97
9886154,9990752,2980,1043000,11033752,10.44
9886155,9986759,2503,876050,10862809,8.77
9886156,9304784,3490,1221500,10526284,13.13
9886157,9963337,4998,1749300,11712637,17.56
9886158,9971488,6637,2322950,12294438,23.30
9886159,740996,135,47250,788246,6.38
9886160,9963432,3684,1289400,11252832,12.94
9886162,9975629,4799,1679650,11655279,16.84
9886163,9476087,4030,1410500,10886587,14.88
9886164,9984143,3011,1053850,11037993,10.56
9886165,9963594,2911,1018850,10982444,10.23
9886166,9958582,2701,945350,10903932,9.49
9886167,9966977,4641,1624350,11591327,16.30
9886168,9970485,3461,1211350,11181835,12.15
9886169,9970740,7095,2483250,12453990,24.91
9886170,9974391,5120,1792000,11766391,17.97
9886172,9961980,2902,1015700,10977680,10.20
9886173,9958733,1314,459900,10418633,4.62
9886174,9989363,2719,951650,10941013,9.53
9886175,9991941,139,48650,10040591,0.49
9886176,9984501,4821,1687350,11671851,16.90
9886177,3141896,1835,642250,3784146,20.44
9886178,9973856,6216,2175600,12149456,21.81
9886179,646958,415,145250,792208,22.45
9886180,7818582,2630,920500,8739082,11.77
9886181,249820,103,36050,285870,14.43
9886182,9927988,2587,905450,10833438,9.12
9886183,9936954,3795,1328250,11265204,13.37
9886184,9958324,4593,1607550,11565874,16.14
9886185,9958476,4582,1603700,11562176,16.10
9886186,9963084,5087,1780450,11743534,17.87
9886187,9967129,1568,548800,10515929,5.51
9886188,9987996,4275,1496250,11484246,14.98
9886189,9995611,7358,2575300,12570911,25.76
9886190,1075828,636,222600,1298428,20.69
9886191,9969322,4262,1491700,11461022,14.96
9886192,9967275,5296,1853600,11820875,18.60
9886193,9965256,5254,1838900,11804156,18.45
9886194,9961624,3518,1231300,11192924,12.36
9886195,1010761,360,126000,1136761,12.47
9886196,9940554,4755,1664250,11604804,16.74
9886197,9918852,5785,2024750,11943602,20.41
9886198,9582018,3637,1272950,10854968,13.28
9886199,9899431,1717,600950,10500381,6.07
9886200,9904593,5547,1941450,11846043,19.60
9886201,132255,86,30100,162355,22.76
9886202,9926504,3128,1094800,11021304,11.03
9886203,9935338,4242,1484700,11420038,14.94
9886204,9946573,4417,1545950,11492523,15.54
9886205,9942462,3369,1179150,11121612,11.86
9886206,9949602,4011,1403850,11353452,14.11
9886207,783332,257,89950,873282,11.48
9886208,9959112,5731,2005850,11964962,20.14
9886209,8084753,4340,1519000,9603753,18.79
9886210,9943174,2108,737800,10680974,7.42
9886211,2805484,1265,442750,3248234,15.78
9886212,9940944,5327,1864450,11805394,18.76
9886213,4176005,2543,890050,5066055,21.31
9886214,9940291,4745,1660750,11601041,16.71
9886215,9941400,1624,568400,10509800,5.72
9886216,9952075,1430,500500,10452575,5.03
9886217,9947802,1390,486500,10434302,4.89
9886218,9963411,3811,1333850,11297261,13.39
9886219,9974714,4107,1437450,11412164,14.41
9886220,347699,139,48650,396349,13.99
9886221,9136805,4272,1495200,10632005,16.36
9886222,9978919,3759,1315650,11294569,13.18
9886224,9988493,3317,1160950,11149443,11.62
9886225,9969944,4123,1443050,11412994,14.47
9886226,9980030,3402,1190700,11170730,11.93
9886227,9997810,3559,1245650,11243460,12.46
9886228,9762907,661,231350,9994257,2.37
9886229,9992496,3827,1339450,11331946,13.40
9886230,2520729,536,187600,2708329,7.44
9886231,9993565,2616,915600,10909165,9.16
9886232,9992900,2702,945700,10938600,9.46
9886233,825373,425,148750,974123,18.02
9886234,9975497,5581,1953350,11928847,19.58
9886235,9967677,2669,934150,10901827,9.37
9886236,9974915,4410,1543500,11518415,15.47
9886237,9968088,2701,945350,10913438,9.48
9886238,1403420,629,220150,1623570,15.69
9886239,9971368,5050,1767500,11738868,17.73
9886240,9972973,3141,1099350,11072323,11.02
9886241,9972917,2207,772450,10745367,7.75
9886242,918217,334,116900,1035117,12.73
9886243,9985443,3884,1359400,11344843,13.61
9886244,9986611,3281,1148350,11134961,11.50
9886245,758651,346,121100,879751,15.96
9886246,9915570,4611,1613850,11529420,16.28
9886247,9994720,3663,1282050,11276770,12.83
9886248,9985279,5595,1958250,11943529,19.61
9886249,9990416,3699,1294650,11285066,12.96
9886250,9995891,6130,2145500,12141391,21.46
9886251,9960879,4787,1675450,11636329,16.82
9886252,4075303,2792,977200,5052503,23.98
9886253,9974539,5517,1930950,11905489,19.36
9886254,9965841,3308,1157800,11123641,11.62
9886255,9979839,4205,1471750,11451589,14.75
9886256,9983049,5109,1788150,11771199,17.91
9886257,9945714,3995,1398250,11343964,14.06
9886258,9331461,3308,1157800,10489261,12.41
9886259,9979449,6699,2344650,12324099,23.49
9886260,9990622,5885,2059750,12050372,20.62
9886261,9984194,4073,1425550,11409744,14.28
9886262,9997411,3929,1375150,11372561,13.76
9886263,9973608,1394,487900,10461508,4.89
9886264,9985262,3737,1307950,11293212,13.10
9886265,9972485,3571,1249850,11222335,12.53
9886266,3676467,1005,351750,4028217,9.57
9886267,9973420,4858,1700300,11673720,17.05
9886269,9988765,5417,1895950,11884715,18.98
9886270,9992118,4287,1500450,11492568,15.02
9886271,9995298,6302,2205700,12200998,22.07
9886272,2894271,2932,1026200,3920471,35.46
9886273,9996108,4887,1710450,11706558,17.11
9886274,9974815,811,283850,10258665,2.85
9886275,9976011,2656,929600,10905611,9.32
9886277,9971580,3818,1336300,11307880,13.40
9886278,9984989,4531,1585850,11570839,15.88
9886279,9988151,2627,919450,10907601,9.21
9886280,9988750,2320,812000,10800750,8.13
9886281,9988850,3514,1229900,11218750,12.31
9886282,9986641,2314,809900,10796541,8.11
9886283,1263842,1627,569450,1833292,45.06
9886284,9968943,1118,391300,10360243,3.93
9886285,9951946,1749,612150,10564096,6.15
9886286,9952885,2638,923300,10876185,9.28
9886287,9961290,3694,1292900,11254190,12.98
9886288,9958671,2222,777700,10736371,7.81
9886289,1662471,1595,558250,2220721,33.58
9886290,9945691,2192,767200,10712891,7.71
9886291,1129909,1089,381150,1511059,33.73
9886292,9917201,4409,1543150,11460351,15.56
9886293,9925235,5955,2084250,12009485,21.00
9886294,9883398,5322,1862700,11746098,18.85
9886295,9893829,4946,1731100,11624929,17.50
9886296,9864209,2371,829850,10694059,8.41
9886297,9879012,4060,1421000,11300012,14.38
9886298,9887983,410,143500,10031483,1.45
9886299,9863352,1689,591150,10454502,5.99
9886301,9896711,3714,1299900,11196611,13.13
9886302,9891643,4335,1517250,11408893,15.34
9886303,9904092,4281,1498350,11402442,15.13
9886304,9905765,809,283150,10188915,2.86
9886305,9903160,6317,2210950,12114110,22.33
9886306,9909243,3782,1323700,11232943,13.36
9886307,9919099,5052,1768200,11687299,17.83
9886308,1717145,510,178500,1895645,10.40
9886309,2768310,1659,580650,3348960,20.97
9886311,9916838,4631,1620850,11537688,16.34
9886312,9916353,2395,838250,10754603,8.45
9886313,9920758,2576,901600,10822358,9.09
9886314,9943493,4795,1678250,11621743,16.88
9886315,9938461,4008,1402800,11341261,14.11
9886316,9948870,4197,1468950,11417820,14.76
9886317,9945069,735,257250,10202319,2.59
9886318,9954085,4522,1582700,11536785,15.90
9886319,9944140,4248,1486800,11430940,14.95
9886320,9963152,3593,1257550,11220702,12.62
9886321,9972854,3811,1333850,11306704,13.37
9886322,9963714,4117,1440950,11404664,14.46
9886323,9951014,3338,1168300,11119314,11.74
9886324,9943063,6253,2188550,12131613,22.01
9886326,9920597,6178,2162300,12082897,21.80
9886327,9941948,2432,851200,10793148,8.56
9886328,9954966,4551,1592850,11547816,16.00
9886329,9935440,4833,1691550,11626990,17.03
9886331,9933426,4863,1702050,11635476,17.13
9886332,504904,399,139650,644554,27.66
9886333,9923647,4111,1438850,11362497,14.50
9886334,996396,630,220500,1216896,22.13
9886335,9916183,5010,1753500,11669683,17.68
9886338,6600623,1834,641900,7242523,9.72
9886339,9918888,5698,1994300,11913188,20.11
9886340,9907730,3159,1105650,11013380,11.16
9886341,9918916,3953,1383550,11302466,13.95
9886342,9914653,6161,2156350,12071003,21.75
9886343,9910238,3701,1295350,11205588,13.07
9886344,9917255,3483,1219050,11136305,12.29
9886346,9910531,4584,1604400,11514931,16.19
9886347,9910862,4417,1545950,11456812,15.60
9886348,9556656,4657,1629950,11186606,17.06
9886349,9904034,4794,1677900,11581934,16.94
9886350,9919169,3210,1123500,11042669,11.33
9886351,7278254,2346,821100,8099354,11.28
9886352,9895416,3532,1236200,11131616,12.49
9886353,9904787,3033,1061550,10966337,10.72
9886354,5904369,2626,919100,6823469,15.57
9886355,9905115,3925,1373750,11278865,13.87
9886356,1849134,858,300300,2149434,16.24
9886357,2013342,1634,571900,2585242,28.41
9886358,9910623,2518,881300,10791923,8.89
9886359,9898313,3657,1279950,11178263,12.93
9886360,9907295,3557,1244950,11152245,12.57
9886361,9912091,5684,1989400,11901491,20.07
9886362,9909927,7547,2641450,12551377,26.65
9886363,9913007,6972,2440200,12353207,24.62
9886364,9935639,5089,1781150,11716789,17.93
9886365,9904673,3790,1326500,11231173,13.39
9886366,9926940,3998,1399300,11326240,14.10
9886367,9898124,4505,1576750,11474874,15.93
9886368,9945364,6553,2293550,12238914,23.06
9886369,9952834,4234,1481900,11434734,14.89
9886370,9922590,5989,2096150,12018740,21.13
9886371,9943776,6760,2366000,12309776,23.79
9886372,9955751,7530,2635500,12591251,26.47
9886373,9958446,5656,1979600,11938046,19.88
9886374,4884354,1927,674450,5558804,13.81
9886375,9976656,4922,1722700,11699356,17.27
9886376,9973455,7132,2496200,12469655,25.03
9886377,1535394,496,173600,1708994,11.31
9886378,9948939,4605,1611750,11560689,16.20
9886379,9968176,6584,2304400,12272576,23.12
9886380,9979383,4768,1668800,11648183,16.72
9886381,455030,210,73500,528530,16.15
9886382,9985492,7055,2469250,12454742,24.73
9886383,9988143,5288,1850800,11838943,18.53
9886384,9986513,5414,1894900,11881413,18.97
9886385,9982178,2085,729750,10711928,7.31
9886386,9099643,4263,1492050,10591693,16.40
9886387,9979877,3366,1178100,11157977,11.80
9886388,9981346,6252,2188200,12169546,21.92
9886389,1305772,426,149100,1454872,11.42
9886390,9989437,5298,1854300,11843737,18.56
9886391,5151611,2459,860650,6012261,16.71
9886392,9983875,3950,1382500,11366375,13.85
9886393,9987473,7119,2491650,12479123,24.95
9886394,9565881,3903,1366050,10931931,14.28
9886395,9982116,4577,1601950,11584066,16.05
9886396,9980782,4889,1711150,11691932,17.14
9886397,9982365,1286,450100,10432465,4.51
9886398,9994471,3170,1109500,11103971,11.10
9886400,9978002,4686,1640100,11618102,16.44
9886401,9979990,4910,1718500,11698490,17.22
9886402,9975556,6253,2188550,12164106,21.94
9886403,9995730,4979,1742650,11738380,17.43
9886404,9973887,5377,1881950,11855837,18.87
9886405,9987403,5501,1925350,11912753,19.28
9886406,262941,387,135450,398391,51.51
9886407,9966552,3973,1390550,11357102,13.95
9886408,9956429,5786,2025100,11981529,20.34
9886409,7006534,2518,881300,7887834,12.58
9886410,9974013,5202,1820700,11794713,18.25
9886411,9949669,4257,1489950,11439619,14.97
9886412,2428266,1977,691950,3120216,28.50
9886413,9955864,4535,1587250,11543114,15.94
9886414,8874575,4736,1657600,10532175,18.68
9886415,9957593,5428,1899800,11857393,19.08
9886417,9954385,5131,1795850,11750235,18.04
9886418,9945892,6038,2113300,12059192,21.25
9886419,9950364,381,133350,10083714,1.34
9886420,9938015,5653,1978550,11916565,19.91
9886421,967253,385,134750,1102003,13.93
9886422,9952156,4940,1729000,11681156,17.37
9886423,9952506,2774,970900,10923406,9.76
9886424,1631469,606,212100,1843569,13.00
9886425,9978574,4900,1715000,11693574,17.19
9886426,9975024,7089,2481150,12456174,24.87
9886427,9987056,7227,2529450,12516506,25.33
9886428,9969235,3716,1300600,11269835,13.05
9886429,9409764,1027,359450,9769214,3.82
9886430,9972228,5342,1869700,11841928,18.75
9886431,1284041,1402,490700,1774741,38.22
9886432,9978117,938,328300,10306417,3.29
9886433,9983599,1059,370650,10354249,3.71
9886434,9989153,5040,1764000,11753153,17.66
9886435,9998094,2231,780850,10778944,7.81
9886436,9984298,2588,905800,10890098,9.07
9886437,9990332,5544,1940400,11930732,19.42
9886438,9992789,6294,2202900,12195689,22.04
9886439,2274518,971,339850,2614368,14.94
9886440,9650109,6224,2178400,11828509,22.57
9886441,758340,484,169400,927740,22.34
9886442,1583448,873,305550,1888998,19.30
9886443,640810,523,183050,823860,28.57
9886444,9992914,5528,1934800,11927714,19.36
9886445,9953884,3610,1263500,11217384,12.69
9886446,4120972,2341,819350,4940322,19.88
9886447,9977192,4131,1445850,11423042,14.49
9886449,9967342,5002,1750700,11718042,17.56
9886450,9981599,4119,1441650,11423249,14.44
9886451,4419901,3132,1096200,5516101,24.80
9886452,9961528,2900,1015000,10976528,10.19
9886453,9960905,4686,1640100,11601005,16.47
9886454,9967418,3868,1353800,11321218,13.58
9886455,8307389,2632,921200,9228589,11.09
9886456,9963956,5464,1912400,11876356,19.19
9886457,9973120,907,317450,10290570,3.18
9886458,5506604,3819,1336650,6843254,24.27
9886459,807460,864,302400,1109860,37.45
9886460,9969400,4482,1568700,11538100,15.74
9886461,9982034,5609,1963150,11945184,19.67
9886462,9985549,4119,1441650,11427199,14.44
9886463,9982327,4275,1496250,11478577,14.99
9886464,9985726,3648,1276800,11262526,12.79
9886465,9997851,4348,1521800,11519651,15.22
9886466,9993506,3264,1142400,11135906,11.43
9886467,1336862,535,187250,1524112,14.01
9886468,8841729,3865,1352750,10194479,15.30
9886469,9975205,4960,1736000,11711205,17.40
9886470,9980775,2366,828100,10808875,8.30
9886471,9976856,4967,1738450,11715306,17.42
9886473,9982623,2590,906500,10889123,9.08
9886474,475924,400,140000,615924,29.42
9886475,396458,126,44100,440558,11.12
9886477,9950276,5141,1799350,11749626,18.08
9886478,2242453,752,263200,2505653,11.74
9886479,9932968,3678,1287300,11220268,12.96
9886480,9938689,3270,1144500,11083189,11.52
9886481,9933110,4413,1544550,11477660,15.55
9886482,9945570,5930,2075500,12021070,20.87
9886483,9927427,4718,1651300,11578727,16.63
9886484,9904575,6173,2160550,12065125,21.81
9886485,9928088,5612,1964200,11892288,19.78
9886486,9906205,4933,1726550,11632755,17.43
9886487,9904274,2695,943250,10847524,9.52
9886488,8604501,2455,859250,9463751,9.99
9886489,9905795,4243,1485050,11390845,14.99
9886490,9921047,6231,2180850,12101897,21.98
9886491,1164581,1182,413700,1578281,35.52
9886492,9891653,4698,1644300,11535953,16.62
9886493,9893095,3577,1251950,11145045,12.65
9886494,9885707,3844,1345400,11231107,13.61
9886495,9859503,3810,1333500,11193003,13.53
9886496,9869808,4645,1625750,11495558,16.47
9886497,9889824,6355,2224250,12114074,22.49
9886498,9875171,5085,1779750,11654921,18.02
9886499,9877913,2841,994350,10872263,10.07
9886500,9896688,1690,591500,10488188,5.98
9886501,9896891,5861,2051350,11948241,20.73
9886502,9915411,2934,1026900,10942311,10.36
9886503,9917964,956,334600,10252564,3.37
9886504,9929564,3320,1162000,11091564,11.70
9886505,1369162,545,190750,1559912,13.93
9886506,9902750,2998,1049300,10952050,10.60
9886507,9883753,266,93100,9976853,0.94
9886508,9921941,841,294350,10216291,2.97
9886509,9917515,4210,1473500,11391015,14.86
9886510,2921801,1125,393750,3315551,13.48
9886511,9903822,2526,884100,10787922,8.93
9886512,9913419,5191,1816850,11730269,18.33
9886513,1184004,974,340900,1524904,28.79
9886514,9907380,3566,1248100,11155480,12.60
9886515,9913913,2016,705600,10619513,7.12
9886516,2852861,709,248150,3101011,8.70
9886517,9909080,3190,1116500,11025580,11.27
9886518,9912336,6524,2283400,12195736,23.04
9886519,9921073,2273,795550,10716623,8.02
9886520,1449604,692,242200,1691804,16.71
9886521,9932298,5462,1911700,11843998,19.25
9886522,9936357,3493,1222550,11158907,12.30
9886523,9934296,4614,1614900,11549196,16.26
9886524,9949130,3662,1281700,11230830,12.88
9886525,9949620,4246,1486100,11435720,14.94
9886526,9902600,4039,1413650,11316250,14.28
9886527,9968570,2067,723450,10692020,7.26
9886528,9964688,3480,1218000,11182688,12.22
9886529,7560595,3003,1051050,8611645,13.90
9886530,9963885,2956,1034600,10998485,10.38
9886531,9968251,4689,1641150,11609401,16.46
9886532,9963160,4859,1700650,11663810,17.07
9886533,9982260,6489,2271150,12253410,22.75
9886534,9970509,1560,546000,10516509,5.48
9886535,9970879,2700,945000,10915879,9.48
9886536,9989248,703,246050,10235298,2.46
9886537,9990410,3547,1241450,11231860,12.43
9886538,1878298,373,130550,2008848,6.95
9886539,3567607,1004,351400,3919007,9.85
9886540,9989407,2472,865200,10854607,8.66
9886541,9984563,2138,748300,10732863,7.49
9886542,9899736,4349,1522150,11421886,15.38
9886543,2221694,1297,453950,2675644,20.43
9886544,9962740,3559,1245650,11208390,12.50
9886545,9963170,3454,1208900,11172070,12.13
9886546,9945325,3926,1374100,11319425,13.82
9886547,7385859,2842,994700,8380559,13.47
9886548,9946056,4586,1605100,11551156,16.14
9886549,9957419,4940,1729000,11686419,17.36
9886550,9959136,4484,1569400,11528536,15.76
9886551,9885974,5075,1776250,11662224,17.97
9886552,9975475,4992,1747200,11722675,17.51
9886553,9987323,5545,1940750,11928073,19.43
9886554,9996007,4484,1569400,11565407,15.70
9886555,552538,421,147350,699888,26.67
9886556,7056016,3525,1233750,8289766,17.49
9886557,6097385,4078,1427300,7524685,23.41
9886558,1442966,1221,427350,1870316,29.62
9886559,9165405,5314,1859900,11025305,20.29
9886560,9971327,3782,1323700,11295027,13.28
9886561,9981028,7152,2503200,12484228,25.08
9886562,9982988,2456,859600,10842588,8.61
9886563,9991541,2922,1022700,11014241,10.24
9886564,9981112,5513,1929550,11910662,19.33
9886565,9976260,5138,1798300,11774560,18.03
9886567,8936744,4664,1632400,10569144,18.27
9886568,9985588,4025,1408750,11394338,14.11
9886569,9974453,6213,2174550,12149003,21.80
9886570,730592,210,73500,804092,10.06
9886571,9986121,4515,1580250,11566371,15.82
9886572,9977130,3186,1115100,11092230,11.18
9886573,2804711,680,238000,3042711,8.49
9886574,9964592,4086,1430100,11394692,14.35
9886575,9984068,3274,1145900,11129968,11.48
9886576,9990709,3821,1337350,11328059,13.39
9886577,9996163,7288,2550800,12546963,25.52
9886578,9980150,4682,1638700,11618850,16.42
9886580,9991244,4101,1435350,11426594,14.37
9886581,9984757,2873,1005550,10990307,10.07
9886582,9997503,5457,1909950,11907453,19.10
9886583,3681159,1545,540750,4221909,14.69
9886584,9985783,4254,1488900,11474683,14.91
9886585,9974933,5070,1774500,11749433,17.79
9886586,1041451,1161,406350,1447801,39.02
9886587,9970828,3623,1268050,11238878,12.72
9886588,2364214,530,185500,2549714,7.85
9886589,9971106,1774,620900,10592006,6.23
9886590,9978701,3367,1178450,11157151,11.81
9886591,9988964,4568,1598800,11587764,16.01
9886593,9976804,3308,1157800,11134604,11.60
9886594,9978209,3359,1175650,11153859,11.78
9886595,9982989,2346,821100,10804089,8.22
9886596,9992971,3258,1140300,11133271,11.41
9886597,9989827,4525,1583750,11573577,15.85
9886598,9979563,3782,1323700,11303263,13.26
9886599,9986440,4295,1503250,11489690,15.05
9886600,9975551,5883,2059050,12034601,20.64
9886601,1329966,646,226100,1556066,17.00
9886602,1309463,1067,373450,1682913,28.52
9886603,9964856,4220,1477000,11441856,14.82
9886605,9964747,3542,1239700,11204447,12.44
9886606,9961728,4188,1465800,11427528,14.71
9886607,9954802,5878,2057300,12012102,20.67
9886608,9957165,3329,1165150,11122315,11.70
9886609,9985474,5135,1797250,11782724,18.00
9886610,9986806,3502,1225700,11212506,12.27
9886611,9978195,5174,1810900,11789095,18.15
9886612,569372,244,85400,654772,15.00
9886613,9993316,3740,1309000,11302316,13.10
9886614,9980572,5424,1898400,11878972,19.02
9886615,9978687,6044,2115400,12094087,21.20
9886616,9999895,4443,1555050,11554945,15.55
9886617,9985129,4934,1726900,11712029,17.29
9886618,9998338,3901,1365350,11363688,13.66
9886619,9975913,4012,1404200,11380113,14.08
9886621,9985324,3448,1206800,11192124,12.09
9886622,9983463,2788,975800,10959263,9.77
9886623,9599068,3847,1346450,10945518,14.03
9886624,9986927,6158,2155300,12142227,21.58
9886625,799677,141,49350,849027,6.17
9886626,9984436,5448,1906800,11891236,19.10
9886627,4492873,2283,799050,5291923,17.78
9886628,9981212,4971,1739850,11721062,17.43
9886629,9961731,2142,749700,10711431,7.53
9886630,9960995,5013,1754550,11715545,17.61
9886631,9954879,4838,1693300,11648179,17.01
9886632,6027103,3091,1081850,7108953,17.95
9886633,9947232,6021,2107350,12054582,21.19
9886634,9938329,6736,2357600,12295929,23.72
9886635,9940632,4665,1632750,11573382,16.43
9886636,9930935,6921,2422350,12353285,24.39
9886637,9918923,3848,1346800,11265723,13.58
9886638,9936998,7015,2455250,12392248,24.71
9886639,5616845,3260,1141000,6757845,20.31
9886640,9950147,4498,1574300,11524447,15.82
9886641,9929720,3277,1146950,11076670,11.55
9886642,9919427,6079,2127650,12047077,21.45
9886643,9940299,4274,1495900,11436199,15.05
9886644,9934738,5297,1853950,11788688,18.66
9886645,9949090,2633,921550,10870640,9.26
9886646,9948449,3502,1225700,11174149,12.32
9886647,9947872,3462,1211700,11159572,12.18
9886648,9953666,6144,2150400,12104066,21.60
9886649,1233716,294,102900,1336616,8.34
9886650,9947947,6057,2119950,12067897,21.31
9886651,9958583,4256,1489600,11448183,14.96
9886652,9959345,4259,1490650,11449995,14.97
9886653,5139855,3274,1145900,6285755,22.29
9886654,9995835,5418,1896300,11892135,18.97
9886656,9964745,4869,1704150,11668895,17.10
9886657,9985590,3579,1252650,11238240,12.54
9886658,6274817,967,338450,6613267,5.39
9886659,9999176,5264,1842400,11841576,18.43
9886660,9828712,4158,1455300,11284012,14.81
9886661,9964964,4055,1419250,11384214,14.24
9886662,9979823,3844,1345400,11325223,13.48
9886663,9984418,5307,1857450,11841868,18.60
9886664,9987694,2837,992950,10980644,9.94
9886665,9980382,2455,859250,10839632,8.61
9886666,9999748,5982,2093700,12093448,20.94
9886667,9977936,2336,817600,10795536,8.19
9886668,9980119,3590,1256500,11236619,12.59
9886669,9999496,4373,1530550,11530046,15.31
9886670,9915257,5994,2097900,12013157,21.16
9886671,9989610,4820,1687000,11676610,16.89
9886672,9984945,7046,2466100,12451045,24.70
9886673,9994768,5572,1950200,11944968,19.51
9886674,9973089,4456,1559600,11532689,15.64
9886675,9986061,1435,502250,10488311,5.03
9886676,9989156,5373,1880550,11869706,18.83
9886677,9984355,5486,1920100,11904455,19.23
9886678,9970186,5537,1937950,11908136,19.44
9886679,9965956,4574,1600900,11566856,16.06
9886680,9894307,5710,1998500,11892807,20.20
9886681,889170,322,112700,1001870,12.67
9886682,9896635,5132,1796200,11692835,18.15
9886683,9572105,5490,1921500,11493605,20.07
9886684,2032287,1405,491750,2524037,24.20
9886685,9941268,5496,1923600,11864868,19.35
9886686,9956446,5729,2005150,11961596,20.14
9886687,9985429,5784,2024400,12009829,20.27
9886688,9979586,2887,1010450,10990036,10.13
9886689,9999091,7413,2594550,12593641,25.95
9886690,5254903,3325,1163750,6418653,22.15
9886691,8986250,4120,1442000,10428250,16.05
9886692,9997996,4219,1476650,11474646,14.77
9886693,9999269,3154,1103900,11103169,11.04
9886694,9988444,5243,1835050,11823494,18.37
9886695,9979919,1247,436450,10416369,4.37
9886696,9989898,1546,541100,10530998,5.42
9886697,9987522,2358,825300,10812822,8.26
9886698,9591069,5762,2016700,11607769,21.03
9886699,9987602,4185,1464750,11452352,14.67
9886700,894736,223,78050,972786,8.72
9886701,9989373,4305,1506750,11496123,15.08
9886702,9973068,4608,1612800,11585868,16.17
9886703,9974731,5633,1971550,11946281,19.77
9886704,9996656,4609,1613150,11609806,16.14
9886705,9972363,5299,1854650,11827013,18.60
9886706,9993956,7148,2501800,12495756,25.03
9886707,2353433,1072,375200,2728633,15.94
9886708,892782,679,237650,1130432,26.62
9886709,943075,373,130550,1073625,13.84
9886710,9964521,5462,1911700,11876221,19.19
9886711,9963589,3029,1060150,11023739,10.64
9886712,9960661,3998,1399300,11359961,14.05
9886713,9956386,4332,1516200,11472586,15.23
9886714,9935070,4265,1492750,11427820,15.03
9886715,9171636,3878,1357300,10528936,14.80
9886716,9084519,5116,1790600,10875119,19.71
9886717,9947264,1716,600600,10547864,6.04
9886718,9967630,4146,1451100,11418730,14.56
9886719,9958979,3232,1131200,11090179,11.36
9886720,9948284,2832,991200,10939484,9.96
9886721,6713709,3462,1211700,7925409,18.05
9886722,9930545,3680,1288000,11218545,12.97
9886723,9893241,2723,953050,10846291,9.63
9886724,2742493,1130,395500,3137993,14.42
9886725,9943690,3776,1321600,11265290,13.29
9886726,3063766,1354,473900,3537666,15.47
9886727,1630828,612,214200,1845028,13.13
9886728,708665,1293,452550,1161215,63.86
9886729,9961535,4499,1574650,11536185,15.81
9886730,7488324,2786,975100,8463424,13.02
9886731,3033826,1942,679700,3713526,22.40
9886732,82458,156,54600,137058,66.22
9886733,9980307,2516,880600,10860907,8.82
9886734,9988625,4229,1480150,11468775,14.82
9886735,9991859,5641,1974350,11966209,19.76
9886736,1214316,344,120400,1334716,9.92
9886737,9982770,4247,1486450,11469220,14.89
9886738,4745265,2187,765450,5510715,16.13
9886739,9979893,2892,1012200,10992093,10.14
9886740,9963587,4826,1689100,11652687,16.95
9886741,1839748,640,224000,2063748,12.18
9886742,9975306,2919,1021650,10996956,10.24
9886743,9984298,4873,1705550,11689848,17.08
9886744,9969308,3324,1163400,11132708,11.67
9886745,9974352,3339,1168650,11143002,11.72
9886746,9998995,3851,1347850,11346845,13.48
9886747,9998887,3970,1389500,11388387,13.90
9886748,9971219,4182,1463700,11434919,14.68
9886749,9973274,3406,1192100,11165374,11.95
9886750,9966151,2721,952350,10918501,9.56
9886751,9977584,3754,1313900,11291484,13.17
9886752,9987928,2708,947800,10935728,9.49
9886753,9999123,1153,403550,10402673,4.04
9886754,9978531,1450,507500,10486031,5.09
9886755,9974020,3427,1199450,11173470,12.03
9886756,9983582,2692,942200,10925782,9.44
9886757,9973798,5714,1999900,11973698,20.05
9886758,7833320,1405,491750,8325070,6.28
9886759,9978941,3429,1200150,11179091,12.03
9886760,9967738,2985,1044750,11012488,10.48
9886761,9978703,4822,1687700,11666403,16.91
9886762,9972210,2887,1010450,10982660,10.13
9886763,9968150,4117,1440950,11409100,14.46
9886764,9986292,2351,822850,10809142,8.24
9886765,9962814,1252,438200,10401014,4.40
9886767,1979341,1266,443100,2422441,22.39
9886768,9961665,2475,866250,10827915,8.70
9886769,9948139,5066,1773100,11721239,17.82
9886771,9958339,4254,1488900,11447239,14.95
9886772,777111,432,151200,928311,19.46
9886773,3488441,1063,372050,3860491,10.67
9886774,5613264,2443,855050,6468314,15.23
9886775,9922942,3165,1107750,11030692,11.16
9886776,9936298,4882,1708700,11644998,17.20
9886777,9929056,5073,1775550,11704606,17.88
9886778,1198750,367,128450,1327200,10.72
9886780,4182297,1590,556500,4738797,13.31
9886781,9909510,2753,963550,10873060,9.72
9886782,9885062,4810,1683500,11568562,17.03
9886783,9919263,4941,1729350,11648613,17.43
9886784,9923522,5208,1822800,11746322,18.37
9886785,9930043,994,347900,10277943,3.50
9886786,9926764,3393,1187550,11114314,11.96
9886787,9933239,3425,1198750,11131989,12.07
9886790,9936035,1869,654150,10590185,6.58
9886791,9926268,4566,1598100,11524368,16.10
9886792,3029090,1052,368200,3397290,12.16
9886793,9933049,3063,1072050,11005099,10.79
9886794,9948760,3884,1359400,11308160,13.66
9886795,9939528,1040,364000,10303528,3.66
9886796,4444955,837,292950,4737905,6.59
9886797,9942868,3101,1085350,11028218,10.92
9886798,9927654,3714,1299900,11227554,13.09
9886799,9935354,4611,1613850,11549204,16.24
9886800,9940542,2271,794850,10735392,8.00
9886801,9940210,2717,950950,10891160,9.57
9886802,9947369,781,273350,10220719,2.75
9886803,9934025,2591,906850,10840875,9.13
9886804,1145214,1259,440650,1585864,38.48
9886805,9925119,4990,1746500,11671619,17.60
9886806,9934045,3463,1212050,11146095,12.20
9886808,9927727,2624,918400,10846127,9.25
9886810,9922414,3228,1129800,11052214,11.39
9886811,729495,322,112700,842195,15.45
9886812,8749889,4456,1559600,10309489,17.82
9886813,9935831,5626,1969100,11904931,19.82
9886814,9939588,4888,1710800,11650388,17.21
9886815,9912682,2921,1022350,10935032,10.31
9886816,9928111,1937,677950,10606061,6.83
9886817,9937059,3021,1057350,10994409,10.64
9886818,9951780,3184,1114400,11066180,11.20
9886819,9939846,4242,1484700,11424546,14.94
9886820,9780874,4196,1468600,11249474,15.02
9886821,5446844,2238,783300,6230144,14.38
9886822,542808,277,96950,639758,17.86
9886823,9973106,3283,1149050,11122156,11.52
9886824,9979776,5138,1798300,11778076,18.02
9886825,8046211,3270,1144500,9190711,14.22
9886826,9966280,5528,1934800,11901080,19.41
9886828,9966795,4737,1657950,11624745,16.63
9886829,8191621,4050,1417500,9609121,17.30
9886830,9927782,3025,1058750,10986532,10.66
9886831,9943694,5935,2077250,12020944,20.89
9886832,9948417,2712,949200,10897617,9.54
9886833,9958751,4328,1514800,11473551,15.21
9886834,9955967,4119,1441650,11397617,14.48
9886835,9974893,3384,1184400,11159293,11.87
9886836,2436754,362,126700,2563454,5.20
9886837,9988775,3527,1234450,11223225,12.36
9886838,9590038,5337,1867950,11457988,19.48
9886839,9993416,6671,2334850,12328266,23.36
9886840,9986877,1890,661500,10648377,6.62
9886841,9972860,3356,1174600,11147460,11.78
9886842,9988602,3394,1187900,11176502,11.89
9886844,9978803,6412,2244200,12223003,22.49
9886845,9981291,3840,1344000,11325291,13.47
9886846,9979487,2807,982450,10961937,9.84
9886847,9988790,3530,1235500,11224290,12.37
9886848,9989727,4345,1520750,11510477,15.22
9886849,9971491,4012,1404200,11375691,14.08
9886850,9970949,2949,1032150,11003099,10.35
9886851,9987574,2058,720300,10707874,7.21
9886852,2679269,1347,471450,3150719,17.60
9886853,949153,463,162050,1111203,17.07
9886854,9963361,5544,1940400,11903761,19.48
9886855,9983693,4394,1537900,11521593,15.40
9886856,9984997,3893,1362550,11347547,13.65
9886857,9978830,3506,1227100,11205930,12.30
9886858,9979047,2447,856450,10835497,8.58
9886859,4477181,2990,1046500,5523681,23.37
9886860,9973985,3146,1101100,11075085,11.04
9886861,9984198,4751,1662850,11647048,16.65
9886862,9988119,2851,997850,10985969,9.99
9886863,1806922,576,201600,2008522,11.16
9886865,4996435,1609,563150,5559585,11.27
9886866,9963818,5343,1870050,11833868,18.77
9886867,4327567,1527,534450,4862017,12.35
9886868,9968140,2682,938700,10906840,9.42
9886869,9966313,3894,1362900,11329213,13.68
9886870,9971025,2545,890750,10861775,8.93
9886871,9183452,2232,781200,9964652,8.51
9886872,9982729,2810,983500,10966229,9.85
9886873,9981989,3069,1074150,11056139,10.76
9886874,9965805,3743,1310050,11275855,13.15
9886875,9970410,4428,1549800,11520210,15.54
9886876,9964958,3222,1127700,11092658,11.32
9886877,9992814,4569,1599150,11591964,16.00
9886878,9889546,4958,1735300,11624846,17.55
9886879,9964937,3974,1390900,11355837,13.96
9886880,5603136,1640,574000,6177136,10.24
9886881,9954813,3805,1331750,11286563,13.38
9886882,9956731,3883,1359050,11315781,13.65
9886883,9949039,5829,2040150,11989189,20.51
9886884,9960172,4484,1569400,11529572,15.76
9886885,9671035,2852,998200,10669235,10.32
9886886,9969978,2818,986300,10956278,9.89
9886887,9961869,3856,1349600,11311469,13.55
9886888,9954621,2806,982100,10936721,9.87
9886889,1450872,434,151900,1602772,10.47
9886890,9945322,3745,1310750,11256072,13.18
9886891,9933901,5548,1941800,11875701,19.55
9886892,5526519,2015,705250,6231769,12.76
9886893,3885055,1488,520800,4405855,13.41
9886894,9922828,3181,1113350,11036178,11.22
9886895,9923143,5754,2013900,11937043,20.29
9886896,9940248,4500,1575000,11515248,15.84
9886897,9952572,2502,875700,10828272,8.80
9886898,9948424,3210,1123500,11071924,11.29
9886899,9949232,2522,882700,10831932,8.87
9886900,1265074,439,153650,1418724,12.15
9886901,1920520,1280,448000,2368520,23.33
9886902,9968806,1926,674100,10642906,6.76
9886903,9963047,5590,1956500,11919547,19.64
9886904,9955997,3156,1104600,11060597,11.09
9886905,9964042,2366,828100,10792142,8.31
9886906,9990249,2792,977200,10967449,9.78
9886907,1980753,720,252000,2232753,12.72
9886908,9954183,4101,1435350,11389533,14.42
9886910,9960170,3417,1195950,11156120,12.01
9886911,9973943,5113,1789550,11763493,17.94
9886912,9960074,4099,1434650,11394724,14.40
9886913,9970572,3101,1085350,11055922,10.89
9886914,9989835,4300,1505000,11494835,15.07
9886915,9996998,3434,1201900,11198898,12.02
9886916,9983277,3539,1238650,11221927,12.41
9886917,765868,373,130550,896418,17.05
9886918,9972553,2792,977200,10949753,9.80
9886919,9973931,3655,1279250,11253181,12.83
9886920,9957586,4389,1536150,11493736,15.43
9886921,4214242,2398,839300,5053542,19.92
9886922,9974729,2906,1017100,10991829,10.20
9886923,9972284,3276,1146600,11118884,11.50
9886924,1156552,604,211400,1367952,18.28
9886925,9987726,2852,998200,10985926,9.99
9886926,5099103,281,98350,5197453,1.93
9886927,9989803,6518,2281300,12271103,22.84
9886928,2601525,541,189350,2790875,7.28
9886929,9961087,3823,1338050,11299137,13.43
9886930,9965270,2144,750400,10715670,7.53
9886931,1226587,509,178150,1404737,14.52
9886932,9946280,3157,1104950,11051230,11.11
9886933,9937302,4257,1489950,11427252,14.99
9886934,2258991,220,77000,2335991,3.41
9886935,9954967,5633,1971550,11926517,19.80
9886936,9951876,2736,957600,10909476,9.62
9886937,1994094,378,132300,2126394,6.63
9886938,9958029,4699,1644650,11602679,16.52
9886939,9962478,2334,816900,10779378,8.20
9886940,9980756,1403,491050,10471806,4.92
9886941,9987872,2187,765450,10753322,7.66
9886942,9993927,4395,1538250,11532177,15.39
9886943,7779253,3566,1248100,9027353,16.04
9886944,9997838,4583,1604050,11601888,16.04
9886945,9971526,2763,967050,10938576,9.70
9886946,9982012,2972,1040200,11022212,10.42
9886947,9978055,2060,721000,10699055,7.23
9886948,9974659,3411,1193850,11168509,11.97
9886949,1220322,696,243600,1463922,19.96
9886950,9988928,3343,1170050,11158978,11.71
9886951,9998838,2887,1010450,11009288,10.11
9886952,9971994,2794,977900,10949894,9.81
9886953,9965454,3671,1284850,11250304,12.89
9886954,6451197,2513,879550,7330747,13.63
9886955,4501918,1154,403900,4905818,8.97
9886956,9987770,4084,1429400,11417170,14.31
9886957,9967758,3113,1089550,11057308,10.93
9886958,9971042,4523,1583050,11554092,15.88
9886959,9995804,3119,1091650,11087454,10.92
9886960,9979747,2488,870800,10850547,8.73
9886961,9989735,860,301000,10290735,3.01
9886962,9982007,4426,1549100,11531107,15.52
9886963,1721373,509,178150,1899523,10.35
9886964,9986229,3643,1275050,11261279,12.77
9886965,9989867,4213,1474550,11464417,14.76
9886966,9985609,2627,919450,10905059,9.21
9886967,8997189,4233,1481550,10478739,16.47
9886968,9993409,1156,404600,10398009,4.05
9886969,9980620,1272,445200,10425820,4.46
9886970,9998205,1730,605500,10603705,6.06
9886971,9982624,332,116200,10098824,1.16
9886972,9979609,1965,687750,10667359,6.89
9886973,9987100,1191,416850,10403950,4.17
9886975,3891460,1796,628600,4520060,16.15
9886976,9983409,3743,1310050,11293459,13.12
9886977,9995619,3704,1296400,11292019,12.97
9886978,9987948,1390,486500,10474448,4.87
9886979,9981419,1653,578550,10559969,5.80
9886980,2092115,749,262150,2354265,12.53
9886981,9963180,2406,842100,10805280,8.45
9886983,9958056,3160,1106000,11064056,11.11
9886984,9972470,3116,1090600,11063070,10.94
9886985,9963496,3164,1107400,11070896,11.11
9886986,9958649,2774,970900,10929549,9.75
9886987,1947561,970,339500,2287061,17.43
9886988,716772,249,87150,803922,12.16
9886989,9950101,5356,1874600,11824701,18.84
9886990,9948822,3488,1220800,11169622,12.27
9886991,9952557,1729,605150,10557707,6.08
9886992,8053138,1338,468300,8521438,5.82
9886993,9568257,3634,1271900,10840157,13.29
9886994,9950333,4227,1479450,11429783,14.87
9886996,9923418,3793,1327550,11250968,13.38
9886997,9954557,4714,1649900,11604457,16.57
9886998,9952467,1092,382200,10334667,3.84
9886999,8948463,2959,1035650,9984113,11.57
9887000,9960773,3458,1210300,11171073,12.15
9887001,9953168,3669,1284150,11237318,12.90
9887002,9949971,3563,1247050,11197021,12.53
9887004,9965208,4765,1667750,11632958,16.74
9887005,9942457,1181,413350,10355807,4.16
9887006,9930524,3487,1220450,11150974,12.29
9887007,9950928,2847,996450,10947378,10.01
9887008,9928777,3593,1257550,11186327,12.67
9887009,9956213,4547,1591450,11547663,15.98
9887010,9919984,3719,1301650,11221634,13.12
9887011,416703,738,258300,675003,61.99
9887012,9938342,3903,1366050,11304392,13.75
9887013,9957148,4442,1554700,11511848,15.61
9887014,2106334,2327,814450,2920784,38.67
9887015,9917469,5987,2095450,12012919,21.13
9887016,3904303,1400,490000,4394303,12.55
9887017,6538797,1602,560700,7099497,8.57
9887018,9943390,3356,1174600,11117990,11.81
9887019,9947336,3502,1225700,11173036,12.32
9887020,9941065,3727,1304450,11245515,13.12
9887021,9938610,2464,862400,10801010,8.68
9887022,9948894,1425,498750,10447644,5.01
9887023,9942370,3605,1261750,11204120,12.69
9887024,9944873,2971,1039850,10984723,10.46
9887025,9923118,2514,879900,10803018,8.87
9887027,9943643,4921,1722350,11665993,17.32
9887028,9958603,3069,1074150,11032753,10.79
9887029,9934733,3990,1396500,11331233,14.06
9887030,9938194,3621,1267350,11205544,12.75
9887031,9445867,2676,936600,10382467,9.92
9887032,9943251,4741,1659350,11602601,16.69
9887033,9942837,1374,480900,10423737,4.84
9887034,9947657,2069,724150,10671807,7.28
9887035,9950956,3948,1381800,11332756,13.89
9887036,9968268,3069,1074150,11042418,10.78
9887037,9959658,2348,821800,10781458,8.25
9887038,3928869,1606,562100,4490969,14.31
9887039,5172072,947,331450,5503522,6.41
9887040,9980238,3423,1198050,11178288,12.00
9887041,9989586,2535,887250,10876836,8.88
9887042,9265534,3083,1079050,10344584,11.65
9887043,9268792,622,217700,9486492,2.35
9887044,9268386,3605,1261750,10530136,13.61
9887045,9949029,4815,1685250,11634279,16.94
9887046,2850341,1179,412650,3262991,14.48
9887047,5544347,1868,653800,6198147,11.79
9887048,9965514,1259,440650,10406164,4.42
9887049,9955853,3135,1097250,11053103,11.02
9887050,9943204,2973,1040550,10983754,10.46
9887051,9961844,2660,931000,10892844,9.35
9887052,9957551,3985,1394750,11352301,14.01
9887053,9946264,5635,1972250,11918514,19.83
9887054,9975814,4274,1495900,11471714,15.00
9887055,9984675,7126,2494100,12478775,24.98
9887056,9982676,3726,1304100,11286776,13.06
9887057,1357248,309,108150,1465398,7.97
9887058,9978901,3171,1109850,11088751,11.12
9887059,9976070,4324,1513400,11489470,15.17
9887060,9989831,3654,1278900,11268731,12.80
9887061,7322314,1751,612850,7935164,8.37
9887062,9987553,5062,1771700,11759253,17.74
9887063,9980644,1751,612850,10593494,6.14
9887064,9985150,3147,1101450,11086600,11.03
9887065,9981923,3464,1212400,11194323,12.15
9887066,9988368,3901,1365350,11353718,13.67
9887067,8503645,3522,1232700,9736345,14.50
9887068,8518523,4102,1435700,9954223,16.85
9887069,9998065,4456,1559600,11557665,15.60
9887070,9988613,3362,1176700,11165313,11.78
9887071,9983585,3773,1320550,11304135,13.23
9887072,9608746,2747,961450,10570196,10.01
9887073,9982768,2998,1049300,11032068,10.51
9887074,9974590,2048,716800,10691390,7.19
9887076,9972873,2186,765100,10737973,7.67
9887077,9962075,2774,970900,10932975,9.75
9887078,9981632,2807,982450,10964082,9.84
9887079,9979937,3177,1111950,11091887,11.14
9887080,878867,315,110250,989117,12.54
9887081,9978935,3804,1331400,11310335,13.34
9887082,9984667,5883,2059050,12043717,20.62
9887083,5549835,3290,1151500,6701335,20.75
9887084,9968410,4692,1642200,11610610,16.47
9887085,9987126,5323,1863050,11850176,18.65
9887086,9972629,4812,1684200,11656829,16.89
9887087,1021489,168,58800,1080289,5.76
9887088,9967499,4212,1474200,11441699,14.79
9887089,9962896,3411,1193850,11156746,11.98
9887090,9942706,3141,1099350,11042056,11.06
9887091,9961349,3826,1339100,11300449,13.44
9887092,9956446,2725,953750,10910196,9.58
9887093,9952883,4121,1442350,11395233,14.49
9887094,9981234,2488,870800,10852034,8.72
9887095,503520,434,151900,655420,30.17
9887096,9984154,1902,665700,10649854,6.67
9887097,9958850,3029,1060150,11019000,10.65
9887099,440361,211,73850,514211,16.77
9887100,9934919,5267,1843450,11778369,18.56
9887101,9943909,3162,1106700,11050609,11.13
9887102,9952070,2407,842450,10794520,8.47
9887103,9959622,2767,968450,10928072,9.72
9887104,9963201,4644,1625400,11588601,16.31
9887105,9979519,3133,1096550,11076069,10.99
9887106,446568,370,129500,576068,29.00
9887107,9963454,3287,1150450,11113904,11.55
9887108,9993337,3522,1232700,11226037,12.34
9887109,9997825,3188,1115800,11113625,11.16
9887110,9136683,3257,1139950,10276633,12.48
9887111,9989688,3117,1090950,11080638,10.92
9887112,9992562,2620,917000,10909562,9.18
9887113,9973188,2789,976150,10949338,9.79
9887114,1391015,612,214200,1605215,15.40
9887115,9979032,4389,1536150,11515182,15.39
9887116,9988515,4157,1454950,11443465,14.57
9887117,9985777,3474,1215900,11201677,12.18
9887118,9990609,2800,980000,10970609,9.81
9887119,9975417,3554,1243900,11219317,12.47
9887120,9980352,2415,845250,10825602,8.47
9887121,9975048,1100,385000,10360048,3.86
9887122,9958974,2898,1014300,10973274,10.18
9887123,9931296,2273,795550,10726846,8.01
9887124,9962408,4298,1504300,11466708,15.10
9887125,1318323,379,132650,1450973,10.06
9887126,9958048,3385,1184750,11142798,11.90
9887127,9943592,3706,1297100,11240692,13.04
9887128,9966330,5502,1925700,11892030,19.32
9887129,9967387,1372,480200,10447587,4.82
9887130,9980310,5376,1881600,11861910,18.85
9887131,9789670,1388,485800,10275470,4.96
9887132,1580766,665,232750,1813516,14.72
9887133,9961088,5307,1857450,11818538,18.65
9887134,9961578,2726,954100,10915678,9.58
9887135,9947314,1335,467250,10414564,4.70
9887136,5945185,2068,723800,6668985,12.17
9887137,9970629,4158,1455300,11425929,14.60
9887139,9959958,4041,1414350,11374308,14.20
9887140,9955411,3666,1283100,11238511,12.89
9887141,9973234,3417,1195950,11169184,11.99
9887142,9958893,1611,563850,10522743,5.66
9887143,6029241,3600,1260000,7289241,20.90
9887144,9956288,2978,1042300,10998588,10.47
9887145,9949808,4659,1630650,11580458,16.39
9887146,9957941,1994,697900,10655841,7.01
9887147,4392592,1058,370300,4762892,8.43
9887148,9934163,1364,477400,10411563,4.81
9887149,9933707,1784,624400,10558107,6.29
9887150,9921667,3774,1320900,11242567,13.31
9887151,9810875,3281,1148350,10959225,11.70
9887152,9943462,3673,1285550,11229012,12.93
9887153,9957262,3230,1130500,11087762,11.35
9887154,9952934,2802,980700,10933634,9.85
9887155,9955515,1810,633500,10589015,6.36
9887156,9962232,1656,579600,10541832,5.82
9887157,9938107,3972,1390200,11328307,13.99
9887158,9953832,1378,482300,10436132,4.85
9887159,9954739,2452,858200,10812939,8.62
9887160,9940774,2018,706300,10647074,7.11
9887161,9965125,2809,983150,10948275,9.87
9887162,9955243,5018,1756300,11711543,17.64
9887163,7635602,4599,1609650,9245252,21.08
9887164,9950989,4135,1447250,11398239,14.54
9887165,3713734,2018,706300,4420034,19.02
9887166,9936256,3897,1363950,11300206,13.73
9887167,9945902,4397,1538950,11484852,15.47
9887168,9955038,4125,1443750,11398788,14.50
9887169,9933760,3750,1312500,11246260,13.21
9887170,2874908,1042,364700,3239608,12.69
9887171,9941022,4464,1562400,11503422,15.72
9887172,9948753,3182,1113700,11062453,11.19
9887173,9803070,4479,1567650,11370720,15.99
9887174,9925106,2904,1016400,10941506,10.24
9887175,9943157,1135,397250,10340407,4.00
9887176,5591378,1165,407750,5999128,7.29
9887177,8286244,4190,1466500,9752744,17.70
9887178,3820133,2138,748300,4568433,19.59
9887179,9939161,3503,1226050,11165211,12.34
9887180,9357943,4091,1431850,10789793,15.30
9887181,9939682,3231,1130850,11070532,11.38
9887182,403418,178,62300,465718,15.44
9887183,9926907,3852,1348200,11275107,13.58
9887184,9904493,3470,1214500,11118993,12.26
9887185,9183344,3354,1173900,10357244,12.78
9887186,9901984,3943,1380050,11282034,13.94
9887187,9894349,4298,1504300,11398649,15.20
9887188,9909866,4331,1515850,11425716,15.30
9887189,9901683,3711,1298850,11200533,13.12
9887190,9903947,3141,1099350,11003297,11.10
9887191,9922902,3350,1172500,11095402,11.82
9887192,9917695,3420,1197000,11114695,12.07
9887193,1433741,544,190400,1624141,13.28
9887194,9916079,2567,898450,10814529,9.06
9887195,9942836,5038,1763300,11706136,17.73
9887196,2554730,1631,570850,3125580,22.34
9887197,9927951,4386,1535100,11463051,15.46
9887198,9955450,2288,800800,10756250,8.04
9887199,9946887,3936,1377600,11324487,13.85
9887200,9945674,4705,1646750,11592424,16.56
9887201,9954416,1987,695450,10649866,6.99
9887202,9931531,3048,1066800,10998331,10.74
9887203,9937281,2437,852950,10790231,8.58
9887204,9953791,5353,1873550,11827341,18.82
9887205,9955597,4049,1417150,11372747,14.23
9887206,9961767,5167,1808450,11770217,18.15
9887207,4463996,1450,507500,4971496,11.37
9887208,9963814,2638,923300,10887114,9.27
9887209,9955897,4429,1550150,11506047,15.57
9887210,9972285,3192,1117200,11089485,11.20
9887211,9981326,3271,1144850,11126176,11.47
9887212,9991942,2834,991900,10983842,9.93
9887213,9995456,4022,1407700,11403156,14.08
9887214,9974154,3963,1387050,11361204,13.91
9887215,9992268,4704,1646400,11638668,16.48
9887216,9998839,3662,1281700,11280539,12.82
9887217,9979075,4480,1568000,11547075,15.71
9887218,9976397,4893,1712550,11688947,17.17
9887219,9979027,796,278600,10257627,2.79
9887220,9594792,3035,1062250,10657042,11.07
9887221,9978831,5335,1867250,11846081,18.71
9887222,9992345,3587,1255450,11247795,12.56
9887223,9986264,4498,1574300,11560564,15.76
9887224,9992154,3035,1062250,11054404,10.63
9887225,9981481,3804,1331400,11312881,13.34
9887226,9978064,3342,1169700,11147764,11.72
9887227,9986473,3694,1292900,11279373,12.95
9887228,4358410,1563,547050,4905460,12.55
9887229,9981636,5533,1936550,11918186,19.40
9887230,9999915,2456,859600,10859515,8.60
9887231,9983940,3883,1359050,11342990,13.61
9887232,9959084,5930,2075500,12034584,20.84
9887233,9998621,3536,1237600,11236221,12.38
9887234,9989950,2213,774550,10764500,7.75
9887235,4977402,2308,807800,5785202,16.23
9887236,9986760,2498,874300,10861060,8.75
9887237,9989634,2051,717850,10707484,7.19
9887238,9987721,3517,1230950,11218671,12.32
9887239,9984935,3054,1068900,11053835,10.71
9887240,836168,291,101850,938018,12.18
9887241,6511536,1807,632450,7143986,9.71
9887242,9991876,3448,1206800,11198676,12.08
9887243,4295317,1323,463050,4758367,10.78
9887244,3163616,2130,745500,3909116,23.56
9887245,9962128,3858,1350300,11312428,13.55
9887246,1687157,505,176750,1863907,10.48
9887247,9939126,2666,933100,10872226,9.39
9887248,9948835,3810,1333500,11282335,13.40
9887249,6493073,1869,654150,7147223,10.07
9887250,9973654,2916,1020600,10994254,10.23
9887251,9448834,3154,1103900,10552734,11.68
9887252,9976249,2052,718200,10694449,7.20
9887253,9064629,3279,1147650,10212279,12.66
9887254,9997033,3900,1365000,11362033,13.65
9887255,9979015,4584,1604400,11583415,16.08
9887256,9990381,4381,1533350,11523731,15.35
9887257,9967906,3871,1354850,11322756,13.59
9887258,9981091,3422,1197700,11178791,12.00
9887259,633093,452,158200,791293,24.99
9887260,9984120,3459,1210650,11194770,12.13
9887261,3268530,2215,775250,4043780,23.72
9887262,7660243,2752,963200,8623443,12.57
9887263,9944046,2760,966000,10910046,9.71
9887264,1559005,1289,451150,2010155,28.94
9887265,9952777,3996,1398600,11351377,14.05
9887266,9962659,4607,1612450,11575109,16.18
9887267,9961916,1759,615650,10577566,6.18
9887268,9964037,4454,1558900,11522937,15.65
9887269,9584676,2626,919100,10503776,9.59
9887270,9963680,2365,827750,10791430,8.31
9887271,9949172,2489,871150,10820322,8.76
9887272,9955384,3843,1345050,11300434,13.51
9887273,9956014,2991,1046850,11002864,10.51
9887274,9969213,2260,791000,10760213,7.93
9887275,9970786,3227,1129450,11100236,11.33
9887276,9963796,3789,1326150,11289946,13.31
9887277,9969129,2627,919450,10888579,9.22
9887278,9975054,4844,1695400,11670454,17.00
9887279,9982521,4039,1413650,11396171,14.16
9887280,1812552,403,141050,1953602,7.78
9887281,1635460,1229,430150,2065610,26.30
9887282,9953929,3164,1107400,11061329,11.13
9887283,9957982,3708,1297800,11255782,13.03
9887284,9931956,3904,1366400,11298356,13.76
9887285,9951725,3038,1063300,11015025,10.68
9887286,9947072,3213,1124550,11071622,11.31
9887287,9951993,5211,1823850,11775843,18.33
9887288,9972845,2432,851200,10824045,8.54
9887289,9978062,4451,1557850,11535912,15.61
9887290,9981308,2480,868000,10849308,8.70
9887292,9964363,2884,1009400,10973763,10.13
9887293,9976037,1913,669550,10645587,6.71
9887295,2667588,1495,523250,3190838,19.62
9887296,9975119,2935,1027250,11002369,10.30
9887297,9987528,2192,767200,10754728,7.68
9887298,9983013,3040,1064000,11047013,10.66
9887299,9964865,2061,721350,10686215,7.24
9887300,6718771,2268,793800,7512571,11.81
9887301,9952555,5157,1804950,11757505,18.14
9887303,9972197,2687,940450,10912647,9.43
9887305,9958963,4267,1493450,11452413,15.00
9887306,9985010,2674,935900,10920910,9.37
9887307,9975006,3549,1242150,11217156,12.45
9887308,9961903,2850,997500,10959403,10.01
9887309,9471556,3299,1154650,10626206,12.19
9887310,4223147,1503,526050,4749197,12.46
9887311,9991521,2638,923300,10914821,9.24
9887312,9990799,4200,1470000,11460799,14.71
9887313,9975639,3026,1059100,11034739,10.62
9887314,9961354,2990,1046500,11007854,10.51
9887315,9982693,4818,1686300,11668993,16.89
9887316,4958470,2009,703150,5661620,14.18
9887317,9970541,4519,1581650,11552191,15.86
9887318,9966514,3726,1304100,11270614,13.08
9887319,9969509,3327,1164450,11133959,11.68
9887320,9982547,2810,983500,10966047,9.85
9887321,9973876,3802,1330700,11304576,13.34
9887322,9960506,4153,1453550,11414056,14.59
9887323,9979990,3464,1212400,11192390,12.15
9887324,9991989,5276,1846600,11838589,18.48
9887325,9998189,3790,1326500,11324689,13.27
9887326,9974663,4476,1566600,11541263,15.71
9887327,9989024,2221,777350,10766374,7.78
9887328,1586602,1140,399000,1985602,25.15
9887329,9954989,4410,1543500,11498489,15.50
9887330,9963343,6410,2243500,12206843,22.52
9887331,9993432,2012,704200,10697632,7.05
9887332,9962023,4800,1680000,11642023,16.86
9887333,9947838,3484,1219400,11167238,12.26
9887334,9998591,3687,1290450,11289041,12.91
9887335,9972028,2313,809550,10781578,8.12
9887336,9982706,4242,1484700,11467406,14.87
9887337,9989121,5108,1787800,11776921,17.90
9887338,9979207,2990,1046500,11025707,10.49
9887339,9983579,3067,1073450,11057029,10.75
9887340,9958683,2805,981750,10940433,9.86
9887341,9969361,3914,1369900,11339261,13.74
9887342,2258216,881,308350,2566566,13.65
9887343,9983703,3498,1224300,11208003,12.26
9887344,9989207,2270,794500,10783707,7.95
9887345,9980609,4209,1473150,11453759,14.76
9887346,9985236,3950,1382500,11367736,13.85
9887347,9984715,3890,1361500,11346215,13.64
9887348,9983582,4109,1438150,11421732,14.41
9887349,9986343,3359,1175650,11161993,11.77
9887350,9986536,2379,832650,10819186,8.34
9887351,9989779,4700,1645000,11634779,16.47
9887352,9978576,1623,568050,10546626,5.69
9887353,9973412,2582,903700,10877112,9.06
9887354,9975746,2563,897050,10872796,8.99
9887355,9994319,2219,776650,10770969,7.77
9887356,9993790,2035,712250,10706040,7.13
9887357,9984737,5010,1753500,11738237,17.56
9887358,9978038,2093,732550,10710588,7.34
9887359,9945864,3713,1299550,11245414,13.07
9887360,9983372,2528,884800,10868172,8.86
9887361,9982155,3001,1050350,11032505,10.52
9887362,9978842,3796,1328600,11307442,13.31
9887363,9966735,1905,666750,10633485,6.69
9887364,9964526,3781,1323350,11287876,13.28
9887365,9969669,5414,1894900,11864569,19.01
9887366,9981649,2496,873600,10855249,8.75
9887367,9671014,2867,1003450,10674464,10.38
9887368,9650495,2458,860300,10510795,8.91
9887369,9985385,961,336350,10321735,3.37
9887370,9964898,4010,1403500,11368398,14.08
9887371,9966614,3850,1347500,11314114,13.52
9887372,9970198,5843,2045050,12015248,20.51
9887373,9977161,3633,1271550,11248711,12.74
9887374,9972461,2934,1026900,10999361,10.30
9887375,8131209,2132,746200,8877409,9.18
9887376,9962399,2402,840700,10803099,8.44
9887377,9966498,3571,1249850,11216348,12.54
9887378,9974063,3073,1075550,11049613,10.78
9887379,9967302,2063,722050,10689352,7.24
9887380,9954842,3791,1326850,11281692,13.33
9887381,9977120,2510,878500,10855620,8.81
9887382,9986875,1448,506800,10493675,5.07
9887383,9981794,4573,1600550,11582344,16.03
9887384,9987860,1594,557900,10545760,5.59
9887385,9983492,4371,1529850,11513342,15.32
9887386,9980384,2811,983850,10964234,9.86
9887387,9987695,3999,1399650,11387345,14.01
9887388,9984512,720,252000,10236512,2.52
9887389,9983770,3315,1160250,11144020,11.62
9887390,9979356,3692,1292200,11271556,12.95
9887391,4499899,2291,801850,5301749,17.82
9887392,9990403,2627,919450,10909853,9.20
9887393,9967410,3985,1394750,11362160,13.99
9887394,9985927,3261,1141350,11127277,11.43
9887395,9987538,2701,945350,10932888,9.47
9887396,9994896,5698,1994300,11989196,19.95
9887397,9986365,5162,1806700,11793065,18.09
9887398,9437533,3766,1318100,10755633,13.97
9887399,9988293,4206,1472100,11460393,14.74
9887400,9972506,2987,1045450,11017956,10.48
9887401,9990257,2802,980700,10970957,9.82
9887402,9993531,1381,483350,10476881,4.84
9887403,9976804,4673,1635550,11612354,16.39
9887405,9968700,1231,430850,10399550,4.32
9887406,9959957,911,318850,10278807,3.20
9887407,9966209,3074,1075900,11042109,10.80
9887408,9980531,3329,1165150,11145681,11.67
9887409,9979617,3776,1321600,11301217,13.24
9887410,9983139,64,22400,10005539,0.22
9887411,9989458,2937,1027950,11017408,10.29
9887412,9553961,3018,1056300,10610261,11.06
9887413,9996148,3294,1152900,11149048,11.53
9887414,9983177,4264,1492400,11475577,14.95
9887415,9980507,2855,999250,10979757,10.01
9887416,6343307,2471,864850,7208157,13.63
9887417,9981210,2211,773850,10755060,7.75
9887418,9984627,82,28700,10013327,0.29
9887419,9977697,2904,1016400,10994097,10.19
9887420,9984036,2677,936950,10920986,9.38
9887421,9976525,3653,1278550,11255075,12.82
9887422,9965224,4557,1594950,11560174,16.01
9887423,9983187,5264,1842400,11825587,18.46
9887424,9966234,4207,1472450,11438684,14.77
9887425,9957562,3932,1376200,11333762,13.82
9887426,9946172,6977,2441950,12388122,24.55
9887427,9970809,2180,763000,10733809,7.65
9887428,9962601,3950,1382500,11345101,13.88
9887429,9940994,3053,1068550,11009544,10.75
9887430,9947451,157,54950,10002401,0.55
9887431,9968870,2852,998200,10967070,10.01
9887432,9965423,4144,1450400,11415823,14.55
9887433,9983788,2206,772100,10755888,7.73
9887434,4070286,736,257600,4327886,6.33
9887436,9985476,5156,1804600,11790076,18.07
9887437,9959700,4673,1635550,11595250,16.42
9887438,9964129,2310,808500,10772629,8.11
9887439,9984960,3201,1120350,11105310,11.22
9887440,9981269,4249,1487150,11468419,14.90
9887441,9994126,4806,1682100,11676226,16.83
9887442,9954382,3096,1083600,11037982,10.89
9887443,9976441,3873,1355550,11331991,13.59
9887444,9969971,3611,1263850,11233821,12.68
9887445,9956023,3278,1147300,11103323,11.52
9887446,9965426,3971,1389850,11355276,13.95
9887447,9971287,2538,888300,10859587,8.91
9887448,9984336,3446,1206100,11190436,12.08
9887449,9984279,2366,828100,10812379,8.29
9887450,9982749,2473,865550,10848299,8.67
9887451,9971786,2706,947100,10918886,9.50
9887452,9995945,77,26950,10022895,0.27
9887453,9970976,5364,1877400,11848376,18.83
9887454,9970219,3551,1242850,11213069,12.47
9887455,9979581,3881,1358350,11337931,13.61
9887456,9970164,4048,1416800,11386964,14.21
9887457,9991510,3728,1304800,11296310,13.06
9887458,9992477,3332,1166200,11158677,11.67
9887459,9094348,1006,352100,9446448,3.87
9887460,9979402,2628,919800,10899202,9.22
9887461,9989645,3529,1235150,11224795,12.36
9887462,9986588,4509,1578150,11564738,15.80
9887463,9986859,2926,1024100,11010959,10.25
9887464,9579391,2177,761950,10341341,7.95
9887465,2149165,657,229950,2379115,10.70
9887466,9970974,4335,1517250,11488224,15.22
9887467,9986217,5196,1818600,11804817,18.21
9887468,9996160,3810,1333500,11329660,13.34
9887469,9985151,3943,1380050,11365201,13.82
9887470,881918,922,322700,1204618,36.59
9887471,9972014,3705,1296750,11268764,13.00
9887473,9965598,5661,1981350,11946948,19.88
9887474,7244832,2678,937300,8182132,12.94
9887475,9948027,1975,691250,10639277,6.95
9887476,9942790,3281,1148350,11091140,11.55
9887477,9944937,2320,812000,10756937,8.16
9887478,9940077,3538,1238300,11178377,12.46
9887479,9929412,5210,1823500,11752912,18.36
9887480,9971669,3579,1252650,11224319,12.56
9887481,9957310,5426,1899100,11856410,19.07
9887482,9979803,4903,1716050,11695853,17.20
9887483,9981751,2775,971250,10953001,9.73
9887484,9971422,3619,1266650,11238072,12.70
9887485,9993303,1043,365050,10358353,3.65
9887486,9973721,1533,536550,10510271,5.38
9887488,9989076,3819,1336650,11325726,13.38
9887489,9973304,2871,1004850,10978154,10.08
9887490,9965604,2879,1007650,10973254,10.11
9887491,9985005,4406,1542100,11527105,15.44
9887492,9975789,3912,1369200,11344989,13.73
9887493,9980720,3338,1168300,11149020,11.71
9887494,9977773,4913,1719550,11697323,17.23
9887495,9984948,4007,1402450,11387398,14.05
9887496,9984341,3341,1169350,11153691,11.71
9887497,1751963,500,175000,1926963,9.99
9887498,9975116,4559,1595650,11570766,16.00
9887499,9979818,3709,1298150,11277968,13.01
9887500,9989614,3399,1189650,11179264,11.91
9887501,7199286,4749,1662150,8861436,23.09
9887502,9976689,3873,1355550,11332239,13.59
9887503,9992420,4120,1442000,11434420,14.43
9887504,6007383,2339,818650,6826033,13.63
9887505,9944738,3407,1192450,11137188,11.99
9887507,9941403,4135,1447250,11388653,14.56
9887509,9948150,3787,1325450,11273600,13.32
9887510,9950437,4280,1498000,11448437,15.05
9887511,1788482,546,191100,1979582,10.69
9887512,3222816,1256,439600,3662416,13.64
9887513,9973304,4137,1447950,11421254,14.52
9887514,2580086,2818,986300,3566386,38.23
9887515,9961290,5493,1922550,11883840,19.30
9887516,9947547,6510,2278500,12226047,22.91
9887517,9955095,3086,1080100,11035195,10.85
9887518,9954027,4316,1510600,11464627,15.18
9887519,9950643,6846,2396100,12346743,24.08
9887520,9964222,5451,1907850,11872072,19.15
9887521,2386358,807,282450,2668808,11.84
9887522,9956552,4543,1590050,11546602,15.97
9887523,9963667,3687,1290450,11254117,12.95
9887524,6823532,4070,1424500,8248032,20.88
9887525,9936775,3797,1328950,11265725,13.37
9887526,9947089,2705,946750,10893839,9.52
9887527,3230079,2002,700700,3930779,21.69
9887528,9930339,5313,1859550,11789889,18.73
9887529,9910759,3235,1132250,11043009,11.42
9887530,9929195,5393,1887550,11816745,19.01
9887531,9910583,4977,1741950,11652533,17.58
9887532,9918224,4966,1738100,11656324,17.52
9887533,9922464,3278,1147300,11069764,11.56
9887534,9941072,4258,1490300,11431372,14.99
9887535,9945312,3883,1359050,11304362,13.67
9887536,9955929,4156,1454600,11410529,14.61
9887537,8066225,2040,714000,8780225,8.85
9887539,5230314,2372,830200,6060514,15.87
9887540,9979445,3219,1126650,11106095,11.29
9887541,9999539,4547,1591450,11590989,15.92
9887542,9985074,4812,1684200,11669274,16.87
9887543,9986411,4482,1568700,11555111,15.71
9887544,9985852,3947,1381450,11367302,13.83
9887545,9746788,6485,2269750,12016538,23.29
9887546,9995931,3151,1102850,11098781,11.03
9887547,9726454,4503,1576050,11302504,16.20
9887548,9979281,2676,936600,10915881,9.39
9887550,9982752,2952,1033200,11015952,10.35
9887551,9953353,2876,1006600,10959953,10.11
9887552,7201673,1822,637700,7839373,8.85
9887553,9981710,4074,1425900,11407610,14.29
9887554,2159215,577,201950,2361165,9.35
9887555,9954915,2782,973700,10928615,9.78
9887556,9949874,2463,862050,10811924,8.66
9887557,9942152,4753,1663550,11605702,16.73
9887558,9962399,3799,1329650,11292049,13.35
9887559,9961528,4956,1734600,11696128,17.41
9887560,9964212,2291,801850,10766062,8.05
9887561,9982621,4902,1715700,11698321,17.19
9887562,9979034,5298,1854300,11833334,18.58
9887563,9989565,4279,1497650,11487215,14.99
9887564,7350115,3436,1202600,8552715,16.36
9887565,187559,116,40600,228159,21.65
9887566,9968517,3718,1301300,11269817,13.05
9887567,9975309,2957,1034950,11010259,10.38
9887568,9954671,4389,1536150,11490821,15.43
9887569,9966631,1873,655550,10622181,6.58
9887570,9965183,1908,667800,10632983,6.70
9887571,9945770,5524,1933400,11879170,19.44
9887572,9947809,2948,1031800,10979609,10.37
9887574,9948206,4079,1427650,11375856,14.35
9887575,9950263,1591,556850,10507113,5.60
9887576,9958772,2888,1010800,10969572,10.15
9887577,9966661,5151,1802850,11769511,18.09
9887578,9962774,2510,878500,10841274,8.82
9887579,9968715,5196,1818600,11787315,18.24
9887580,700320,366,128100,828420,18.29
9887581,9961613,4743,1660050,11621663,16.66
9887582,9960080,4603,1611050,11571130,16.18
9887583,9972828,5031,1760850,11733678,17.66
9887584,9959735,6277,2196950,12156685,22.06
9887585,9981321,3712,1299200,11280521,13.02
9887587,9968294,5826,2039100,12007394,20.46
9887588,722478,293,102550,825028,14.19
9887589,9586897,6672,2335200,11922097,24.36
9887590,9961553,4211,1473850,11435403,14.80
9887591,9971408,5903,2066050,12037458,20.72
9887592,9955318,4951,1732850,11688168,17.41
9887593,3506103,2715,950250,4456353,27.10
9887594,9950914,4143,1450050,11400964,14.57
9887595,9940643,2659,930650,10871293,9.36
9887596,9933515,4195,1468250,11401765,14.78
9887597,9947728,5745,2010750,11958478,20.21
9887598,9953461,4894,1712900,11666361,17.21
9887599,9943294,2595,908250,10851544,9.13
9887600,9945741,3845,1345750,11291491,13.53
9887601,9940999,2425,848750,10789749,8.54
9887602,9965173,4783,1674050,11639223,16.80
9887603,500503,230,80500,581003,16.08
9887604,9982654,3510,1228500,11211154,12.31
9887605,9972822,3789,1326150,11298972,13.30
9887606,7050264,4256,1489600,8539864,21.13
9887607,9967109,2546,891100,10858209,8.94
9887608,9982252,1800,630000,10612252,6.31
9887609,9985179,3173,1110550,11095729,11.12
9887610,3068839,1129,395150,3463989,12.88
9887611,9978587,6498,2274300,12252887,22.79
9887612,9989605,5943,2080050,12069655,20.82
9887613,9989202,3941,1379350,11368552,13.81
9887614,9984706,2727,954450,10939156,9.56
9887615,9978389,1398,489300,10467689,4.90
9887616,9984326,3478,1217300,11201626,12.19
9887617,9985664,1920,672000,10657664,6.73
9887618,9998408,5027,1759450,11757858,17.60
9887619,9984089,6549,2292150,12276239,22.96
9887620,1883430,1028,359800,2243230,19.10
9887621,9968840,4371,1529850,11498690,15.35
9887622,9986714,4323,1513050,11499764,15.15
9887623,3239749,1004,351400,3591149,10.85
9887624,9980705,6019,2106650,12087355,21.11
9887625,9981721,4579,1602650,11584371,16.06
9887626,9985388,3972,1390200,11375588,13.92
9887627,9978181,680,238000,10216181,2.39
9887628,9958517,822,287700,10246217,2.89
9887629,9984117,4214,1474900,11459017,14.77
9887630,9979570,2508,877800,10857370,8.80
9887631,9999892,4826,1689100,11688992,16.89
9887632,9970791,4192,1467200,11437991,14.71
9887633,9975208,3595,1258250,11233458,12.61
9887634,9984687,3989,1396150,11380837,13.98
9887635,9969499,5005,1751750,11721249,17.57
9887636,9991410,5633,1971550,11962960,19.73
9887637,9985294,764,267400,10252694,2.68
9887639,9973748,2973,1040550,11014298,10.43
9887640,9989129,5612,1964200,11953329,19.66
9887641,1296715,356,124600,1421315,9.61
9887642,9970853,4825,1688750,11659603,16.94
9887643,9979260,4711,1648850,11628110,16.52
9887644,9975589,4181,1463350,11438939,14.67
9887645,5456973,3752,1313200,6770173,24.06
9887646,9982330,5537,1937950,11920280,19.41
9887647,9975958,2374,830900,10806858,8.33
9887648,9993663,5617,1965950,11959613,19.67
9887650,9971796,3646,1276100,11247896,12.80
9887651,9974104,5410,1893500,11867604,18.98
9887652,9981608,3168,1108800,11090408,11.11
9887653,9954609,6441,2254350,12208959,22.65
9887654,9991900,6005,2101750,12093650,21.03
9887655,9995347,5022,1757700,11753047,17.59
9887656,9978014,2527,884450,10862464,8.86
9887657,3610635,949,332150,3942785,9.20
9887658,9994330,6438,2253300,12247630,22.55
9887659,9912542,2255,789250,10701792,7.96
9887660,9981941,4529,1585150,11567091,15.88
9887661,9963936,2612,914200,10878136,9.18
9887662,9987770,5910,2068500,12056270,20.71
9887663,9998659,1215,425250,10423909,4.25
9887664,9983688,1188,415800,10399488,4.16
9887665,9980396,3751,1312850,11293246,13.15
9887666,1236706,1839,643650,1880356,52.05
9887667,9955487,1071,374850,10330337,3.77
9887668,3083344,2479,867650,3950994,28.14
9887669,776005,216,75600,851605,9.74
9887670,5746710,2823,988050,6734760,17.19
9887671,9919738,3969,1389150,11308888,14.00
9887672,9909003,1604,561400,10470403,5.67
9887673,9928133,2544,890400,10818533,8.97
9887674,895575,187,65450,961025,7.31
9887675,6514684,3049,1067150,7581834,16.38
9887676,3830417,3231,1130850,4961267,29.52
9887677,320570,201,70350,390920,21.95
9887678,9910815,2601,910350,10821165,9.19
9887679,9910455,5246,1836100,11746555,18.53
9887680,915375,212,74200,989575,8.11
9887681,9925372,5257,1839950,11765322,18.54
9887682,9908642,3326,1164100,11072742,11.75
9887683,9921143,5285,1849750,11770893,18.64
9887684,9921269,3171,1109850,11031119,11.19
9887685,9904221,5653,1978550,11882771,19.98
9887686,9917172,4561,1596350,11513522,16.10
9887687,476600,201,70350,546950,14.76
9887688,3286754,3048,1066800,4353554,32.46
9887689,9888941,3834,1341900,11230841,13.57
9887690,9847124,1851,647850,10494974,6.58
9887691,9879595,3634,1271900,11151495,12.87
9887692,9929034,1609,563150,10492184,5.67
9887693,9936604,3091,1081850,11018454,10.89
9887694,9929914,5777,2021950,11951864,20.36
9887695,9934241,4330,1515500,11449741,15.26
9887696,9933437,4000,1400000,11333437,14.09
9887697,9948306,5520,1932000,11880306,19.42
9887698,9937255,2700,945000,10882255,9.51
9887699,9931749,1891,661850,10593599,6.66
9887700,9933764,3082,1078700,11012464,10.86
9887701,9951125,2744,960400,10911525,9.65
9887702,9959962,2499,874650,10834612,8.78
9887704,9958873,3568,1248800,11207673,12.54
9887705,9945870,4219,1476650,11422520,14.85
9887706,9938777,3378,1182300,11121077,11.90
9887707,9923356,6474,2265900,12189256,22.83
9887708,9935060,5336,1867600,11802660,18.80
9887709,9945763,5003,1751050,11696813,17.61
9887711,9952617,4017,1405950,11358567,14.13
9887712,9964965,6948,2431800,12396765,24.40
9887713,9975058,4551,1592850,11567908,15.97
9887714,9967231,3144,1100400,11067631,11.04
9887715,9988728,1971,689850,10678578,6.91
9887716,9983685,3001,1050350,11034035,10.52
9887717,9980635,6199,2169650,12150285,21.74
9887718,9985670,3929,1375150,11360820,13.77
9887719,9989819,5943,2080050,12069869,20.82
9887720,9957855,4076,1426600,11384455,14.33
9887721,6167752,4473,1565550,7733302,25.38
9887723,4642619,2249,787150,5429769,16.95
9887724,1938070,1436,502600,2440670,25.93
9887725,9993850,4716,1650600,11644450,16.52
9887726,9976085,6174,2160900,12136985,21.66
9887727,9994370,4534,1586900,11581270,15.88
9887728,9994492,5999,2099650,12094142,21.01
9887729,2809102,1884,659400,3468502,23.47
9887730,9970288,5356,1874600,11844888,18.80
9887731,9979248,4383,1534050,11513298,15.37
9887732,9996047,6660,2331000,12327047,23.32
9887733,9989872,6023,2108050,12097922,21.10
9887734,9977404,3056,1069600,11047004,10.72
9887735,9995420,4195,1468250,11463670,14.69
9887736,380485,147,51450,431935,13.52
9887737,9964841,5156,1804600,11769441,18.11
9887739,9974634,3915,1370250,11344884,13.74
9887740,9970316,2418,846300,10816616,8.49
9887741,9955488,4527,1584450,11539938,15.92
9887742,9198113,2294,802900,10001013,8.73
9887743,3132488,1911,668850,3801338,21.35
9887744,9936729,4249,1487150,11423879,14.97
9887745,7455092,3150,1102500,8557592,14.79
9887746,9949819,3797,1328950,11278769,13.36
9887747,9949295,4081,1428350,11377645,14.36
9887748,9971012,2935,1027250,10998262,10.30
9887749,667467,148,51800,719267,7.76
9887750,9933110,4461,1561350,11494460,15.72
9887751,4289380,356,124600,4413980,2.90
9887753,9962139,4500,1575000,11537139,15.81
9887754,9970236,3689,1291150,11261386,12.95
9887755,9977970,5002,1750700,11728670,17.55
9887756,9895010,5252,1838200,11733210,18.58
9887757,9967761,3823,1338050,11305811,13.42
9887758,9960567,2835,992250,10952817,9.96
9887759,9949862,6151,2152850,12102712,21.64
9887760,2017091,879,307650,2324741,15.25
9887761,9983699,4039,1413650,11397349,14.16
9887762,9979393,2263,792050,10771443,7.94
9887763,6916084,1936,677600,7593684,9.80
9887764,9988288,5985,2094750,12083038,20.97
9887765,9975693,2033,711550,10687243,7.13
9887766,9977779,6787,2375450,12353229,23.81
9887767,9971966,1406,492100,10464066,4.93
9887768,3422955,1565,547750,3970705,16.00
9887769,9972238,3120,1092000,11064238,10.95
9887770,768034,191,66850,834884,8.70
9887771,9981407,4337,1517950,11499357,15.21
9887772,9964409,3928,1374800,11339209,13.80
9887773,9983633,2018,706300,10689933,7.07
9887774,9961290,653,228550,10189840,2.29
9887775,9984357,4074,1425900,11410257,14.28
9887776,9946715,3326,1164100,11110815,11.70
9887777,9984748,4322,1512700,11497448,15.15
9887778,9961382,3392,1187200,11148582,11.92
9887779,9963384,653,228550,10191934,2.29
9887780,9364962,1394,487900,9852862,5.21
9887781,2009605,592,207200,2216805,10.31
9887782,4964861,3047,1066450,6031311,21.48
9887783,6233838,3566,1248100,7481938,20.02
9887784,9969233,4809,1683150,11652383,16.88
9887785,7488344,4300,1505000,8993344,20.10
9887786,6274512,4053,1418550,7693062,22.61
9887787,9945083,4147,1451450,11396533,14.59
9887788,9948516,4976,1741600,11690116,17.51
9887789,3049318,602,210700,3260018,6.91
9887790,9931129,6233,2181550,12112679,21.97
9887791,2335597,1012,354200,2689797,15.17
9887792,9914253,5568,1948800,11863053,19.66
9887793,9931087,3485,1219750,11150837,12.28
9887794,9925074,4119,1441650,11366724,14.53
9887795,9933401,2489,871150,10804551,8.77
9887796,9950809,1496,523600,10474409,5.26
9887797,9956555,2233,781550,10738105,7.85
9887798,9954567,5023,1758050,11712617,17.66
9887799,9979376,3503,1226050,11205426,12.29
9887800,9955248,4770,1669500,11624748,16.77
9887801,9946268,1418,496300,10442568,4.99
9887802,9972754,4335,1517250,11490004,15.21
9887803,9986390,4746,1661100,11647490,16.63
9887804,9996667,2032,711200,10707867,7.11
9887805,9987963,3260,1141000,11128963,11.42
9887806,9978917,3889,1361150,11340067,13.64
9887807,5812373,1914,669900,6482273,11.53
9887808,9989230,3918,1371300,11360530,13.73
9887810,9965620,1772,620200,10585820,6.22
9887811,9975556,5485,1919750,11895306,19.24
9887812,9983850,6599,2309650,12293500,23.13
9887813,9980136,4856,1699600,11679736,17.03
9887814,2684700,2872,1005200,3689900,37.44
9887815,9968588,2988,1045800,11014388,10.49
9887816,9988560,3268,1143800,11132360,11.45
9887819,9952106,3487,1220450,11172556,12.26
9887820,9960449,3377,1181950,11142399,11.87
9887821,9959580,4980,1743000,11702580,17.50
9887822,9921085,4404,1541400,11462485,15.54
9887823,9966982,2261,791350,10758332,7.94
9887824,9986050,4381,1533350,11519400,15.35
9887825,9986825,2571,899850,10886675,9.01
9887826,9987512,3181,1113350,11100862,11.15
9887827,9976915,3957,1384950,11361865,13.88
9887828,9964163,2194,767900,10732063,7.71
9887829,9958285,3751,1312850,11271135,13.18
9887830,9966606,5004,1751400,11718006,17.57
9887831,9970142,3123,1093050,11063192,10.96
9887832,9970617,5383,1884050,11854667,18.90
9887833,9912204,2039,713650,10625854,7.20
9887834,2148296,1397,488950,2637246,22.76
9887835,9953747,3058,1070300,11024047,10.75
9887836,9963939,3959,1385650,11349589,13.91
9887837,9955881,2773,970550,10926431,9.75
9887838,9950857,3082,1078700,11029557,10.84
9887839,9940721,1403,491050,10431771,4.94
9887840,1827554,783,274050,2101604,15.00
9887841,4107873,2757,964950,5072823,23.49
9887842,9938808,4261,1491350,11430158,15.01
9887843,9947352,4289,1501150,11448502,15.09
9887844,1564254,1313,459550,2023804,29.38
9887845,9940868,3974,1390900,11331768,13.99
9887846,9958586,3520,1232000,11190586,12.37
9887847,1042500,728,254800,1297300,24.44
9887848,9753288,3118,1091300,10844588,11.19
9887849,1545294,722,252700,1797994,16.35
9887850,9912650,3701,1295350,11208000,13.07
9887851,1997345,349,122150,2119495,6.12
9887852,9888613,5028,1759800,11648413,17.80
9887854,9943889,2534,886900,10830789,8.92
9887855,9950714,2352,823200,10773914,8.27
9887856,9958826,1406,492100,10450926,4.94
9887857,9958887,4814,1684900,11643787,16.92
9887858,9956121,2294,802900,10759021,8.06
9887859,9957469,3345,1170750,11128219,11.76
9887860,9975540,5007,1752450,11727990,17.57
9887861,9970006,3203,1121050,11091056,11.24
9887862,9975127,3521,1232350,11207477,12.35
9887863,9990304,4258,1490300,11480604,14.92
9887864,9439647,2657,929950,10369597,9.85
9887865,9990710,4721,1652350,11643060,16.54
9887866,9980752,2614,914900,10895652,9.17
9887867,9968636,3197,1118950,11087586,11.22
9887868,9983903,4824,1688400,11672303,16.91
9887869,6944808,3121,1092350,8037158,15.73
9887870,9989678,4821,1687350,11677028,16.89
9887871,9899140,3088,1080800,10979940,10.92
9887872,9984787,3879,1357650,11342437,13.60
9887874,1659553,926,324100,1983653,19.53
9887875,9966183,6402,2240700,12206883,22.48
9887876,9956934,4786,1675100,11632034,16.82
9887877,9964458,2952,1033200,10997658,10.37
9887878,9972639,4289,1501150,11473789,15.05
9887879,9960276,5081,1778350,11738626,17.85
9887880,9982788,4494,1572900,11555688,15.76
9887883,8202041,5945,2080750,10282791,25.37
9887884,9975595,3929,1375150,11350745,13.79
9887885,9226670,3740,1309000,10535670,14.19
9887886,9990781,4324,1513400,11504181,15.15
9887887,9985915,5203,1821050,11806965,18.24
9887888,9985082,5012,1754200,11739282,17.57
9887889,171086,91,31850,202936,18.62
9887890,8992561,3722,1302700,10295261,14.49
9887891,9979372,4579,1602650,11582022,16.06
9887892,412052,182,63700,475752,15.46
9887893,9974417,3313,1159550,11133967,11.63
9887894,9199298,2069,724150,9923448,7.87
9887895,3912123,2126,744100,4656223,19.02
9887896,9973598,2993,1047550,11021148,10.50
9887897,9981003,3635,1272250,11253253,12.75
9887898,2671886,1705,596750,3268636,22.33
9887899,9958506,4477,1566950,11525456,15.73
9887900,6525084,2690,941500,7466584,14.43
9887901,1956578,1101,385350,2341928,19.70
9887902,9939492,4844,1695400,11634892,17.06
9887903,4337565,1144,400400,4737965,9.23
9887904,9945512,3978,1392300,11337812,14.00
9887905,9925672,3443,1205050,11130722,12.14
9887907,6327017,2010,703500,7030517,11.12
9887908,9900950,3071,1074850,10975800,10.86
9887909,9932336,3768,1318800,11251136,13.28
9887910,9911279,3470,1214500,11125779,12.25
9887911,9926492,3584,1254400,11180892,12.64
9887912,1874886,892,312200,2187086,16.65
9887913,9951844,3880,1358000,11309844,13.65
9887914,979596,614,214900,1194496,21.94
9887915,9917675,4432,1551200,11468875,15.64
9887916,5419349,1337,467950,5887299,8.63
9887917,8873025,3127,1094450,9967475,12.33
9887918,9934871,3735,1307250,11242121,13.16
9887919,9950442,4298,1504300,11454742,15.12
9887920,2941659,913,319550,3261209,10.86
9887921,8519219,2425,848750,9367969,9.96
9887922,9956016,3801,1330350,11286366,13.36
9887923,9940592,5052,1768200,11708792,17.79
9887924,9948068,3399,1189650,11137718,11.96
9887925,9957672,3495,1223250,11180922,12.28
9887926,6843387,2227,779450,7622837,11.39
9887927,9979502,4069,1424150,11403652,14.27
9887928,9966995,4627,1619450,11586445,16.25
9887929,9994149,3721,1302350,11296499,13.03
9887930,9989294,1855,649250,10638544,6.50
9887931,9981611,3633,1271550,11253161,12.74
9887932,9983560,1210,423500,10407060,4.24
9887933,9989447,1239,433650,10423097,4.34
9887934,9983760,4027,1409450,11393210,14.12
9887935,9998387,4075,1426250,11424637,14.26
9887936,9994473,4251,1487850,11482323,14.89
9887937,9984411,4853,1698550,11682961,17.01
9887938,1763937,1337,467950,2231887,26.53
9887939,9951368,4155,1454250,11405618,14.61
9887940,9975744,3051,1067850,11043594,10.70
9887941,9977520,6028,2109800,12087320,21.15
9887942,9613250,3428,1199800,10813050,12.48
9887943,9968438,3851,1347850,11316288,13.52
9887944,9959429,5443,1905050,11864479,19.13
9887945,9971385,4986,1745100,11716485,17.50
9887946,9982562,6327,2214450,12197012,22.18
9887947,8766853,2133,746550,9513403,8.52
9887948,9998267,4066,1423100,11421367,14.23
9887949,9995980,1956,684600,10680580,6.85
9887950,9987855,3941,1379350,11367205,13.81
9887951,9968042,5561,1946350,11914392,19.53
9887952,9985414,1594,557900,10543314,5.59
9887953,9979409,4783,1674050,11653459,16.78
9887954,9980237,4570,1599500,11579737,16.03
9887955,9988867,5423,1898050,11886917,19.00
9887956,9989873,6614,2314900,12304773,23.17
9887957,2427731,1048,366800,2794531,15.11
9887958,9962234,4419,1546650,11508884,15.53
9887959,9965724,3919,1371650,11337374,13.76
9887960,5144520,1499,524650,5669170,10.20
9887961,9984562,5743,2010050,11994612,20.13
9887962,9971780,2927,1024450,10996230,10.27
9887964,9989817,4145,1450750,11440567,14.52
9887965,9975744,4143,1450050,11425794,14.54
9887966,9986527,2348,821800,10808327,8.23
9887967,9989546,2202,770700,10760246,7.72
9887968,9976966,3590,1256500,11233466,12.59
9887969,9999495,6455,2259250,12258745,22.59
9887970,9998256,4275,1496250,11494506,14.97
9887971,9985641,6484,2269400,12255041,22.73
9887972,9977296,3674,1285900,11263196,12.89
9887973,9990063,6210,2173500,12163563,21.76
9887974,9982607,4902,1715700,11698307,17.19
9887975,9976928,3526,1234100,11211028,12.37
9887976,9988549,4845,1695750,11684299,16.98
9887977,9681392,948,331800,10013192,3.43
9887978,2866889,1072,375200,3242089,13.09
9887979,9984131,4644,1625400,11609531,16.28
9887980,9982438,7425,2598750,12581188,26.03
9887981,9997164,2108,737800,10734964,7.38
9887982,9983689,4249,1487150,11470839,14.90
9887983,9975121,5389,1886150,11861271,18.91
9887984,9985035,5362,1876700,11861735,18.80
9887985,9996711,4435,1552250,11548961,15.53
9887986,9979609,4897,1713950,11693559,17.17
9887987,9996160,4129,1445150,11441310,14.46
9887988,9977681,1312,459200,10436881,4.60
9887989,9965827,995,348250,10314077,3.49
9887990,9975672,2408,842800,10818472,8.45
9887991,9868759,5597,1958950,11827709,19.85
9887992,9983823,2374,830900,10814723,8.32
9887993,2641360,1611,563850,3205210,21.35
9887994,9983971,5772,2020200,12004171,20.23
9887995,9989999,5487,1920450,11910449,19.22
9887996,9998818,3369,1179150,11177968,11.79
9887997,9970912,4524,1583400,11554312,15.88
9887998,9981692,2925,1023750,11005442,10.26
9887999,9983552,3509,1228150,11211702,12.30
9888000,9985298,2767,968450,10953748,9.70
9888001,9974853,5007,1752450,11727303,17.57
9888002,7654487,1000,350000,8004487,4.57
9888003,9962617,2452,858200,10820817,8.61
9888004,9972457,5564,1947400,11919857,19.53
9888005,9971037,2133,746550,10717587,7.49
9888006,9953384,3319,1161650,11115034,11.67
9888007,9966456,3682,1288700,11255156,12.93
9888008,9967008,5518,1931300,11898308,19.38
9888009,9984120,3855,1349250,11333370,13.51
9888011,9976141,2197,768950,10745091,7.71
9888012,9981082,5350,1872500,11853582,18.76
9888013,9973172,2753,963550,10936722,9.66
9888014,9996114,2136,747600,10743714,7.48
9888015,9983618,5040,1764000,11747618,17.67
9888016,7363631,2690,941500,8305131,12.79
9888017,9984179,5657,1979950,11964129,19.83
9888018,9987301,4540,1589000,11576301,15.91
9888019,9988456,2321,812350,10800806,8.13
9888020,9979648,5619,1966650,11946298,19.71
9888021,9987170,2513,879550,10866720,8.81
9888022,9998925,2966,1038100,11037025,10.38
9888023,9996519,2471,864850,10861369,8.65
9888024,9986623,5336,1867600,11854223,18.70
9888025,9991465,4884,1709400,11700865,17.11
9888026,9994060,1803,631050,10625110,6.31
9888027,9987364,3341,1169350,11156714,11.71
9888028,9982538,1570,549500,10532038,5.50
9888029,7182835,1548,541800,7724635,7.54
9888030,9978302,2707,947450,10925752,9.50
9888031,9983618,5413,1894550,11878168,18.98
9888033,9988481,2362,826700,10815181,8.28
9888034,9962172,3313,1159550,11121722,11.64
9888035,9952215,3038,1063300,11015515,10.68
9888036,9974109,3426,1199100,11173209,12.02
9888037,9980292,2815,985250,10965542,9.87
9888038,9973541,3570,1249500,11223041,12.53
9888039,9976763,3055,1069250,11046013,10.72
9888040,9999339,3328,1164800,11164139,11.65
9888041,9981731,2619,916650,10898381,9.18
9888042,9918741,4891,1711850,11630591,17.26
9888043,9970572,4145,1450750,11421322,14.55
9888044,1784045,944,330400,2114445,18.52
9888045,9983318,1719,601650,10584968,6.03
9888046,56209,42,14700,70909,26.15
9888047,9989524,5169,1809150,11798674,18.11
9888048,9989881,4318,1511300,11501181,15.13
9888049,9980145,1939,678650,10658795,6.80
9888050,9990598,4069,1424150,11414748,14.25
9888051,9907590,4884,1709400,11616990,17.25
9888052,7547187,2764,967400,8514587,12.82
9888053,9990193,4911,1718850,11709043,17.21
9888054,9985343,3199,1119650,11104993,11.21
9888055,9982822,4344,1520400,11503222,15.23
9888056,1517497,498,174300,1691797,11.49
9888057,9959823,3745,1310750,11270573,13.16
9888058,9940432,3385,1184750,11125182,11.92
9888059,9943610,2983,1044050,10987660,10.50
9888060,9943524,3644,1275400,11218924,12.83
9888061,9946233,3447,1206450,11152683,12.13
9888062,9949011,4141,1449350,11398361,14.57
9888063,9955999,4074,1425900,11381899,14.32
9888064,5776019,1048,366800,6142819,6.35
9888065,9949878,3665,1282750,11232628,12.89
9888066,9943222,4431,1550850,11494072,15.60
9888067,9939929,3067,1073450,11013379,10.80
9888068,9942345,2322,812700,10755045,8.17
9888069,9876491,2591,906850,10783341,9.18
9888070,9965874,4691,1641850,11607724,16.47
9888071,9958652,2768,968800,10927452,9.73
9888072,9312268,4671,1634850,10947118,17.56
9888073,8359181,2490,871500,9230681,10.43
9888074,9970281,2575,901250,10871531,9.04
9888075,3214081,1232,431200,3645281,13.42
9888076,5310459,1696,593600,5904059,11.18
9888077,9967978,3343,1170050,11138028,11.74
9888079,9952936,3137,1097950,11050886,11.03
9888080,9980450,3569,1249150,11229600,12.52
9888081,9975804,5499,1924650,11900454,19.29
9888082,9991198,3561,1246350,11237548,12.47
9888083,9964859,4928,1724800,11689659,17.31
9888084,9966041,3570,1249500,11215541,12.54
9888085,9989682,3282,1148700,11138382,11.50
9888086,4859044,2577,901950,5760994,18.56
9888087,9980632,3085,1079750,11060382,10.82
9888088,9996640,2916,1020600,11017240,10.21
9888090,9989701,2163,757050,10746751,7.58
9888091,9992975,6252,2188200,12181175,21.90
9888092,9974570,2659,930650,10905220,9.33
9888093,9984138,2291,801850,10785988,8.03
9888094,9974000,3688,1290800,11264800,12.94
9888095,9971395,4735,1657250,11628645,16.62
9888096,9962178,2494,872900,10835078,8.76
9888098,9970256,5511,1928850,11899106,19.35
9888099,9991259,4520,1582000,11573259,15.83
9888100,9985761,3593,1257550,11243311,12.59
9888101,9981102,4672,1635200,11616302,16.38
9888102,9978317,2415,845250,10823567,8.47
9888103,5204637,1565,547750,5752387,10.52
9888104,1723718,735,257250,1980968,14.92
9888105,9952202,2155,754250,10706452,7.58
9888106,9969253,3779,1322650,11291903,13.27
9888107,9946510,3563,1247050,11193560,12.54
9888108,7299049,1883,659050,7958099,9.03
9888109,9971827,2343,820050,10791877,8.22
9888110,4443316,1269,444150,4887466,10.00
9888111,9989976,1953,683550,10673526,6.84
9888112,9976722,1960,686000,10662722,6.88
9888113,9979795,4310,1508500,11488295,15.12
9888114,1532938,327,114450,1647388,7.47
9888115,9995196,4231,1480850,11476046,14.82
9888116,9988551,2566,898100,10886651,8.99
9888117,9995053,2689,941150,10936203,9.42
9888118,9985139,2401,840350,10825489,8.42
9888119,9991221,5085,1779750,11770971,17.81
9888120,9997051,6096,2133600,12130651,21.34
9888121,9643749,3440,1204000,10847749,12.48
9888122,9969152,2394,837900,10807052,8.40
9888123,6454422,1547,541450,6995872,8.39
9888124,9954903,1761,616350,10571253,6.19
9888125,9959889,2924,1023400,10983289,10.28
9888126,9948681,2825,988750,10937431,9.94
9888127,9938208,4830,1690500,11628708,17.01
9888128,9957579,3986,1395100,11352679,14.01
9888129,9948167,2622,917700,10865867,9.22
9888130,6661453,2572,900200,7561653,13.51
9888131,9925456,2879,1007650,10933106,10.15
9888132,9952126,2054,718900,10671026,7.22
9888133,9964059,939,328650,10292709,3.30
9888134,9940428,955,334250,10274678,3.36
9888135,9953320,2236,782600,10735920,7.86
9888136,9950935,1055,369250,10320185,3.71
9888137,9932043,2481,868350,10800393,8.74
9888138,9938459,3034,1061900,11000359,10.68
9888139,9947891,3946,1381100,11328991,13.88
9888140,9951000,1676,586600,10537600,5.89
9888141,9970117,1052,368200,10338317,3.69
9888142,9959255,1043,365050,10324305,3.67
9888143,3272865,1126,394100,3666965,12.04
9888144,9956821,2301,805350,10762171,8.09
9888145,9951769,2405,841750,10793519,8.46
9888146,9956300,6602,2310700,12267000,23.21
9888147,9959428,2294,802900,10762328,8.06
9888148,9970303,1748,611800,10582103,6.14
9888149,9984381,2767,968450,10952831,9.70
9888150,9992309,2476,866600,10858909,8.67
9888151,9997861,2881,1008350,11006211,10.09
9888152,4827960,1805,631750,5459710,13.09
9888153,9984381,4632,1621200,11605581,16.24
9888154,6934480,1927,674450,7608930,9.73
9888155,9964260,2125,743750,10708010,7.46
9888156,9959521,3164,1107400,11066921,11.12
9888157,9950301,4201,1470350,11420651,14.78
9888158,9977605,3767,1318450,11296055,13.21
9888159,1786252,479,167650,1953902,9.39
9888160,9953258,5143,1800050,11753308,18.09
9888161,9940274,2744,960400,10900674,9.66
9888162,9946001,3435,1202250,11148251,12.09
9888163,9944779,2664,932400,10877179,9.38
9888164,9952124,3372,1180200,11132324,11.86
9888165,9944978,5029,1760150,11705128,17.70
9888166,9954482,3701,1295350,11249832,13.01
9888167,9877754,2675,936250,10814004,9.48
9888168,9954981,3889,1361150,11316131,13.67
9888169,9934590,3258,1140300,11074890,11.48
9888170,9947969,4851,1697850,11645819,17.07
9888171,481841,226,79100,560941,16.42
9888172,9920402,6030,2110500,12030902,21.27
9888173,189405,233,81550,270955,43.06
9888175,9901020,4176,1461600,11362620,14.76
9888176,9879424,3090,1081500,10960924,10.95
9888177,7873802,3742,1309700,9183502,16.63
9888180,9875335,2924,1023400,10898735,10.36
9888181,9900583,3920,1372000,11272583,13.86
9888182,9903151,2611,913850,10817001,9.23
9888183,9625453,5285,1849750,11475203,19.22
9888184,9908582,4385,1534750,11443332,15.49
9888185,9935492,3874,1355900,11291392,13.65
9888186,9896370,3759,1315650,11212020,13.29
9888187,9928232,4354,1523900,11452132,15.35
9888188,9944382,4426,1549100,11493482,15.58
9888189,9948434,3445,1205750,11154184,12.12
9888190,9934279,4347,1521450,11455729,15.32
9888191,9916247,2850,997500,10913747,10.06
9888192,9920610,2532,886200,10806810,8.93
9888193,1966187,815,285250,2251437,14.51
9888194,9930546,4164,1457400,11387946,14.68
9888195,9939439,3469,1214150,11153589,12.22
9888196,9944223,2233,781550,10725773,7.86
9888197,9958126,3063,1072050,11030176,10.77
9888198,9960105,2487,870450,10830555,8.74
9888199,9970558,4986,1745100,11715658,17.50
9888200,9964707,4450,1557500,11522207,15.63
9888202,9958579,3713,1299550,11258129,13.05
9888203,9968532,2014,704900,10673432,7.07
9888204,9946218,2600,910000,10856218,9.15
9888205,9958559,2901,1015350,10973909,10.20
9888206,9938488,2214,774900,10713388,7.80
9888207,9949015,3883,1359050,11308065,13.66
9888208,9960193,4688,1640800,11600993,16.47
9888209,9966872,1755,614250,10581122,6.16
9888210,9982956,3075,1076250,11059206,10.78
9888213,9933434,4280,1498000,11431434,15.08
9888214,9956723,3444,1205400,11162123,12.11
9888215,9952419,4443,1555050,11507469,15.62
9888216,9958436,4615,1615250,11573686,16.22
9888217,9913838,3789,1326150,11239988,13.38
9888218,9957182,1428,499800,10456982,5.02
9888219,9931966,2352,823200,10755166,8.29
9888220,9946226,3368,1178800,11125026,11.85
9888221,9952267,4027,1409450,11361717,14.16
9888222,9943632,3485,1219750,11163382,12.27
9888223,9943498,1806,632100,10575598,6.36
9888225,9940074,4539,1588650,11528724,15.98
9888226,9738475,1633,571550,10310025,5.87
9888227,9886248,4836,1692600,11578848,17.12
9888228,9916953,4556,1594600,11511553,16.08
9888229,9899107,3344,1170400,11069507,11.82
9888230,9928763,1683,589050,10517813,5.93
9888231,9918544,3323,1163050,11081594,11.73
9888232,9931189,4678,1637300,11568489,16.49
9888233,9938261,1923,673050,10611311,6.77
9888234,9938862,3172,1110200,11049062,11.17
9888235,9917972,5044,1765400,11683372,17.80
9888236,9928307,2692,942200,10870507,9.49
9888237,9948226,3727,1304450,11252676,13.11
9888238,9945658,2964,1037400,10983058,10.43
9888239,9945800,1676,586600,10532400,5.90
9888240,9949802,3620,1267000,11216802,12.73
9888241,9501214,4122,1442700,10943914,15.18
9888242,9967465,2527,884450,10851915,8.87
9888243,9945936,3716,1300600,11246536,13.08
9888244,9944954,2746,961100,10906054,9.66
9888245,9581721,2298,804300,10386021,8.39
9888246,9959401,3858,1350300,11309701,13.56
9888247,9980729,3821,1337350,11318079,13.40
9888248,9985234,4474,1565900,11551134,15.68
9888249,9974747,3742,1309700,11284447,13.13
9888251,9973172,2928,1024800,10997972,10.28
9888252,9962672,3004,1051400,11014072,10.55
9888253,9993407,4602,1610700,11604107,16.12
9888254,9970459,2826,989100,10959559,9.92
9888255,4645538,1301,455350,5100888,9.80
9888256,9992549,1771,619850,10612399,6.20
9888257,1936110,1172,410200,2346310,21.19
9888258,9922365,2700,945000,10867365,9.52
9888259,9973566,2888,1010800,10984366,10.13
9888260,9999060,973,340550,10339610,3.41
9888261,9975088,3140,1099000,11074088,11.02
9888262,9977865,2860,1001000,10978865,10.03
9888263,9979147,3365,1177750,11156897,11.80
9888264,9965767,3823,1338050,11303817,13.43
9888265,9955774,3018,1056300,11012074,10.61
9888266,9963424,3947,1381450,11344874,13.87
9888267,4013366,2203,771050,4784416,19.21
9888268,9969852,1506,527100,10496952,5.29
9888269,9968966,3413,1194550,11163516,11.98
9888270,6273688,3108,1087800,7361488,17.34
9888271,9952035,4717,1650950,11602985,16.59
9888272,9944664,3051,1067850,11012514,10.74
9888273,9948938,4260,1491000,11439938,14.99
9888274,9951081,4150,1452500,11403581,14.60
9888275,9947529,3697,1293950,11241479,13.01
9888276,9949641,4740,1659000,11608641,16.67
9888277,916188,201,70350,986538,7.68
9888278,9939943,3918,1371300,11311243,13.80
9888279,9152261,1363,477050,9629311,5.21
9888280,9942457,3594,1257900,11200357,12.65
9888281,9938731,3367,1178450,11117181,11.86
9888282,9942459,4710,1648500,11590959,16.58
9888283,9953448,2658,930300,10883748,9.35
9888284,9957557,4755,1664250,11621807,16.71
9888285,5975504,2504,876400,6851904,14.67
9888286,9960244,4101,1435350,11395594,14.41
9888287,9987902,2016,705600,10693502,7.06
9888288,9997721,4014,1404900,11402621,14.05
9888289,9989034,2860,1001000,10990034,10.02
9888290,9979861,3357,1174950,11154811,11.77
9888291,8387731,2609,913150,9300881,10.89
9888292,9984265,4638,1623300,11607565,16.26
9888293,9945157,5247,1836450,11781607,18.47
9888294,9989414,1695,593250,10582664,5.94
9888295,9979814,3499,1224650,11204464,12.27
9888296,9987362,4807,1682450,11669812,16.85
9888297,9962204,3738,1308300,11270504,13.13
9888298,9964413,3992,1397200,11361613,14.02
9888299,9968961,4249,1487150,11456111,14.92
9888300,1657329,611,213850,1871179,12.90
9888301,9954850,4624,1618400,11573250,16.26
9888302,9966736,3184,1114400,11081136,11.18
9888303,9943249,1680,588000,10531249,5.91
9888304,9962334,3675,1286250,11248584,12.91
9888305,9957045,2176,761600,10718645,7.65
9888306,9408815,2897,1013950,10422765,10.78
9888307,9966145,4276,1496600,11462745,15.02
9888308,8342949,5199,1819650,10162599,21.81
9888309,9953170,2727,954450,10907620,9.59
9888310,9970574,2671,934850,10905424,9.38
9888311,9498480,1978,692300,10190780,7.29
9888312,9969799,4103,1436050,11405849,14.40
9888313,9967132,2856,999600,10966732,10.03
9888314,9963385,5206,1822100,11785485,18.29
9888315,9967595,2635,922250,10889845,9.25
9888316,9963579,847,296450,10260029,2.98
9888317,9965483,3816,1335600,11301083,13.40
9888318,9971300,2881,1008350,10979650,10.11
9888319,9958454,3872,1355200,11313654,13.61
9888320,9963687,3744,1310400,11274087,13.15
9888321,9942858,2579,902650,10845508,9.08
9888322,9974894,2476,866600,10841494,8.69
9888323,9973255,3926,1374100,11347355,13.78
9888324,9970889,2884,1009400,10980289,10.12
9888325,9967497,4575,1601250,11568747,16.06
9888326,9968002,3877,1356950,11324952,13.61
9888327,9942688,5088,1780800,11723488,17.91
9888328,9955936,2906,1017100,10973036,10.22
9888329,9874192,4879,1707650,11581842,17.29
9888330,9971676,3751,1312850,11284526,13.17
9888331,9974856,3421,1197350,11172206,12.00
9888332,9970530,1096,383600,10354130,3.85
9888333,9960683,2626,919100,10879783,9.23
9888334,9966022,1814,634900,10600922,6.37
9888335,9955018,3608,1262800,11217818,12.69
9888336,9951571,4194,1467900,11419471,14.75
9888337,9956226,5825,2038750,11994976,20.48
9888338,9969002,2309,808150,10777152,8.11
9888339,9949845,5055,1769250,11719095,17.78
9888340,9925880,4552,1593200,11519080,16.05
9888341,9934520,4347,1521450,11455970,15.31
9888342,9935864,4112,1439200,11375064,14.48
9888343,9956295,2929,1025150,10981445,10.30
9888344,9931043,4576,1601600,11532643,16.13
9888345,9932529,3481,1218350,11150879,12.27
9888346,9927144,3381,1183350,11110494,11.92
9888347,9908280,3267,1143450,11051730,11.54
9888348,9912939,3257,1139950,11052889,11.50
9888349,9918593,4226,1479100,11397693,14.91
9888350,9919706,3257,1139950,11059656,11.49
9888351,9914329,3067,1073450,10987779,10.83
9888352,9947315,3621,1267350,11214665,12.74
9888354,9928044,3392,1187200,11115244,11.96
9888355,9939132,2834,991900,10931032,9.98
9888356,9946384,3261,1141350,11087734,11.48
9888357,9955835,3987,1395450,11351285,14.02
9888358,9950996,2525,883750,10834746,8.88
9888359,9956357,2894,1012900,10969257,10.17
9888360,9958787,1754,613900,10572687,6.16
9888361,9961937,2960,1036000,10997937,10.40
9888362,9967225,4359,1525650,11492875,15.31
9888363,9972030,3360,1176000,11148030,11.79
9888364,9974075,2282,798700,10772775,8.01
9888365,9968449,4052,1418200,11386649,14.23
9888366,9864849,2810,983500,10848349,9.97
9888367,9981155,3258,1140300,11121455,11.42
9888368,9965836,2710,948500,10914336,9.52
9888369,9956231,3297,1153950,11110181,11.59
9888370,9978228,1263,442050,10420278,4.43
9888371,9973438,5201,1820350,11793788,18.25
9888372,9969793,3787,1325450,11295243,13.29
9888373,9982143,3479,1217650,11199793,12.20
9888374,9980175,4988,1745800,11725975,17.49
9888375,9984205,2046,716100,10700305,7.17
9888376,9966506,3859,1350650,11317156,13.55
9888377,3055581,405,141750,3197331,4.64
9888378,9974914,1264,442400,10417314,4.44
9888379,9973859,2404,841400,10815259,8.44
9888380,9970562,3240,1134000,11104562,11.37
9888381,9997218,3554,1243900,11241118,12.44
9888382,6873320,1352,473200,7346520,6.88
9888383,9981975,3385,1184750,11166725,11.87
9888384,9974834,2997,1048950,11023784,10.52
9888385,9975590,2597,908950,10884540,9.11
9888386,9990327,1838,643300,10633627,6.44
9888387,9974665,2310,808500,10783165,8.11
9888388,9967160,1285,449750,10416910,4.51
9888389,9945485,3444,1205400,11150885,12.12
9888390,9963751,3422,1197700,11161451,12.02
9888391,9972744,1847,646450,10619194,6.48
9888392,9981436,4316,1510600,11492036,15.13
9888393,9978173,3117,1090950,11069123,10.93
9888394,9986791,2484,869400,10856191,8.71
9888395,9990020,3309,1158150,11148170,11.59
9888396,9980433,3145,1100750,11081183,11.03
9888397,2478866,1835,642250,3121116,25.91
9888398,9244556,3005,1051750,10296306,11.38
9888399,9978398,3070,1074500,11052898,10.77
9888400,9982650,3281,1148350,11131000,11.50
9888401,3582863,839,293650,3876513,8.20
9888402,9969056,3046,1066100,11035156,10.69
9888403,9963213,2297,803950,10767163,8.07
9888404,9949877,3056,1069600,11019477,10.75
9888405,9976292,3149,1102150,11078442,11.05
9888406,9972713,2992,1047200,11019913,10.50
9888407,9953027,4139,1448650,11401677,14.55
9888408,9880263,1749,612150,10492413,6.20
9888409,9970470,3641,1274350,11244820,12.78
9888410,9975232,2097,733950,10709182,7.36
9888411,9981139,4189,1466150,11447289,14.69
9888412,9979233,2576,901600,10880833,9.03
9888413,5530325,1274,445900,5976225,8.06
9888414,4889021,2701,945350,5834371,19.34
9888415,9983952,4484,1569400,11553352,15.72
9888416,9974156,4066,1423100,11397256,14.27
9888417,9973567,2680,938000,10911567,9.40
9888418,4954115,3189,1116150,6070265,22.53
9888419,9977962,2736,957600,10935562,9.60
9888420,9975749,1688,590800,10566549,5.92
9888421,9997157,2766,968100,10965257,9.68
9888422,9979625,3903,1366050,11345675,13.69
9888423,9990418,3124,1093400,11083818,10.94
9888424,9990169,4491,1571850,11562019,15.73
9888425,9986663,2669,934150,10920813,9.35
9888426,9986789,3638,1273300,11260089,12.75
9888427,9937027,5093,1782550,11719577,17.94
9888428,9987025,3017,1055950,11042975,10.57
9888429,9962778,392,137200,10099978,1.38
9888430,9995212,2320,812000,10807212,8.12
9888431,9998086,1101,385350,10383436,3.85
9888432,9996096,3590,1256500,11252596,12.57
9888433,9987504,2192,767200,10754704,7.68
9888435,1817211,694,242900,2060111,13.37
9888436,9966743,2511,878850,10845593,8.82
9888437,9979704,4384,1534400,11514104,15.38
9888438,9958349,2108,737800,10696149,7.41
9888439,9953946,3492,1222200,11176146,12.28
9888440,9925941,4264,1492400,11418341,15.04
9888441,9969741,2355,824250,10793991,8.27
9888442,9962607,3027,1059450,11022057,10.63
9888443,9964273,3501,1225350,11189623,12.30
9888444,167369,42,14700,182069,8.78
9888445,9979989,2304,806400,10786389,8.08
9888446,6202821,1533,536550,6739371,8.65
9888447,9965323,1773,620550,10585873,6.23
9888448,9988680,4325,1513750,11502430,15.15
9888449,1571950,702,245700,1817650,15.63
9888450,9954079,3510,1228500,11182579,12.34
9888451,9971121,4354,1523900,11495021,15.28
9888452,9953346,3496,1223600,11176946,12.29
9888453,9958510,2467,863450,10821960,8.67
9888454,9929992,3214,1124900,11054892,11.33
9888455,884761,216,75600,960361,8.54
9888456,5553800,1616,565600,6119400,10.18
9888457,9946489,2943,1030050,10976539,10.36
9888459,9939919,2962,1036700,10976619,10.43
9888460,1859364,636,222600,2081964,11.97
9888461,9934675,3600,1260000,11194675,12.68
9888462,9939121,3968,1388800,11327921,13.97
9888463,9923354,4537,1587950,11511304,16.00
9888464,9929547,2797,978950,10908497,9.86
9888465,9905120,3484,1219400,11124520,12.31
9888466,9944723,2916,1020600,10965323,10.26
9888467,9940952,2772,970200,10911152,9.76
9888468,9949353,2633,921550,10870903,9.26
9888469,9773756,2214,774900,10548656,7.93
9888470,9936385,3690,1291500,11227885,13.00
9888471,9941176,3968,1388800,11329976,13.97
9888472,9960003,4127,1444450,11404453,14.50
9888473,9958653,3916,1370600,11329253,13.76
9888474,9962316,2172,760200,10722516,7.63
9888475,7764603,3265,1142750,8907353,14.72
9888476,9973892,3071,1074850,11048742,10.78
9888477,9982302,3198,1119300,11101602,11.21
9888478,9970247,3790,1326500,11296747,13.30
9888479,9981676,3246,1136100,11117776,11.38
9888480,9976043,5370,1879500,11855543,18.84
9888481,9979961,4376,1531600,11511561,15.35
9888482,882565,263,92050,974615,10.43
9888483,9998060,2754,963900,10961960,9.64
9888484,9988410,4161,1456350,11444760,14.58
9888485,9967192,3190,1116500,11083692,11.20
9888486,9964224,3600,1260000,11224224,12.65
9888487,9958373,1447,506450,10464823,5.09
9888488,9968851,1902,665700,10634551,6.68
9888489,9962295,2000,700000,10662295,7.03
9888490,9969638,1552,543200,10512838,5.45
9888491,9968356,3575,1251250,11219606,12.55
9888492,9970203,2219,776650,10746853,7.79
9888493,9980210,3712,1299200,11279410,13.02
9888495,4433821,2049,717150,5150971,16.17
9888496,9992879,4266,1493100,11485979,14.94
9888497,9843862,2712,949200,10793062,9.64
9888498,9996289,5807,2032450,12028739,20.33
9888499,9988759,2061,721350,10710109,7.22
9888500,9988001,2834,991900,10979901,9.93
9888502,9986950,2426,849100,10836050,8.50
9888503,9976508,3557,1244950,11221458,12.48
9888504,9992836,2555,894250,10887086,8.95
9888505,9978301,3841,1344350,11322651,13.47
9888506,9992583,2473,865550,10858133,8.66
9888507,8889519,2082,728700,9618219,8.20
9888508,9945171,2493,872550,10817721,8.77
9888509,9979217,4893,1712550,11691767,17.16
9888510,9991581,4580,1603000,11594581,16.04
9888511,9997667,3732,1306200,11303867,13.07
9888512,9983589,2696,943600,10927189,9.45
9888513,9984418,2160,756000,10740418,7.57
9888514,9986205,3733,1306550,11292755,13.08
9888515,9981673,3858,1350300,11331973,13.53
9888516,9992312,3266,1143100,11135412,11.44
9888517,9976465,5643,1975050,11951515,19.80
9888518,9995898,5578,1952300,11948198,19.53
9888519,9971536,4702,1645700,11617236,16.50
9888520,9981248,2896,1013600,10994848,10.16
9888521,9979536,4757,1664950,11644486,16.68
9888522,9990255,3862,1351700,11341955,13.53
9888523,9986644,3508,1227800,11214444,12.29
9888524,9983718,1608,562800,10546518,5.64
9888525,9994329,4675,1636250,11630579,16.37
9888526,9969014,4232,1481200,11450214,14.86
9888527,9982782,6096,2133600,12116382,21.37
9888528,9985896,5672,1985200,11971096,19.88
9888529,9998099,5236,1832600,11830699,18.33
9888530,9991684,4686,1640100,11631784,16.41
9888531,1442194,885,309750,1751944,21.48
9888532,9978612,4628,1619800,11598412,16.23
9888533,9978474,1560,546000,10524474,5.47
9888534,9985012,3166,1108100,11093112,11.10
9888535,9989957,3559,1245650,11235607,12.47
9888536,9986742,4091,1431850,11418592,14.34
9888537,9980243,2653,928550,10908793,9.30
9888538,9989745,1537,537950,10527695,5.39
9888539,9984865,1433,501550,10486415,5.02
9888540,1730753,580,203000,1933753,11.73
9888541,9972612,2172,760200,10732812,7.62
9888542,9982281,3736,1307600,11289881,13.10
9888543,9992189,4501,1575350,11567539,15.77
9888544,9979516,2555,894250,10873766,8.96
9888545,9990823,5906,2067100,12057923,20.69
9888546,9976443,5042,1764700,11741143,17.69
9888547,9988185,2525,883750,10871935,8.85
9888548,9991297,2040,714000,10705297,7.15
9888549,4554168,906,317100,4871268,6.96
9888550,9974930,3240,1134000,11108930,11.37
9888551,9975935,3297,1153950,11129885,11.57
9888552,9979670,4786,1675100,11654770,16.79
9888553,9979438,5837,2042950,12022388,20.47
9888554,9990155,3546,1241100,11231255,12.42
9888555,8384225,4130,1445500,9829725,17.24
9888556,9984659,4008,1402800,11387459,14.05
9888558,474742,208,72800,547542,15.33
9888559,5575920,2808,982800,6558720,17.63
9888560,9975335,5831,2040850,12016185,20.46
9888561,9972881,4120,1442000,11414881,14.46
9888562,9988815,3464,1212400,11201215,12.14
9888563,9973630,6285,2199750,12173380,22.06
9888564,4399234,2816,985600,5384834,22.40
9888565,9965184,4403,1541050,11506234,15.46
9888566,9957638,3420,1197000,11154638,12.02
9888567,9961818,3340,1169000,11130818,11.73
9888568,9968021,3985,1394750,11362771,13.99
9888569,9983084,2967,1038450,11021534,10.40
9888570,7570446,2040,714000,8284446,9.43
9888571,9969793,3353,1173550,11143343,11.77
9888572,1669708,287,100450,1770158,6.02
9888574,9975958,2910,1018500,10994458,10.21
9888576,9969324,4363,1527050,11496374,15.32
9888577,9966161,4679,1637650,11603811,16.43
9888578,9948154,2683,939050,10887204,9.44
9888579,9942117,2069,724150,10666267,7.28
9888580,9955508,1416,495600,10451108,4.98
9888581,9964217,3977,1391950,11356167,13.97
9888582,9788147,2087,730450,10518597,7.46
9888583,5062268,2383,834050,5896318,16.48
9888584,9980552,3147,1101450,11082002,11.04
9888585,9985205,4231,1480850,11466055,14.83
9888586,9980276,4205,1471750,11452026,14.75
9888587,6107275,1025,358750,6466025,5.87
9888588,9971755,3711,1298850,11270605,13.03
9888589,9996501,3784,1324400,11320901,13.25
9888590,9972943,1925,673750,10646693,6.76
9888591,9976119,4854,1698900,11675019,17.03
9888592,9962278,3149,1102150,11064428,11.06
9888593,9862700,3505,1226750,11089450,12.44
9888594,8909169,1576,551600,9460769,6.19
9888595,9956372,2356,824600,10780972,8.28
9888596,9964836,3902,1365700,11330536,13.71
9888597,9974772,3100,1085000,11059772,10.88
9888598,9953566,2953,1033550,10987116,10.38
9888599,9969864,2646,926100,10895964,9.29
9888600,9953771,4112,1439200,11392971,14.46
9888601,9960661,3194,1117900,11078561,11.22
9888602,9927941,3029,1060150,10988091,10.68
9888603,9941347,2160,756000,10697347,7.60
9888604,9943171,3047,1066450,11009621,10.73
9888605,9963526,3367,1178450,11141976,11.83
9888606,1154607,608,212800,1367407,18.43
9888607,9922923,4672,1635200,11558123,16.48
9888609,9928734,3192,1117200,11045934,11.25
9888610,9931974,3468,1213800,11145774,12.22
9888611,9934348,1072,375200,10309548,3.78
9888612,9942243,3734,1306900,11249143,13.14
9888613,9946431,1515,530250,10476681,5.33
9888614,9941186,4511,1578850,11520036,15.88
9888615,9960262,4250,1487500,11447762,14.93
9888616,9961042,3181,1113350,11074392,11.18
9888617,9977217,5320,1862000,11839217,18.66
9888618,9968116,2916,1020600,10988716,10.24
9888619,5216747,2077,726950,5943697,13.93
9888620,9979395,2963,1037050,11016445,10.39
9888621,9974657,3073,1075550,11050207,10.78
9888622,9976742,3231,1130850,11107592,11.33
9888623,9984205,2748,961800,10946005,9.63
9888624,9998613,4778,1672300,11670913,16.73
9888626,9990346,3597,1258950,11249296,12.60
9888627,9979363,3675,1286250,11265613,12.89
9888628,1175201,358,125300,1300501,10.66
9888629,9983911,2339,818650,10802561,8.20
9888630,9963488,2515,880250,10843738,8.83
9888631,9946041,1558,545300,10491341,5.48
9888632,9961870,1727,604450,10566320,6.07
9888633,9964934,3670,1284500,11249434,12.89
9888634,9971671,4797,1678950,11650621,16.84
9888635,9993807,1355,474250,10468057,4.75
9888636,9977224,4004,1401400,11378624,14.05
9888637,9979738,1238,433300,10413038,4.34
9888638,9240277,2654,928900,10169177,10.05
9888639,9993984,3134,1096900,11090884,10.98
9888640,9983406,2787,975450,10958856,9.77
9888642,9961335,515,180250,10141585,1.81
9888643,9950434,3310,1158500,11108934,11.64
9888644,9683256,1951,682850,10366106,7.05
9888645,9950322,1326,464100,10414422,4.66
9888646,9988029,3088,1080800,11068829,10.82
9888647,9983762,2114,739900,10723662,7.41
9888648,9902640,2151,752850,10655490,7.60
9888649,9981419,6013,2104550,12085969,21.08
9888650,9979022,4019,1406650,11385672,14.10
9888651,9980385,3721,1302350,11282735,13.05
9888652,9993922,4661,1631350,11625272,16.32
9888653,9984884,4021,1407350,11392234,14.09
9888654,9979804,4677,1636950,11616754,16.40
9888655,9999328,4604,1611400,11610728,16.12
9888656,4132370,1717,600950,4733320,14.54
9888657,9986239,4273,1495550,11481789,14.98
9888658,9724662,2515,880250,10604912,9.05
9888659,8808820,2758,965300,9774120,10.96
9888660,9914760,3995,1398250,11313010,14.10
9888661,9974466,3118,1091300,11065766,10.94
9888662,9986985,2952,1033200,11020185,10.35
9888663,9982833,3996,1398600,11381433,14.01
9888665,9967202,2157,754950,10722152,7.57
9888666,9950307,3282,1148700,11099007,11.54
9888667,9946529,3301,1155350,11101879,11.62
9888668,9947198,2602,910700,10857898,9.16
9888669,9969866,3059,1070650,11040516,10.74
9888670,9945532,1183,414050,10359582,4.16
9888671,9869767,2794,977900,10847667,9.91
9888672,9945841,4397,1538950,11484791,15.47
9888673,9953345,2062,721700,10675045,7.25
9888674,9967219,4150,1452500,11419719,14.57
9888675,9959573,3910,1368500,11328073,13.74
9888676,9955168,4174,1460900,11416068,14.67
9888677,9974452,3502,1225700,11200152,12.29
9888678,9974234,5413,1894550,11868784,18.99
9888679,9959124,4654,1628900,11588024,16.36
9888680,9953252,2892,1012200,10965452,10.17
9888681,9735538,4865,1702750,11438288,17.49
9888682,9949188,3721,1302350,11251538,13.09
9888683,9937605,3122,1092700,11030305,11.00
9888684,9655667,1358,475300,10130967,4.92
9888685,9938271,1399,489650,10427921,4.93
9888687,9928252,2527,884450,10812702,8.91
9888688,9932586,3406,1192100,11124686,12.00
9888689,9941490,2923,1023050,10964540,10.29
9888690,9866803,1136,397600,10264403,4.03
9888691,9922032,2880,1008000,10930032,10.16
9888692,9933919,3818,1336300,11270219,13.45
9888693,9931462,3396,1188600,11120062,11.97
9888694,9920767,3759,1315650,11236417,13.26
9888695,9936265,2833,991550,10927815,9.98
9888696,9940111,6447,2256450,12196561,22.70
9888697,9930913,2744,960400,10891313,9.67
9888698,9936249,1986,695100,10631349,7.00
9888699,9924493,2801,980350,10904843,9.88
9888700,3243909,975,341250,3585159,10.52
9888701,9907573,3104,1086400,10993973,10.97
9888702,9949645,4265,1492750,11442395,15.00
9888703,9944798,1470,514500,10459298,5.17
9888704,9959295,3920,1372000,11331295,13.78
9888705,9979096,3539,1238650,11217746,12.41
9888706,215539,47,16450,231989,7.63
9888707,9958936,2504,876400,10835336,8.80
9888708,9945024,2763,967050,10912074,9.72
9888709,9952567,2819,986650,10939217,9.91
9888710,9946762,2501,875350,10822112,8.80
9888711,9955977,3061,1071350,11027327,10.76
9888712,9964186,2272,795200,10759386,7.98
9888713,9954050,1340,469000,10423050,4.71
9888714,9970579,5540,1939000,11909579,19.45
9888715,9958996,3649,1277150,11236146,12.82
9888716,9969246,2467,863450,10832696,8.66
9888717,9260077,3492,1222200,10482277,13.20
9888718,9990222,3216,1125600,11115822,11.27
9888719,9989724,2470,864500,10854224,8.65
9888720,9990253,3566,1248100,11238353,12.49
9888721,9994335,2297,803950,10798285,8.04
9888722,9982371,3064,1072400,11054771,10.74
9888723,9992530,2901,1015350,11007880,10.16
9888724,1426924,631,220850,1647774,15.48
9888725,9974750,2544,890400,10865150,8.93
9888726,9986995,3251,1137850,11124845,11.39
9888727,9988343,3304,1156400,11144743,11.58
9888728,9973389,1786,625100,10598489,6.27
9888729,9960641,1435,502250,10462891,5.04
9888730,9975201,3016,1055600,11030801,10.58
9888731,9984584,2691,941850,10926434,9.43
9888732,9974577,2170,759500,10734077,7.61
9888733,9969367,2647,926450,10895817,9.29
9888734,9970577,3752,1313200,11283777,13.17
9888735,9953295,4083,1429050,11382345,14.36
9888736,9963936,2915,1020250,10984186,10.24
9888737,9956463,6140,2149000,12105463,21.58
9888738,9962524,3762,1316700,11279224,13.22
9888740,9957239,5344,1870400,11827639,18.78
9888741,1988797,831,290850,2279647,14.62
9888742,9961103,2227,779450,10740553,7.82
9888743,9969907,2656,929600,10899507,9.32
9888744,9974402,3117,1090950,11065352,10.94
9888745,9999751,3923,1373050,11372801,13.73
9888746,9980788,2523,883050,10863838,8.85
9888748,9978981,1662,581700,10560681,5.83
9888749,9984218,5360,1876000,11860218,18.79
9888750,9996914,2893,1012550,11009464,10.13
9888751,9992734,2407,842450,10835184,8.43
9888752,9985361,2264,792400,10777761,7.94
9888753,9979503,4522,1582700,11562203,15.86
9888754,6113189,2503,876050,6989239,14.33
9888755,9989999,3246,1136100,11126099,11.37
9888756,9989307,2075,726250,10715557,7.27
9888757,9993724,2334,816900,10810624,8.17
9888758,9999615,4246,1486100,11485715,14.86
9888759,9980081,4017,1405950,11386031,14.09
9888760,9960046,3948,1381800,11341846,13.87
9888761,9964379,2081,728350,10692729,7.31
9888762,9976806,3902,1365700,11342506,13.69
9888763,9978021,4014,1404900,11382921,14.08
9888764,9975124,3589,1256150,11231274,12.59
9888765,9986845,3553,1243550,11230395,12.45
9888766,9988990,3269,1144150,11133140,11.45
9888767,9984371,1283,449050,10433421,4.50
9888768,9996521,2475,866250,10862771,8.67
9888769,9984071,5560,1946000,11930071,19.49
9888770,9990186,2115,740250,10730436,7.41
9888771,9995168,2494,872900,10868068,8.73
9888772,9976556,4690,1641500,11618056,16.45
9888773,9989103,2296,803600,10792703,8.04
9888774,9974420,1623,568050,10542470,5.70
9888775,9977946,2455,859250,10837196,8.61
9888776,9969538,5577,1951950,11921488,19.58
9888777,9978148,4599,1609650,11587798,16.13
9888778,9996555,1389,486150,10482705,4.86
9888779,9985075,3498,1224300,11209375,12.26
9888780,9988742,2968,1038800,11027542,10.40
9888781,9992542,2983,1044050,11036592,10.45
9888782,9972286,3668,1283800,11256086,12.87
9888783,9977714,3915,1370250,11347964,13.73
9888784,9978247,3340,1169000,11147247,11.72
9888785,9988286,3196,1118600,11106886,11.20
9888786,9971960,3326,1164100,11136060,11.67
9888787,9986061,3333,1166550,11152611,11.68
9888788,9997075,1224,428400,10425475,4.29
9888789,9973574,3410,1193500,11167074,11.97
9888790,9992267,3558,1245300,11237567,12.46
9888791,9980348,4442,1554700,11535048,15.58
9888792,9989095,3430,1200500,11189595,12.02
9888793,9970158,2594,907900,10878058,9.11
9888794,9984791,3112,1089200,11073991,10.91
9888795,9991252,2212,774200,10765452,7.75
9888796,9980129,4160,1456000,11436129,14.59
9888797,9994842,3944,1380400,11375242,13.81
9888798,9979656,4019,1406650,11386306,14.10
9888799,9993933,4305,1506750,11500683,15.08
9888800,9978291,3451,1207850,11186141,12.10
9888801,9974128,2808,982800,10956928,9.85
9888802,9960817,6527,2284450,12245267,22.93
9888803,9967049,3378,1182300,11149349,11.86
9888804,9969936,3198,1119300,11089236,11.23
9888805,9970855,4077,1426950,11397805,14.31
9888806,9968953,2927,1024450,10993403,10.28
9888807,9952137,1424,498400,10450537,5.01
9888808,9990667,3327,1164450,11155117,11.66
9888809,9983206,2984,1044400,11027606,10.46
9888810,9992000,4136,1447600,11439600,14.49
9888811,9909095,5820,2037000,11946095,20.56
9888812,9999516,3499,1224650,11224166,12.25
9888813,9986543,3333,1166550,11153093,11.68
9888814,9970288,5946,2081100,12051388,20.87
9888815,9979796,4817,1685950,11665746,16.89
9888816,9477166,2807,982450,10459616,10.37
9888817,9987799,4613,1614550,11602349,16.17
9888818,9963884,2575,901250,10865134,9.05
9888819,9966885,3992,1397200,11364085,14.02
9888820,2224574,704,246400,2470974,11.08
9888821,9977985,3755,1314250,11292235,13.17
9888822,9967658,4089,1431150,11398808,14.36
9888823,9981181,3326,1164100,11145281,11.66
9888824,9707703,3115,1090250,10797953,11.23
9888825,9987025,4151,1452850,11439875,14.55
9888826,9977037,3935,1377250,11354287,13.80
9888827,9982909,2262,791700,10774609,7.93
9888828,9545326,5389,1886150,11431476,19.76
9888829,9983127,3415,1195250,11178377,11.97
9888830,9972420,7065,2472750,12445170,24.80
9888831,9967150,3466,1213100,11180250,12.17
9888832,9971719,3792,1327200,11298919,13.31
9888833,9965948,2656,929600,10895548,9.33
9888834,9957867,4520,1582000,11539867,15.89
9888835,9964405,2912,1019200,10983605,10.23
9888836,9957995,4008,1402800,11360795,14.09
9888837,9969288,4004,1401400,11370688,14.06
9888838,9965240,3551,1242850,11208090,12.47
9888839,9962161,3493,1222550,11184711,12.27
9888840,9912526,4021,1407350,11319876,14.20
9888841,9964495,4293,1502550,11467045,15.08
9888842,9992862,4222,1477700,11470562,14.79
9888843,9983510,4325,1513750,11497260,15.16
9888845,9985774,3486,1220100,11205874,12.22
9888846,1641949,1213,424550,2066499,25.86
9888847,9932996,2963,1037050,10970046,10.44
9888848,2876750,832,291200,3167950,10.12
9888849,9991373,1614,564900,10556273,5.65
9888850,9988664,4064,1422400,11411064,14.24
9888851,204055,83,29050,233105,14.24
9888852,9895573,4766,1668100,11563673,16.86
9888853,5858601,2326,814100,6672701,13.90
9888854,9974705,3139,1098650,11073355,11.01
9888855,9974211,4253,1488550,11462761,14.92
9888856,9992430,4868,1703800,11696230,17.05
9888857,9993147,5191,1816850,11809997,18.18
9888858,5293031,2112,739200,6032231,13.97
9888859,9972276,4239,1483650,11455926,14.88
9888860,9953891,2339,818650,10772541,8.22
9888861,9603450,4035,1412250,11015700,14.71
9888862,9954243,2963,1037050,10991293,10.42
9888863,9953893,3352,1173200,11127093,11.79
9888864,9948042,2814,984900,10932942,9.90
9888865,9934930,949,332150,10267080,3.34
9888866,9947385,4127,1444450,11391835,14.52
9888867,9964950,3528,1234800,11199750,12.39
9888868,9968354,2980,1043000,11011354,10.46
9888869,9969934,4997,1748950,11718884,17.54
9888870,9983027,2815,985250,10968277,9.87
9888871,8362871,3330,1165500,9528371,13.94
9888872,9986238,3871,1354850,11341088,13.57
9888873,9991329,3340,1169000,11160329,11.70
9888874,9995574,1985,694750,10690324,6.95
9888875,9982204,2321,812350,10794554,8.14
9888876,9997366,3741,1309350,11306716,13.10
9888877,9981890,2826,989100,10970990,9.91
9888878,9974081,4292,1502200,11476281,15.06
9888879,9987161,3422,1197700,11184861,11.99
9888880,9994527,3570,1249500,11244027,12.50
9888881,9974871,2879,1007650,10982521,10.10
9888882,9962415,3074,1075900,11038315,10.80
9888883,9971968,4153,1453550,11425518,14.58
9888884,9975846,6750,2362500,12338346,23.68
9888885,9983985,4220,1477000,11460985,14.79
9888886,9982448,1693,592550,10574998,5.94
9888887,5036043,814,284900,5320943,5.66
9888888,6790479,3557,1244950,8035429,18.33
9888889,9956558,2154,753900,10710458,7.57
9888890,9981815,2206,772100,10753915,7.74
9888891,9975477,5340,1869000,11844477,18.74
9888892,9975641,3900,1365000,11340641,13.68
9888893,9959974,3504,1226400,11186374,12.31
9888894,9969106,3687,1290450,11259556,12.94
9888895,9958731,3230,1130500,11089231,11.35
9888896,9979510,3640,1274000,11253510,12.77
9888898,9969306,5363,1877050,11846356,18.83
9888899,3902391,1316,460600,4362991,11.80
9888900,9984413,4682,1638700,11623113,16.41
9888901,9970277,2272,795200,10765477,7.98
9888902,9972365,2467,863450,10835815,8.66
9888905,9968684,2787,975450,10944134,9.79
9888906,9964601,5033,1761550,11726151,17.68
9888907,9985421,3886,1360100,11345521,13.62
9888908,9960380,2958,1035300,10995680,10.39
9888909,4246817,1868,653800,4900617,15.40
9888910,9943235,2224,778400,10721635,7.83
9888911,9951069,2752,963200,10914269,9.68
9888912,9949200,2606,912100,10861300,9.17
9888913,1453322,601,210350,1663672,14.47
9888914,9958032,891,311850,10269882,3.13
9888915,9961065,1736,607600,10568665,6.10
9888916,9958853,2187,765450,10724303,7.69
9888917,9950071,3944,1380400,11330471,13.87
9888918,9949835,2058,720300,10670135,7.24
9888919,9943248,3591,1256850,11200098,12.64
9888920,9959034,3501,1225350,11184384,12.30
9888921,9458829,3024,1058400,10517229,11.19
9888922,9949636,2629,920150,10869786,9.25
9888923,9931600,3093,1082550,11014150,10.90
9888924,9937603,2822,987700,10925303,9.94
9888925,9946390,5020,1757000,11703390,17.66
9888926,9951287,3656,1279600,11230887,12.86
9888927,9955316,2380,833000,10788316,8.37
9888928,9936802,3731,1305850,11242652,13.14
9888929,9944004,2466,863100,10807104,8.68
9888931,9935372,3400,1190000,11125372,11.98
9888932,9930935,4486,1570100,11501035,15.81
9888933,9950338,2484,869400,10819738,8.74
9888934,9955653,4268,1493800,11449453,15.00
9888935,9959204,2562,896700,10855904,9.00
9888936,9961988,3554,1243900,11205888,12.49
9888937,9976641,1734,606900,10583541,6.08
9888938,9991702,3518,1231300,11223002,12.32
9888939,9984636,2883,1009050,10993686,10.11
9888940,9982566,1998,699300,10681866,7.01
9888941,9980293,3451,1207850,11188143,12.10
9888942,940056,256,89600,1029656,9.53
9888943,9952220,2467,863450,10815670,8.68
9888944,9973766,2613,914550,10888316,9.17
9888945,9960981,3169,1109150,11070131,11.13
9888946,9975804,3227,1129450,11105254,11.32
9888947,9977705,2781,973350,10951055,9.76
9888948,9987250,3240,1134000,11121250,11.35
9888949,9981172,3192,1117200,11098372,11.19
9888950,9993958,2494,872900,10866858,8.73
9888951,9979415,2725,953750,10933165,9.56
9888952,9963959,2826,989100,10953059,9.93
9888953,9944002,4568,1598800,11542802,16.08
9888954,9975247,3109,1088150,11063397,10.91
9888955,9974719,4821,1687350,11662069,16.92
9888956,9983092,2424,848400,10831492,8.50
9888957,9968790,2911,1018850,10987640,10.22
9888958,9962593,2161,756350,10718943,7.59
9888960,9962729,3988,1395800,11358529,14.01
9888961,9952921,3775,1321250,11274171,13.27
9888962,9943892,2916,1020600,10964492,10.26
9888963,9949267,4983,1744050,11693317,17.53
9888964,5477661,2505,876750,6354411,16.01
9888965,9933521,2715,950250,10883771,9.57
9888966,9932860,2152,753200,10686060,7.58
9888967,9921894,3824,1338400,11260294,13.49
9888968,9927685,2129,745150,10672835,7.51
9888969,9918146,3059,1070650,10988796,10.79
9888970,3954698,1593,557550,4512248,14.10
9888971,9938528,2534,886900,10825428,8.92
9888972,9910669,1310,458500,10369169,4.63
9888973,9945743,6104,2136400,12082143,21.48
9888974,9940187,2253,788550,10728737,7.93
9888975,9944644,4693,1642550,11587194,16.52
9888976,9949708,4291,1501850,11451558,15.09
9888977,9936806,1630,570500,10507306,5.74
9888978,9961147,4444,1555400,11516547,15.61
9888979,9965601,3099,1084650,11050251,10.88
9888980,9966123,3053,1068550,11034673,10.72
9888981,9973833,944,330400,10304233,3.31
9888982,9961026,2523,883050,10844076,8.87
9888983,9979634,2498,874300,10853934,8.76
9888984,9959981,2498,874300,10834281,8.78
9888986,9972940,3339,1168650,11141590,11.72
9888987,9977121,2708,947800,10924921,9.50
9888988,9963696,3118,1091300,11054996,10.95
9888989,9973057,882,308700,10281757,3.10
9888990,9979090,3251,1137850,11116940,11.40
9888991,9978480,3943,1380050,11358530,13.83
9888992,9998061,3694,1292900,11290961,12.93
9888993,9980912,3504,1226400,11207312,12.29
9888994,6939905,2376,831600,7771505,11.98
9888995,9986910,2933,1026550,11013460,10.28
9888996,9970087,2014,704900,10674987,7.07
9888997,1717624,1261,441350,2158974,25.70
9888998,9994174,3406,1192100,11186274,11.93
9888999,9978238,1441,504350,10482588,5.05
9889000,9987546,5023,1758050,11745596,17.60
9889001,9988245,1337,467950,10456195,4.69
9889002,9991709,5895,2063250,12054959,20.65
9889003,9999722,2735,957250,10956972,9.57
9889004,9976041,2010,703500,10679541,7.05
9889005,9977457,3248,1136800,11114257,11.39
9889006,9985334,1135,397250,10382584,3.98
9889007,9955900,1917,670950,10626850,6.74
9889008,9984071,2008,702800,10686871,7.04
9889009,9984615,1272,445200,10429815,4.46
9889010,9986038,3383,1184050,11170088,11.86
9889011,9979004,4692,1642200,11621204,16.46
9889012,9970938,4833,1691550,11662488,16.96
9889013,9968409,4465,1562750,11531159,15.68
9889014,9950834,2962,1036700,10987534,10.42
9889015,9953385,2784,974400,10927785,9.79
9889016,9977081,2955,1034250,11011331,10.37
9889017,9974119,3206,1122100,11096219,11.25
9889018,9972482,3589,1256150,11228632,12.60
9889019,9977416,3528,1234800,11212216,12.38
9889020,9981117,2358,825300,10806417,8.27
9889021,9978701,3853,1348550,11327251,13.51
9889022,9934037,4567,1598450,11532487,16.09
9889023,9992160,4870,1704500,11696660,17.06
9889024,9962450,5821,2037350,11999800,20.45
9889025,9980951,3541,1239350,11220301,12.42
9889026,9986570,5552,1943200,11929770,19.46
9889027,9974132,2225,778750,10752882,7.81
9889028,9988153,2695,943250,10931403,9.44
9889029,9970028,3103,1086050,11056078,10.89
9889030,9979652,2313,809550,10789202,8.11
9889031,9958334,3824,1338400,11296734,13.44
9889032,9955923,1764,617400,10573323,6.20
9889033,9958809,2716,950600,10909409,9.55
9889034,9961708,1987,695450,10657158,6.98
9889035,9961887,1498,524300,10486187,5.26
9889036,9973006,2916,1020600,10993606,10.23
9889037,9730843,1879,657650,10388493,6.76
9889038,9976400,2974,1040900,11017300,10.43
9889039,9971829,5587,1955450,11927279,19.61
9889040,9967065,1056,369600,10336665,3.71
9889042,9987618,2074,725900,10713518,7.27
9889043,9974168,2119,741650,10715818,7.44
9889045,9947092,1573,550550,10497642,5.53
9889046,9956807,3724,1303400,11260207,13.09
9889047,9332476,5428,1899800,11232276,20.36
9889048,2922188,860,301000,3223188,10.30
9889049,9966951,3879,1357650,11324601,13.62
9889050,9973230,3056,1069600,11042830,10.72
9889051,9984250,2819,986650,10970900,9.88
9889052,9988115,1172,410200,10398315,4.11
9889053,9979366,3223,1128050,11107416,11.30
9889054,9988470,3606,1262100,11250570,12.64
9889055,9989261,5144,1800400,11789661,18.02
9889056,9984009,1541,539350,10523359,5.40
9889057,9994942,3558,1245300,11240242,12.46
9889058,9988970,4377,1531950,11520920,15.34
9889059,9996884,4371,1529850,11526734,15.30
9889060,9983502,6897,2413950,12397452,24.18
9889061,9979440,4334,1516900,11496340,15.20
9889063,9988743,6590,2306500,12295243,23.09
9889064,9988826,3006,1052100,11040926,10.53
9889065,9976274,2479,867650,10843924,8.70
9889066,9979571,3472,1215200,11194771,12.18
9889067,9998386,2849,997150,10995536,9.97
9889068,9977628,5366,1878100,11855728,18.82
9889069,9985151,4604,1611400,11596551,16.14
9889072,9986376,4038,1413300,11399676,14.15
9889074,9997468,3314,1159900,11157368,11.60
9889075,9990889,4003,1401050,11391939,14.02
9889076,9983557,4625,1618750,11602307,16.21
9889077,9964162,6079,2127650,12091812,21.35
9889078,9964847,3771,1319850,11284697,13.25
9889079,9963742,3842,1344700,11308442,13.50
9889080,9972326,3517,1230950,11203276,12.34
9889081,6367993,3034,1061900,7429893,16.68
9889082,9977499,3241,1134350,11111849,11.37
9889084,9975438,4792,1677200,11652638,16.81
9889085,9985074,2300,805000,10790074,8.06
9889086,9979510,3817,1335950,11315460,13.39
9889087,9964793,3261,1141350,11106143,11.45
9889088,9987648,2971,1039850,11027498,10.41
9889089,9965553,3210,1123500,11089053,11.27
9889090,9979910,4458,1560300,11540210,15.63
9889091,9985138,2273,795550,10780688,7.97
9889092,9978824,4999,1749650,11728474,17.53
9889093,9974341,5706,1997100,11971441,20.02
9889094,9964867,2802,980700,10945567,9.84
9889095,9976504,4053,1418550,11395054,14.22
9889096,9986363,2144,750400,10736763,7.51
9889097,9983759,2647,926450,10910209,9.28
9889098,9989753,4808,1682800,11672553,16.85
9889099,9969867,4161,1456350,11426217,14.61
9889100,8210763,2534,886900,9097663,10.80
9889101,9980542,3156,1104600,11085142,11.07
9889102,9997998,3768,1318800,11316798,13.19
9889103,9980004,4650,1627500,11607504,16.31
9889104,9977177,1436,502600,10479777,5.04
9889105,9983128,3469,1214150,11197278,12.16
9889106,9954784,2358,825300,10780084,8.29
9889107,9965890,2919,1021650,10987540,10.25
9889108,9944392,2194,767900,10712292,7.72
9889109,9953397,2842,994700,10948097,9.99
9889110,9964326,1291,451850,10416176,4.53
9889112,9950645,3550,1242500,11193145,12.49
9889113,9955092,2379,832650,10787742,8.36
9889114,9969902,3587,1255450,11225352,12.59
9889115,9979620,3083,1079050,11058670,10.81
9889117,9980920,3690,1291500,11272420,12.94
9889118,9972845,3792,1327200,11300045,13.31
9889119,9958629,1784,624400,10583029,6.27
9889120,9973294,2448,856800,10830094,8.59
9889121,9973148,3656,1279600,11252748,12.83
9889123,9955377,3859,1350650,11306027,13.57
9889124,9948278,3792,1327200,11275478,13.34
9889125,9970118,2836,992600,10962718,9.96
9889126,9949967,3371,1179850,11129817,11.86
9889127,9962348,3269,1144150,11106498,11.48
9889128,9976971,4760,1666000,11642971,16.70
9889129,9985393,2740,959000,10944393,9.60
9889130,9985975,6751,2362850,12348825,23.66
9889131,9983617,4183,1464050,11447667,14.66
9889132,9982696,4626,1619100,11601796,16.22
9889133,9991510,1843,645050,10636560,6.46
9889134,9991511,3470,1214500,11206011,12.16
9889135,9985526,4549,1592150,11577676,15.94
9889136,9981244,2006,702100,10683344,7.03
9889137,9973529,4593,1607550,11581079,16.12
9889138,9990538,2552,893200,10883738,8.94
9889139,9992201,3694,1292900,11285101,12.94
9889140,9979134,2171,759850,10738984,7.61
9889141,9988663,6871,2404850,12393513,24.08
9889142,9989069,4342,1519700,11508769,15.21
9889143,9960658,3008,1052800,11013458,10.57
9889144,9965896,5055,1769250,11735146,17.75
9889146,9978606,3128,1094800,11073406,10.97
9889147,9475021,5720,2002000,11477021,21.13
9889148,9958973,4028,1409800,11368773,14.16
9889149,9853397,3987,1395450,11248847,14.16
9889150,9973322,3035,1062250,11035572,10.65
9889151,9986683,2761,966350,10953033,9.68
9889152,9982347,4868,1703800,11686147,17.07
9889153,9971362,3481,1218350,11189712,12.22
9889154,9966117,4869,1704150,11670267,17.10
9889155,9986451,3833,1341550,11328001,13.43
9889156,9981323,2134,746900,10728223,7.48
9889157,9988422,2305,806750,10795172,8.08
9889158,9984346,3263,1142050,11126396,11.44
9889159,9980070,5950,2082500,12062570,20.87
9889160,7908345,3987,1395450,9303795,17.65
9889161,9955214,4374,1530900,11486114,15.38
9889162,9958999,3794,1327900,11286899,13.33
9889163,9976007,3882,1358700,11334707,13.62
9889164,9951429,3210,1123500,11074929,11.29
9889165,9966968,6061,2121350,12088318,21.28
9889166,9973967,6910,2418500,12392467,24.25
9889167,9949399,2324,813400,10762799,8.18
9889168,9950122,3867,1353450,11303572,13.60
9889169,9977310,4306,1507100,11484410,15.11
9889170,9975469,1749,612150,10587619,6.14
9889171,4073522,1185,414750,4488272,10.18
9889172,9958661,4301,1505350,11464011,15.12
9889173,9964753,2574,900900,10865653,9.04
9889174,9984534,4297,1503950,11488484,15.06
9889175,9980708,3191,1116850,11097558,11.19
9889176,9258148,2797,978950,10237098,10.57
9889177,9959881,1919,671650,10631531,6.74
9889178,9423163,2033,711550,10134713,7.55
9889179,9988055,1869,654150,10642205,6.55
9889181,9989929,2705,946750,10936679,9.48
9889183,9978611,4050,1417500,11396111,14.21
9889184,9970618,3068,1073800,11044418,10.77
9889185,9974412,5683,1989050,11963462,19.94
9889186,9992893,4125,1443750,11436643,14.45
9889187,9971858,2731,955850,10927708,9.59
9889188,9976372,3304,1156400,11132772,11.59
9889189,9969968,5257,1839950,11809918,18.45
9889190,9960610,5762,2016700,11977310,20.25
9889191,9975951,3402,1190700,11166651,11.94
9889192,9956902,4060,1421000,11377902,14.27
9889193,9976365,2209,773150,10749515,7.75
9889194,9968640,3149,1102150,11070790,11.06
9889195,9970727,4333,1516550,11487277,15.21
9889196,9973675,6098,2134300,12107975,21.40
9889197,9968288,5125,1793750,11762038,17.99
9889198,9866979,5564,1947400,11814379,19.74
9889199,9964049,3017,1055950,11019999,10.60
9889200,9986928,4932,1726200,11713128,17.28
9889201,9981529,4453,1558550,11540079,15.61
9889202,9820121,4969,1739150,11559271,17.71
9889203,9989757,6337,2217950,12207707,22.20
9889204,9976603,5441,1904350,11880953,19.09
9889206,9981022,3843,1345050,11326072,13.48
9889207,9983154,5246,1836100,11819254,18.39
9889208,9981922,3527,1234450,11216372,12.37
9889209,9989104,4076,1426600,11415704,14.28
9889210,9986791,3818,1336300,11323091,13.38
9889211,9988936,2815,985250,10974186,9.86
9889212,9987610,4176,1461600,11449210,14.63
9889213,9999508,2627,919450,10918958,9.19
9889214,9975445,5553,1943550,11918995,19.48
9889215,9987255,2532,886200,10873455,8.87
9889216,9740256,3882,1358700,11098956,13.95
9889217,465774,224,78400,544174,16.83
9889218,9969574,4515,1580250,11549824,15.85
9889219,9117666,2697,943950,10061616,10.35
9889220,9990555,3567,1248450,11239005,12.50
9889221,9986323,3694,1292900,11279223,12.95
9889222,9984681,3357,1174950,11159631,11.77
9889223,5443602,1169,409150,5852752,7.52
9889224,9959795,2385,834750,10794545,8.38
9889225,9982105,3412,1194200,11176305,11.96
9889226,9975678,1384,484400,10460078,4.86
9889227,9961308,3085,1079750,11041058,10.84
9889228,5950319,2529,885150,6835469,14.88
9889229,9980754,4275,1496250,11477004,14.99
9889230,9977648,3192,1117200,11094848,11.20
9889231,9975734,4712,1649200,11624934,16.53
9889232,9985777,3235,1132250,11118027,11.34
9889233,9982325,1977,691950,10674275,6.93
9889234,9986540,3237,1132950,11119490,11.34
9889235,9987801,923,323050,10310851,3.23
9889236,9991225,3299,1154650,11145875,11.56
9889237,9981489,2329,815150,10796639,8.17
9889238,9983673,995,348250,10331923,3.49
9889239,9994556,2374,830900,10825456,8.31
9889240,9988437,4566,1598100,11586537,16.00
9889241,9985169,3806,1332100,11317269,13.34
9889242,9996525,2687,940450,10936975,9.41
9889243,9973548,4354,1523900,11497448,15.28
9889244,9987075,2870,1004500,10991575,10.06
9889245,9997401,3891,1361850,11359251,13.62
9889246,9972697,3631,1270850,11243547,12.74
9889248,4068258,1396,488600,4556858,12.01
9889249,9955260,2326,814100,10769360,8.18
9889250,9984304,2005,701750,10686054,7.03
9889251,9961641,3784,1324400,11286041,13.29
9889252,9972678,3452,1208200,11180878,12.12
9889253,9953976,2609,913150,10867126,9.17
9889254,9943496,3925,1373750,11317246,13.82
9889255,9937765,3377,1181950,11119715,11.89
9889256,9956782,3590,1256500,11213282,12.62
9889257,9868861,6696,2343600,12212461,23.75
9889258,9957308,3183,1114050,11071358,11.19
9889259,9965639,4622,1617700,11583339,16.23
9889260,9985050,4202,1470700,11455750,14.73
9889261,9980551,2909,1018150,10998701,10.20
9889262,9966082,3538,1238300,11204382,12.43
9889264,9963387,3971,1389850,11353237,13.95
9889265,9972420,4556,1594600,11567020,15.99
9889266,9989875,2793,977550,10967425,9.79
9889267,7109882,1751,612850,7722732,8.62
9889268,9989812,2597,908950,10898762,9.10
9889269,9980767,4429,1550150,11530917,15.53
9889270,9985026,4308,1507800,11492826,15.10
9889271,9988876,3163,1107050,11095926,11.08
9889272,9986665,3348,1171800,11158465,11.73
9889273,9998206,3181,1113350,11111556,11.14
9889274,9984648,4350,1522500,11507148,15.25
9889275,9972335,3062,1071700,11044035,10.75
9889276,9991897,2245,785750,10777647,7.86
9889277,9980969,4913,1719550,11700519,17.23
9889278,9973171,1519,531650,10504821,5.33
9889279,9970513,2736,957600,10928113,9.60
9889280,9970292,2891,1011850,10982142,10.15
9889281,9977354,4312,1509200,11486554,15.13
9889282,9989371,4624,1618400,11607771,16.20
9889284,9965165,4283,1499050,11464215,15.04
9889285,9950262,4771,1669850,11620112,16.78
9889286,9975256,2818,986300,10961556,9.89
9889287,9966971,2962,1036700,11003671,10.40
9889288,9957946,2445,855750,10813696,8.59
9889289,9973131,3351,1172850,11145981,11.76
9889290,9959523,4395,1538250,11497773,15.45
9889291,8277658,1818,636300,8913958,7.69
9889292,9959548,2966,1038100,10997648,10.42
9889293,9964611,1776,621600,10586211,6.24
9889294,6263545,1352,473200,6736745,7.55
9889295,9967836,3721,1302350,11270186,13.07
9889296,9971475,5218,1826300,11797775,18.32
9889297,9979740,1593,557550,10537290,5.59
9889298,9986078,2135,747250,10733328,7.48
9889299,9973743,3851,1347850,11321593,13.51
9889300,7811133,2914,1019900,8831033,13.06
9889301,9973579,3273,1145550,11119129,11.49
9889302,9558533,1945,680750,10239283,7.12
9889303,9986785,2036,712600,10699385,7.14
9889304,9993212,2844,995400,10988612,9.96
9889305,9994130,3006,1052100,11046230,10.53
9889306,9998423,2093,732550,10730973,7.33
9889307,9989073,2036,712600,10701673,7.13
9889308,9988106,3395,1188250,11176356,11.90
9889309,9972689,2259,790650,10763339,7.93
9889310,9976007,4513,1579550,11555557,15.83
9889311,9995878,3618,1266300,11262178,12.67
9889313,9834706,2343,820050,10654756,8.34
9889315,9966668,4091,1431850,11398518,14.37
9889316,9973703,3265,1142750,11116453,11.46
9889317,9959265,4217,1475950,11435215,14.82
9889318,9989253,1849,647150,10636403,6.48
9889319,9990341,3676,1286600,11276941,12.88
9889320,9938453,2350,822500,10760953,8.28
9889321,9986041,5130,1795500,11781541,17.98
9889322,9999491,3974,1390900,11390391,13.91
9889323,9970583,1763,617050,10587633,6.19
9889324,9965973,3198,1119300,11085273,11.23
9889325,2575494,1472,515200,3090694,20.00
9889326,9966465,5374,1880900,11847365,18.87
9889327,9983424,3350,1172500,11155924,11.74
9889328,9984450,3772,1320200,11304650,13.22
9889329,9994950,2930,1025500,11020450,10.26
9889330,9976583,2940,1029000,11005583,10.31
9889331,9978709,3363,1177050,11155759,11.80
9889332,9988791,2484,869400,10858191,8.70
9889333,9988552,3591,1256850,11245402,12.58
9889334,9984799,3441,1204350,11189149,12.06
9889336,9969640,2917,1020950,10990590,10.24
9889337,9966301,2538,888300,10854601,8.91
9889338,9964422,4107,1437450,11401872,14.43
9889339,9978794,3457,1209950,11188744,12.13
9889340,9966909,3808,1332800,11299709,13.37
9889341,9959527,2953,1033550,10993077,10.38
9889342,9975489,5758,2015300,11990789,20.20
9889343,9967956,2586,905100,10873056,9.08
9889344,9970681,4219,1476650,11447331,14.81
9889345,9984092,2764,967400,10951492,9.69
9889346,3945108,1209,423150,4368258,10.73
9889347,9975245,3826,1339100,11314345,13.42
9889348,9958866,2161,756350,10715216,7.59
9889349,9965400,3460,1211000,11176400,12.15
9889350,9910399,4775,1671250,11581649,16.86
9889351,9995007,4000,1400000,11395007,14.01
9889352,9984003,5573,1950550,11934553,19.54
9889353,9984456,3970,1389500,11373956,13.92
9889354,9979500,2749,962150,10941650,9.64
9889355,9987813,3328,1164800,11152613,11.66
9889356,9987928,3910,1368500,11356428,13.70
9889357,9991611,2887,1010450,11002061,10.11
9889358,9967018,2187,765450,10732468,7.68
9889359,9953754,4642,1624700,11578454,16.32
9889360,9953688,4090,1431500,11385188,14.38
9889361,9958755,3350,1172500,11131255,11.77
9889362,9980230,1826,639100,10619330,6.40
9889363,9982650,1040,364000,10346650,3.65
9889364,8125528,686,240100,8365628,2.95
9889365,9956276,2119,741650,10697926,7.45
9889366,9975922,4930,1725500,11701422,17.30
9889367,8555885,2067,723450,9279335,8.46
9889368,9526641,2322,812700,10339341,8.53
9889369,9592346,3019,1056650,10648996,11.02
9889370,9983825,3163,1107050,11090875,11.09
9889371,9979360,4413,1544550,11523910,15.48
9889372,9965231,4610,1613500,11578731,16.19
9889373,9983564,1726,604100,10587664,6.05
9889374,9979462,3382,1183700,11163162,11.86
9889375,9803928,5577,1951950,11755878,19.91
9889376,9989784,3797,1328950,11318734,13.30
9889377,9926413,4207,1472450,11398863,14.83
9889378,9942288,3486,1220100,11162388,12.27
9889379,9978524,2734,956900,10935424,9.59
9889380,9946529,3989,1396150,11342679,14.04
9889381,9891863,3180,1113000,11004863,11.25
9889382,9885099,1582,553700,10438799,5.60
9889383,9953887,3585,1254750,11208637,12.61
9889384,9927535,6082,2128700,12056235,21.44
9889385,9950597,3061,1071350,11021947,10.77
9889386,5671334,3532,1236200,6907534,21.80
9889387,9369733,4703,1646050,11015783,17.57
9889388,9973178,1751,612850,10586028,6.14
9889389,9974368,4674,1635900,11610268,16.40
9889390,9979098,4776,1671600,11650698,16.75
9889391,9992065,4189,1466150,11458215,14.67
9889392,9997395,2060,721000,10718395,7.21
9889393,9982938,3009,1053150,11036088,10.55
9889394,9981187,4326,1514100,11495287,15.17
9889395,9974525,2609,913150,10887675,9.15
9889396,4576205,2335,817250,5393455,17.86
9889397,9972248,5069,1774150,11746398,17.79
9889398,9982605,3084,1079400,11062005,10.81
9889399,9992626,4498,1574300,11566926,15.75
9889400,9981365,3015,1055250,11036615,10.57
9889401,9983173,3942,1379700,11362873,13.82
9889402,9980191,1790,626500,10606691,6.28
9889403,9948497,1673,585550,10534047,5.89
9889404,9996651,2753,963550,10960201,9.64
9889406,9986435,3301,1155350,11141785,11.57
9889407,9987293,4994,1747900,11735193,17.50
9889408,9976988,3505,1226750,11203738,12.30
9889409,9963473,4810,1683500,11646973,16.90
9889410,9970286,4823,1688050,11658336,16.93
9889412,9615485,2933,1026550,10642035,10.68
9889413,9958552,3644,1275400,11233952,12.81
9889414,9966428,3682,1288700,11255128,12.93
9889415,9742903,1628,569800,10312703,5.85
9889416,9966604,5168,1808800,11775404,18.15
9889418,7193350,2532,886200,8079550,12.32
9889419,9954913,4109,1438150,11393063,14.45
9889420,9963793,4084,1429400,11393193,14.35
9889421,9979765,4794,1677900,11657665,16.81
9889422,9998282,2534,886900,10885182,8.87
9889425,9986214,2960,1036000,11022214,10.37
9889426,9640492,1992,697200,10337692,7.23
9889427,3797864,1821,637350,4435214,16.78
9889428,2151872,521,182350,2334222,8.47
9889429,9966566,4609,1613150,11579716,16.19
9889430,9979163,3099,1084650,11063813,10.87
9889431,9978043,3198,1119300,11097343,11.22
9889432,9995500,3376,1181600,11177100,11.82
9889433,9988713,4189,1466150,11454863,14.68
9889434,9967967,5080,1778000,11745967,17.84
9889435,9983498,6633,2321550,12305048,23.25
9889436,9978170,5341,1869350,11847520,18.73
9889437,9974441,2718,951300,10925741,9.54
9889438,9985739,3448,1206800,11192539,12.09
9889439,9989488,4121,1442350,11431838,14.44
9889440,9973883,2665,932750,10906633,9.35
9889441,9950377,2014,704900,10655277,7.08
9889442,9945894,2881,1008350,10954244,10.14
9889443,9962127,1863,652050,10614177,6.55
9889444,9958443,3300,1155000,11113443,11.60
9889445,9942073,3793,1327550,11269623,13.35
9889446,9955376,3539,1238650,11194026,12.44
9889447,9963972,2076,726600,10690572,7.29
9889448,9959637,4881,1708350,11667987,17.15
9889449,9977938,3018,1056300,11034238,10.59
9889450,9980711,4607,1612450,11593161,16.16
9889451,9971450,6019,2106650,12078100,21.13
9889452,9979208,3883,1359050,11338258,13.62
9889453,9991092,3454,1208900,11199992,12.10
9889454,9978338,4866,1703100,11681438,17.07
9889455,9287888,3301,1155350,10443238,12.44
9889456,9997456,2457,859950,10857406,8.60
9889457,3453250,848,296800,3750050,8.59
9889458,9972651,4024,1408400,11381051,14.12
9889459,9983422,3913,1369550,11352972,13.72
9889460,9991127,3814,1334900,11326027,13.36
9889461,9976726,2141,749350,10726076,7.51
9889462,1766229,324,113400,1879629,6.42
9889463,3368850,3066,1073100,4441950,31.85
9889464,9959481,5163,1807050,11766531,18.14
9889465,9952977,4137,1447950,11400927,14.55
9889466,9951417,5522,1932700,11884117,19.42
9889467,8486172,2406,842100,9328272,9.92
9889468,9943231,315,110250,10053481,1.11
9889469,9949649,5330,1865500,11815149,18.75
9889470,9942742,4594,1607900,11550642,16.17
9889471,9483000,4367,1528450,11011450,16.12
9889472,9952954,4979,1742650,11695604,17.51
9889473,2891618,1190,416500,3308118,14.40
9889474,9919813,3448,1206800,11126613,12.17
9889475,9938988,3958,1385300,11324288,13.94
9889477,9926242,3532,1236200,11162442,12.45
9889478,9934029,4019,1406650,11340679,14.16
9889479,9926513,3244,1135400,11061913,11.44
9889480,9948619,2628,919800,10868419,9.25
9889481,894362,411,143850,1038212,16.08
9889482,9934037,3610,1263500,11197537,12.72
9889483,9940927,5197,1818950,11759877,18.30
9889484,9941445,4384,1534400,11475845,15.43
9889485,9945860,2481,868350,10814210,8.73
9889486,9845158,4208,1472800,11317958,14.96
9889487,9959431,4200,1470000,11429431,14.76
9889488,9961233,4884,1709400,11670633,17.16
9889489,9954932,2836,992600,10947532,9.97
9889490,9910108,1961,686350,10596458,6.93
9889491,9964272,4074,1425900,11390172,14.31
9889492,9957476,4042,1414700,11372176,14.21
9889493,9720867,2885,1009750,10730617,10.39
9889494,9969766,3537,1237950,11207716,12.42
9889495,9953446,3721,1302350,11255796,13.08
9889496,9957836,4201,1470350,11428186,14.77
9889497,9947811,1300,455000,10402811,4.57
9889498,9956822,3809,1333150,11289972,13.39
9889499,9947603,3383,1184050,11131653,11.90
9889500,9961145,2908,1017800,10978945,10.22
9889501,9929879,3468,1213800,11143679,12.22
9889502,9941469,3158,1105300,11046769,11.12
9889503,9962202,2580,903000,10865202,9.06
9889504,9947611,3850,1347500,11295111,13.55
9889505,9943667,4280,1498000,11441667,15.06
9889506,9930399,4458,1560300,11490699,15.71
9889507,9931414,3367,1178450,11109864,11.87
9889508,9821197,3604,1261400,11082597,12.84
9889509,9930579,3144,1100400,11030979,11.08
9889510,9949989,3710,1298500,11248489,13.05
9889511,9945679,2629,920150,10865829,9.25
9889512,9916426,3952,1383200,11299626,13.95
9889513,9931185,3822,1337700,11268885,13.47
9889514,9942895,5942,2079700,12022595,20.92
9889515,4990473,2188,765800,5756273,15.35
9889516,9950142,4009,1403150,11353292,14.10
9889517,9955802,2616,915600,10871402,9.20
9889518,9962616,2114,739900,10702516,7.43
9889519,9950184,3710,1298500,11248684,13.05
9889520,9972198,3622,1267700,11239898,12.71
9889521,9979043,3293,1152550,11131593,11.55
9889522,9980010,3134,1096900,11076910,10.99
9889523,9986241,1993,697550,10683791,6.99
9889524,9970618,4268,1493800,11464418,14.98
9889525,9996638,3779,1322650,11319288,13.23
9889526,9980566,4651,1627850,11608416,16.31
9889527,3690994,931,325850,4016844,8.83
9889528,8994438,5124,1793400,10787838,19.94
9889529,5926526,3609,1263150,7189676,21.31
9889530,9984983,3252,1138200,11123183,11.40
9889531,9983130,4041,1414350,11397480,14.17
9889532,9991762,5030,1760500,11752262,17.62
9889533,9981404,1855,649250,10630654,6.50
9889534,9984055,4823,1688050,11672105,16.91
9889535,2849948,941,329350,3179298,11.56
9889536,9775456,1350,472500,10247956,4.83
9889537,9992100,4220,1477000,11469100,14.78
9889538,9979006,3282,1148700,11127706,11.51
9889539,9999726,2581,903350,10903076,9.03
9889540,9985515,3615,1265250,11250765,12.67
9889541,9993193,3328,1164800,11157993,11.66
9889542,9976384,1512,529200,10505584,5.30
9889543,9985887,2387,835450,10821337,8.37
9889544,5124071,1681,588350,5712421,11.48
9889545,9976074,3874,1355900,11331974,13.59
9889547,9965006,2817,985950,10950956,9.89
9889548,9966755,3371,1179850,11146605,11.84
9889549,9964670,1017,355950,10320620,3.57
9889551,9077243,5093,1782550,10859793,19.64
9889554,9977913,3866,1353100,11331013,13.56
9889555,9974434,4054,1418900,11393334,14.23
9889556,9969231,2823,988050,10957281,9.91
9889557,9959764,3250,1137500,11097264,11.42
9889558,9965403,2198,769300,10734703,7.72
9889559,9985582,4035,1412250,11397832,14.14
9889560,9981859,4118,1441300,11423159,14.44
9889561,9983042,2709,948150,10931192,9.50
9889562,9973357,2878,1007300,10980657,10.10
9889563,9976290,5675,1986250,11962540,19.91
9889564,9992813,3787,1325450,11318263,13.26
9889565,9974463,4762,1666700,11641163,16.71
9889566,9975628,6049,2117150,12092778,21.22
9889567,9969483,2980,1043000,11012483,10.46
9889568,9996083,4624,1618400,11614483,16.19
9889569,3580610,1206,422100,4002710,11.79
9889570,9981378,4462,1561700,11543078,15.65
9889572,9960459,4597,1608950,11569409,16.15
9889573,9950097,5215,1825250,11775347,18.34
9889574,9962424,2774,970900,10933324,9.75
9889575,5198548,1903,666050,5864598,12.81
9889576,9949795,4598,1609300,11559095,16.17
9889577,9938491,2565,897750,10836241,9.03
9889578,9941586,2652,928200,10869786,9.34
9889579,9935317,3159,1105650,11040967,11.13
9889580,9945102,4068,1423800,11368902,14.32
9889581,9956905,3295,1153250,11110155,11.58
9889582,9963142,4659,1630650,11593792,16.37
9889583,9974695,2165,757750,10732445,7.60
9889584,7045555,2364,827400,7872955,11.74
9889585,9985253,5122,1792700,11777953,17.95
9889586,9995907,2539,888650,10884557,8.89
9889587,9970269,2985,1044750,11015019,10.48
9889588,9979061,4164,1457400,11436461,14.60
9889589,9987417,2639,923650,10911067,9.25
9889590,9969272,3298,1154300,11123572,11.58
9889591,9978315,2725,953750,10932065,9.56
9889592,9965285,3174,1110900,11076185,11.15
9889593,9976542,4018,1406300,11382842,14.10
9889594,9980858,2662,931700,10912558,9.33
9889595,9979700,4565,1597750,11577450,16.01
9889596,9977458,2519,881650,10859108,8.84
9889597,9993227,5711,1998850,11992077,20.00
9889598,9630036,2879,1007650,10637686,10.46
9889599,9980299,4699,1644650,11624949,16.48
9889600,9998353,3159,1105650,11104003,11.06
9889601,9969270,2509,878150,10847420,8.81
9889602,9972016,6180,2163000,12135016,21.69
9889603,9975557,2807,982450,10958007,9.85
9889605,9965783,2437,852950,10818733,8.56
9889606,9981347,1444,505400,10486747,5.06
9889607,9215803,2438,853300,10069103,9.26
9889608,9973888,2746,961100,10934988,9.64
9889609,9988317,2671,934850,10923167,9.36
9889610,9980546,2352,823200,10803746,8.25
9889611,9974142,2892,1012200,10986342,10.15
9889612,9958694,4776,1671600,11630294,16.79
9889613,9928189,3569,1249150,11177339,12.58
9889614,9946383,2982,1043700,10990083,10.49
9889615,8761618,3597,1258950,10020568,14.37
9889616,9968490,4737,1657950,11626440,16.63
9889617,2604384,355,124250,2728634,4.77
9889618,9961689,3767,1318450,11280139,13.24
9889619,9959128,2973,1040550,10999678,10.45
9889620,9974617,3626,1269100,11243717,12.72
9889621,9968016,4525,1583750,11551766,15.89
9889622,9961865,3834,1341900,11303765,13.47
9889623,9991989,3047,1066450,11058439,10.67
9889624,9974508,6031,2110850,12085358,21.16
9889625,9983332,3947,1381450,11364782,13.84
9889626,9975512,3726,1304100,11279612,13.07
9889627,9978884,3470,1214500,11193384,12.17
9889628,9998095,3163,1107050,11105145,11.07
9889629,9966723,2682,938700,10905423,9.42
9889630,9959617,3079,1077650,11037267,10.82
9889631,9965686,4118,1441300,11406986,14.46
9889632,1389705,1297,453950,1843655,32.67
9889633,4466295,1341,469350,4935645,10.51
9889634,9964184,2087,730450,10694634,7.33
9889635,3397174,1545,540750,3937924,15.92
9889636,9959224,3828,1339800,11299024,13.45
9889638,9975011,4871,1704850,11679861,17.09
9889639,9981528,3882,1358700,11340228,13.61
9889640,9987219,3779,1322650,11309869,13.24
9889641,9990121,2116,740600,10730721,7.41
9889642,9968229,4046,1416100,11384329,14.21
9889643,9990929,2804,981400,10972329,9.82
9889644,730703,310,108500,839203,14.85
9889645,1874941,1097,383950,2258891,20.48
9889646,2484181,1664,582400,3066581,23.44
9889647,9455451,2837,992950,10448401,10.50
9889648,9979528,2899,1014650,10994178,10.17
9889649,9989495,3032,1061200,11050695,10.62
9889650,1676431,704,246400,1922831,14.70
9889651,9985064,4012,1404200,11389264,14.06
9889652,7168849,2886,1010100,8178949,14.09
9889653,9984641,2416,845600,10830241,8.47
9889654,9994656,5736,2007600,12002256,20.09
9889655,1765780,2417,845950,2611730,47.91
9889656,4885404,1229,430150,5315554,8.80
9889657,9988924,2533,886550,10875474,8.88
9889658,9998147,3159,1105650,11103797,11.06
9889659,9974330,2599,909650,10883980,9.12
9889660,9977678,2926,1024100,11001778,10.26
9889661,9990436,2552,893200,10883636,8.94
9889662,9982827,6264,2192400,12175227,21.96
9889663,9983375,3140,1099000,11082375,11.01
9889664,9998426,2447,856450,10854876,8.57
9889665,9980585,4833,1691550,11672135,16.95
9889666,9988742,3519,1231650,11220392,12.33
9889667,9961476,4517,1580950,11542426,15.87
9889668,9981934,4951,1732850,11714784,17.36
9889669,9918191,1274,445900,10364091,4.50
9889670,9995661,2409,843150,10838811,8.44
9889672,9984052,3450,1207500,11191552,12.09
9889673,9978446,2385,834750,10813196,8.37
9889674,9973279,3568,1248800,11222079,12.52
9889675,9021704,2448,856800,9878504,9.50
9889676,9965645,3849,1347150,11312795,13.52
9889677,9965481,2083,729050,10694531,7.32
9889678,9994166,3318,1161300,11155466,11.62
9889679,9979647,3835,1342250,11321897,13.45
9889680,9979673,2769,969150,10948823,9.71
9889681,9983957,5344,1870400,11854357,18.73
9889682,9989739,4820,1687000,11676739,16.89
9889683,9982562,3332,1166200,11148762,11.68
9889684,9970975,1138,398300,10369275,3.99
9889686,9960791,3312,1159200,11119991,11.64
9889687,9951794,1660,581000,10532794,5.84
9889688,9967366,4975,1741250,11708616,17.47
9889689,9950351,2574,900900,10851251,9.05
9889690,9954027,3992,1397200,11351227,14.04
9889692,9970317,4962,1736700,11707017,17.42
9889693,9974817,2687,940450,10915267,9.43
9889695,9962493,4769,1669150,11631643,16.75
9889696,9979022,996,348600,10327622,3.49
9889697,9981256,4731,1655850,11637106,16.59
9889699,9983120,2374,830900,10814020,8.32
9889700,9987377,4208,1472800,11460177,14.75
9889701,9981030,2573,900550,10881580,9.02
9889702,9986796,4575,1601250,11588046,16.03
9889703,9991036,5403,1891050,11882086,18.93
9889704,3049492,800,280000,3329492,9.18
9889705,9963766,2428,849800,10813566,8.53
9889706,9979822,3649,1277150,11256972,12.80
9889707,3393854,1026,359100,3752954,10.58
9889708,9978818,2935,1027250,11006068,10.29
9889709,9992883,3281,1148350,11141233,11.49
9889710,9999300,2430,850500,10849800,8.51
9889711,9993645,5023,1758050,11751695,17.59
9889712,9988314,3138,1098300,11086614,11.00
9889713,9986041,3928,1374800,11360841,13.77
9889714,9981366,4239,1483650,11465016,14.86
9889715,9999605,3654,1278900,11278505,12.79
9889716,9986166,6457,2259950,12246116,22.63
9889717,9989808,4950,1732500,11722308,17.34
9889718,9996760,4978,1742300,11739060,17.43
9889719,9982157,5460,1911000,11893157,19.14
9889720,9989943,3678,1287300,11277243,12.89
9889721,9989597,3954,1383900,11373497,13.85
9889722,9980547,3859,1350650,11331197,13.53
9889723,9985456,2147,751450,10736906,7.53
9889724,9971381,2794,977900,10949281,9.81
9889725,9974252,3153,1103550,11077802,11.06
9889726,9969405,3229,1130150,11099555,11.34
9889727,9984088,4559,1595650,11579738,15.98
9889728,9995009,3058,1070300,11065309,10.71
9889729,9985539,3651,1277850,11263389,12.80
9889730,9990457,4640,1624000,11614457,16.26
9889731,9733990,3802,1330700,11064690,13.67
9889732,6878537,3132,1096200,7974737,15.94
9889733,9958218,4204,1471400,11429618,14.78
9889734,9971964,2861,1001350,10973314,10.04
9889735,9989800,3276,1146600,11136400,11.48
9889737,9999232,4108,1437800,11437032,14.38
9889739,9988202,3035,1062250,11050452,10.64
9889740,9976124,2084,729400,10705524,7.31
9889741,9984651,1660,581000,10565651,5.82
9889742,9977146,2650,927500,10904646,9.30
9889743,9997418,2691,941850,10939268,9.42
9889744,9993672,4321,1512350,11506022,15.13
9889745,9984210,3645,1275750,11259960,12.78
9889746,7469145,3474,1215900,8685045,16.28
9889747,9975370,3848,1346800,11322170,13.50
9889748,9971698,3229,1130150,11101848,11.33
9889749,9985051,4008,1402800,11387851,14.05
9889750,9986846,2630,920500,10907346,9.22
9889751,9991093,3895,1363250,11354343,13.64
9889752,9987334,5268,1843800,11831134,18.46
9889753,9977501,2441,854350,10831851,8.56
9889754,9977722,5817,2035950,12013672,20.40
9889755,9971619,4908,1717800,11689419,17.23
9889756,9975469,4044,1415400,11390869,14.19
9889757,9734537,1865,652750,10387287,6.71
9889758,9975088,1943,680050,10655138,6.82
9889759,9950784,3634,1271900,11222684,12.78
9889760,9959729,4280,1498000,11457729,15.04
9889761,9956018,3314,1159900,11115918,11.65
9889762,9973441,3166,1108100,11081541,11.11
9889763,9978751,2274,795900,10774651,7.98
9889764,9956834,4234,1481900,11438734,14.88
9889766,1275726,660,231000,1506726,18.11
9889767,9979685,3579,1252650,11232335,12.55
9889768,9982211,2216,775600,10757811,7.77
9889769,9988016,5332,1866200,11854216,18.68
9889770,6277171,2690,941500,7218671,15.00
9889771,9357533,2011,703850,10061383,7.52
9889772,9983522,3869,1354150,11337672,13.56
9889773,9976639,4421,1547350,11523989,15.51
9889774,9993453,5538,1938300,11931753,19.40
9889775,9980927,4038,1413300,11394227,14.16
9889776,9983696,2417,845950,10829646,8.47
9889777,9994634,4807,1682450,11677084,16.83
9889778,1711093,1679,587650,2298743,34.34
9889779,9999739,2362,826700,10826439,8.27
9889780,9996953,2622,917700,10914653,9.18
9889781,9974957,4602,1610700,11585657,16.15
9889782,9981035,3326,1164100,11145135,11.66
9889783,9970110,1404,491400,10461510,4.93
9889784,9985008,3000,1050000,11035008,10.52
9889785,9961290,3672,1285200,11246490,12.90
9889786,9980016,1900,665000,10645016,6.66
9889787,9993635,4442,1554700,11548335,15.56
9889788,9969523,4588,1605800,11575323,16.11
9889789,9970282,6355,2224250,12194532,22.31
9889790,9952055,5383,1884050,11836105,18.93
9889791,9966539,4204,1471400,11437939,14.76
9889792,9789925,3616,1265600,11055525,12.93
9889793,9964906,1894,662900,10627806,6.65
9889794,3712666,1267,443450,4156116,11.94
9889795,9969937,2565,897750,10867687,9.00
9889796,9969994,4115,1440250,11410244,14.45
9889797,9956216,3823,1338050,11294266,13.44
9889798,9636461,5759,2015650,11652111,20.92
9889799,9982513,5124,1793400,11775913,17.97
9889800,9959752,2967,1038450,10998202,10.43
9889801,9979493,4529,1585150,11564643,15.88
9889802,9974584,6272,2195200,12169784,22.01
9889803,9992489,2137,747950,10740439,7.49
9889804,9992134,2692,942200,10934334,9.43
9889805,9988555,3756,1314600,11303155,13.16
9889806,9982950,2206,772100,10755050,7.73
9889807,9991857,5468,1913800,11905657,19.15
9889808,9972652,4096,1433600,11406252,14.38
9889809,9969439,3027,1059450,11028889,10.63
9889810,9949407,3987,1395450,11344857,14.03
9889811,9974347,1785,624750,10599097,6.26
9889812,9995155,3632,1271200,11266355,12.72
9889813,9989993,3299,1154650,11144643,11.56
9889814,9985541,4266,1493100,11478641,14.95
9889815,9678813,4452,1558200,11237013,16.10
9889816,9961995,4026,1409100,11371095,14.14
9889817,9972058,5513,1929550,11901608,19.35
9889818,5116176,4083,1429050,6545226,27.93
9889819,9952783,3915,1370250,11323033,13.77
9889820,9946775,3535,1237250,11184025,12.44
9889821,9963826,7202,2520700,12484526,25.30
9889822,9955218,4370,1529500,11484718,15.36
9889823,9960399,2903,1016050,10976449,10.20
9889824,9948216,3460,1211000,11159216,12.17
9889825,9950797,5500,1925000,11875797,19.35
9889826,9968278,1813,634550,10602828,6.37
9889827,9946857,4178,1462300,11409157,14.70
9889828,9952835,1744,610400,10563235,6.13
9889829,9930422,4572,1600200,11530622,16.11
9889830,9943649,4860,1701000,11644649,17.11
9889831,9926027,4840,1694000,11620027,17.07
9889832,9930056,5243,1835050,11765106,18.48
9889833,3769881,2349,822150,4592031,21.81
9889834,9909282,3839,1343650,11252932,13.56
9889835,9933869,3281,1148350,11082219,11.56
9889836,9938616,3871,1354850,11293466,13.63
9889837,9958787,2153,753550,10712337,7.57
9889838,9941274,1609,563150,10504424,5.66
9889839,9924155,3993,1397550,11321705,14.08
9889840,9968058,3769,1319150,11287208,13.23
9889841,9943576,3319,1161650,11105226,11.68
9889842,9961505,3487,1220450,11181955,12.25
9889843,9961489,3744,1310400,11271889,13.15
9889844,9954462,1697,593950,10548412,5.97
9889845,9953744,3151,1102850,11056594,11.08
9889846,9975391,3809,1333150,11308541,13.36
9889847,9964906,4414,1544900,11509806,15.50
9889848,9960460,6034,2111900,12072360,21.20
9889849,9979715,3318,1161300,11141015,11.64
9889850,9960082,1165,407750,10367832,4.09
9889851,9961314,3865,1352750,11314064,13.58
9889852,9986188,1271,444850,10431038,4.45
9889853,9981145,2389,836150,10817295,8.38
9889855,9962363,2562,896700,10859063,9.00
9889856,9970113,3732,1306200,11276313,13.10
9889857,9951740,2157,754950,10706690,7.59
9889858,9965213,3161,1106350,11071563,11.10
9889859,9976578,2619,916650,10893228,9.19
9889860,9974283,4351,1522850,11497133,15.27
9889861,9973808,4195,1468250,11442058,14.72
9889862,3744197,747,261450,4005647,6.98
9889863,694542,236,82600,777142,11.89
9889864,9968690,3264,1142400,11111090,11.46
9889865,9986068,3925,1373750,11359818,13.76
9889866,9979386,2677,936950,10916336,9.39
9889867,9953800,3408,1192800,11146600,11.98
9889868,9994277,2510,878500,10872777,8.79
9889869,9988647,3482,1218700,11207347,12.20
9889870,9991889,4364,1527400,11519289,15.29
9889871,9989990,4064,1422400,11412390,14.24
9889872,9990448,4591,1606850,11597298,16.08
9889873,9991288,3908,1367800,11359088,13.69
9889874,9985578,3371,1179850,11165428,11.82
9889875,9483447,1335,467250,9950697,4.93
9889876,9952671,3359,1175650,11128321,11.81
9889877,9972992,3768,1318800,11291792,13.22
9889878,9982688,3893,1362550,11345238,13.65
9889879,9964850,2244,785400,10750250,7.88
9889880,9973877,3921,1372350,11346227,13.76
9889881,9968888,3265,1142750,11111638,11.46
9889882,9952580,1495,523250,10475830,5.26
9889883,9951040,4441,1554350,11505390,15.62
9889884,9953501,2824,988400,10941901,9.93
9889885,9953650,3171,1109850,11063500,11.15
9889886,9979045,1469,514150,10493195,5.15
9889887,9963511,5091,1781850,11745361,17.88
9889888,9972335,2293,802550,10774885,8.05
9889889,9981926,2375,831250,10813176,8.33
9889890,9987321,3548,1241800,11229121,12.43
9889891,9976784,3382,1183700,11160484,11.86
9889892,9980468,3609,1263150,11243618,12.66
9889893,9983465,2025,708750,10692215,7.10
9889894,9998572,3838,1343300,11341872,13.43
9889895,9948714,2502,875700,10824414,8.80
9889896,9980627,1990,696500,10677127,6.98
9889897,9972931,4171,1459850,11432781,14.64
9889898,9979016,5330,1865500,11844516,18.69
9889900,9971420,3242,1134700,11106120,11.38
9889901,9975065,4745,1660750,11635815,16.65
9889902,9974038,4439,1553650,11527688,15.58
9889903,9564442,3632,1271200,10835642,13.29
9889904,9982796,2567,898450,10881246,9.00
9889905,9987929,2121,742350,10730279,7.43
9889906,9993508,1123,393050,10386558,3.93
9889907,9998844,3839,1343650,11342494,13.44
9889908,9987258,3644,1275400,11262658,12.77
9889909,9973011,4103,1436050,11409061,14.40
9889910,9991572,2526,884100,10875672,8.85
9889911,9973992,3665,1282750,11256742,12.86
9889912,9903064,2875,1006250,10909314,10.16
9889913,9917052,2394,837900,10754952,8.45
9889914,9986705,5001,1750350,11737055,17.53
9889915,9977299,3099,1084650,11061949,10.87
9889916,9971199,3348,1171800,11142999,11.75
9889917,9971007,1736,607600,10578607,6.09
9889918,9973655,2175,761250,10734905,7.63
9889919,9988474,4718,1651300,11639774,16.53
9889920,9975200,4020,1407000,11382200,14.10
9889921,9971473,3493,1222550,11194023,12.26
9889922,9843201,3506,1227100,11070301,12.47
9889923,9978909,3154,1103900,11082809,11.06
9889924,1974944,1674,585900,2560844,29.67
9889925,9955760,4286,1500100,11455860,15.07
9889926,9959764,4060,1421000,11380764,14.27
9889927,9968822,1453,508550,10477372,5.10
9889928,9966829,3822,1337700,11304529,13.42
9889929,9956007,3694,1292900,11248907,12.99
9889930,9977330,5122,1792700,11770030,17.97
9889931,9984323,3252,1138200,11122523,11.40
9889932,9892741,6479,2267650,12160391,22.92
9889933,9970365,3831,1340850,11311215,13.45
9889934,9948202,3354,1173900,11122102,11.80
9889935,9986770,3210,1123500,11110270,11.25
9889936,9765133,4111,1438850,11203983,14.73
9889937,9977943,3294,1152900,11130843,11.55
9889938,9953309,2600,910000,10863309,9.14
9889939,9966010,6284,2199400,12165410,22.07
9889940,9974535,3680,1288000,11262535,12.91
9889941,9963056,4717,1650950,11614006,16.57
9889942,9953653,3084,1079400,11033053,10.84
9889943,9931587,3985,1394750,11326337,14.04
9889944,4620776,2387,835450,5456226,18.08
9889945,9936648,7395,2588250,12524898,26.05
9889946,9923759,4020,1407000,11330759,14.18
9889947,9925946,4136,1447600,11373546,14.58
9889948,8456864,3284,1149400,9606264,13.59
9889949,9945846,4780,1673000,11618846,16.82
9889951,9940276,2456,859600,10799876,8.65
9889952,9963432,5605,1961750,11925182,19.69
9889953,9964987,2066,723100,10688087,7.26
9889954,9976120,5196,1818600,11794720,18.23
9889955,9984115,2744,960400,10944515,9.62
9889956,9961707,1104,386400,10348107,3.88
9889957,9962872,4425,1548750,11511622,15.55
9889958,9965046,3579,1252650,11217696,12.57
9889959,9978501,2756,964600,10943101,9.67
9889960,9976185,2088,730800,10706985,7.33
9889961,9963300,5090,1781500,11744800,17.88
9889963,9961895,2491,871850,10833745,8.75
9889964,9969409,4000,1400000,11369409,14.04
9889965,9971965,3575,1251250,11223215,12.55
9889966,9972417,1737,607950,10580367,6.10
9889967,9989258,3186,1115100,11104358,11.16
9889968,9968881,2419,846650,10815531,8.49
9889969,9972586,4406,1542100,11514686,15.46
9889970,9978454,3765,1317750,11296204,13.21
9889971,8984524,3376,1181600,10166124,13.15
9889972,8993634,5982,2093700,11087334,23.28
9889973,9987426,2691,941850,10929276,9.43
9889974,9981561,3315,1160250,11141811,11.62
9889975,9980824,3723,1303050,11283874,13.06
9889976,9989580,3576,1251600,11241180,12.53
9889977,9988954,1906,667100,10656054,6.68
9889978,9988431,5399,1889650,11878081,18.92
9889979,9977577,3986,1395100,11372677,13.98
9889980,9476947,2540,889000,10365947,9.38
9889981,9997489,2940,1029000,11026489,10.29
9889982,9718267,2896,1013600,10731867,10.43
9889983,9977964,3338,1168300,11146264,11.71
9889984,9968972,4990,1746500,11715472,17.52
9889985,9966248,3608,1262800,11229048,12.67
9889986,9987167,2471,864850,10852017,8.66
9889987,9979133,2393,837550,10816683,8.39
9889988,9983641,2208,772800,10756441,7.74
9889989,9982340,4166,1458100,11440440,14.61
9889990,9979254,3771,1319850,11299104,13.23
9889991,9986202,3493,1222550,11208752,12.24
9889992,9987446,3350,1172500,11159946,11.74
9889993,9979410,4459,1560650,11540060,15.64
9889994,9972435,1745,610750,10583185,6.12
9889995,9960380,274,95900,10056280,0.96
9889996,9980143,2608,912800,10892943,9.15
9889997,9986598,4672,1635200,11621798,16.37
9889998,2201927,1940,679000,2880927,30.84
9889999,9976654,4605,1611750,11588404,16.16
9890000,9977689,3136,1097600,11075289,11.00
9890001,9987431,3693,1292550,11279981,12.94
9890002,9979759,2117,740950,10720709,7.42
9890003,7208167,2518,881300,8089467,12.23
9890004,9979563,3910,1368500,11348063,13.71
9890005,9921491,5683,1989050,11910541,20.05
9890006,9968988,3810,1333500,11302488,13.38
9890007,9960489,5659,1980650,11941139,19.89
9890010,9908890,4336,1517600,11426490,15.32
9890011,9937276,5164,1807400,11744676,18.19
9890012,9939438,4474,1565900,11505338,15.75
9890013,414437,123,43050,457487,10.39
9890014,9940395,4867,1703450,11643845,17.14
9890015,9953564,4907,1717450,11671014,17.25
9890016,9949845,4340,1519000,11468845,15.27
9890017,9969949,3067,1073450,11043399,10.77
9890018,9973265,4258,1490300,11463565,14.94
9890019,9952183,3570,1249500,11201683,12.56
9890020,9955054,3269,1144150,11099204,11.49
9890021,9954092,4353,1523550,11477642,15.31
9890022,9958123,3205,1121750,11079873,11.26
9890023,9970116,3793,1327550,11297666,13.32
9890024,9979356,2156,754600,10733956,7.56
9890025,9962300,3351,1172850,11135150,11.77
9890026,9977910,3370,1179500,11157410,11.82
9890027,9957133,2471,864850,10821983,8.69
9890028,9935474,3863,1352050,11287524,13.61
9890029,9977578,2682,938700,10916278,9.41
9890030,9987321,1990,696500,10683821,6.97
9890031,9989706,5736,2007600,11997306,20.10
9890032,9969501,4741,1659350,11628851,16.64
9890033,9327742,2833,991550,10319292,10.63
9890034,5653749,2046,716100,6369849,12.67
9890035,3000331,1841,644350,3644681,21.48
9890037,9992368,2618,916300,10908668,9.17
9890038,9986950,4593,1607550,11594500,16.10
9890039,9969791,3499,1224650,11194441,12.28
9890040,9979174,3593,1257550,11236724,12.60
9890041,9991775,5709,1998150,11989925,20.00
9890042,9995855,2422,847700,10843555,8.48
9890043,9116892,3760,1316000,10432892,14.43
9890044,9954308,1928,674800,10629108,6.78
9890045,9970770,4185,1464750,11435520,14.69
9890046,9969697,2294,802900,10772597,8.05
9890047,9975457,3689,1291150,11266607,12.94
9890048,9990036,2787,975450,10965486,9.76
9890049,9987502,4143,1450050,11437552,14.52
9890050,9986724,2985,1044750,11031474,10.46
9890051,9974956,3539,1238650,11213606,12.42
9890052,9986202,4605,1611750,11597952,16.14
9890053,9973423,4533,1586550,11559973,15.91
9890054,9953380,3547,1241450,11194830,12.47
9890055,9992395,3445,1205750,11198145,12.07
9890056,9981277,4343,1520050,11501327,15.23
9890057,9977981,2896,1013600,10991581,10.16
9890058,9981809,2522,882700,10864509,8.84
9890059,9987525,4355,1524250,11511775,15.26
9890060,9759702,1324,463400,10223102,4.75
9890061,9976443,3134,1096900,11073343,10.99
9890062,9400319,2112,739200,10139519,7.86
9890063,1506793,1107,387450,1894243,25.71
9890064,9979326,4374,1530900,11510226,15.34
9890067,5010048,1387,485450,5495498,9.69
9890068,9990077,1849,647150,10637227,6.48
9890069,9983120,2686,940100,10923220,9.42
9890070,9994048,4824,1688400,11682448,16.89
9890071,9997922,3016,1055600,11053522,10.56
9890072,9982155,4554,1593900,11576055,15.97
9890073,9997270,4850,1697500,11694770,16.98
9890074,9977678,2255,789250,10766928,7.91
9890075,9984847,3659,1280650,11265497,12.83
9890076,9975690,4963,1737050,11712740,17.41
9890077,9999656,2715,950250,10949906,9.50
9890078,9961690,4255,1489250,11450940,14.95
9890079,9981956,1909,668150,10650106,6.69
9890080,9985821,3147,1101450,11087271,11.03
9890081,9987132,3651,1277850,11264982,12.79
9890082,9972879,2814,984900,10957779,9.88
9890083,3197246,2007,702450,3899696,21.97
9890084,9976068,3260,1141000,11117068,11.44
9890085,9971565,2565,897750,10869315,9.00
9890086,9969806,3983,1394050,11363856,13.98
9890087,9959873,5095,1783250,11743123,17.90
9890088,9746819,2566,898100,10644919,9.21
9890089,9983773,2773,970550,10954323,9.72
9890090,9970969,2765,967750,10938719,9.71
9890091,9988166,2781,973350,10961516,9.75
9890092,9973928,2634,921900,10895828,9.24
9890093,9982187,2953,1033550,11015737,10.35
9890094,9989498,820,287000,10276498,2.87
9890095,9994290,3855,1349250,11343540,13.50
9890096,9991812,2873,1005550,10997362,10.06
9890097,9747503,2072,725200,10472703,7.44
9890098,3810314,1085,379750,4190064,9.97
9890099,9961540,3852,1348200,11309740,13.53
9890100,9964093,4703,1646050,11610143,16.52
9890101,9964249,2147,751450,10715699,7.54
9890102,9966604,2916,1020600,10987204,10.24
9890103,9980461,3596,1258600,11239061,12.61
9890104,9993669,4031,1410850,11404519,14.12
9890105,9985363,2832,991200,10976563,9.93
9890106,9973660,2082,728700,10702360,7.31
9890107,9990085,1052,368200,10358285,3.69
9890108,9982286,3605,1261750,11244036,12.64
9890109,9983124,2929,1025150,11008274,10.27
9890110,9969389,3927,1374450,11343839,13.79
9890111,9969175,3428,1199800,11168975,12.04
9890112,1418656,562,196700,1615356,13.87
9890113,9980249,1349,472150,10452399,4.73
9890114,9975050,1906,667100,10642150,6.69
9890115,9794257,3150,1102500,10896757,11.26
9890116,3104771,866,303100,3407871,9.76
9890117,3337813,1117,390950,3728763,11.71
9890118,9967992,2596,908600,10876592,9.12
9890119,927515,426,149100,1076615,16.08
9890120,9972811,2703,946050,10918861,9.49
9890121,8729893,3592,1257200,9987093,14.40
9890122,9970894,5611,1963850,11934744,19.70
9890123,9959333,3450,1207500,11166833,12.12
9890124,9950150,5001,1750350,11700500,17.59
9890125,9963250,3381,1183350,11146600,11.88
9890126,9945244,3962,1386700,11331944,13.94
9890127,9965339,4712,1649200,11614539,16.55
9890128,9959807,6322,2212700,12172507,22.22
9890129,334339,149,52150,386489,15.60
9890130,9958637,4660,1631000,11589637,16.38
9890131,9954609,4224,1478400,11433009,14.85
9890132,9956084,6204,2171400,12127484,21.81
9890133,9942932,5270,1844500,11787432,18.55
9890134,9938867,3788,1325800,11264667,13.34
9890135,9963222,3185,1114750,11077972,11.19
9890136,9971092,3842,1344700,11315792,13.49
9890137,9963507,2481,868350,10831857,8.72
9890138,9973955,4135,1447250,11421205,14.51
9890139,9991726,3551,1242850,11234576,12.44
9890140,9971756,3493,1222550,11194306,12.26
9890141,9984966,3189,1116150,11101116,11.18
9890142,9979388,3375,1181250,11160638,11.84
9890143,9991651,3206,1122100,11113751,11.23
9890144,6928354,1305,456750,7385104,6.59
9890145,9980654,1846,646100,10626754,6.47
9890146,9999342,3115,1090250,11089592,10.90
9890147,9973673,4293,1502550,11476223,15.07
9890148,9984575,2815,985250,10969825,9.87
9890149,9988601,2640,924000,10912601,9.25
9890150,9986884,4525,1583750,11570634,15.86
9890151,9982708,3104,1086400,11069108,10.88
9890152,9999962,3858,1350300,11350262,13.50
9890153,9979192,4582,1603700,11582892,16.07
9890154,9989544,3087,1080450,11069994,10.82
9890155,9980042,1738,608300,10588342,6.10
9890156,9987103,3566,1248100,11235203,12.50
9890157,9979446,2905,1016750,10996196,10.19
9890158,9991787,3191,1116850,11108637,11.18
9890159,9997598,3795,1328250,11325848,13.29
9890160,9993440,4471,1564850,11558290,15.66
9890161,9984503,3613,1264550,11249053,12.67
9890162,9990776,4301,1505350,11496126,15.07
9890163,9999647,3866,1353100,11352747,13.53
9890164,9984651,3234,1131900,11116551,11.34
9890165,9135642,3454,1208900,10344542,13.23
9890166,9987771,4448,1556800,11544571,15.59
9890167,9969720,3477,1216950,11186670,12.21
9890168,9985769,3955,1384250,11370019,13.86
9890169,9963318,5324,1863400,11826718,18.70
9890170,9960579,4608,1612800,11573379,16.19
9890171,6138836,3851,1347850,7486686,21.96
9890172,9976840,4643,1625050,11601890,16.29
9890173,9975265,3077,1076950,11052215,10.80
9890174,9994088,4533,1586550,11580638,15.87
9890175,9974716,4767,1668450,11643166,16.73
9890176,9979535,3701,1295350,11274885,12.98
9890177,9989871,2836,992600,10982471,9.94
9890178,9979746,4251,1487850,11467596,14.91
9890179,9998224,3523,1233050,11231274,12.33
9890180,9989472,3387,1185450,11174922,11.87
9890181,5554912,2704,946400,6501312,17.04
9890182,6355990,6511,2278850,8634840,35.85
9890183,9970019,3589,1256150,11226169,12.60
9890184,9965669,4513,1579550,11545219,15.85
9890185,9952933,7082,2478700,12431633,24.90
9890186,9971065,4277,1496950,11468015,15.01
9890187,4565199,5698,1994300,6559499,43.68
9890188,9975002,6507,2277450,12252452,22.83
9890189,9975540,2630,920500,10896040,9.23
9890190,9983016,2501,875350,10858366,8.77
9890191,9976991,4909,1718150,11695141,17.22
9890192,3351610,1462,511700,3863310,15.27
9890193,9960651,3321,1162350,11123001,11.67
9890195,9935760,4894,1712900,11648660,17.24
9890196,9856340,4012,1404200,11260540,14.25
9890197,9951748,5028,1759800,11711548,17.68
9890198,9941692,3674,1285900,11227592,12.93
9890199,9959172,5181,1813350,11772522,18.21
9890200,9954185,3401,1190350,11144535,11.96
9890201,9454798,3199,1119650,10574448,11.84
9890202,9973605,3138,1098300,11071905,11.01
9890203,7094458,2658,930300,8024758,13.11
9890204,9969299,4646,1626100,11595399,16.31
9890205,9972403,2932,1026200,10998603,10.29
9890206,9975762,3573,1250550,11226312,12.54
9890207,9973523,4257,1489950,11463473,14.94
9890208,9982821,2479,867650,10850471,8.69
9890209,3246966,524,183400,3430366,5.65
9890210,9975104,3057,1069950,11045054,10.73
9890211,4898689,2156,754600,5653289,15.40
9890212,9977105,2461,861350,10838455,8.63
9890213,9993851,5027,1759450,11753301,17.61
9890214,9974636,3929,1375150,11349786,13.79
9890215,9969069,1474,515900,10484969,5.18
9890216,9961114,2102,735700,10696814,7.39
9890217,9977859,3430,1200500,11178359,12.03
9890218,9962173,3819,1336650,11298823,13.42
9890219,9984863,2825,988750,10973613,9.90
9890220,9974717,3579,1252650,11227367,12.56
9890221,9954391,5638,1973300,11927691,19.82
9890222,9963481,1375,481250,10444731,4.83
9890223,9964489,3339,1168650,11133139,11.73
9890224,9968542,1525,533750,10502292,5.35
9890225,2989862,980,343000,3332862,11.47
9890226,5442946,3204,1121400,6564346,20.60
9890227,9937938,4753,1663550,11601488,16.74
9890228,9961882,2891,1011850,10973732,10.16
9890229,9967390,971,339850,10307240,3.41
9890230,9552137,2249,787150,10339287,8.24
9890231,5601993,2335,817250,6419243,14.59
9890232,9953692,4868,1703800,11657492,17.12
9890233,9972574,3785,1324750,11297324,13.28
9890234,9967974,6581,2303350,12271324,23.11
9890235,9986879,3681,1288350,11275229,12.90
9890236,9995832,5204,1821400,11817232,18.22
9890237,9995177,4632,1621200,11616377,16.22
9890238,3835264,3075,1076250,4911514,28.06
9890239,9966893,5565,1947750,11914643,19.54
9890240,9973124,2063,722050,10695174,7.24
9890241,9988591,3558,1245300,11233891,12.47
9890242,9985469,3293,1152550,11138019,11.54
9890243,9987402,4178,1462300,11449702,14.64
9890244,9405769,5023,1758050,11163819,18.69
9890245,9996897,2485,869750,10866647,8.70
9890246,9957684,2489,871150,10828834,8.75
9890247,9980223,2926,1024100,11004323,10.26
9890248,9988022,2960,1036000,11024022,10.37
9890249,9979585,4056,1419600,11399185,14.23
9890250,9997092,3558,1245300,11242392,12.46
9890251,9987404,4390,1536500,11523904,15.38
9890252,9984211,1150,402500,10386711,4.03
9890253,9965387,2353,823550,10788937,8.26
9890254,9978274,3453,1208550,11186824,12.11
9890255,9984197,4064,1422400,11406597,14.25
9890256,9997182,4614,1614900,11612082,16.15
9890257,1649432,359,125650,1775082,7.62
9890258,9976767,4279,1497650,11474417,15.01
9890259,9963598,5413,1894550,11858148,19.01
9890260,9970973,6162,2156700,12127673,21.63
9890261,6897700,2982,1043700,7941400,15.13
9890262,9966572,2885,1009750,10976322,10.13
9890263,9951894,2494,872900,10824794,8.77
9890264,9958803,4959,1735650,11694453,17.43
9890265,9948193,6064,2122400,12070593,21.33
9890267,9933765,2955,1034250,10968015,10.41
9890268,9937626,3212,1124200,11061826,11.31
9890269,9941471,1801,630350,10571821,6.34
9890270,9946785,5431,1900850,11847635,19.11
9890271,9961701,2162,756700,10718401,7.60
9890272,9959907,3166,1108100,11068007,11.13
9890273,9976676,3104,1086400,11063076,10.89
9890274,9978479,3603,1261050,11239529,12.64
9890275,9982045,3005,1051750,11033795,10.54
9890276,9970245,2307,807450,10777695,8.10
9890277,9995642,4043,1415050,11410692,14.16
9890278,9976842,1837,642950,10619792,6.44
9890279,9997123,3461,1211350,11208473,12.12
9890280,9988487,4008,1402800,11391287,14.04
9890281,9971621,3177,1111950,11083571,11.15
9890282,9456305,3535,1237250,10693555,13.08
9890283,9968290,4846,1696100,11664390,17.01
9890285,9965547,5537,1937950,11903497,19.45
9890286,9973921,5312,1859200,11833121,18.64
9890287,9965590,3579,1252650,11218240,12.57
9890288,9970965,3371,1179850,11150815,11.83
9890289,9981834,3630,1270500,11252334,12.73
9890290,5906126,2283,799050,6705176,13.53
9890291,9989876,4138,1448300,11438176,14.50
9890292,9983146,6393,2237550,12220696,22.41
9890293,9992014,4791,1676850,11668864,16.78
9890294,9987392,2728,954800,10942192,9.56
9890295,9981645,4519,1581650,11563295,15.85
9890297,9965445,4915,1720250,11685695,17.26
9890298,9969289,5112,1789200,11758489,17.95
9890299,9984081,1744,610400,10594481,6.11
9890300,9979833,2535,887250,10867083,8.89
9890301,9977379,3630,1270500,11247879,12.73
9890302,9995577,3763,1317050,11312627,13.18
9890303,7689740,2514,879900,8569640,11.44
9890304,9983418,2477,866950,10850368,8.68
9890305,9980979,1889,661150,10642129,6.62
9890306,9972751,1833,641550,10614301,6.43
9890309,9979272,3295,1153250,11132522,11.56
9890310,7005993,2377,831950,7837943,11.87
9890311,9959967,3816,1335600,11295567,13.41
9890313,9957095,2754,963900,10920995,9.68
9890314,9948755,2297,803950,10752705,8.08
9890315,9945893,5006,1752100,11697993,17.62
9890316,9939800,4433,1551550,11491350,15.61
9890317,2570884,765,267750,2838634,10.41
9890318,9912288,3859,1350650,11262938,13.63
9890319,3675350,2288,800800,4476150,21.79
9890320,9933857,1921,672350,10606207,6.77
9890321,9924918,1002,350700,10275618,3.53
9890322,9941112,3629,1270150,11211262,12.78
9890323,9914073,3011,1053850,10967923,10.63
9890325,9929951,3467,1213450,11143401,12.22
9890326,9953548,2841,994350,10947898,9.99
9890327,9957215,2615,915250,10872465,9.19
9890328,9968886,2950,1032500,11001386,10.36
9890329,9952029,4597,1608950,11560979,16.17
9890330,9947507,1821,637350,10584857,6.41
9890331,9956619,2232,781200,10737819,7.85
9890332,9977045,2795,978250,10955295,9.81
9890333,9979043,5662,1981700,11960743,19.86
9890335,9907030,3399,1189650,11096680,12.01
9890336,9906058,3418,1196300,11102358,12.08
9890337,1031170,328,114800,1145970,11.13
9890338,9976241,2834,991900,10968141,9.94
9890339,9978513,3064,1072400,11050913,10.75
9890340,9983306,2549,892150,10875456,8.94
9890341,9969147,5606,1962100,11931247,19.68
9890342,9968716,2184,764400,10733116,7.67
9890343,9987756,5132,1796200,11783956,17.98
9890344,9988353,3249,1137150,11125503,11.38
9890345,9990128,4331,1515850,11505978,15.17
9890346,9987663,5505,1926750,11914413,19.29
9890347,9984267,2251,787850,10772117,7.89
9890348,9970894,5339,1868650,11839544,18.74
9890349,9960451,2198,769300,10729751,7.72
9890350,9964845,1859,650650,10615495,6.53
9890351,67406,42,14700,82106,21.81
9890353,9826797,3134,1096900,10923697,11.16
9890354,9873444,2873,1005550,10878994,10.18
9890355,9925679,4188,1465800,11391479,14.77
9890356,9942118,2598,909300,10851418,9.15
9890358,9954158,5041,1764350,11718508,17.72
9890359,9949421,4442,1554700,11504121,15.63
9890360,9933181,5520,1932000,11865181,19.45
9890361,9948062,3377,1181950,11130012,11.88
9890362,9719069,4916,1720600,11439669,17.70
9890363,9974707,2290,801500,10776207,8.04
9890364,9976241,5185,1814750,11790991,18.19
9890365,5361420,2233,781550,6142970,14.58
9890366,9976635,5257,1839950,11816585,18.44
9890367,9990107,3161,1106350,11096457,11.07
9890368,9982631,4364,1527400,11510031,15.30
9890369,9985618,3142,1099700,11085318,11.01
9890370,9986122,4235,1482250,11468372,14.84
9890371,9999144,5688,1990800,11989944,19.91
9890372,9922584,3527,1234450,11157034,12.44
9890374,9989021,6288,2200800,12189821,22.03
9890375,4162629,1601,560350,4722979,13.46
9890376,9993264,3354,1173900,11167164,11.75
9890377,9966594,3314,1159900,11126494,11.64
9890378,9987565,3657,1279950,11267515,12.82
9890379,9982387,2101,735350,10717737,7.37
9890380,9974631,2611,913850,10888481,9.16
9890381,9965477,3844,1345400,11310877,13.50
9890382,6276092,3044,1065400,7341492,16.98
9890383,3672686,941,329350,4002036,8.97
9890384,9953327,2512,879200,10832527,8.83
9890385,9935821,3848,1346800,11282621,13.55
9890386,3776481,2556,894600,4671081,23.69
9890387,9956742,4394,1537900,11494642,15.45
9890389,9976415,2607,912450,10888865,9.15
9890390,9942439,2637,922950,10865389,9.28
9890391,9959173,3966,1388100,11347273,13.94
9890392,9985896,3940,1379000,11364896,13.81
9890393,9992706,1506,527100,10519806,5.27
9890394,9988001,2676,936600,10924601,9.38
9890395,9982256,3339,1168650,11150906,11.71
9890396,9991033,3006,1052100,11043133,10.53
9890397,9983701,4717,1650950,11634651,16.54
9890398,9966863,3992,1397200,11364063,14.02
9890399,9977548,5965,2087750,12065298,20.92
9890400,5079145,2561,896350,5975495,17.65
9890401,9995853,2856,999600,10995453,10.00
9890402,9970718,2252,788200,10758918,7.91
9890403,4963304,1523,533050,5496354,10.74
9890404,9957194,4547,1591450,11548644,15.98
9890405,9936695,3347,1171450,11108145,11.79
9890406,9962312,3915,1370250,11332562,13.75
9890407,8175241,1253,438550,8613791,5.36
9890408,9994443,3880,1358000,11352443,13.59
9890409,9982195,4496,1573600,11555795,15.76
9890410,9966296,4494,1572900,11539196,15.78
9890411,8414404,4493,1572550,9986954,18.69
9890412,3543503,1069,374150,3917653,10.56
9890413,9983876,4070,1424500,11408376,14.27
9890414,5651852,2037,712950,6364802,12.61
9890415,9993681,4002,1400700,11394381,14.02
9890416,9980789,2997,1048950,11029739,10.51
9890417,9979721,2075,726250,10705971,7.28
9890418,5301977,1656,579600,5881577,10.93
9890419,9984040,3907,1367450,11351490,13.70
9890421,9967957,1980,693000,10660957,6.95
9890422,9915587,3370,1179500,11095087,11.90
9890423,9969536,1537,537950,10507486,5.40
9890424,9985651,2334,816900,10802551,8.18
9890425,1538468,1209,423150,1961618,27.50
9890426,9976782,4672,1635200,11611982,16.39
9890427,9964880,5510,1928500,11893380,19.35
9890428,9970297,3860,1351000,11321297,13.55
9890429,9970854,3938,1378300,11349154,13.82
9890430,9989057,3803,1331050,11320107,13.33
9890431,9970777,1057,369950,10340727,3.71
9890432,9966844,2270,794500,10761344,7.97
9890433,9973068,2897,1013950,10987018,10.17
9890434,9959575,4442,1554700,11514275,15.61
9890435,9958657,1557,544950,10503607,5.47
9890436,9975161,2900,1015000,10990161,10.18
9890437,9970954,3285,1149750,11120704,11.53
9890438,9955081,1197,418950,10374031,4.21
9890439,9952135,2893,1012550,10964685,10.17
9890440,9981309,4080,1428000,11409309,14.31
9890441,9979344,3837,1342950,11322294,13.46
9890442,5290912,2220,777000,6067912,14.69
9890443,652382,202,70700,723082,10.84
9890444,9970545,4604,1611400,11581945,16.16
9890445,9989153,4867,1703450,11692603,17.05
9890446,9998160,7678,2687300,12685460,26.88
9890447,9984271,3406,1192100,11176371,11.94
9890448,9994794,2323,813050,10807844,8.13
9890449,9984648,4426,1549100,11533748,15.51
9890450,9984493,2248,786800,10771293,7.88
9890452,9996825,3678,1287300,11284125,12.88
9890453,9979887,6033,2111550,12091437,21.16
9890454,9986065,4543,1590050,11576115,15.92
9890455,9989462,4639,1623650,11613112,16.25
9890456,9993838,4133,1446550,11440388,14.47
9890457,9480366,3409,1193150,10673516,12.59
9890458,9979046,4100,1435000,11414046,14.38
9890459,5655566,2368,828800,6484366,14.65
9890460,9994298,3869,1354150,11348448,13.55
9890461,9976892,4418,1546300,11523192,15.50
9890462,9972294,2734,956900,10929194,9.60
9890463,1140428,782,273700,1414128,24.00
9890464,3984499,1186,415100,4399599,10.42
9890465,9945961,3375,1181250,11127211,11.88
9890466,9947746,1393,487550,10435296,4.90
9890467,9966703,3455,1209250,11175953,12.13
9890468,9968728,3427,1199450,11168178,12.03
9890469,9982956,3499,1224650,11207606,12.27
9890470,2164501,589,206150,2370651,9.52
9890471,9973280,2604,911400,10884680,9.14
9890472,9991853,1766,618100,10609953,6.19
9890473,9983820,3751,1312850,11296670,13.15
9890474,9977360,1604,561400,10538760,5.63
9890475,9997413,1885,659750,10657163,6.60
9890476,9978911,2210,773500,10752411,7.75
9890477,9963008,3642,1274700,11237708,12.79
9890479,9990261,3488,1220800,11211061,12.22
9890480,9826192,2930,1025500,10851692,10.44
9890481,937040,900,315000,1252040,33.62
9890483,9983843,3834,1341900,11325743,13.44
9890484,9980107,4013,1404550,11384657,14.07
9890485,9973333,2988,1045800,11019133,10.49
9890486,2299832,1364,477400,2777232,20.76
9890487,371436,208,72800,444236,19.60
9890488,9940165,3782,1323700,11263865,13.32
9890489,9965241,1978,692300,10657541,6.95
9890490,9953031,3617,1265950,11218981,12.72
9890491,9945238,4877,1706950,11652188,17.16
9890492,9957133,3085,1079750,11036883,10.84
9890493,9952845,5362,1876700,11829545,18.86
9890494,9956026,5472,1915200,11871226,19.24
9890495,2478661,2392,837200,3315861,33.78
9890496,9930372,3290,1151500,11081872,11.60
9890497,9935396,3148,1101800,11037196,11.09
9890498,9944695,2882,1008700,10953395,10.14
9890499,9941657,1747,611450,10553107,6.15
9890500,9945707,3425,1198750,11144457,12.05
9890501,9964732,3249,1137150,11101882,11.41
9890502,9973126,3337,1167950,11141076,11.71
9890503,6554912,792,277200,6832112,4.23
9890504,9944467,4414,1544900,11489367,15.54
9890505,9948896,3630,1270500,11219396,12.77
9890506,7532839,3349,1172150,8704989,15.56
9890507,9969424,4053,1418550,11387974,14.23
9890508,9985910,3808,1332800,11318710,13.35
9890509,9974473,3772,1320200,11294673,13.24
9890510,9874511,2345,820750,10695261,8.31
9890511,9987068,2605,911750,10898818,9.13
9890512,9996975,5660,1981000,11977975,19.82
9890513,9978376,3892,1362200,11340576,13.65
9890514,9991854,3192,1117200,11109054,11.18
9890515,9980130,3965,1387750,11367880,13.91
9890516,9984135,3196,1118600,11102735,11.20
9890517,2556015,983,344050,2900065,13.46
9890518,9965925,3723,1303050,11268975,13.08
9890519,9955990,3836,1342600,11298590,13.49
9890520,9941885,2931,1025850,10967735,10.32
9890522,9931669,4982,1743700,11675369,17.56
9890523,9952042,3778,1322300,11274342,13.29
9890524,9950019,2655,929250,10879269,9.34
9890525,9955473,5054,1768900,11724373,17.77
9890526,9964579,2463,862050,10826629,8.65
9890527,9978835,4712,1649200,11628035,16.53
9890528,9986015,3389,1186150,11172165,11.88
9890529,9985997,4111,1438850,11424847,14.41
9890530,9994326,2535,887250,10881576,8.88
9890531,9983410,3685,1289750,11273160,12.92
9890532,9986020,6357,2224950,12210970,22.28
9890533,9975670,6324,2213400,12189070,22.19
9890534,9985918,3935,1377250,11363168,13.79
9890535,1223661,1334,466900,1690561,38.16
9890536,9980435,3684,1289400,11269835,12.92
9890537,9991838,3209,1123150,11114988,11.24
9890538,9996708,3306,1157100,11153808,11.57
9890539,6771995,1830,640500,7412495,9.46
9890540,1679414,1190,416500,2095914,24.80
9890541,9997758,4926,1724100,11721858,17.24
9890542,2953279,835,292250,3245529,9.90
9890543,9969283,1573,550550,10519833,5.52
9890544,9980045,3207,1122450,11102495,11.25
9890545,9944023,3438,1203300,11147323,12.10
9890546,9983310,3020,1057000,11040310,10.59
9890547,9977582,3773,1320550,11298132,13.24
9890548,9991861,4561,1596350,11588211,15.98
9890549,9999500,2135,747250,10746750,7.47
9890550,7756557,2053,718550,8475107,9.26
9890551,9992578,4148,1451800,11444378,14.53
9890552,9685156,1146,401100,10086256,4.14
9890553,9962344,5656,1979600,11941944,19.87
9890554,9811525,2066,723100,10534625,7.37
9890555,9972015,3815,1335250,11307265,13.39
9890556,9989437,3606,1262100,11251537,12.63
9890557,9976861,4063,1422050,11398911,14.25
9890558,1404045,977,341950,1745995,24.35
9890559,9942993,4482,1568700,11511693,15.78
9890560,9962099,2953,1033550,10995649,10.37
9890561,9972185,1958,685300,10657485,6.87
9890562,9975044,988,345800,10320844,3.47
9890563,9978148,666,233100,10211248,2.34
9890564,9960568,3111,1088850,11049418,10.93
9890565,9959533,3678,1287300,11246833,12.93
9890566,9970329,4426,1549100,11519429,15.54
9890567,9976569,3564,1247400,11223969,12.50
9890568,2675096,1009,353150,3028246,13.20
9890569,9948373,3475,1216250,11164623,12.23
9890570,9559831,4640,1624000,11183831,16.99
9890571,9660514,5783,2024050,11684564,20.95
9890572,9952389,2069,724150,10676539,7.28
9890573,9974964,3959,1385650,11360614,13.89
9890574,9964808,5613,1964550,11929358,19.71
9890575,9977268,4700,1645000,11622268,16.49
9890576,5458099,2704,946400,6404499,17.34
9890577,9967881,3125,1093750,11061631,10.97
9890578,9944284,5072,1775200,11719484,17.85
9890579,5660651,1441,504350,6165001,8.91
9890580,9957204,2979,1042650,10999854,10.47
9890581,9958974,2995,1048250,11007224,10.53
9890582,9964203,4454,1558900,11523103,15.65
9890583,9969959,2041,714350,10684309,7.17
9890584,8640717,1047,366450,9007167,4.24
9890585,9946523,2597,908950,10855473,9.14
9890586,9939557,4238,1483300,11422857,14.92
9890587,9954994,1805,631750,10586744,6.35
9890588,9956866,3852,1348200,11305066,13.54
9890589,9947604,4033,1411550,11359154,14.19
9890590,9961023,3364,1177400,11138423,11.82
9890591,2576653,917,320950,2897603,12.46
9890592,9942203,2077,726950,10669153,7.31
9890593,9962396,4168,1458800,11421196,14.64
9890594,9966134,3043,1065050,11031184,10.69
9890595,9958045,2683,939050,10897095,9.43
9890596,9980653,5770,2019500,12000153,20.23
9890597,9965410,3300,1155000,11120410,11.59
9890598,9978859,5411,1893850,11872709,18.98
9890599,9986587,4495,1573250,11559837,15.75
9890600,9974091,4655,1629250,11603341,16.33
9890601,9985092,2802,980700,10965792,9.82
9890602,9995224,3428,1199800,11195024,12.00
9890603,9983411,2409,843150,10826561,8.45
9890604,9974026,3956,1384600,11358626,13.88
9890605,9959645,5726,2004100,11963745,20.12
9890606,9976425,4126,1444100,11420525,14.48
9890607,9975446,6428,2249800,12225246,22.55
9890608,9999352,5046,1766100,11765452,17.66
9890609,9984593,4777,1671950,11656543,16.75
9890610,9967286,2497,873950,10841236,8.77
9890612,9950625,1968,688800,10639425,6.92
9890613,9958245,4371,1529850,11488095,15.36
9890614,9969586,5428,1899800,11869386,19.06
9890615,9962928,4504,1576400,11539328,15.82
9890616,9959594,1978,692300,10651894,6.95
9890617,9958341,3654,1278900,11237241,12.84
9890618,9955123,4079,1427650,11382773,14.34
9890619,9946887,3463,1212050,11158937,12.19
9890620,9974683,5244,1835400,11810083,18.40
9890621,9976196,5805,2031750,12007946,20.37
9890622,9957514,5643,1975050,11932564,19.83
9890623,9987792,5320,1862000,11849792,18.64
9890624,9982891,3909,1368150,11351041,13.70
9890625,9973220,2831,990850,10964070,9.94
9890626,9946261,5626,1969100,11915361,19.80
9890627,9962281,4258,1490300,11452581,14.96
9890628,9967786,2870,1004500,10972286,10.08
9890629,4966983,1636,572600,5539583,11.53
9890630,9972276,1791,626850,10599126,6.29
9890631,9954806,5265,1842750,11797556,18.51
9890632,9962560,4545,1590750,11553310,15.97
9890633,9965884,4172,1460200,11426084,14.65
9890634,9991861,3374,1180900,11172761,11.82
9890635,9964536,3839,1343650,11308186,13.48
9890636,9974308,2746,961100,10935408,9.64
9890637,9967383,3874,1355900,11323283,13.60
9890638,9966084,3091,1081850,11047934,10.86
9890639,9664364,3650,1277500,10941864,13.22
9890640,9961735,3547,1241450,11203185,12.46
9890641,9942857,4095,1433250,11376107,14.41
9890642,9938119,3543,1240050,11178169,12.48
9890643,9685880,4110,1438500,11124380,14.85
9890644,9680826,3288,1150800,10831626,11.89
9890645,9941848,4051,1417850,11359698,14.26
9890646,9950215,2740,959000,10909215,9.64
9890648,9950156,6461,2261350,12211506,22.73
9890649,9927045,1541,539350,10466395,5.43
9890650,9938210,5235,1832250,11770460,18.44
9890651,9951230,4716,1650600,11601830,16.59
9890652,9946483,4018,1406300,11352783,14.14
9890653,9943434,4028,1409800,11353234,14.18
9890654,5442217,2468,863800,6306017,15.87
9890655,9940875,4764,1667400,11608275,16.77
9890656,9952382,4013,1404550,11356932,14.11
9890657,9930335,1797,628950,10559285,6.33
9890658,9951232,2791,976850,10928082,9.82
9890659,9950805,4482,1568700,11519505,15.76
9890660,9921565,3281,1148350,11069915,11.57
9890661,9943988,2777,971950,10915938,9.77
9890662,9943688,3229,1130150,11073838,11.37
9890663,9949650,4040,1414000,11363650,14.21
9890664,9957962,2713,949550,10907512,9.54
9890665,9969335,4715,1650250,11619585,16.55
9890666,9942684,3443,1205050,11147734,12.12
9890667,9961802,3280,1148000,11109802,11.52
9890668,9970230,2788,975800,10946030,9.79
9890669,9981777,3006,1052100,11033877,10.54
9890670,9985329,2226,779100,10764429,7.80
9890671,9984622,2541,889350,10873972,8.91
9890672,9978202,4904,1716400,11694602,17.20
9890673,9983898,4044,1415400,11399298,14.18
9890674,9980779,2982,1043700,11024479,10.46
9890675,9979139,5067,1773450,11752589,17.77
9890676,9987990,5148,1801800,11789790,18.04
9890677,9998486,4033,1411550,11410036,14.12
9890678,1776522,857,299950,2076472,16.88
9890679,9977222,2742,959700,10936922,9.62
9890680,9972509,3029,1060150,11032659,10.63
9890681,9978694,5948,2081800,12060494,20.86
9890682,9989306,3418,1196300,11185606,11.98
9890683,9990126,5233,1831550,11821676,18.33
9890685,9998499,3912,1369200,11367699,13.69
9890686,9977672,4972,1740200,11717872,17.44
9890687,9992880,5952,2083200,12076080,20.85
9890688,9976219,2604,911400,10887619,9.14
9890689,9986594,1815,635250,10621844,6.36
9890690,9975200,5288,1850800,11826000,18.55
9890691,9981881,3233,1131550,11113431,11.34
9890692,4871893,992,347200,5219093,7.13
9890693,9928902,3185,1114750,11043652,11.23
9890694,9913360,2696,943600,10856960,9.52
9890695,9546275,4253,1488550,11034825,15.59
9890696,9968422,4284,1499400,11467822,15.04
9890697,9982926,5071,1774850,11757776,17.78
9890698,5287511,1931,675850,5963361,12.78
9890699,9969322,2755,964250,10933572,9.67
9890700,9956459,5661,1981350,11937809,19.90
9890701,9952492,3172,1110200,11062692,11.15
9890702,9934200,5298,1854300,11788500,18.67
9890703,9960914,3698,1294300,11255214,12.99
9890704,9947372,4313,1509550,11456922,15.18
9890705,9954045,6442,2254700,12208745,22.65
9890706,2840092,521,182350,3022442,6.42
9890707,9941707,4433,1551550,11493257,15.61
9890708,9940482,5376,1881600,11822082,18.93
9890709,9945923,3004,1051400,10997323,10.57
9890710,9963956,4477,1566950,11530906,15.73
9890711,9969178,2236,782600,10751778,7.85
9890712,9979664,2653,928550,10908214,9.30
9890713,9956570,4079,1427650,11384220,14.34
9890714,9989148,3178,1112300,11101448,11.14
9890715,9999224,2079,727650,10726874,7.28
9890716,9983863,5993,2097550,12081413,21.01
9890717,9993179,4539,1588650,11581829,15.90
9890718,9981109,1818,636300,10617409,6.38
9890719,9985587,4481,1568350,11553937,15.71
9890720,9991213,5363,1877050,11868263,18.79
9890721,9991299,5605,1961750,11953049,19.63
9890722,1775170,1856,649600,2424770,36.59
9890723,792914,710,248500,1041414,31.34
9890724,834469,176,61600,896069,7.38
9890725,9993867,3755,1314250,11308117,13.15
9890726,9978326,3328,1164800,11143126,11.67
9890727,9991218,4882,1708700,11699918,17.10
9890728,9979168,2994,1047900,11027068,10.50
9890729,9986049,2685,939750,10925799,9.41
9890730,9991419,3455,1209250,11200669,12.10
9890731,5804839,1277,446950,6251789,7.70
9890732,9982370,4157,1454950,11437320,14.58
9890733,3381946,2256,789600,4171546,23.35
9890734,9975357,5650,1977500,11952857,19.82
9890735,5132261,2972,1040200,6172461,20.27
9890736,9124676,4423,1548050,10672726,16.97
9890737,9989027,3939,1378650,11367677,13.80
9890738,9993209,3809,1333150,11326359,13.34
9890739,9986530,4189,1466150,11452680,14.68
9890740,9988240,3040,1064000,11052240,10.65
9890741,7429125,2737,957950,8387075,12.89
9890742,7447124,3350,1172500,8619624,15.74
9890743,9988229,6303,2206050,12194279,22.09
9890744,9999273,3269,1144150,11143423,11.44
9890745,9992197,6199,2169650,12161847,21.71
9890746,9998281,4507,1577450,11575731,15.78
9890747,9985055,3002,1050700,11035755,10.52
9890748,9986733,3331,1165850,11152583,11.67
9890749,4072049,185,64750,4136799,1.59
9890750,9771463,2700,945000,10716463,9.67
9890751,9969469,2856,999600,10969069,10.03
9890752,9978597,5215,1825250,11803847,18.29
9890753,9980046,3095,1083250,11063296,10.85
9890754,9985349,1002,350700,10336049,3.51
9890755,9974948,5424,1898400,11873348,19.03
9890756,9985226,3867,1353450,11338676,13.55
9890757,9996922,4002,1400700,11397622,14.01
9890758,9974663,3125,1093750,11068413,10.97
9890759,9994330,3407,1192450,11186780,11.93
9890760,9988224,2478,867300,10855524,8.68
9890761,9983543,3036,1062600,11046143,10.64
9890762,9972276,4650,1627500,11599776,16.32
9890763,9964298,3363,1177050,11141348,11.81
9890764,9970232,5263,1842050,11812282,18.48
9890765,9681468,1578,552300,10233768,5.70
9890766,2052994,533,186550,2239544,9.09
9890767,9982810,1057,369950,10352760,3.71
9890768,9957629,3752,1313200,11270829,13.19
9890769,5717790,3228,1129800,6847590,19.76
9890770,9984737,2063,722050,10706787,7.23
9890771,9979849,4146,1451100,11430949,14.54
9890772,9971331,3292,1152200,11123531,11.56
9890773,9972529,2208,772800,10745329,7.75
9890774,2768975,1538,538300,3307275,19.44
9890775,4617790,1091,381850,4999640,8.27
9890776,9959879,3569,1249150,11209029,12.54
9890777,9970384,2986,1045100,11015484,10.48
9890778,9971088,3332,1166200,11137288,11.70
9890779,1123866,369,129150,1253016,11.49
9890780,9991004,2180,763000,10754004,7.64
9890781,9979586,3077,1076950,11056536,10.79
9890782,9973274,2951,1032850,11006124,10.36
9890783,9980735,2327,814450,10795185,8.16
9890784,9996600,5185,1814750,11811350,18.15
9890785,9984957,635,222250,10207207,2.23
9890786,9981248,2991,1046850,11028098,10.49
9890787,2495171,413,144550,2639721,5.79
9890788,9969547,2912,1019200,10988747,10.22
9890789,9958081,4037,1412950,11371031,14.19
9890790,9932178,3006,1052100,10984278,10.59
9890791,9935797,3661,1281350,11217147,12.90
9890792,9982039,2811,983850,10965889,9.86
9890793,8363709,2939,1028650,9392359,12.30
9890794,9964452,2910,1018500,10982952,10.22
9890795,9966984,3308,1157800,11124784,11.62
9890796,3256059,2940,1029000,4285059,31.60
9890797,9983920,4674,1635900,11619820,16.39
9890798,9993923,3151,1102850,11096773,11.04
9890799,9992068,4334,1516900,11508968,15.18
9890800,9985896,3790,1326500,11312396,13.28
9890801,9992148,2086,730100,10722248,7.31
9890802,9984253,3508,1227800,11212053,12.30
9890803,9988159,1967,688450,10676609,6.89
9890804,9977422,4029,1410150,11387572,14.13
9890805,6162149,3449,1207150,7369299,19.59
9890806,1783517,801,280350,2063867,15.72
9890807,3681451,2110,738500,4419951,20.06
9890808,4371139,1329,465150,4836289,10.64
9890809,9987049,2106,737100,10724149,7.38
9890810,9553784,3141,1099350,10653134,11.51
9890811,9998687,4165,1457750,11456437,14.58
9890812,9979285,2010,703500,10682785,7.05
9890813,9984858,5492,1922200,11907058,19.25
9890814,9972596,1778,622300,10594896,6.24
9890815,9982690,3256,1139600,11122290,11.42
9890816,9992152,3618,1266300,11258452,12.67
9890817,9994281,3565,1247750,11242031,12.48
9890818,9975745,3323,1163050,11138795,11.66
9890819,9991124,5012,1754200,11745324,17.56
9890820,9994513,3263,1142050,11136563,11.43
9890821,9974413,2587,905450,10879863,9.08
9890822,9976676,2685,939750,10916426,9.42
9890823,9984967,5059,1770650,11755617,17.73
9890825,9975340,4199,1469650,11444990,14.73
9890826,9973291,3842,1344700,11317991,13.48
9890827,9480608,3199,1119650,10600258,11.81
9890828,9981740,4397,1538950,11520690,15.42
9890829,9976582,3726,1304100,11280682,13.07
9890830,5052115,1886,660100,5712215,13.07
9890831,9986286,3656,1279600,11265886,12.81
9890832,9976961,3873,1355550,11332511,13.59
9890833,9968808,3591,1256850,11225658,12.61
9890834,2563261,870,304500,2867761,11.88
9890835,9982138,2498,874300,10856438,8.76
9890836,9981489,4815,1685250,11666739,16.88
9890837,8385900,2467,863450,9249350,10.30
9890838,9995714,3567,1248450,11244164,12.49
9890839,9988221,1370,479500,10467721,4.80
9890840,9985994,3323,1163050,11149044,11.65
9890841,1625938,635,222250,1848188,13.67
9890842,9954000,3504,1226400,11180400,12.32
9890843,9985224,1092,382200,10367424,3.83
9890845,9971030,4815,1685250,11656280,16.90
9890846,9982689,4608,1612800,11595489,16.16
9890847,9981043,3468,1213800,11194843,12.16
9890848,9979018,1266,443100,10422118,4.44
9890849,9995281,3332,1166200,11161481,11.67
9890850,9975171,3980,1393000,11368171,13.96
9890851,9974755,1116,390600,10365355,3.92
9890852,815603,373,130550,946153,16.01
9890853,9970495,2997,1048950,11019445,10.52
9890854,9967133,3066,1073100,11040233,10.77
9890855,9970719,3342,1169700,11140419,11.73
9890856,9985929,4548,1591800,11577729,15.94
9890857,9983030,3072,1075200,11058230,10.77
9890858,9978884,3299,1154650,11133534,11.57
9890859,2127448,820,287000,2414448,13.49
9890860,9956600,3249,1137150,11093750,11.42
9890861,9979946,3363,1177050,11156996,11.79
9890862,9957123,2570,899500,10856623,9.03
9890864,9967565,3896,1363600,11331165,13.68
9890865,9966179,3842,1344700,11310879,13.49
9890866,3187833,1880,658000,3845833,20.64
9890867,9960717,4346,1521100,11481817,15.27
9890868,9974887,4382,1533700,11508587,15.38
9890869,9994860,1036,362600,10357460,3.63
9890870,9999493,4822,1687700,11687193,16.88
9890871,9980023,5455,1909250,11889273,19.13
9890873,9984814,3286,1150100,11134914,11.52
9890874,1550307,854,298900,1849207,19.28
9890875,2330742,1098,384300,2715042,16.49
9890876,8956956,4934,1726900,10683856,19.28
9890877,9976740,3385,1184750,11161490,11.88
9890878,9971937,4086,1430100,11402037,14.34
9890879,9963806,3751,1312850,11276656,13.18
9890880,9982264,3037,1062950,11045214,10.65
9890881,9983814,3473,1215550,11199364,12.18
9890882,9989794,3477,1216950,11206744,12.18
9890883,9987939,2835,992250,10980189,9.93
9890884,7051867,2163,757050,7808917,10.74
9890885,9984435,1995,698250,10682685,6.99
9890886,9976887,5267,1843450,11820337,18.48
9890887,9938635,6092,2132200,12070835,21.45
9890888,9993125,1959,685650,10678775,6.86
9890889,9999216,6358,2225300,12224516,22.25
9890891,9969211,3737,1307950,11277161,13.12
9890892,9983592,4643,1625050,11608642,16.28
9890893,9976812,3889,1361150,11337962,13.64
9890894,9974760,7013,2454550,12429310,24.61
9890895,9961455,4720,1652000,11613455,16.58
9890896,9972508,3675,1286250,11258758,12.90
9890897,9955929,4220,1477000,11432929,14.84
9890898,9974424,3091,1081850,11056274,10.85
9890899,9967087,4130,1445500,11412587,14.50
9890900,9976644,2381,833350,10809994,8.35
9890902,9989255,2143,750050,10739305,7.51
9890903,9977848,6292,2202200,12180048,22.07
9890904,5525427,963,337050,5862477,6.10
9890905,9961113,4573,1600550,11561663,16.07
9890906,9970359,4635,1622250,11592609,16.27
9890907,9984507,2328,814800,10799307,8.16
9890908,9988899,1128,394800,10383699,3.95
9890909,9986247,4963,1737050,11723297,17.39
9890910,9974575,2333,816550,10791125,8.19
9890911,9991676,585,204750,10196426,2.05
9890912,9986845,2527,884450,10871295,8.86
9890913,9988309,518,181300,10169609,1.82
9890914,9984527,2818,986300,10970827,9.88
9890915,1203029,368,128800,1331829,10.71
9890916,9999020,1270,444500,10443520,4.45
9890917,9994259,667,233450,10227709,2.34
9890918,9981845,3559,1245650,11227495,12.48
9890919,9963970,3412,1194200,11158170,11.99
9890920,9972762,4824,1688400,11661162,16.93
9890921,9486435,3327,1164450,10650885,12.27
9890922,1647872,547,191450,1839322,11.62
9890923,9990997,3875,1356250,11347247,13.57
9890924,9977868,1442,504700,10482568,5.06
9890925,9987275,4042,1414700,11401975,14.17
9890926,9986119,5612,1964200,11950319,19.67
9890927,9994734,2780,973000,10967734,9.74
9890928,3395475,1219,426650,3822125,12.57
9890930,5418904,3338,1168300,6587204,21.56
9890932,2658526,1067,373450,3031976,14.05
9890933,9987398,3643,1275050,11262448,12.77
9890934,9988843,4077,1426950,11415793,14.29
9890935,9997814,2594,907900,10905714,9.08
9890936,9998668,3693,1292550,11291218,12.93
9890937,9978158,7516,2630600,12608758,26.36
9890938,9992694,4792,1677200,11669894,16.78
9890939,9996497,2094,732900,10729397,7.33
9890940,9989021,5641,1974350,11963371,19.77
9890941,9992918,4655,1629250,11622168,16.30
9890942,9977871,3068,1073800,11051671,10.76
9890943,9969882,3956,1384600,11354482,13.89
9890944,9967770,4503,1576050,11543820,15.81
9890945,9034704,3388,1185800,10220504,13.12
9890946,4477201,2842,994700,5471901,22.22
9890947,9971947,2391,836850,10808797,8.39
9890948,9977336,5844,2045400,12022736,20.50
9890949,884879,353,123550,1008429,13.96
9890950,508752,432,151200,659952,29.72
9890951,4775011,926,324100,5099111,6.79
9890952,8948550,3129,1095150,10043700,12.24
9890954,9919198,2752,963200,10882398,9.71
9890956,608554,182,63700,672254,10.47
9890957,1567767,824,288400,1856167,18.40
9890958,8184238,3745,1310750,9494988,16.02
9890959,9951342,4021,1407350,11358692,14.14
9890960,9933299,2197,768950,10702249,7.74
9890961,9956314,3100,1085000,11041314,10.90
9890962,9948158,3650,1277500,11225658,12.84
9890963,4761319,262,91700,4853019,1.93
9890964,9929267,4805,1681750,11611017,16.94
9890965,9941818,2420,847000,10788818,8.52
9890966,9944516,4682,1638700,11583216,16.48
9890967,9941700,4546,1591100,11532800,16.00
9890968,9965238,3784,1324400,11289638,13.29
9890969,9976593,3639,1273650,11250243,12.77
9890970,9950677,1604,561400,10512077,5.64
9890971,9968542,1603,561050,10529592,5.63
9890972,9992575,1920,672000,10664575,6.72
9890973,9987689,1327,464450,10452139,4.65
9890974,9993589,2353,823550,10817139,8.24
9890975,9982270,3368,1178800,11161070,11.81
9890976,9990628,3126,1094100,11084728,10.95
9890977,9983887,3037,1062950,11046837,10.65
9890978,9995118,3650,1277500,11272618,12.78
9890979,9985655,2208,772800,10758455,7.74
9890980,9988500,2955,1034250,11022750,10.35
9890981,9971354,3152,1103200,11074554,11.06
9890982,9960941,1117,390950,10351891,3.92
9890983,9966808,3656,1279600,11246408,12.84
9890984,9964365,4296,1503600,11467965,15.09
9890985,9948456,3182,1113700,11062156,11.19
9890986,9968568,3695,1293250,11261818,12.97
9890987,9971883,3549,1242150,11214033,12.46
9890988,9972724,4803,1681050,11653774,16.86
9890989,9969337,2676,936600,10905937,9.39
9890990,9969221,3413,1194550,11163771,11.98
9890991,9956074,3345,1170750,11126824,11.76
9890992,7943707,2159,755650,8699357,9.51
9890993,9951165,4885,1709750,11660915,17.18
9890994,9963345,5009,1753150,11716495,17.60
9890995,343903,63,22050,365953,6.41
9890996,9955479,3776,1321600,11277079,13.28
9890997,9959030,1409,493150,10452180,4.95
9890998,9950778,2733,956550,10907328,9.61
9890999,1850799,884,309400,2160199,16.72
9891000,9953741,5409,1893150,11846891,19.02
9891001,9925010,1960,686000,10611010,6.91
9891002,9975384,3996,1398600,11373984,14.02
9891003,9976883,3157,1104950,11081833,11.08
9891004,9981747,3719,1301650,11283397,13.04
9891005,9985125,5892,2062200,12047325,20.65
9891006,9946523,3669,1284150,11230673,12.91
9891007,9173459,4075,1426250,10599709,15.55
9891008,9991783,4094,1432900,11424683,14.34
9891009,9984357,3312,1159200,11143557,11.61
9891010,9992099,2088,730800,10722899,7.31
9891011,9973027,4747,1661450,11634477,16.66
9891012,9962299,3728,1304800,11267099,13.10
9891013,9801369,3109,1088150,10889519,11.10
9891014,9986617,4428,1549800,11536417,15.52
9891015,9983235,2939,1028650,11011885,10.30
9891016,9982019,4261,1491350,11473369,14.94
9891017,9984701,1119,391650,10376351,3.92
9891018,9986090,3945,1380750,11366840,13.83
9891019,9488233,2049,717150,10205383,7.56
9891020,9989690,5647,1976450,11966140,19.78
9891021,9974186,5613,1964550,11938736,19.70
9891022,9998707,6263,2192050,12190757,21.92
9891023,3315417,3952,1383200,4698617,41.72
9891024,9969258,6216,2175600,12144858,21.82
9891025,9841780,2251,787850,10629630,8.01
9891026,9989944,3810,1333500,11323444,13.35
9891027,1306434,1371,479850,1786284,36.73
9891028,9978279,3402,1190700,11168979,11.93
9891029,9975563,3340,1169000,11144563,11.72
9891030,9981502,5035,1762250,11743752,17.66
9891031,9979078,4161,1456350,11435428,14.59
9891032,9975147,5752,2013200,11988347,20.18
9891033,2093935,930,325500,2419435,15.54
9891034,9961266,4217,1475950,11437216,14.82
9891035,9988753,3639,1273650,11262403,12.75
9891036,757863,320,112000,869863,14.78
9891037,9966127,5151,1802850,11768977,18.09
9891038,9959007,3185,1114750,11073757,11.19
9891039,9972648,1192,417200,10389848,4.18
9891040,9980564,1421,497350,10477914,4.98
9891041,9978832,1691,591850,10570682,5.93
9891042,9968334,893,312550,10280884,3.14
9891043,9976465,2220,777000,10753465,7.79
9891044,9978331,1789,626150,10604481,6.28
9891045,9987914,2553,893550,10881464,8.95
9891046,9984594,4362,1526700,11511294,15.29
9891047,9949607,4193,1467550,11417157,14.75
9891048,8981365,3453,1208550,10189915,13.46
9891049,9978873,6020,2107000,12085873,21.11
9891050,9996482,3273,1145550,11142032,11.46
9891051,8737536,3778,1322300,10059836,15.13
9891052,9971718,4906,1717100,11688818,17.22
9891053,9963774,3882,1358700,11322474,13.64
9891054,3793546,1147,401450,4194996,10.58
9891055,9986089,6932,2426200,12412289,24.30
9891056,9985862,1464,512400,10498262,5.13
9891057,9966837,3295,1153250,11120087,11.57
9891058,9701263,3549,1242150,10943413,12.80
9891059,9963120,3454,1208900,11172020,12.13
9891060,9959879,2816,985600,10945479,9.90
9891062,9974753,4674,1635900,11610653,16.40
9891063,9960427,4400,1540000,11500427,15.46
9891064,9973855,2090,731500,10705355,7.33
9891065,9951996,3982,1393700,11345696,14.00
9891066,9983235,3046,1066100,11049335,10.68
9891067,9990288,2095,733250,10723538,7.34
9891068,9983003,5266,1843100,11826103,18.46
9891069,9992797,3760,1316000,11308797,13.17
9891070,9985334,2718,951300,10936634,9.53
9891071,9999524,5463,1912050,11911574,19.12
9891072,3681924,369,129150,3811074,3.51
9891073,9999675,5174,1810900,11810575,18.11
9891074,2583788,816,285600,2869388,11.05
9891075,2571294,1564,547400,3118694,21.29
9891076,9958619,3308,1157800,11116419,11.63
9891077,4316865,1248,436800,4753665,10.12
9891078,516836,266,93100,609936,18.01
9891079,9990204,5422,1897700,11887904,19.00
9891080,8914827,2582,903700,9818527,10.14
9891081,9987581,1821,637350,10624931,6.38
9891082,9991576,1681,588350,10579926,5.89
9891083,9975529,2205,771750,10747279,7.74
9891084,9995875,4446,1556100,11551975,15.57
9891085,9987147,4932,1726200,11713347,17.28
9891086,9984762,1478,517300,10502062,5.18
9891087,3040408,695,243250,3283658,8.00
9891088,9973494,2985,1044750,11018244,10.48
9891089,9960093,1313,459550,10419643,4.61
9891090,5869750,1822,637700,6507450,10.86
9891091,9953527,4485,1569750,11523277,15.77
9891092,9940789,5290,1851500,11792289,18.63
9891093,5197863,646,226100,5423963,4.35
9891094,2882443,1645,575750,3458193,19.97
9891095,9942918,3365,1177750,11120668,11.85
9891096,9836171,3662,1281700,11117871,13.03
9891097,9966428,3004,1051400,11017828,10.55
9891098,9124841,2008,702800,9827641,7.70
9891099,9961126,3016,1055600,11016726,10.60
9891100,9187140,4199,1469650,10656790,16.00
9891101,9962306,2245,785750,10748056,7.89
9891102,9969972,4820,1687000,11656972,16.92
9891103,9976654,3303,1156050,11132704,11.59
9891104,9971633,4237,1482950,11454583,14.87
9891105,9966463,5087,1780450,11746913,17.86
9891106,9537785,3076,1076600,10614385,11.29
9891107,9898625,3528,1234800,11133425,12.47
9891108,9986773,5118,1791300,11778073,17.94
9891109,9992717,3041,1064350,11057067,10.65
9891110,9395379,3159,1105650,10501029,11.77
9891111,9374436,3450,1207500,10581936,12.88
9891112,9985119,3778,1322300,11307419,13.24
9891113,9966742,4145,1450750,11417492,14.56
9891114,9987649,2988,1045800,11033449,10.47
9891115,9973195,1688,590800,10563995,5.92
9891116,9977092,3262,1141700,11118792,11.44
9891117,9986488,2411,843850,10830338,8.45
9891118,9988859,4470,1564500,11553359,15.66
9891119,9982584,4518,1581300,11563884,15.84
9891120,994532,480,168000,1162532,16.89
9891121,9985649,2312,809200,10794849,8.10
9891122,7182323,1097,383950,7566273,5.35
9891123,9970443,5099,1784650,11755093,17.90
9891124,9967323,3945,1380750,11348073,13.85
9891125,9971415,868,303800,10275215,3.05
9891126,9973910,2185,764750,10738660,7.67
9891127,9970753,5260,1841000,11811753,18.46
9891128,9978622,2549,892150,10870772,8.94
9891129,9976759,3081,1078350,11055109,10.81
9891130,9987637,4233,1481550,11469187,14.83
9891131,5724640,1923,673050,6397690,11.76
9891132,9966627,3583,1254050,11220677,12.58
9891133,9980133,4979,1742650,11722783,17.46
9891134,200345,131,45850,246195,22.89
9891135,9968516,3967,1388450,11356966,13.93
9891136,9989910,3859,1350650,11340560,13.52
9891137,9984550,1951,682850,10667400,6.84
9891138,9982242,2430,850500,10832742,8.52
9891139,9989458,2992,1047200,11036658,10.48
9891140,2570782,655,229250,2800032,8.92
9891141,2463894,1891,661850,3125744,26.86
9891142,9978193,5345,1870750,11848943,18.75
9891143,9975207,5379,1882650,11857857,18.87
9891144,9857612,5985,2094750,11952362,21.25
9891145,9973714,5290,1851500,11825214,18.56
9891146,9979340,4952,1733200,11712540,17.37
9891147,9988616,5524,1933400,11922016,19.36
9891148,9956349,3744,1310400,11266749,13.16
9891149,9974491,4905,1716750,11691241,17.21
9891150,9973184,3785,1324750,11297934,13.28
9891151,9981977,6232,2181200,12163177,21.85
9891152,9992331,6029,2110150,12102481,21.12
9891153,3072487,635,222250,3294737,7.23
9891154,9981297,3738,1308300,11289597,13.11
9891155,9983811,7087,2480450,12464261,24.84
9891156,6701966,814,284900,6986866,4.25
9891157,9979629,4611,1613850,11593479,16.17
9891158,9970090,3254,1138900,11108990,11.42
9891159,9957416,4871,1704850,11662266,17.12
9891160,9989432,2314,809900,10799332,8.11
9891161,6781928,482,168700,6950628,2.49
9891162,9975130,3635,1272250,11247380,12.75
9891163,190766,167,58450,249216,30.64
9891164,9990479,4234,1481900,11472379,14.83
9891165,9980196,2174,760900,10741096,7.62
9891166,9996588,2113,739550,10736138,7.40
9891167,9972802,4550,1592500,11565302,15.97
9891168,9970214,3498,1224300,11194514,12.28
9891169,9609293,4574,1600900,11210193,16.66
9891170,9994994,3429,1200150,11195144,12.01
9891171,9998459,4333,1516550,11515009,15.17
9891172,9986337,1914,669900,10656237,6.71
9891173,9991535,4457,1559950,11551485,15.61
9891174,9979054,4723,1653050,11632104,16.57
9891175,9991809,3969,1389150,11380959,13.90
9891176,9976922,1942,679700,10656622,6.81
9891177,9981301,2778,972300,10953601,9.74
9891178,9993720,3449,1207150,11200870,12.08
9891179,5867673,4169,1459150,7326823,24.87
9891180,9985747,4241,1484350,11470097,14.86
9891181,9973372,3110,1088500,11061872,10.91
9891182,9981546,4215,1475250,11456796,14.78
9891183,9979052,2988,1045800,11024852,10.48
9891184,9982989,5558,1945300,11928289,19.49
9891185,9998959,3632,1271200,11270159,12.71
9891186,9979152,3100,1085000,11064152,10.87
9891187,9977981,3121,1092350,11070331,10.95
9891188,9999819,4559,1595650,11595469,15.96
9891189,9986639,2679,937650,10924289,9.39
9891190,9962837,4596,1608600,11571437,16.15
9891191,9975069,3758,1315300,11290369,13.19
9891192,9950930,4437,1552950,11503880,15.61
9891193,9976096,2556,894600,10870696,8.97
9891194,9969278,3021,1057350,11026628,10.61
9891195,9992243,3914,1369900,11362143,13.71
9891196,9976823,4401,1540350,11517173,15.44
9891197,9992765,4413,1544550,11537315,15.46
9891198,9986495,5771,2019850,12006345,20.23
9891199,9401908,1405,491750,9893658,5.23
9891200,9984704,2855,999250,10983954,10.01
9891201,8071186,2716,950600,9021786,11.78
9891202,9989951,2704,946400,10936351,9.47
9891203,2299828,1626,569100,2868928,24.75
9891204,9993249,3756,1314600,11307849,13.15
9891205,9996043,2792,977200,10973243,9.78
9891206,9821601,962,336700,10158301,3.43
9891207,9924747,4347,1521450,11446197,15.33
9891208,9975290,5229,1830150,11805440,18.35
9891209,9989082,4197,1468950,11458032,14.71
9891210,9993164,5078,1777300,11770464,17.79
9891211,9987099,3081,1078350,11065449,10.80
9891212,9987881,4695,1643250,11631131,16.45
9891213,9987116,3917,1370950,11358066,13.73
9891214,9346107,2008,702800,10048907,7.52
9891216,9950941,5186,1815100,11766041,18.24
9891217,9953725,5234,1831900,11785625,18.40
9891218,9942324,4377,1531950,11474274,15.41
9891219,9657262,1203,421050,10078312,4.36
9891220,9950725,5224,1828400,11779125,18.37
9891221,9843326,1809,633150,10476476,6.43
9891222,9944034,4171,1459850,11403884,14.68
9891223,9943155,5164,1807400,11750555,18.18
9891224,1300055,717,250950,1551005,19.30
9891225,9972623,6193,2167550,12140173,21.74
9891226,9870496,4508,1577800,11448296,15.99
9891227,9899903,5291,1851850,11751753,18.71
9891228,9955567,4157,1454950,11410517,14.61
9891229,9980509,3867,1353450,11333959,13.56
9891230,3565440,1178,412300,3977740,11.56
9891231,9708882,3398,1189300,10898182,12.25
9891232,9994422,5816,2035600,12030022,20.37
9891233,9992855,2561,896350,10889205,8.97
9891234,9949430,2246,786100,10735530,7.90
9891235,9979025,1420,497000,10476025,4.98
9891236,9982256,3501,1225350,11207606,12.28
9891237,8818384,4060,1421000,10239384,16.11
9891238,9982606,4233,1481550,11464156,14.84
9891239,9974744,3246,1136100,11110844,11.39
9891240,3042170,2037,712950,3755120,23.44
9891241,9989622,4263,1492050,11481672,14.94
9891242,9987370,2103,736050,10723420,7.37
9891244,9976054,3671,1284850,11260904,12.88
9891245,9989360,3909,1368150,11357510,13.70
9891246,9995118,3741,1309350,11304468,13.10
9891247,9986134,3201,1120350,11106484,11.22
9891249,9965548,2005,701750,10667298,7.04
9891250,9985070,1779,622650,10607720,6.24
9891251,9969995,4253,1488550,11458545,14.93
9891252,9984031,4140,1449000,11433031,14.51
9891253,9991427,3573,1250550,11241977,12.52
9891254,9972931,5291,1851850,11824781,18.57
9891255,9989230,3141,1099350,11088580,11.01
9891256,9984339,6960,2436000,12420339,24.40
9891257,9906409,5792,2027200,11933609,20.46
9891258,9961048,4820,1687000,11648048,16.94
9891259,9974365,1733,606550,10580915,6.08
9891260,9986833,3160,1106000,11092833,11.07
9891261,9976807,3090,1081500,11058307,10.84
9891262,9986315,4596,1608600,11594915,16.11
9891263,1171156,439,153650,1324806,13.12
9891264,9990020,1971,689850,10679870,6.91
9891265,9975287,3616,1265600,11240887,12.69
9891266,9994476,4581,1603350,11597826,16.04
9891267,9983979,4210,1473500,11457479,14.76
9891268,9970408,2111,738850,10709258,7.41
9891270,9984978,4543,1590050,11575028,15.92
9891271,9991470,5186,1815100,11806570,18.17
9891272,9966371,1836,642600,10608971,6.45
9891273,9974232,5592,1957200,11931432,19.62
9891274,9960064,4488,1570800,11530864,15.77
9891275,9963193,3329,1165150,11128343,11.69
9891276,9960253,3226,1129100,11089353,11.34
9891277,9981376,6478,2267300,12248676,22.72
9891278,9978525,3034,1061900,11040425,10.64
9891279,7889347,3123,1093050,8982397,13.85
9891280,9989817,2987,1045450,11035267,10.47
9891281,9479457,2199,769650,10249107,8.12
9891282,9986871,3488,1220800,11207671,12.22
9891283,5466476,1296,453600,5920076,8.30
9891284,9977910,5054,1768900,11746810,17.73
9891286,9980483,4282,1498700,11479183,15.02
9891287,9957502,2893,1012550,10970052,10.17
9891288,9959614,3222,1127700,11087314,11.32
9891289,9976219,3607,1262450,11238669,12.65
9891290,9987683,2739,958650,10946333,9.60
9891291,9990708,3338,1168300,11159008,11.69
9891292,9984237,2739,958650,10942887,9.60
9891293,9980552,3846,1346100,11326652,13.49
9891294,9997927,3334,1166900,11164827,11.67
9891295,9978811,2889,1011150,10989961,10.13
9891296,9994193,3194,1117900,11112093,11.19
9891297,9985794,2183,764050,10749844,7.65
9891298,9964880,2403,841050,10805930,8.44
9891299,9964897,3134,1096900,11061797,11.01
9891300,3485446,309,108150,3593596,3.10
9891301,3581003,1387,485450,4066453,13.56
9891302,9969323,3396,1188600,11157923,11.92
9891303,9965317,3337,1167950,11133267,11.72
9891304,411153,183,64050,475203,15.58
9891305,9949629,2541,889350,10838979,8.94
9891307,9941117,1928,674800,10615917,6.79
9891308,9936195,2001,700350,10636545,7.05
9891309,7366850,2842,994700,8361550,13.50
9891310,9948127,1637,572950,10521077,5.76
9891311,9941709,1977,691950,10633659,6.96
9891312,9957236,4506,1577100,11534336,15.84
9891313,9958456,3418,1196300,11154756,12.01
9891314,9966343,5760,2016000,11982343,20.23
9891315,9956059,4145,1450750,11406809,14.57
9891316,9958192,2997,1048950,11007142,10.53
9891317,4123656,672,235200,4358856,5.70
9891318,9950946,1973,690550,10641496,6.94
9891319,9976045,3051,1067850,11043895,10.70
9891320,9981312,3914,1369900,11351212,13.72
9891321,9978977,2309,808150,10787127,8.10
9891322,9883462,4564,1597400,11480862,16.16
9891323,9970004,3323,1163050,11133054,11.67
9891324,9977601,2727,954450,10932051,9.57
9891325,9977236,4054,1418900,11396136,14.22
9891326,9295638,3167,1108450,10404088,11.92
9891327,6954298,636,222600,7176898,3.20
9891328,9981085,1950,682500,10663585,6.84
9891329,1488192,1082,378700,1866892,25.45
9891330,9949832,5440,1904000,11853832,19.14
9891331,9613596,3968,1388800,11002396,14.45
9891332,9734605,3799,1329650,11064255,13.66
9891333,9989361,5395,1888250,11877611,18.90
9891334,9982376,5367,1878450,11860826,18.82
9891335,9969444,2668,933800,10903244,9.37
9891336,9962939,3469,1214150,11177089,12.19
9891337,9952046,1930,675500,10627546,6.79
9891338,9975203,2153,753550,10728753,7.55
9891339,9961353,2622,917700,10879053,9.21
9891340,5880232,2101,735350,6615582,12.51
9891341,6913500,358,125300,7038800,1.81
9891342,9928873,3952,1383200,11312073,13.93
9891343,419634,279,97650,517284,23.27
9891344,9925197,4944,1730400,11655597,17.43
9891345,9927529,1679,587650,10515179,5.92
9891346,9922457,3275,1146250,11068707,11.55
9891347,9923790,4250,1487500,11411290,14.99
9891348,9933192,3696,1293600,11226792,13.02
9891349,9938595,4534,1586900,11525495,15.97
9891350,9921302,2795,978250,10899552,9.86
9891351,9925802,2493,872550,10798352,8.79
9891352,9946747,5479,1917650,11864397,19.28
9891353,9919186,5704,1996400,11915586,20.13
9891354,9916378,3213,1124550,11040928,11.34
9891355,9927236,5364,1877400,11804636,18.91
9891356,9921592,3354,1173900,11095492,11.83
9891357,9925803,4903,1716050,11641853,17.29
9891358,9931615,1757,614950,10546565,6.19
9891359,9933227,6349,2222150,12155377,22.37
9891360,9960675,4656,1629600,11590275,16.36
9891361,9954718,4347,1521450,11476168,15.28
9891362,9655145,4229,1480150,11135295,15.33
9891363,9969677,4904,1716400,11686077,17.22
9891364,9988774,2891,1011850,11000624,10.13
9891365,9978107,4310,1508500,11486607,15.12
9891366,6365982,368,128800,6494782,2.02
9891367,9994538,4645,1625750,11620288,16.27
9891368,9971688,2955,1034250,11005938,10.37
9891369,9992139,2997,1048950,11041089,10.50
9891370,9985301,2216,775600,10760901,7.77
9891371,3461182,1585,554750,4015932,16.03
9891372,9989661,5761,2016350,12006011,20.18
9891373,9968858,1732,606200,10575058,6.08
9891374,9978497,3224,1128400,11106897,11.31
9891375,9983835,2763,967050,10950885,9.69
9891376,9961387,2568,898800,10860187,9.02
9891378,9964722,2603,911050,10875772,9.14
9891379,9972472,4023,1408050,11380522,14.12
9891380,9987435,1967,688450,10675885,6.89
9891381,3095702,2045,715750,3811452,23.12
9891382,9987551,4340,1519000,11506551,15.21
9891383,9994314,3964,1387400,11381714,13.88
9891384,9974972,3619,1266650,11241622,12.70
9891385,9970312,5226,1829100,11799412,18.35
9891386,9950077,2429,850150,10800227,8.54
9891387,9947279,2599,909650,10856929,9.14
9891388,9965050,4514,1579900,11544950,15.85
9891389,9973802,4243,1485050,11458852,14.89
9891390,9974915,5404,1891400,11866315,18.96
9891391,9973206,4385,1534750,11507956,15.39
9891392,3862586,1223,428050,4290636,11.08
9891393,9958688,4264,1492400,11451088,14.99
9891394,9969320,3487,1220450,11189770,12.24
9891395,975805,371,129850,1105655,13.31
9891396,186057,105,36750,222807,19.75
9891397,9963796,5117,1790950,11754746,17.97
9891398,9975358,3847,1346450,11321808,13.50
9891399,9970646,3849,1347150,11317796,13.51
9891400,8664078,3438,1203300,9867378,13.89
9891402,9882069,6777,2371950,12254019,24.00
9891403,6648822,1789,626150,7274972,9.42
9891404,9929769,3530,1235500,11165269,12.44
9891405,303324,21,7350,310674,2.42
9891406,9911559,6706,2347100,12258659,23.68
9891407,5851486,528,184800,6036286,3.16
9891408,9926248,3674,1285900,11212148,12.95
9891409,9930977,5474,1915900,11846877,19.29
9891410,9932294,3620,1267000,11199294,12.76
9891411,9914330,2713,949550,10863880,9.58
9891412,9921197,5125,1793750,11714947,18.08
9891413,9917219,1921,672350,10589569,6.78
9891415,9901177,5113,1789550,11690727,18.07
9891416,9229731,4793,1677550,10907281,18.18
9891417,9915818,2895,1013250,10929068,10.22
9891418,9920851,7155,2504250,12425101,25.24
9891419,2049652,1606,562100,2611752,27.42
9891420,9942079,3948,1381800,11323879,13.90
9891421,7040115,1793,627550,7667665,8.91
9891423,9940530,4880,1708000,11648530,17.18
9891424,9945597,5328,1864800,11810397,18.75
9891425,9691332,3827,1339450,11030782,13.82
9891426,9943914,2743,960050,10903964,9.65
9891427,9950629,4336,1517600,11468229,15.25
9891428,9955232,3605,1261750,11216982,12.67
9891429,9971688,3725,1303750,11275438,13.07
9891430,9983560,3055,1069250,11052810,10.71
9891431,9987441,4334,1516900,11504341,15.19
9891432,9978860,4449,1557150,11536010,15.60
9891433,9968089,6447,2256450,12224539,22.64
9891434,9952475,3931,1375850,11328325,13.82
9891435,8101356,548,191800,8293156,2.37
9891436,9996669,3444,1205400,11202069,12.06
9891437,9986249,3701,1295350,11281599,12.97
9891438,9990386,4390,1536500,11526886,15.38
9891439,240047,85,29750,269797,12.39
9891440,9985474,4723,1653050,11638524,16.55
9891441,9996011,3592,1257200,11253211,12.58
9891442,9983050,3812,1334200,11317250,13.36
9891443,4561138,775,271250,4832388,5.95
9891444,9981675,3640,1274000,11255675,12.76
9891445,508220,319,111650,619870,21.97
9891446,9990276,6226,2179100,12169376,21.81
9891447,9974589,2293,802550,10777139,8.05
9891448,9994387,2971,1039850,11034237,10.40
9891449,9987116,4200,1470000,11457116,14.72
9891450,9980694,1734,606900,10587594,6.08
9891451,9996400,3976,1391600,11388000,13.92
9891452,2480836,121,42350,2523186,1.71
9891453,9960517,3503,1226050,11186567,12.31
9891454,9988683,3048,1066800,11055483,10.68
9891455,9991597,1518,531300,10522897,5.32
9891456,9989595,1119,391650,10381245,3.92
9891457,9986091,4243,1485050,11471141,14.87
9891458,9985363,1564,547400,10532763,5.48
9891459,9477324,3672,1285200,10762524,13.56
9891460,9983709,2614,914900,10898609,9.16
9891461,9978010,1136,397600,10375610,3.98
9891462,2506134,764,267400,2773534,10.67
9891463,9961606,3214,1124900,11086506,11.29
9891464,9981779,3654,1278900,11260679,12.81
9891465,9997902,2131,745850,10743752,7.46
9891466,9985001,5472,1915200,11900201,19.18
9891467,9998165,7646,2676100,12674265,26.77
9891468,7113030,968,338800,7451830,4.76
9891469,9972978,3710,1298500,11271478,13.02
9891470,9994826,3582,1253700,11248526,12.54
9891471,9969656,3510,1228500,11198156,12.32
9891472,9979341,4083,1429050,11408391,14.32
9891474,9986714,4436,1552600,11539314,15.55
9891475,9983543,1452,508200,10491743,5.09
9891476,9979026,1134,396900,10375926,3.98
9891477,9979624,4911,1718850,11698474,17.22
9891478,9492242,5446,1906100,11398342,20.08
9891479,3705593,1275,446250,4151843,12.04
9891481,9984012,1725,603750,10587762,6.05
9891482,9979324,4367,1528450,11507774,15.32
9891483,9977511,2678,937300,10914811,9.39
9891484,9977817,5074,1775900,11753717,17.80
9891485,9969644,1975,691250,10660894,6.93
9891487,9966818,3599,1259650,11226468,12.64
9891488,9989317,4012,1404200,11393517,14.06
9891489,9987167,2216,775600,10762767,7.77
9891490,9979686,5528,1934800,11914486,19.39
9891491,9969419,7106,2487100,12456519,24.95
9891492,9971108,6079,2127650,12098758,21.34
9891493,8421737,774,270900,8692637,3.22
9891494,9969560,2117,740950,10710510,7.43
9891495,9983853,5018,1756300,11740153,17.59
9891496,9972163,3091,1081850,11054013,10.85
9891497,9977902,4278,1497300,11475202,15.01
9891498,9979515,3635,1272250,11251765,12.75
9891499,9981139,2407,842450,10823589,8.44
9891500,9973554,4330,1515500,11489054,15.20
9891501,9996831,3540,1239000,11235831,12.39
9891502,9977150,1603,561050,10538200,5.62
9891503,9990133,4113,1439550,11429683,14.41
9891504,9993852,3334,1166900,11160752,11.68
9891505,9990421,2491,871850,10862271,8.73
9891506,168207,66,23100,191307,13.73
9891507,9984935,3195,1118250,11103185,11.20
9891508,9994360,1815,635250,10629610,6.36
9891509,178736,123,43050,221786,24.09
9891510,9974129,2607,912450,10886579,9.15
9891511,4298615,2303,806050,5104665,18.75
9891512,9963062,3606,1262100,11225162,12.67
9891513,9985201,4275,1496250,11481451,14.98
9891514,9972022,785,274750,10246772,2.76
9891515,5744625,1730,605500,6350125,10.54
9891516,9958621,4799,1679650,11638271,16.87
9891517,9945783,4280,1498000,11443783,15.06
9891518,9970605,3941,1379350,11349955,13.83
9891519,9963267,3720,1302000,11265267,13.07
9891520,9968479,5401,1890350,11858829,18.96
9891521,4867058,1309,458150,5325208,9.41
9891522,9983163,2698,944300,10927463,9.46
9891523,9992462,5378,1882300,11874762,18.84
9891524,9999446,3761,1316350,11315796,13.16
9891525,9999695,2577,901950,10901645,9.02
9891526,9984732,1487,520450,10505182,5.21
9891527,774879,423,148050,922929,19.11
9891528,272477,131,45850,318327,16.83
9891529,9975435,2995,1048250,11023685,10.51
9891530,9980108,2999,1049650,11029758,10.52
9891531,2572628,409,143150,2715778,5.56
9891532,9983539,4488,1570800,11554339,15.73
9891533,9994986,1232,431200,10426186,4.31
9891534,4532249,467,163450,4695699,3.61
9891535,9979728,4143,1450050,11429778,14.53
9891536,9981752,2846,996100,10977852,9.98
9891537,9999850,3559,1245650,11245500,12.46
9891538,567798,175,61250,629048,10.79
9891539,9956928,5773,2020550,11977478,20.29
9891540,9941304,2196,768600,10709904,7.73
9891541,9975011,5394,1887900,11862911,18.93
9891542,9970460,5099,1784650,11755110,17.90
9891543,9988250,6629,2320150,12308400,23.23
9891544,9988013,3893,1362550,11350563,13.64
9891545,9996600,1820,637000,10633600,6.37
9891546,7568899,2291,801850,8370749,10.59
9891547,2369161,625,218750,2587911,9.23
9891548,9974896,3995,1398250,11373146,14.02
9891549,7758050,2196,768600,8526650,9.91
9891550,5404362,1582,553700,5958062,10.25
9891551,9973483,3102,1085700,11059183,10.89
9891552,9955368,3441,1204350,11159718,12.10
9891553,4387751,1886,660100,5047851,15.04
9891554,9969047,5393,1887550,11856597,18.93
9891555,1483073,1111,388850,1871923,26.22
9891556,9958686,3787,1325450,11284136,13.31
9891557,5021105,1150,402500,5423605,8.02
9891558,5958115,1564,547400,6505515,9.19
9891559,9964649,6744,2360400,12325049,23.69
9891561,339138,151,52850,391988,15.58
9891562,1839290,776,271600,2110890,14.77
9891563,9989427,4051,1417850,11407277,14.19
9891564,9977048,3181,1113350,11090398,11.16
9891565,9986315,6778,2372300,12358615,23.76
9891567,9979544,4202,1470700,11450244,14.74
9891568,4236148,1132,396200,4632348,9.35
9891569,9976076,6770,2369500,12345576,23.75
9891570,9972769,1506,527100,10499869,5.29
9891571,9979292,4223,1478050,11457342,14.81
9891572,9995029,3798,1329300,11324329,13.30
9891573,26197,42,14700,40897,56.11
9891574,9986973,2817,985950,10972923,9.87
9891575,9984287,3790,1326500,11310787,13.29
9891576,800450,438,153300,953750,19.15
9891577,9979703,4810,1683500,11663203,16.87
9891578,9967371,1957,684950,10652321,6.87
9891579,977536,422,147700,1125236,15.11
9891580,9977744,4261,1491350,11469094,14.95
9891581,7868934,3546,1241100,9110034,15.77
9891582,9909344,3944,1380400,11289744,13.93
9891583,9994629,4769,1669150,11663779,16.70
9891585,2514372,890,311500,2825872,12.39
9891586,6324620,2024,708400,7033020,11.20
9891587,9976698,3022,1057700,11034398,10.60
9891589,9964238,4581,1603350,11567588,16.09
9891590,9961413,5258,1840300,11801713,18.47
9891591,9954056,6227,2179450,12133506,21.90
9891592,807386,741,259350,1066736,32.12
9891593,9939700,1854,648900,10588600,6.53
9891594,9949574,1306,457100,10406674,4.59
9891595,9929511,6542,2289700,12219211,23.06
9891596,3718700,1455,509250,4227950,13.69
9891597,9940053,2813,984550,10924603,9.90
9891598,9945250,4786,1675100,11620350,16.84
9891599,9931614,1018,356300,10287914,3.59
9891600,9938683,1736,607600,10546283,6.11
9891602,9946801,1298,454300,10401101,4.57
9891603,9949133,4734,1656900,11606033,16.65
9891604,9949703,4075,1426250,11375953,14.33
9891605,9945064,2946,1031100,10976164,10.37
9891606,9951450,1050,367500,10318950,3.69
9891607,9961526,3925,1373750,11335276,13.79
9891608,9971215,1001,350350,10321565,3.51
9891609,9966011,3173,1110550,11076561,11.14
9891610,9971120,2102,735700,10706820,7.38
9891611,9991970,3768,1318800,11310770,13.20
9891612,9997174,1018,356300,10353474,3.56
9891613,9989539,3097,1083950,11073489,10.85
9891614,9985678,3601,1260350,11246028,12.62
9891615,9991096,2266,793100,10784196,7.94
9891616,9988779,3552,1243200,11231979,12.45
9891617,395100,275,96250,491350,24.36
9891618,9974186,4815,1685250,11659436,16.90
9891619,9971157,4246,1486100,11457257,14.90
9891620,9969160,3132,1096200,11065360,11.00
9891621,123628,27,9450,133078,7.64
9891622,9782580,4537,1587950,11370530,16.23
9891623,9986100,4084,1429400,11415500,14.31
9891624,2213675,1681,588350,2802025,26.58
9891625,9987082,5389,1886150,11873232,18.89
9891626,3377444,335,117250,3494694,3.47
9891627,9994543,3709,1298150,11292693,12.99
9891628,382504,184,64400,446904,16.84
9891629,9975366,1642,574700,10550066,5.76
9891630,9971127,3716,1300600,11271727,13.04
9891632,9969167,907,317450,10286617,3.18
9891633,1838523,703,246050,2084573,13.38
9891634,9974295,3858,1350300,11324595,13.54
9891635,2360294,1175,411250,2771544,17.42
9891636,2215647,1042,364700,2580347,16.46
9891637,9959170,4357,1524950,11484120,15.31
9891638,9964545,4800,1680000,11644545,16.86
9891639,478354,127,44450,522804,9.29
9891640,9969366,3517,1230950,11200316,12.35
9891641,9966048,1445,505750,10471798,5.07
9891642,9954596,3488,1220800,11175396,12.26
9891643,4341741,1296,453600,4795341,10.45
9891644,9991001,3095,1083250,11074251,10.84
9891645,9996484,4090,1431500,11427984,14.32
9891646,9998966,2237,782950,10781916,7.83
9891647,9973331,3359,1175650,11148981,11.79
9891648,1417933,193,67550,1485483,4.76
9891649,644287,294,102900,747187,15.97
9891650,144628,27,9450,154078,6.53
9891651,9936179,3968,1388800,11324979,13.98
9891652,3324096,342,119700,3443796,3.60
9891653,9936564,3876,1356600,11293164,13.65
9891654,9951044,2493,872550,10823594,8.77
9891655,9951989,5548,1941800,11893789,19.51
9891656,9958336,5364,1877400,11835736,18.85
9891657,9968791,4685,1639750,11608541,16.45
9891658,5534393,1755,614250,6148643,11.10
9891659,4203885,2449,857150,5061035,20.39
9891660,9937951,3648,1276800,11214751,12.85
9891661,59285,103,36050,95335,60.81
9891662,9929919,4745,1660750,11590669,16.72
9891663,9938594,1966,688100,10626694,6.92
9891664,9946370,2899,1014650,10961020,10.20
9891665,9938768,4868,1703800,11642568,17.14
9891666,2021000,708,247800,2268800,12.26
9891668,9917318,5238,1833300,11750618,18.49
9891669,9928947,3396,1188600,11117547,11.97
9891670,490451,250,87500,577951,17.84
9891671,9918478,3774,1320900,11239378,13.32
9891672,9938023,4771,1669850,11607873,16.80
9891673,9929899,3113,1089550,11019449,10.97
9891674,3807697,1144,400400,4208097,10.52
9891675,9941409,4400,1540000,11481409,15.49
9891676,9946405,5176,1811600,11758005,18.21
9891677,9943132,4313,1509550,11452682,15.18
9891678,9940341,2974,1040900,10981241,10.47
9891679,3383629,630,220500,3604129,6.52
9891680,9951641,4417,1545950,11497591,15.53
9891681,9941375,2927,1024450,10965825,10.30
9891682,9943470,4668,1633800,11577270,16.43
9891683,9946736,2741,959350,10906086,9.64
9891685,9962262,3066,1073100,11035362,10.77
9891686,9956929,4025,1408750,11365679,14.15
9891687,9982181,1462,511700,10493881,5.13
9891688,1203036,234,81900,1284936,6.81
9891689,2479669,754,263900,2743569,10.64
9891690,2500813,548,191800,2692613,7.67
9891691,1839851,804,281400,2121251,15.29
9891692,9963988,3579,1252650,11216638,12.57
9891693,9958648,4349,1522150,11480798,15.28
9891694,9963563,2338,818300,10781863,8.21
9891695,1425149,1071,374850,1799999,26.30
9891696,9963295,4873,1705550,11668845,17.12
9891697,9966191,3705,1296750,11262941,13.01
9891698,9959923,3780,1323000,11282923,13.28
9891699,9979006,3080,1078000,11057006,10.80
9891700,9982879,4719,1651650,11634529,16.54
9891702,9959404,3340,1169000,11128404,11.74
9891703,9957861,3666,1283100,11240961,12.89
9891704,9965687,4053,1418550,11384237,14.23
9891705,9963267,2360,826000,10789267,8.29
9891706,9960501,4525,1583750,11544251,15.90
9891707,9954074,2598,909300,10863374,9.13
9891708,9975537,3592,1257200,11232737,12.60
9891709,3994929,972,340200,4335129,8.52
9891710,9982973,4638,1623300,11606273,16.26
9891711,9972268,3331,1165850,11138118,11.69
9891712,9978832,4043,1415050,11393882,14.18
9891713,799105,115,40250,839355,5.04
9891714,9972904,3501,1225350,11198254,12.29
9891715,9961212,1369,479150,10440362,4.81
9891716,9961745,1438,503300,10465045,5.05
9891717,9973807,5486,1920100,11893907,19.25
9891718,9983743,3671,1284850,11268593,12.87
9891719,9956389,2373,830550,10786939,8.34
9891720,9967097,3578,1252300,11219397,12.56
9891721,9983125,2481,868350,10851475,8.70
9891722,9993970,6201,2170350,12164320,21.72
9891723,9982835,926,324100,10306935,3.25
9891724,9982383,3524,1233400,11215783,12.36
9891725,9964136,1833,641550,10605686,6.44
9891727,9957232,3197,1118950,11076182,11.24
9891729,9939254,836,292600,10231854,2.94
9891731,9941177,2414,844900,10786077,8.50
9891732,9956094,4175,1461250,11417344,14.68
9891733,2319248,172,60200,2379448,2.60
9891734,9950962,2344,820400,10771362,8.24
9891735,5907311,1618,566300,6473611,9.59
9891736,2442699,589,206150,2648849,8.44
9891737,9954358,1649,577150,10531508,5.80
9891738,9977626,3156,1104600,11082226,11.07
9891739,9986188,1554,543900,10530088,5.45
9891740,9981338,1799,629650,10610988,6.31
9891741,9990404,2870,1004500,10994904,10.05
9891742,9967587,5001,1750350,11717937,17.56
9891743,9985887,1836,642600,10628487,6.44
9891744,9993026,4040,1414000,11407026,14.15
9891745,9988345,2483,869050,10857395,8.70
9891746,9979513,1461,511350,10490863,5.12
9891747,9982759,1940,679000,10661759,6.80
9891748,9969308,5268,1843800,11813108,18.49
9891749,3698888,556,194600,3893488,5.26
9891750,9957101,2558,895300,10852401,8.99
9891751,9958122,6955,2434250,12392372,24.44
9891752,9970436,4362,1526700,11497136,15.31
9891753,9946470,3229,1130150,11076620,11.36
9891754,9983937,4418,1546300,11530237,15.49
9891755,9973801,3153,1103550,11077351,11.06
9891756,9984290,4506,1577100,11561390,15.80
9891757,9977034,2620,917000,10894034,9.19
9891758,9992224,2434,851900,10844124,8.53
9891759,9987517,3072,1075200,11062717,10.77
9891760,704961,517,180950,885911,25.67
9891761,6931928,2180,763000,7694928,11.01
9891762,9993366,2692,942200,10935566,9.43
9891763,9986661,2547,891450,10878111,8.93
9891764,9988509,6008,2102800,12091309,21.05
9891765,3227503,254,88900,3316403,2.75
9891766,9990653,3381,1183350,11174003,11.84
9891767,9972811,2781,973350,10946161,9.76
9891768,9977794,1724,603400,10581194,6.05
9891769,9985413,1132,396200,10381613,3.97
9891770,9986460,3114,1089900,11076360,10.91
9891771,9989776,1913,669550,10659326,6.70
9891772,9991478,4809,1683150,11674628,16.85
9891773,9994334,1373,480550,10474884,4.81
9891774,9996390,1197,418950,10415340,4.19
9891776,9991518,684,239400,10230918,2.40
9891777,9981779,682,238700,10220479,2.39
9891778,9972978,2768,968800,10941778,9.71
9891779,3375154,579,202650,3577804,6.00
9891780,9994108,4402,1540700,11534808,15.42
9891781,9990407,1748,611800,10602207,6.12
9891782,9993682,2870,1004500,10998182,10.05
9891783,1211673,364,127400,1339073,10.51
9891784,9962455,4519,1581650,11544105,15.88
9891785,6784798,945,330750,7115548,4.87
9891786,2420581,598,209300,2629881,8.65
9891787,9978266,3970,1389500,11367766,13.93
9891788,9991673,1031,360850,10352523,3.61
9891789,179975,61,21350,201325,11.86
9891790,9966104,2969,1039150,11005254,10.43
9891791,9958704,3354,1173900,11132604,11.79
9891792,9943961,5214,1824900,11768861,18.35
9891793,9676473,3433,1201550,10878023,12.42
9891794,9876949,3113,1089550,10966499,11.03
9891795,9970944,1901,665350,10636294,6.67
9891796,9963369,1465,512750,10476119,5.15
9891797,9977330,4756,1664600,11641930,16.68
9891798,9972086,2239,783650,10755736,7.86
9891799,9982956,6141,2149350,12132306,21.53
9891800,1401062,336,117600,1518662,8.39
9891801,9972337,4721,1652350,11624687,16.57
9891802,9995476,4366,1528100,11523576,15.29
9891803,9998228,3675,1286250,11284478,12.86
9891804,3643253,1033,361550,4004803,9.92
9891806,9643970,3846,1346100,10990070,13.96
9891807,9987068,4806,1682100,11669168,16.84
9891808,1994167,207,72450,2066617,3.63
9891809,9987159,3809,1333150,11320309,13.35
9891810,9974307,3906,1367100,11341407,13.71
9891811,9982130,3128,1094800,11076930,10.97
9891812,9988150,3859,1350650,11338800,13.52
9891813,9950728,4082,1428700,11379428,14.36
9891814,9979541,4640,1624000,11603541,16.27
9891815,9994114,3429,1200150,11194264,12.01
9891816,9972077,3444,1205400,11177477,12.09
9891817,9993250,3710,1298500,11291750,12.99
9891818,2665209,339,118650,2783859,4.45
9891819,9977201,2778,972300,10949501,9.75
9891820,9980617,2177,761950,10742567,7.63
9891821,9988079,4503,1576050,11564129,15.78
9891822,9981146,2870,1004500,10985646,10.06
9891823,9979219,3409,1193150,11172369,11.96
9891824,9992526,2893,1012550,11005076,10.13
9891825,9963539,3613,1264550,11228089,12.69
9891826,9984544,1530,535500,10520044,5.36
9891827,9979648,4771,1669850,11649498,16.73
9891828,9988271,1704,596400,10584671,5.97
9891829,9994020,4244,1485400,11479420,14.86
9891830,2468816,288,100800,2569616,4.08
9891831,9986974,2822,987700,10974674,9.89
9891832,9967777,676,236600,10204377,2.37
9891834,9983571,3228,1129800,11113371,11.32
9891835,9974297,2042,714700,10688997,7.17
9891836,5937087,2085,729750,6666837,12.29
9891837,9966730,3641,1274350,11241080,12.79
9891838,9985226,2683,939050,10924276,9.40
9891839,9974251,3251,1137850,11112101,11.41
9891840,9989924,1375,481250,10471174,4.82
9891841,9987080,2548,891800,10878880,8.93
9891842,9988872,1115,390250,10379122,3.91
9891843,9833782,5151,1802850,11636632,18.33
9891844,9983308,2385,834750,10818058,8.36
9891846,9979666,3359,1175650,11155316,11.78
9891847,9978904,2659,930650,10909554,9.33
9891848,9980434,3573,1250550,11230984,12.53
9891849,9980230,4082,1428700,11408930,14.32
9891850,9994323,2676,936600,10930923,9.37
9891852,3891354,2423,848050,4739404,21.79
9891853,9969341,4231,1480850,11450191,14.85
9891854,9981591,1824,638400,10619991,6.40
9891855,9981601,3187,1115450,11097051,11.18
9891856,709346,202,70700,780046,9.97
9891857,232600,49,17150,249750,7.37
9891858,433838,134,46900,480738,10.81
9891859,9983348,4425,1548750,11532098,15.51
9891860,9982897,3797,1328950,11311847,13.31
9891861,4009928,1074,375900,4385828,9.37
9891862,9965318,5828,2039800,12005118,20.47
9891863,2172969,925,323750,2496719,14.90
9891864,710954,324,113400,824354,15.95
9891865,2286247,474,165900,2452147,7.26
9891866,9963370,5292,1852200,11815570,18.59
9891867,9965731,3832,1341200,11306931,13.46
9891868,9980881,3655,1279250,11260131,12.82
9891869,2195997,893,312550,2508547,14.23
9891870,9991067,3535,1237250,11228317,12.38
9891871,9633156,4201,1470350,11103506,15.26
9891872,9994232,2878,1007300,11001532,10.08
9891873,9994440,7388,2585800,12580240,25.87
9891875,9978211,3946,1381100,11359311,13.84
9891876,9981291,4239,1483650,11464941,14.86
9891877,9980592,3860,1351000,11331592,13.54
9891878,9987503,3892,1362200,11349703,13.64
9891880,9987253,3763,1317050,11304303,13.19
9891881,9998861,3336,1167600,11166461,11.68
9891882,9983846,1546,541100,10524946,5.42
9891883,9989087,4929,1725150,11714237,17.27
9891884,3241029,2457,859950,4100979,26.53
9891885,9968234,4391,1536850,11505084,15.42
9891886,9961616,3735,1307250,11268866,13.12
9891887,9968803,5411,1893850,11862653,19.00
9891888,9979727,5615,1965250,11944977,19.69
9891889,257427,127,44450,301877,17.27
9891890,9618083,2122,742700,10360783,7.72
9891891,9960649,1438,503300,10463949,5.05
9891892,3301656,568,198800,3500456,6.02
9891893,9941304,5053,1768550,11709854,17.79
9891894,9942076,3443,1205050,11147126,12.12
9891895,9931904,4802,1680700,11612604,16.92
9891896,912324,21,7350,919674,0.81
9891897,9950115,3338,1168300,11118415,11.74
9891898,9953244,3683,1289050,11242294,12.95
9891900,9975297,3962,1386700,11361997,13.90
9891901,9974164,1476,516600,10490764,5.18
9891903,9973718,5597,1958950,11932668,19.64
9891904,9953121,3069,1074150,11027271,10.79
9891905,9980042,4818,1686300,11666342,16.90
9891906,9990859,2375,831250,10822109,8.32
9891907,9992796,2668,933800,10926596,9.34
9891908,9980991,4886,1710100,11691091,17.13
9891909,3293732,2653,928550,4222282,28.19
9891910,3431021,1092,382200,3813221,11.14
9891911,9949068,4343,1520050,11469118,15.28
9891912,9962564,2976,1041600,11004164,10.46
9891913,9941127,4294,1502900,11444027,15.12
9891914,264128,107,37450,301578,14.18
9891915,56221,42,14700,70921,26.15
9891916,9965334,3452,1208200,11173534,12.12
9891917,9982574,2750,962500,10945074,9.64
9891918,9995416,2090,731500,10726916,7.32
9891919,9997478,1905,666750,10664228,6.67
9891920,9979645,2706,947100,10926745,9.49
9891921,9994953,2213,774550,10769503,7.75
9891922,9987385,4093,1432550,11419935,14.34
9891923,1155934,262,91700,1247634,7.93
9891924,9962854,5471,1914850,11877704,19.22
9891925,9985250,3423,1198050,11183300,12.00
9891926,9981592,2698,944300,10925892,9.46
9891927,9977915,3460,1211000,11188915,12.14
9891928,9980768,4261,1491350,11472118,14.94
9891929,9999774,1727,604450,10604224,6.04
9891930,9989713,1900,665000,10654713,6.66
9891931,9999738,1298,454300,10454038,4.54
9891932,9990491,5589,1956150,11946641,19.58
9891933,1245057,583,204050,1449107,16.39
9891934,9980441,4283,1499050,11479491,15.02
9891935,154838,96,33600,188438,21.70
9891936,9977009,4503,1576050,11553059,15.80
9891937,9982182,2941,1029350,11011532,10.31
9891938,9989892,3960,1386000,11375892,13.87
9891939,9989736,3783,1324050,11313786,13.25
9891940,9972663,2039,713650,10686313,7.16
9891941,9994510,1693,592550,10587060,5.93
9891942,9987564,4158,1455300,11442864,14.57
9891943,9984997,1385,484750,10469747,4.85
9891944,9991403,3667,1283450,11274853,12.85
9891945,3061913,446,156100,3218013,5.10
9891946,9978350,4831,1690850,11669200,16.95
9891947,9308503,3240,1134000,10442503,12.18
9891948,9970496,3837,1342950,11313446,13.47
9891949,9955019,3557,1244950,11199969,12.51
9891950,9955574,1782,623700,10579274,6.26
9891951,9929540,956,334600,10264140,3.37
9891952,9969994,4648,1626800,11596794,16.32
9891953,9964484,1731,605850,10570334,6.08
9891954,3092297,562,196700,3288997,6.36
9891955,9952192,2940,1029000,10981192,10.34
9891956,9964426,1870,654500,10618926,6.57
9891957,9965787,2322,812700,10778487,8.15
9891958,402515,424,148400,550915,36.87
9891959,9976023,2912,1019200,10995223,10.22
9891960,9965870,8339,2918650,12884520,29.29
9891961,9967078,3605,1261750,11228828,12.66
9891962,9978403,4331,1515850,11494253,15.19
9891963,9975236,2668,933800,10909036,9.36
9891964,991452,443,155050,1146502,15.64
9891965,9963441,3665,1282750,11246191,12.87
9891966,9953828,2342,819700,10773528,8.24
9891967,3925443,2603,911050,4836493,23.21
9891968,9958077,1740,609000,10567077,6.12
9891969,9965001,2867,1003450,10968451,10.07
9891970,2866365,164,57400,2923765,2.00
9891971,9956877,3903,1366050,11322927,13.72
9891972,9960335,2125,743750,10704085,7.47
9891973,9966803,4414,1544900,11511703,15.50
9891974,9973913,2513,879550,10853463,8.82
9891975,9990801,5234,1831900,11822701,18.34
9891976,6128559,2942,1029700,7158259,16.80
9891977,9961528,3732,1306200,11267728,13.11
9891978,9957080,3631,1270850,11227930,12.76
9891979,9970613,3584,1254400,11225013,12.58
9891980,9962494,1418,496300,10458794,4.98
9891981,9954960,1068,373800,10328760,3.75
9891982,9964995,1915,670250,10635245,6.73
9891983,2660803,736,257600,2918403,9.68
9891984,9958725,4688,1640800,11599525,16.48
9891985,9953117,3904,1366400,11319517,13.73
9891986,9970231,2773,970550,10940781,9.73
9891987,2370458,220,77000,2447458,3.25
9891988,9965624,3436,1202600,11168224,12.07
9891989,9981132,3604,1261400,11242532,12.64
9891990,9980120,3076,1076600,11056720,10.79
9891991,9999501,2696,943600,10943101,9.44
9891992,9982468,2423,848050,10830518,8.50
9891993,6488238,1843,645050,7133288,9.94
9891994,6393963,1819,636650,7030613,9.96
9891995,9956583,3969,1389150,11345733,13.95
9891996,9967446,3416,1195600,11163046,12.00
9891997,9967067,2446,856100,10823167,8.59
9891998,9967175,5899,2064650,12031825,20.71
9891999,506685,324,113400,620085,22.38
9892000,9968431,3355,1174250,11142681,11.78
9892001,8794145,4668,1633800,10427945,18.58
9892002,6399708,1785,624750,7024458,9.76
9892003,4180232,1300,455000,4635232,10.88
9892004,9972774,2875,1006250,10979024,10.09
9892005,9955576,4878,1707300,11662876,17.15
9892006,9979474,2972,1040200,11019674,10.42
9892007,9986285,3341,1169350,11155635,11.71
9892008,3994590,1748,611800,4606390,15.32
9892009,1364184,287,100450,1464634,7.36
9892010,9969025,4252,1488200,11457225,14.93
9892011,9965540,3602,1260700,11226240,12.65
9892012,9976075,4076,1426600,11402675,14.30
9892013,787680,353,123550,911230,15.69
9892014,1285971,938,328300,1614271,25.53
9892015,9991395,4086,1430100,11421495,14.31
9892016,9984246,2436,852600,10836846,8.54
9892017,9966947,2207,772450,10739397,7.75
9892018,852360,327,114450,966810,13.43
9892019,9987078,3781,1323350,11310428,13.25
9892020,9985448,3556,1244600,11230048,12.46
9892021,9996377,4025,1408750,11405127,14.09
9892022,6485603,3094,1082900,7568503,16.70
9892023,1649087,653,228550,1877637,13.86
9892024,292038,200,70000,362038,23.97
9892025,9942882,3607,1262450,11205332,12.70
9892026,9954672,2249,787150,10741822,7.91
9892027,9967222,2028,709800,10677022,7.12
9892028,9927260,5004,1751400,11678660,17.64
9892029,9946529,5563,1947050,11893579,19.58
9892030,9952937,3242,1134700,11087637,11.40
9892031,9953321,2308,807800,10761121,8.12
9892032,9950170,4706,1647100,11597270,16.55
9892033,9958512,3504,1226400,11184912,12.32
9892034,9962091,1698,594300,10556391,5.97
9892035,9965765,1898,664300,10630065,6.67
9892036,9970875,5253,1838550,11809425,18.44
9892037,9975590,1182,413700,10389290,4.15
9892038,297002,203,71050,368052,23.92
9892039,1263122,559,195650,1458772,15.49
9892040,3947864,1067,373450,4321314,9.46
9892041,9958520,4825,1688750,11647270,16.96
9892042,9954926,5072,1775200,11730126,17.83
9892043,9944653,3033,1061550,11006203,10.67
9892044,9954432,3965,1387750,11342182,13.94
9892045,9957610,4995,1748250,11705860,17.56
9892046,2229934,479,167650,2397584,7.52
9892047,2188416,1610,563500,2751916,25.75
9892048,9953558,3277,1146950,11100508,11.52
9892049,9965301,2626,919100,10884401,9.22
9892050,9975520,3727,1304450,11279970,13.08
9892051,9958269,3520,1232000,11190269,12.37
9892052,273681,228,79800,353481,29.16
9892053,8176135,3379,1182650,9358785,14.46
9892054,9953229,3349,1172150,11125379,11.78
9892055,9961174,2444,855400,10816574,8.59
9892056,9931158,3325,1163750,11094908,11.72
9892057,9978672,2996,1048600,11027272,10.51
9892058,9954139,4410,1543500,11497639,15.51
9892059,9941737,5707,1997450,11939187,20.09
9892060,9971329,3541,1239350,11210679,12.43
9892061,9990320,1622,567700,10558020,5.68
9892062,9992107,5216,1825600,11817707,18.27
9892063,9996529,3396,1188600,11185129,11.89
9892064,9978591,1364,477400,10455991,4.78
9892065,9960214,4689,1641150,11601364,16.48
9892066,9733934,2585,904750,10638684,9.29
9892067,9753911,2688,940800,10694711,9.65
9892068,9990951,5741,2009350,12000301,20.11
9892069,9982123,6721,2352350,12334473,23.57
9892070,9997158,2376,831600,10828758,8.32
9892071,9986345,2811,983850,10970195,9.85
9892072,9878481,2630,920500,10798981,9.32
9892073,9985892,4664,1632400,11618292,16.35
9892074,9997634,1344,470400,10468034,4.71
9892075,641119,703,246050,887169,38.38
9892076,9988503,4155,1454250,11442753,14.56
9892077,9983600,929,325150,10308750,3.26
9892078,9997338,3494,1222900,11220238,12.23
9892079,9974833,1943,680050,10654883,6.82
9892080,9975270,2632,921200,10896470,9.23
9892082,9993422,4171,1459850,11453272,14.61
9892083,9898082,4635,1622250,11520332,16.39
9892084,630708,825,288750,919458,45.78
9892085,9950035,1965,687750,10637785,6.91
9892086,9977790,4252,1488200,11465990,14.92
9892087,9985857,3560,1246000,11231857,12.48
9892088,9984189,2959,1035650,11019839,10.37
9892089,9981124,1721,602350,10583474,6.03
9892090,78888,49,17150,96038,21.74
9892091,9985054,670,234500,10219554,2.35
9892092,9990873,472,165200,10156073,1.65
9892093,9981300,3173,1110550,11091850,11.13
9892094,9971604,661,231350,10202954,2.32
9892095,9976372,1667,583450,10559822,5.85
9892096,9970645,1521,532350,10502995,5.34
9892097,167798,237,82950,250748,49.43
9892098,9985591,2028,709800,10695391,7.11
9892099,9962515,1477,516950,10479465,5.19
9892100,2290767,1196,418600,2709367,18.27
9892101,9973974,5789,2026150,12000124,20.31
9892102,9980163,1640,574000,10554163,5.75
9892103,9954649,2319,811650,10766299,8.15
9892105,9985864,2737,957950,10943814,9.59
9892106,9976270,2932,1026200,11002470,10.29
9892107,9984678,4114,1439900,11424578,14.42
9892108,9971840,535,187250,10159090,1.88
9892109,9977703,4499,1574650,11552353,15.78
9892110,9988020,290,101500,10089520,1.02
9892111,9981332,1558,545300,10526632,5.46
9892112,9960396,3490,1221500,11181896,12.26
9892113,9954859,2550,892500,10847359,8.97
9892114,9973866,3523,1233050,11206916,12.36
9892115,9972109,4421,1547350,11519459,15.52
9892116,1638907,493,172550,1811457,10.53
9892117,9966645,3268,1143800,11110445,11.48
9892119,9966088,3126,1094100,11060188,10.98
9892120,963797,963,337050,1300847,34.97
9892121,1618766,496,173600,1792366,10.72
9892122,9964437,5565,1947750,11912187,19.55
9892123,2269120,1259,440650,2709770,19.42
9892124,9955431,3438,1203300,11158731,12.09
9892125,9639448,3796,1328600,10968048,13.78
9892126,3492196,306,107100,3599296,3.07
9892127,9929429,2933,1026550,10955979,10.34
9892128,3521666,501,175350,3697016,4.98
9892129,9936139,2757,964950,10901089,9.71
9892130,7825773,538,188300,8014073,2.41
9892131,3652240,654,228900,3881140,6.27
9892132,4108685,1941,679350,4788035,16.53
9892133,9943263,5578,1952300,11895563,19.63
9892134,9947631,3413,1194550,11142181,12.01
9892135,9930436,3955,1384250,11314686,13.94
9892136,9945926,5548,1941800,11887726,19.52
9892137,4033219,806,282100,4315319,6.99
9892138,9956796,3364,1177400,11134196,11.83
9892139,9949529,4828,1689800,11639329,16.98
9892140,9969152,3834,1341900,11311052,13.46
9892141,268679,61,21350,290029,7.95
9892142,9989110,3554,1243900,11233010,12.45
9892143,9979369,4908,1717800,11697169,17.21
9892144,9992432,2727,954450,10946882,9.55
9892145,9977908,1144,400400,10378308,4.01
9892146,9974544,2000,700000,10674544,7.02
9892147,9977907,1116,390600,10368507,3.91
9892148,9975878,2881,1008350,10984228,10.11
9892149,9989980,2398,839300,10829280,8.40
9892150,9975547,3308,1157800,11133347,11.61
9892151,9986107,4532,1586200,11572307,15.88
9892152,9989092,1213,424550,10413642,4.25
9892153,9997252,3545,1240750,11238002,12.41
9892154,9567046,2486,870100,10437146,9.09
9892155,9985744,1238,433300,10419044,4.34
9892156,1186228,363,127050,1313278,10.71
9892157,6999028,3074,1075900,8074928,15.37
9892158,9979733,5296,1853600,11833333,18.57
9892159,9978886,6062,2121700,12100586,21.26
9892160,9983290,2929,1025150,11008440,10.27
9892161,9973200,2740,959000,10932200,9.62
9892162,9990926,2255,789250,10780176,7.90
9892163,9991732,5533,1936550,11928282,19.38
9892164,762004,265,92750,854754,12.17
9892165,9971456,3380,1183000,11154456,11.86
9892166,9974387,2681,938350,10912737,9.41
9892167,556372,843,295050,851422,53.03
9892168,9971603,3304,1156400,11128003,11.60
9892169,9991712,1192,417200,10408912,4.18
9892170,9982987,4221,1477350,11460337,14.80
9892171,9987548,4169,1459150,11446698,14.61
9892172,9970031,2821,987350,10957381,9.90
9892173,9991071,1734,606900,10597971,6.07
9892175,9969636,2062,721700,10691336,7.24
9892176,9945633,4560,1596000,11541633,16.05
9892177,9976478,2560,896000,10872478,8.98
9892178,93184,68,23800,116984,25.54
9892179,9967795,4352,1523200,11490995,15.28
9892180,9972699,1729,605150,10577849,6.07
9892181,1634623,1523,533050,2167673,32.61
9892182,9974614,4529,1585150,11559764,15.89
9892183,9970363,1120,392000,10362363,3.93
9892184,173975,121,42350,216325,24.34
9892185,9984997,1537,537950,10522947,5.39
9892186,9983939,4009,1403150,11387089,14.05
9892187,9989201,2438,853300,10842501,8.54
9892188,9990941,1388,485800,10476741,4.86
9892189,9968403,1390,486500,10454903,4.88
9892190,2781885,1004,351400,3133285,12.63
9892191,9965092,3491,1221850,11186942,12.26
9892192,9979337,2655,929250,10908587,9.31
9892193,9987258,1183,414050,10401308,4.15
9892194,100009,9,3150,103159,3.15
9892195,3764597,482,168700,3933297,4.48
9892196,9969101,4125,1443750,11412851,14.48
9892197,9979277,6200,2170000,12149277,21.75
9892198,9986924,883,309050,10295974,3.09
9892199,9999391,1238,433300,10432691,4.33
9892201,2161628,2326,814100,2975728,37.66
9892202,9953824,987,345450,10299274,3.47
9892203,9955757,1644,575400,10531157,5.78
9892204,9978441,774,270900,10249341,2.71
9892205,9982665,3403,1191050,11173715,11.93
9892206,165582,94,32900,198482,19.87
9892207,9991205,1927,674450,10665655,6.75
9892208,72273,19,6650,78923,9.20
9892209,9968615,3070,1074500,11043115,10.78
9892210,9977698,1370,479500,10457198,4.81
9892211,298494,167,58450,356944,19.58
9892212,649634,145,50750,700384,7.81
9892213,680241,381,133350,813591,19.60
9892214,1175981,578,202300,1378281,17.20
9892215,9952917,6333,2216550,12169467,22.27
9892216,183511,66,23100,206611,12.59
9892217,9173384,4197,1468950,10642334,16.01
9892218,9951538,1500,525000,10476538,5.28
9892220,9926561,2321,812350,10738911,8.18
9892221,9946800,3905,1366750,11313550,13.74
9892222,9951424,1014,354900,10306324,3.57
9892223,9956674,1003,351050,10307724,3.53
9892224,567173,263,92050,659223,16.23
9892225,9956169,4841,1694350,11650519,17.02
9892226,9946250,4027,1409450,11355700,14.17
9892227,614000,224,78400,692400,12.77
9892228,9932823,4616,1615600,11548423,16.27
9892229,1118163,312,109200,1227363,9.77
9892230,9928686,6186,2165100,12093786,21.81
9892231,9946897,5734,2006900,11953797,20.18
9892232,2629390,1555,544250,3173640,20.70
9892233,590952,349,122150,713102,20.67
9892234,3374985,2660,931000,4305985,27.59
9892235,9912205,6793,2377550,12289755,23.99
9892236,9924240,3791,1326850,11251090,13.37
9892238,9930201,5041,1764350,11694551,17.77
9892239,9935034,1918,671300,10606334,6.76
9892240,9939315,4659,1630650,11569965,16.41
9892241,807467,468,163800,971267,20.29
9892242,9936649,6110,2138500,12075149,21.52
9892243,9933121,5609,1963150,11896271,19.76
9892244,6581765,3790,1326500,7908265,20.15
9892245,9910278,5130,1795500,11705778,18.12
9892246,9930377,2930,1025500,10955877,10.33
9892247,9929823,4357,1524950,11454773,15.36
9892248,9944419,5177,1811950,11756369,18.22
9892249,4678826,2652,928200,5607026,19.84
9892250,4256410,2364,827400,5083810,19.44
9892251,9927485,2311,808850,10736335,8.15
9892252,9487712,5244,1835400,11323112,19.35
9892253,7724285,2898,1014300,8738585,13.13
9892254,9915871,3742,1309700,11225571,13.21
9892255,9914085,4935,1727250,11641335,17.42
9892256,8759297,5207,1822450,10581747,20.81
9892257,8766446,1402,490700,9257146,5.60
9892258,9937562,3347,1171450,11109012,11.79
9892259,9955092,4600,1610000,11565092,16.17
9892260,9967393,2553,893550,10860943,8.96
9892261,9955386,5552,1943200,11898586,19.52
9892262,9967811,765,267750,10235561,2.69
9892263,3089711,1600,560000,3649711,18.12
9892265,9944434,5621,1967350,11911784,19.78
9892266,1417134,1276,446600,1863734,31.51
9892267,9930605,1078,377300,10307905,3.80
9892268,9929118,735,257250,10186368,2.59
9892269,9932064,2628,919800,10851864,9.26
9892270,9942660,818,286300,10228960,2.88
9892271,9932066,2005,701750,10633816,7.07
9892272,9730746,3876,1356600,11087346,13.94
9892273,9951796,3242,1134700,11086496,11.40
9892274,9942991,1579,552650,10495641,5.56
9892275,9958505,712,249200,10207705,2.50
9892276,9957907,926,324100,10282007,3.25
9892277,1357783,901,315350,1673133,23.23
9892278,3057094,1832,641200,3698294,20.97
9892279,9970825,3402,1190700,11161525,11.94
9892280,9957586,703,246050,10203636,2.47
9892281,1606149,673,235550,1841699,14.67
9892282,9974036,2890,1011500,10985536,10.14
9892283,9966405,3689,1291150,11257555,12.96
9892284,300991,461,161350,462341,53.61
9892285,9981157,4067,1423450,11404607,14.26
9892286,9983812,4607,1612450,11596262,16.15
9892287,139740,113,39550,179290,28.30
9892289,9950558,4567,1598450,11549008,16.06
9892290,9960842,1925,673750,10634592,6.76
9892291,7338093,1477,516950,7855043,7.04
9892292,9935101,2170,759500,10694601,7.64
9892293,9940600,1743,610050,10550650,6.14
9892294,9931335,4426,1549100,11480435,15.60
9892295,9938766,4389,1536150,11474916,15.46
9892296,9947087,1049,367150,10314237,3.69
9892297,9970320,2139,748650,10718970,7.51
9892298,9966299,4353,1523550,11489849,15.29
9892299,9973342,5363,1877050,11850392,18.82
9892300,9981460,2609,913150,10894610,9.15
9892301,9987178,4408,1542800,11529978,15.45
9892302,402996,300,105000,507996,26.05
9892303,9967591,2524,883400,10850991,8.86
9892304,9975209,4641,1624350,11599559,16.28
9892305,9972994,3718,1301300,11274294,13.05
9892306,9982117,1766,618100,10600217,6.19
9892307,9988929,966,338100,10327029,3.38
9892308,9976167,756,264600,10240767,2.65
9892309,9987115,1431,500850,10487965,5.01
9892310,9980078,1035,362250,10342328,3.63
9892311,9983431,1779,622650,10606081,6.24
9892312,9979692,3359,1175650,11155342,11.78
9892313,9992158,1386,485100,10477258,4.85
9892314,1823040,489,171150,1994190,9.39
9892315,9998372,3949,1382150,11380522,13.82
9892316,398210,102,35700,433910,8.97
9892317,9962828,5289,1851150,11813978,18.58
9892318,1609625,1724,603400,2213025,37.49
9892319,2634479,1029,360150,2994629,13.67
9892320,5255327,2162,756700,6012027,14.40
9892321,9986661,4398,1539300,11525961,15.41
9892322,9972513,3668,1283800,11256313,12.87
9892323,322153,122,42700,364853,13.25
9892324,9987976,1888,660800,10648776,6.62
9892325,9989927,3685,1289750,11279677,12.91
9892326,9987876,4743,1660050,11647926,16.62
9892327,9975560,5247,1836450,11812010,18.41
9892328,9999015,4191,1466850,11465865,14.67
9892330,9978648,3324,1163400,11142048,11.66
9892331,9990415,4290,1501500,11491915,15.03
9892332,2321466,2624,918400,3239866,39.56
9892334,9996536,6438,2253300,12249836,22.54
9892335,9982911,912,319200,10302111,3.20
9892336,5947152,1706,597100,6544252,10.04
9892337,9979942,3097,1083950,11063892,10.86
9892338,9991266,2772,970200,10961466,9.71
9892339,9991524,5532,1936200,11927724,19.38
9892340,9982859,1259,440650,10423509,4.41
9892341,9964640,6005,2101750,12066390,21.09
9892342,9973032,5666,1983100,11956132,19.88
9892343,9983366,3735,1307250,11290616,13.09
9892344,9993819,4625,1618750,11612569,16.20
9892345,9986713,1556,544600,10531313,5.45
9892346,4095961,2107,737450,4833411,18.00
9892347,1167275,375,131250,1298525,11.24
9892348,9964703,2470,864500,10829203,8.68
9892349,9978468,2506,877100,10855568,8.79
9892350,1571232,498,174300,1745532,11.09
9892351,9983207,4015,1405250,11388457,14.08
9892352,9983047,3984,1394400,11377447,13.97
9892353,1193332,109,38150,1231482,3.20
9892354,9985615,4513,1579550,11565165,15.82
9892355,9988077,4683,1639050,11627127,16.41
9892356,9980561,1331,465850,10446411,4.67
9892357,1190145,1524,533400,1723545,44.82
9892358,9990237,4661,1631350,11621587,16.33
9892359,229898,99,34650,264548,15.07
9892360,9556231,4117,1440950,10997181,15.08
9892361,493212,230,80500,573712,16.32
9892362,9971719,4476,1566600,11538319,15.71
9892364,72273,19,6650,78923,9.20
9892365,9944078,3869,1354150,11298228,13.62
9892366,9966477,4595,1608250,11574727,16.14
9892367,9943687,4906,1717100,11660787,17.27
9892368,9930617,3229,1130150,11060767,11.38
9892369,9936164,1347,471450,10407614,4.74
9892371,9923947,1740,609000,10532947,6.14
9892372,9928446,6394,2237900,12166346,22.54
9892373,9932635,3872,1355200,11287835,13.64
9892374,9724211,3455,1209250,10933461,12.44
9892375,9746585,494,172900,9919485,1.77
9892376,9936689,1285,449750,10386439,4.53
9892377,2692049,1694,592900,3284949,22.02
9892378,9913430,3895,1363250,11276680,13.75
9892379,9924490,2170,759500,10683990,7.65
9892380,9885868,3066,1073100,10958968,10.85
9892381,9928181,707,247450,10175631,2.49
9892382,9939990,607,212450,10152440,2.14
9892383,9937849,692,242200,10180049,2.44
9892384,9933997,2406,842100,10776097,8.48
9892385,9939510,4285,1499750,11439260,15.09
9892386,9959023,3835,1342250,11301273,13.48
9892387,9960547,3265,1142750,11103297,11.47
9892388,9955418,1922,672700,10628118,6.76
9892389,3397620,2015,705250,4102870,20.76
9892390,80285,103,36050,116335,44.90
9892391,9983964,2913,1019550,11003514,10.21
9892392,9729670,887,310450,10040120,3.19
9892393,9977591,3512,1229200,11206791,12.32
9892394,9984489,608,212800,10197289,2.13
9892395,1184137,954,333900,1518037,28.20
9892396,9966415,1527,534450,10500865,5.36
9892397,1383047,404,141400,1524447,10.22
9892398,5405193,1481,518350,5923543,9.59
9892399,9969709,3541,1239350,11209059,12.43
9892400,9962368,2713,949550,10911918,9.53
9892401,9970468,2515,880250,10850718,8.83
9892403,5634216,3569,1249150,6883366,22.17
9892404,3139987,833,291550,3431537,9.29
9892405,9982501,3527,1234450,11216951,12.37
9892406,9963412,3961,1386350,11349762,13.91
9892407,9973820,1168,408800,10382620,4.10
9892408,9990395,2172,760200,10750595,7.61
9892409,9967310,931,325850,10293160,3.27
9892410,9965563,5598,1959300,11924863,19.66
9892411,9957661,3553,1243550,11201211,12.49
9892412,9968531,630,220500,10189031,2.21
9892413,9960611,1160,406000,10366611,4.08
9892414,9978806,1961,686350,10665156,6.88
9892415,413184,193,67550,480734,16.35
9892416,314909,129,45150,360059,14.34
9892417,9973961,2632,921200,10895161,9.24
9892418,9985567,2535,887250,10872817,8.89
9892419,9976901,3890,1361500,11338401,13.65
9892420,9979573,3360,1176000,11155573,11.78
9892422,9974174,3493,1222550,11196724,12.26
9892423,9964754,728,254800,10219554,2.56
9892424,9978729,4518,1581300,11560029,15.85
9892425,88325,36,12600,100925,14.27
9892426,9967950,4411,1543850,11511800,15.49
9892427,9979423,1392,487200,10466623,4.88
9892428,9952104,1591,556850,10508954,5.60
9892429,5719143,1763,617050,6336193,10.79
9892430,9973216,2162,756700,10729916,7.59
9892431,9977063,996,348600,10325663,3.49
9892432,9979474,2117,740950,10720424,7.42
9892433,9985731,698,244300,10230031,2.45
9892434,9883152,2051,717850,10601002,7.26
9892435,94297,19,6650,100947,7.05
9892436,9964088,970,339500,10303588,3.41
9892437,9941861,1418,496300,10438161,4.99
9892438,9962948,1295,453250,10416198,4.55
9892439,9950601,997,348950,10299551,3.51
9892440,9942318,3261,1141350,11083668,11.48
9892441,9931899,4206,1472100,11403999,14.82
9892442,9955421,2916,1020600,10976021,10.25
9892443,9958269,517,180950,10139219,1.82
9892444,9964784,3555,1244250,11209034,12.49
9892445,9983017,8333,2916550,12899567,29.22
9892447,9978992,2606,912100,10891092,9.14
9892448,9955341,1052,368200,10323541,3.70
9892450,9977912,3711,1298850,11276762,13.02
9892451,9711601,5138,1798300,11509901,18.52
9892452,9994976,5391,1886850,11881826,18.88
9892453,1862564,105,36750,1899314,1.97
9892454,9980698,3790,1326500,11307198,13.29
9892455,9978399,5269,1844150,11822549,18.48
9892456,9979143,2343,820050,10799193,8.22
9892457,9982937,3283,1149050,11131987,11.51
9892458,9969637,5271,1844850,11814487,18.50
9892459,9976416,5264,1842400,11818816,18.47
9892460,9981323,5746,2011100,11992423,20.15
9892461,9985799,2747,961450,10947249,9.63
9892462,9966486,3305,1156750,11123236,11.61
9892463,133052,61,21350,154402,16.05
9892464,1906071,959,335650,2241721,17.61
9892465,9983332,4392,1537200,11520532,15.40
9892466,9994278,4075,1426250,11420528,14.27
9892467,9969079,7250,2537500,12506579,25.45
9892468,9991808,3426,1199100,11190908,12.00
9892469,640661,840,294000,934661,45.89
9892470,9988890,5026,1759100,11747990,17.61
9892471,9995690,3936,1377600,11373290,13.78
9892472,341291,134,46900,388191,13.74
9892473,9966319,6219,2176650,12142969,21.84
9892474,9763511,5779,2022650,11786161,20.72
9892475,9985095,2872,1005200,10990295,10.07
9892476,9977669,1216,425600,10403269,4.27
9892477,9911170,4623,1618050,11529220,16.33
9892478,9978616,5015,1755250,11733866,17.59
9892479,9984975,4819,1686650,11671625,16.89
9892480,970495,981,343350,1313845,35.38
9892481,197095,63,22050,219145,11.19
9892482,9974872,5424,1898400,11873272,19.03
9892483,9979633,3848,1346800,11326433,13.50
9892484,9985205,4861,1701350,11686555,17.04
9892485,9987822,4804,1681400,11669222,16.83
9892486,727795,405,141750,869545,19.48
9892487,632089,319,111650,743739,17.66
9892488,9970408,3447,1206450,11176858,12.10
9892489,1662247,927,324450,1986697,19.52
9892490,1038030,791,276850,1314880,26.67
9892491,9984950,2037,712950,10697900,7.14
9892492,480453,244,85400,565853,17.77
9892493,9969850,4246,1486100,11455950,14.91
9892494,9982498,4158,1455300,11437798,14.58
9892495,9984142,3522,1232700,11216842,12.35
9892496,9994996,5031,1760850,11755846,17.62
9892497,9983190,3083,1079050,11062240,10.81
9892498,9977964,2701,945350,10923314,9.47
9892499,1709389,585,204750,1914139,11.98
9892500,9944205,5464,1912400,11856605,19.23
9892501,9937865,2397,838950,10776815,8.44
9892502,9922471,4194,1467900,11390371,14.79
9892503,9944632,3264,1142400,11087032,11.49
9892504,451200,219,76650,527850,16.99
9892505,9941903,3286,1150100,11092003,11.57
9892506,9935649,3894,1362900,11298549,13.72
9892507,1741894,538,188300,1930194,10.81
9892508,9899032,3643,1275050,11174082,12.88
9892509,6679951,3725,1303750,7983701,19.52
9892510,9926123,5238,1833300,11759423,18.47
9892511,9917068,2340,819000,10736068,8.26
9892512,9942804,3227,1129450,11072254,11.36
9892513,9951070,5867,2053450,12004520,20.64
9892514,9942936,2392,837200,10780136,8.42
9892515,1224931,1003,351050,1575981,28.66
9892516,9936886,4711,1648850,11585736,16.59
9892517,9926498,4566,1598100,11524598,16.10
9892518,52358,24,8400,60758,16.04
9892519,8098821,3978,1392300,9491121,17.19
9892520,9898786,4160,1456000,11354786,14.71
9892521,9901617,5745,2010750,11912367,20.31
9892522,9901525,2898,1014300,10915825,10.24
9892523,9913448,3789,1326150,11239598,13.38
9892525,9926087,4328,1514800,11440887,15.26
9892526,459813,212,74200,534013,16.14
9892527,9929334,3772,1320200,11249534,13.30
9892528,102818,44,15400,118218,14.98
9892529,9903617,2819,986650,10890267,9.96
9892530,9911394,779,272650,10184044,2.75
9892531,9922380,3809,1333150,11255530,13.44
9892532,9925235,2344,820400,10745635,8.27
9892533,9925277,1954,683900,10609177,6.89
9892534,9943182,4648,1626800,11569982,16.36
9892535,9931562,3891,1361850,11293412,13.71
9892536,9943574,4187,1465450,11409024,14.74
9892537,9962903,3334,1166900,11129803,11.71
9892538,9970238,2607,912450,10882688,9.15
9892539,9950867,3298,1154300,11105167,11.60
9892540,9972293,3702,1295700,11267993,12.99
9892541,1953773,269,94150,2047923,4.82
9892542,9954715,4193,1467550,11422265,14.74
9892543,9949083,3353,1173550,11122633,11.80
9892544,9956886,2659,930650,10887536,9.35
9892545,9943670,2861,1001350,10945020,10.07
9892546,9953249,1647,576450,10529699,5.79
9892547,9962485,2103,736050,10698535,7.39
9892548,9976722,3098,1084300,11061022,10.87
9892549,9975892,5305,1856750,11832642,18.61
9892550,9992655,6716,2350600,12343255,23.52
9892551,9982057,2866,1003100,10985157,10.05
9892552,9896896,5219,1826650,11723546,18.46
9892553,9975868,5179,1812650,11788518,18.17
9892554,9970582,3052,1068200,11038782,10.71
9892555,7061950,515,180250,7242200,2.55
9892556,9981069,2023,708050,10689119,7.09
9892557,9990274,4221,1477350,11467624,14.79
9892558,2622307,2271,794850,3417157,30.31
9892559,9979680,4057,1419950,11399630,14.23
9892560,4217929,3177,1111950,5329879,26.36
9892561,9971143,5392,1887200,11858343,18.93
9892562,9968838,3082,1078700,11047538,10.82
9892563,1331451,562,196700,1528151,14.77
9892564,9944534,3266,1143100,11087634,11.49
9892565,9946061,2985,1044750,10990811,10.50
9892566,9961728,4006,1402100,11363828,14.07
9892567,57931,25,8750,66681,15.10
9892568,9853666,4186,1465100,11318766,14.87
9892569,9940033,5229,1830150,11770183,18.41
9892570,9927944,1340,469000,10396944,4.72
9892571,7451591,4344,1520400,8971991,20.40
9892572,9943640,4987,1745450,11689090,17.55
9892573,311134,142,49700,360834,15.97
9892574,9920615,3896,1363600,11284215,13.75
9892575,5467151,2845,995750,6462901,18.21
9892576,9926489,4120,1442000,11368489,14.53
9892577,9832872,3199,1119650,10952522,11.39
9892578,9928115,5328,1864800,11792915,18.78
9892579,9869624,3668,1283800,11153424,13.01
9892580,2490014,529,185150,2675164,7.44
9892581,9903693,3741,1309350,11213043,13.22
9892582,209902,48,16800,226702,8.00
9892583,9891226,851,297850,10189076,3.01
9892584,9380936,2678,937300,10318236,9.99
9892585,9899958,3570,1249500,11149458,12.62
9892586,9908799,4530,1585500,11494299,16.00
9892587,9912636,2068,723800,10636436,7.30
9892588,9925465,4406,1542100,11467565,15.54
9892589,9917909,2665,932750,10850659,9.40
9892590,9929924,2618,916300,10846224,9.23
9892591,9934502,3180,1113000,11047502,11.20
9892592,652178,334,116900,769078,17.92
9892593,9675786,4150,1452500,11128286,15.01
9892594,9940602,3940,1379000,11319602,13.87
9892595,908422,484,169400,1077822,18.65
9892596,1525386,991,346850,1872236,22.74
9892597,9940901,4720,1652000,11592901,16.62
9892598,1638487,1024,358400,1996887,21.87
9892599,3144116,1972,690200,3834316,21.95
9892600,9947099,5044,1765400,11712499,17.75
9892601,4166347,1882,658700,4825047,15.81
9892602,1111135,400,140000,1251135,12.60
9892603,5811397,3393,1187550,6998947,20.43
9892604,9925951,3378,1182300,11108251,11.91
9892605,2823896,1057,369950,3193846,13.10
9892606,9913508,4322,1512700,11426208,15.26
9892607,9928262,2815,985250,10913512,9.92
9892608,9922848,5770,2019500,11942348,20.35
9892609,9931589,5652,1978200,11909789,19.92
9892610,9934815,4460,1561000,11495815,15.71
9892611,9923161,4369,1529150,11452311,15.41
9892612,2252140,1832,641200,2893340,28.47
9892613,9952324,2940,1029000,10981324,10.34
9892614,9950970,3667,1283450,11234420,12.90
9892615,9960281,3348,1171800,11132081,11.76
9892616,9981064,3628,1269800,11250864,12.72
9892617,4159153,1437,502950,4662103,12.09
9892618,158478,114,39900,198378,25.18
9892619,3989271,2266,793100,4782371,19.88
9892620,9946664,3473,1215550,11162214,12.22
9892621,9955303,2678,937300,10892603,9.42
9892622,9938662,1608,562800,10501462,5.66
9892623,1149216,833,291550,1440766,25.37
9892624,9940429,4014,1404900,11345329,14.13
9892625,9956560,869,304150,10260710,3.05
9892626,9950389,1818,636300,10586689,6.39
9892627,9961616,1536,537600,10499216,5.40
9892628,9953310,1392,487200,10440510,4.89
9892629,9967090,1361,476350,10443440,4.78
9892630,9965957,3897,1363950,11329907,13.69
9892631,259540,89,31150,290690,12.00
9892632,9978891,5892,2062200,12041091,20.67
9892633,951265,982,343700,1294965,36.13
9892634,9967042,4510,1578500,11545542,15.84
9892635,9827886,5830,2040500,11868386,20.76
9892636,9965402,3956,1384600,11350002,13.89
9892637,9998036,1195,418250,10416286,4.18
9892638,3190900,1484,519400,3710300,16.28
9892639,779276,162,56700,835976,7.28
9892640,1734948,609,213150,1948098,12.29
9892641,9941937,2214,774900,10716837,7.79
9892642,9978783,1215,425250,10404033,4.26
9892643,9982047,5393,1887550,11869597,18.91
9892644,9977854,1717,600950,10578804,6.02
9892645,7127747,5190,1816500,8944247,25.48
9892646,9984651,6271,2194850,12179501,21.98
9892647,635340,786,275100,910440,43.30
9892648,4023256,1735,607250,4630506,15.09
9892650,7980887,2640,924000,8904887,11.58
9892651,9915876,5509,1928150,11844026,19.45
9892652,9932759,3672,1285200,11217959,12.94
9892653,9941013,3186,1115100,11056113,11.22
9892654,9951806,4234,1481900,11433706,14.89
9892655,9944739,3292,1152200,11096939,11.59
9892656,9967675,2497,873950,10841625,8.77
9892657,4908420,1778,622300,5530720,12.68
9892658,9971999,4996,1748600,11720599,17.54
9892659,9972436,938,328300,10300736,3.29
9892660,9975916,3643,1275050,11250966,12.78
9892661,9994286,5001,1750350,11744636,17.51
9892662,1715555,856,299600,2015155,17.46
9892663,9963289,4424,1548400,11511689,15.54
9892664,9983616,3365,1177750,11161366,11.80
9892665,2452200,1033,361550,2813750,14.74
9892666,9967839,3985,1394750,11362589,13.99
9892667,9978501,5363,1877050,11855551,18.81
9892668,9968827,4148,1451800,11420627,14.56
9892669,9967505,2759,965650,10933155,9.69
9892670,9982455,3748,1311800,11294255,13.14
9892671,9997510,1232,431200,10428710,4.31
9892672,9986001,2938,1028300,11014301,10.30
9892673,623142,250,87500,710642,14.04
9892674,1720343,489,171150,1891493,9.95
9892675,9978832,4857,1699950,11678782,17.04
9892676,9984774,1064,372400,10357174,3.73
9892677,9989852,2207,772450,10762302,7.73
9892678,1043394,598,209300,1252694,20.06
9892679,9984185,3276,1146600,11130785,11.48
9892680,231665,93,32550,264215,14.05
9892681,9960949,4164,1457400,11418349,14.63
9892682,537023,207,72450,609473,13.49
9892683,5076320,1494,522900,5599220,10.30
9892684,9975204,2337,817950,10793154,8.20
9892685,9952593,1179,412650,10365243,4.15
9892686,9963137,4089,1431150,11394287,14.36
9892687,194492,128,44800,239292,23.03
9892688,9942306,1240,434000,10376306,4.37
9892689,9941509,3189,1116150,11057659,11.23
9892690,386445,48,16800,403245,4.35
9892691,9891989,2419,846650,10738639,8.56
9892692,9924943,3710,1298500,11223443,13.08
9892693,9944810,2630,920500,10865310,9.26
9892694,9951333,1340,469000,10420333,4.71
9892695,9939598,2773,970550,10910148,9.76
9892696,2685629,1451,507850,3193479,18.91
9892697,9948603,2791,976850,10925453,9.82
9892698,9972790,1759,615650,10588440,6.17
9892700,9982043,3715,1300250,11282293,13.03
9892701,9979599,2888,1010800,10990399,10.13
9892702,9984906,534,186900,10171806,1.87
9892703,9972151,5435,1902250,11874401,19.08
9892704,9995359,6441,2254350,12249709,22.55
9892705,9977335,5837,2042950,12020285,20.48
9892706,171127,84,29400,200527,17.18
9892707,4885838,1754,613900,5499738,12.56
9892708,333336,129,45150,378486,13.54
9892709,9967146,5182,1813700,11780846,18.20
9892710,1609263,859,300650,1909913,18.68
9892711,9956910,3920,1372000,11328910,13.78
9892712,5660494,1731,605850,6266344,10.70
9892713,9959066,4956,1734600,11693666,17.42
9892714,9971543,3859,1350650,11322193,13.55
9892715,9947642,3472,1215200,11162842,12.22
9892716,9977129,5124,1793400,11770529,17.98
9892717,966379,835,292250,1258629,30.24
9892718,9966778,4139,1448650,11415428,14.53
9892719,9965038,1339,468650,10433688,4.70
9892720,9976194,6494,2272900,12249094,22.78
9892721,1947049,1629,570150,2517199,29.28
9892722,9973480,1680,588000,10561480,5.90
9892723,9978428,1190,416500,10394928,4.17
9892724,100612,69,24150,124762,24.00
9892725,9975078,3940,1379000,11354078,13.82
9892726,9994897,2607,912450,10907347,9.13
9892727,964466,603,211050,1175516,21.88
9892728,9966278,3827,1339450,11305728,13.44
9892729,9984771,4690,1641500,11626271,16.44
9892730,9967366,2937,1027950,10995316,10.31
9892731,9958552,4792,1677200,11635752,16.84
9892732,154602,158,55300,209902,35.77
9892733,9949077,1679,587650,10536727,5.91
9892734,9954137,3698,1294300,11248437,13.00
9892735,9956844,2910,1018500,10975344,10.23
9892736,9968962,1292,452200,10421162,4.54
9892737,9968689,3707,1297450,11266139,13.02
9892738,9974624,1024,358400,10333024,3.59
9892739,9873479,4261,1491350,11364829,15.10
9892740,9994834,702,245700,10240534,2.46
9892741,9984736,2943,1030050,11014786,10.32
9892742,9956744,1395,488250,10444994,4.90
9892743,9981719,1957,684950,10666669,6.86
9892744,9970516,379,132650,10103166,1.33
9892745,9983232,1958,685300,10668532,6.86
9892746,9979857,1122,392700,10372557,3.93
9892747,9974884,2511,878850,10853734,8.81
9892748,9975183,481,168350,10143533,1.69
9892749,9975379,1172,410200,10385579,4.11
9892750,1326042,892,312200,1638242,23.54
9892751,5480202,3312,1159200,6639402,21.15
9892752,9966628,4133,1446550,11413178,14.51
9892753,9950084,7020,2457000,12407084,24.69
9892754,9967789,3921,1372350,11340139,13.77
9892755,9947141,7244,2535400,12482541,25.49
9892758,9934697,4714,1649900,11584597,16.61
9892759,1371087,1221,427350,1798437,31.17
9892760,9933851,6031,2110850,12044701,21.25
9892761,9932843,4353,1523550,11456393,15.34
9892762,9949635,3317,1160950,11110585,11.67
9892763,9955116,4989,1746150,11701266,17.54
9892764,9957195,5523,1933050,11890245,19.41
9892765,9962044,2158,755300,10717344,7.58
9892766,9949716,1904,666400,10616116,6.70
9892767,9991584,1700,595000,10586584,5.96
9892768,9988368,2436,852600,10840968,8.54
9892769,9977487,1164,407400,10384887,4.08
9892770,9990264,729,255150,10245414,2.55
9892771,9989216,6042,2114700,12103916,21.17
9892772,9987027,3676,1286600,11273627,12.88
9892773,9994713,3158,1105300,11100013,11.06
9892774,9982037,1031,360850,10342887,3.61
9892775,9988165,1070,374500,10362665,3.75
9892776,9991627,2563,897050,10888677,8.98
9892777,9973566,5576,1951600,11925166,19.57
9892778,9975172,2705,946750,10921922,9.49
9892779,1140167,342,119700,1259867,10.50
9892780,9984952,4127,1444450,11429402,14.47
9892781,9987101,3566,1248100,11235201,12.50
9892782,9980113,3361,1176350,11156463,11.79
9892783,9979990,2774,970900,10950890,9.73
9892784,9975012,1861,651350,10626362,6.53
9892785,9978198,2358,825300,10803498,8.27
9892786,9985316,4344,1520400,11505716,15.23
9892787,9954979,6046,2116100,12071079,21.26
9892788,1462607,307,107450,1570057,7.35
9892789,3158261,1473,515550,3673811,16.32
9892790,9955701,3349,1172150,11127851,11.77
9892792,9952290,3126,1094100,11046390,10.99
9892793,9967291,1157,404950,10372241,4.06
9892794,9957605,1023,358050,10315655,3.60
9892795,9948177,2274,795900,10744077,8.00
9892796,462033,194,67900,529933,14.70
9892797,9954004,1557,544950,10498954,5.47
9892798,9944728,2855,999250,10943978,10.05
9892799,9945415,4518,1581300,11526715,15.90
9892800,9962094,1905,666750,10628844,6.69
9892801,2907159,942,329700,3236859,11.34
9892802,9962360,3611,1263850,11226210,12.69
9892803,9965321,2347,821450,10786771,8.24
9892804,2454393,460,161000,2615393,6.56
9892805,1404729,320,112000,1516729,7.97
9892806,9963435,2865,1002750,10966185,10.06
9892807,9982639,3463,1212050,11194689,12.14
9892808,9951779,1908,667800,10619579,6.71
9892809,9975726,3005,1051750,11027476,10.54
9892810,9962287,4078,1427300,11389587,14.33
9892811,9978277,5441,1904350,11882627,19.08
9892812,9991799,1073,375550,10367349,3.76
9892813,9982775,2012,704200,10686975,7.05
9892814,9986070,1979,692650,10678720,6.94
9892815,9987624,2581,903350,10890974,9.04
9892816,9981928,2449,857150,10839078,8.59
9892817,9990073,971,339850,10329923,3.40
9892818,9972666,3173,1110550,11083216,11.14
9892819,9978181,1056,369600,10347781,3.70
9892820,9991893,1342,469700,10461593,4.70
9892821,9974057,1123,393050,10367107,3.94
9892822,3303931,1572,550200,3854131,16.65
9892823,9982334,1702,595700,10578034,5.97
9892824,4808041,1988,695800,5503841,14.47
9892825,9987319,3798,1329300,11316619,13.31
9892826,634285,371,129850,764135,20.47
9892827,9656498,3596,1258600,10915098,13.03
9892828,9954884,3063,1072050,11026934,10.77
9892829,9956835,5271,1844850,11801685,18.53
9892830,9957712,5968,2088800,12046512,20.98
9892831,9977815,1835,642250,10620065,6.44
9892832,4492044,1816,635600,5127644,14.15
9892833,9964655,5432,1901200,11865855,19.08
9892834,9968442,5760,2016000,11984442,20.22
9892835,9973072,3336,1167600,11140672,11.71
9892836,2281809,1599,559650,2841459,24.53
9892837,1962744,734,256900,2219644,13.09
9892838,9969178,5588,1955800,11924978,19.62
9892839,9989025,1715,600250,10589275,6.01
9892840,118406,42,14700,133106,12.41
9892841,9978939,3041,1064350,11043289,10.67
9892842,9977950,3469,1214150,11192100,12.17
9892843,318413,93,32550,350963,10.22
9892844,2402220,896,313600,2715820,13.05
9892845,1925924,2426,849100,2775024,44.09
9892846,9995871,5457,1909950,11905821,19.11
9892847,9993025,3828,1339800,11332825,13.41
9892848,9990841,3236,1132600,11123441,11.34
9892849,9969972,2479,867650,10837622,8.70
9892851,9980414,3818,1336300,11316714,13.39
9892852,1550751,1157,404950,1955701,26.11
9892853,9989106,1960,686000,10675106,6.87
9892854,9992366,500,175000,10167366,1.75
9892855,9989194,2816,985600,10974794,9.87
9892856,9991202,577,201950,10193152,2.02
9892857,859248,1173,410550,1269798,47.78
9892858,9974935,6453,2258550,12233485,22.64
9892859,9988129,2093,732550,10720679,7.33
9892860,9973413,4501,1575350,11548763,15.80
9892861,9993239,5824,2038400,12031639,20.40
9892862,9986252,5011,1753850,11740102,17.56
9892863,9993408,6358,2225300,12218708,22.27
9892864,9980348,5354,1873900,11854248,18.78
9892865,9986579,3508,1227800,11214379,12.29
9892866,9967281,4345,1520750,11488031,15.26
9892867,6224397,5152,1803200,8027597,28.97
9892868,9869831,5822,2037700,11907531,20.65
9892869,9965035,4853,1698550,11663585,17.05
9892870,9989051,5174,1810900,11799951,18.13
9892871,5143930,3318,1161300,6305230,22.58
9892872,9982831,5869,2054150,12036981,20.58
9892873,9959894,5988,2095800,12055694,21.04
9892874,7322108,3041,1064350,8386458,14.54
9892875,4940070,4093,1432550,6372620,29.00
9892876,9979908,7785,2724750,12704658,27.30
9892877,9992332,2735,957250,10949582,9.58
9892878,4273980,2123,743050,5017030,17.39
9892879,9981166,5408,1892800,11873966,18.96
9892880,9977261,5524,1933400,11910661,19.38
9892881,9983913,4820,1687000,11670913,16.90
9892882,9979904,2859,1000650,10980554,10.03
9892883,9976172,3028,1059800,11035972,10.62
9892884,9994606,5699,1994650,11989256,19.96
9892885,9985067,2602,910700,10895767,9.12
9892886,9965125,3093,1082550,11047675,10.86
9892887,9861579,4541,1589350,11450929,16.12
9892888,9958690,3460,1211000,11169690,12.16
9892889,9968725,6483,2269050,12237775,22.76
9892890,9974694,2957,1034950,11009644,10.38
9892891,9987889,5544,1940400,11928289,19.43
9892892,9987787,2762,966700,10954487,9.68
9892893,7492351,4384,1534400,9026751,20.48
9892894,9962896,4904,1716400,11679296,17.23
9892895,9965930,4076,1426600,11392530,14.31
9892896,9727402,5746,2011100,11738502,20.67
9892897,9982319,4745,1660750,11643069,16.64
9892898,9957256,4672,1635200,11592456,16.42
9892899,9674315,3935,1377250,11051565,14.24
9892900,9953684,5606,1962100,11915784,19.71
9892901,9958937,2157,754950,10713887,7.58
9892902,9974219,4315,1510250,11484469,15.14
9892903,9978679,4973,1740550,11719229,17.44
9892904,9993765,6253,2188550,12182315,21.90
9892905,9975009,4327,1514450,11489459,15.18
9892906,9990286,5543,1940050,11930336,19.42
9892907,9989502,6924,2423400,12412902,24.26
9892908,9976262,5749,2012150,11988412,20.17
9892909,9981206,4631,1620850,11602056,16.24
9892910,9979773,8464,2962400,12942173,29.68
9892911,9994406,4037,1412950,11407356,14.14
9892912,5442558,4021,1407350,6849908,25.86
9892913,9968034,6803,2381050,12349084,23.89
9892914,9963716,1921,672350,10636066,6.75
9892915,4889877,3033,1061550,5951427,21.71
9892916,9959001,5851,2047850,12006851,20.56
9892917,1416539,644,225400,1641939,15.91
9892918,9924645,4843,1695050,11619695,17.08
9892919,9937601,5253,1838550,11776151,18.50
9892920,9927289,4659,1630650,11557939,16.43
9892921,9928638,4282,1498700,11427338,15.09
9892922,9940182,5117,1790950,11731132,18.02
9892923,9919198,2621,917350,10836548,9.25
9892924,9926247,5625,1968750,11894997,19.83
9892925,9921546,6353,2223550,12145096,22.41
9892926,9924858,5644,1975400,11900258,19.90
9892927,9941561,2973,1040550,10982111,10.47
9892928,9956573,1433,501550,10458123,5.04
9892929,9952196,925,323750,10275946,3.25
9892931,9931228,535,187250,10118478,1.89
9892932,9923377,1241,434350,10357727,4.38
9892933,9898315,506,177100,10075415,1.79
9892934,9887051,1962,686700,10573751,6.95
9892935,9904923,1313,459550,10364473,4.64
9892937,9884379,2371,829850,10714229,8.40
9892938,9867453,2071,724850,10592303,7.35
9892939,9907167,2101,735350,10642517,7.42
9892940,9909989,2360,826000,10735989,8.34
9892941,9897033,840,294000,10191033,2.97
9892942,9903533,1662,581700,10485233,5.87
9892944,9899712,1932,676200,10575912,6.83
9892945,9924094,3129,1095150,11019244,11.04
9892947,9916252,3055,1069250,10985502,10.78
9892948,9917918,4011,1403850,11321768,14.15
9892949,9924241,5884,2059400,11983641,20.75
9892950,9026263,6006,2102100,11128363,23.29
9892951,9952807,3869,1354150,11306957,13.61
9892952,9968078,4871,1704850,11672928,17.10
9892953,9953132,6923,2423050,12376182,24.34
9892954,9953162,5003,1751050,11704212,17.59
9892955,9964557,2708,947800,10912357,9.51
9892956,9987409,2629,920150,10907559,9.21
9892957,9989505,3831,1340850,11330355,13.42
9892958,9821844,4026,1409100,11230944,14.35
9892959,9973891,5680,1988000,11961891,19.93
9892960,9987075,4923,1723050,11710125,17.25
9892961,9990726,5710,1998500,11989226,20.00
9892962,9973778,3791,1326850,11300628,13.30
9892963,9991862,3181,1113350,11105212,11.14
9892964,2769804,2186,765100,3534904,27.62
9892965,9960748,1697,593950,10554698,5.96
9892966,9956702,988,345800,10302502,3.47
9892967,9973061,1155,404250,10377311,4.05
9892968,9954825,1289,451150,10405975,4.53
9892969,9960765,2056,719600,10680365,7.22
9892970,9967819,1461,511350,10479169,5.13
9892971,9957223,4633,1621550,11578773,16.29
9892972,9950581,1242,434700,10385281,4.37
9892973,9977370,1180,413000,10390370,4.14
9892974,9960337,1426,499100,10459437,5.01
9892975,9973471,4814,1684900,11658371,16.89
9892976,9969322,6172,2160200,12129522,21.67
9892977,9961073,4544,1590400,11551473,15.97
9892978,9955503,4416,1545600,11501103,15.53
9892979,9979353,5763,2017050,11996403,20.21
9892980,9979318,4472,1565200,11544518,15.68
9892981,9779979,4175,1461250,11241229,14.94
9892982,9784555,4570,1599500,11384055,16.35
9892983,9958989,3165,1107750,11066739,11.12
9892984,9970179,3943,1380050,11350229,13.84
9892985,9955058,6170,2159500,12114558,21.69
9892986,9967723,4648,1626800,11594523,16.32
9892987,9972150,4410,1543500,11515650,15.48
9892988,9988082,4534,1586900,11574982,15.89
9892989,9979564,4003,1401050,11380614,14.04
9892990,9995382,5621,1967350,11962732,19.68
9892993,3595227,2316,810600,4405827,22.55
9892994,9982588,5506,1927100,11909688,19.30
9892995,246379,196,68600,314979,27.84
9892996,9963281,4396,1538600,11501881,15.44
9892997,9972116,5274,1845900,11818016,18.51
9892998,9981228,1822,637700,10618928,6.39
9892999,9975887,4323,1513050,11488937,15.17
9893000,9993927,2975,1041250,11035177,10.42
9893001,1735569,771,269850,2005419,15.55
9893002,9961661,299,104650,10066311,1.05
9893003,9963680,4297,1503950,11467630,15.09
9893004,9984968,5071,1774850,11759818,17.78
9893005,9978683,5348,1871800,11850483,18.76
9893006,3495991,1266,443100,3939091,12.67
9893007,9982806,3206,1122100,11104906,11.24
9893008,9993848,4777,1671950,11665798,16.73
9893009,9966853,5220,1827000,11793853,18.33
9893010,9968968,3930,1375500,11344468,13.80
9893011,9985009,1819,636650,10621659,6.38
9893012,9985017,4405,1541750,11526767,15.44
9893013,9998505,2969,1039150,11037655,10.39
9893014,9973040,6422,2247700,12220740,22.54
9893015,2352956,684,239400,2592356,10.17
9893016,9971390,2791,976850,10948240,9.80
9893017,9990992,6089,2131150,12122142,21.33
9893018,9967910,1820,637000,10604910,6.39
9893019,9951658,3678,1287300,11238958,12.94
9893020,1315396,270,94500,1409896,7.18
9893021,9942932,3582,1253700,11196632,12.61
9893022,9949480,4113,1439550,11389030,14.47
9893023,9948755,1852,648200,10596955,6.52
9893024,9932557,2947,1031450,10964007,10.38
9893025,9949217,621,217350,10166567,2.18
9893027,9940484,4988,1745800,11686284,17.56
9893028,9951733,4787,1675450,11627183,16.84
9893029,9969862,1805,631750,10601612,6.34
9893030,1999183,487,170450,2169633,8.53
9893031,9965511,2737,957950,10923461,9.61
9893032,1625639,1443,505050,2130689,31.07
9893033,9950103,5709,1998150,11948253,20.08
9893034,9957342,2937,1027950,10985292,10.32
9893035,9943751,5251,1837850,11781601,18.48
9893036,9954190,4013,1404550,11358740,14.11
9893037,9944542,4162,1456700,11401242,14.65
9893038,9959232,2843,995050,10954282,9.99
9893039,5447960,1749,612150,6060110,11.24
9893040,9941567,3929,1375150,11316717,13.83
9893041,9958191,3842,1344700,11302891,13.50
9893042,1329716,763,267050,1596766,20.08
9893043,9950560,5392,1887200,11837760,18.97
9893044,9953364,3511,1228850,11182214,12.35
9893045,9197044,4247,1486450,10683494,16.16
9893046,3799999,636,222600,4022599,5.86
9893047,9965944,5662,1981700,11947644,19.88
9893048,4789198,2751,962850,5752048,20.10
9893049,9949189,4072,1425200,11374389,14.32
9893050,9965982,5158,1805300,11771282,18.11
9893051,2350171,1651,577850,2928021,24.59
9893052,9956408,4003,1401050,11357458,14.07
9893053,9970347,3126,1094100,11064447,10.97
9893054,9951725,5368,1878800,11830525,18.88
9893055,7838518,3127,1094450,8932968,13.96
9893056,9966614,4387,1535450,11502064,15.41
9893057,2076738,1933,676550,2753288,32.58
9893058,9885930,5049,1767150,11653080,17.88
9893059,5886001,1881,658350,6544351,11.19
9893060,9987070,5950,2082500,12069570,20.85
9893061,9973467,3842,1344700,11318167,13.48
9893062,9979288,3659,1280650,11259938,12.83
9893063,9983175,3443,1205050,11188225,12.07
9893064,9982055,3738,1308300,11290355,13.11
9893065,9977313,2825,988750,10966063,9.91
9893066,9981682,1687,590450,10572132,5.92
9893067,9985486,1880,658000,10643486,6.59
9893068,9980483,4156,1454600,11435083,14.57
9893069,4823901,2061,721350,5545251,14.95
9893070,9989961,3308,1157800,11147761,11.59
9893071,9996750,2929,1025150,11021900,10.25
9893072,9985364,3792,1327200,11312564,13.29
9893073,9998437,952,333200,10331637,3.33
9893075,9990328,3931,1375850,11366178,13.77
9893076,9980385,4198,1469300,11449685,14.72
9893077,9980868,3958,1385300,11366168,13.88
9893078,9975233,2847,996450,10971683,9.99
9893079,9984388,1928,674800,10659188,6.76
9893080,9991179,5925,2073750,12064929,20.76
9893081,9974355,4372,1530200,11504555,15.34
9893082,9979021,4455,1559250,11538271,15.63
9893083,9968690,5649,1977150,11945840,19.83
9893084,3953880,1718,601300,4555180,15.21
9893085,9960907,4126,1444100,11405007,14.50
9893086,4789204,1573,550550,5339754,11.50
9893087,3941545,1358,475300,4416845,12.06
9893088,9953005,5139,1798650,11751655,18.07
9893089,9954810,3969,1389150,11343960,13.95
9893090,9943698,3423,1198050,11141748,12.05
9893091,9959819,3474,1215900,11175719,12.21
9893094,9929816,5114,1789900,11719716,18.03
9893095,4810467,1129,395150,5205617,8.21
9893096,9914352,4357,1524950,11439302,15.38
9893097,9915270,2112,739200,10654470,7.46
9893098,8349883,3576,1251600,9601483,14.99
9893099,9929226,5228,1829800,11759026,18.43
9893100,3441630,459,160650,3602280,4.67
9893101,9952280,3204,1121400,11073680,11.27
9893102,9962919,5178,1812300,11775219,18.19
9893103,9963297,4661,1631350,11594647,16.37
9893104,5498134,2069,724150,6222284,13.17
9893105,3009657,432,151200,3160857,5.02
9893106,9959879,5552,1943200,11903079,19.51
9893107,9958384,3204,1121400,11079784,11.26
9893108,9948260,2671,934850,10883110,9.40
9893109,9959550,3303,1156050,11115600,11.61
9893110,1650719,979,342650,1993369,20.76
9893111,4772439,1509,528150,5300589,11.07
9893112,9926044,3742,1309700,11235744,13.19
9893113,6695223,2464,862400,7557623,12.88
9893114,9932747,3710,1298500,11231247,13.07
9893115,9954142,5606,1962100,11916242,19.71
9893116,186275,76,26600,212875,14.28
9893117,9931238,5753,2013550,11944788,20.27
9893118,9935136,2697,943950,10879086,9.50
9893119,1311653,621,217350,1529003,16.57
9893121,9940098,4285,1499750,11439848,15.09
9893122,9932361,2766,968100,10900461,9.75
9893123,7548948,3017,1055950,8604898,13.99
9893124,9920474,4113,1439550,11360024,14.51
9893125,9940883,4814,1684900,11625783,16.95
9893126,9919239,2387,835450,10754689,8.42
9893127,9934026,750,262500,10196526,2.64
9893128,9916684,4822,1687700,11604384,17.02
9893129,9923842,3010,1053500,10977342,10.62
9893130,9909082,2852,998200,10907282,10.07
9893131,9929672,4145,1450750,11380422,14.61
9893132,9940830,986,345100,10285930,3.47
9893133,9938723,3548,1241800,11180523,12.49
9893134,9942019,774,270900,10212919,2.72
9893135,9949077,1527,534450,10483527,5.37
9893136,899708,992,347200,1246908,38.59
9893137,9935951,3831,1340850,11276801,13.49
9893138,9938216,3632,1271200,11209416,12.79
9893139,9859434,3923,1373050,11232484,13.93
9893140,9953716,4776,1671600,11625316,16.79
9893141,5595037,2611,913850,6508887,16.33
9893142,9939213,5614,1964900,11904113,19.77
9893143,9932344,3762,1316700,11249044,13.26
9893144,1446947,782,273700,1720647,18.92
9893145,9918180,4566,1598100,11516280,16.11
9893146,9907678,6629,2320150,12227828,23.42
9893147,9926202,3893,1362550,11288752,13.73
9893148,9923991,7357,2574950,12498941,25.95
9893149,9920895,2945,1030750,10951645,10.39
9893150,9936063,968,338800,10274863,3.41
9893151,9940922,644,225400,10166322,2.27
9893152,1428698,1834,641900,2070598,44.93
9893153,9920976,2702,945700,10866676,9.53
9893154,9929745,4733,1656550,11586295,16.68
9893155,9926954,4240,1484000,11410954,14.95
9893156,2195798,1799,629650,2825448,28.68
9893157,9951816,2323,813050,10764866,8.17
9893158,9940613,870,304500,10245113,3.06
9893159,9943869,4278,1497300,11441169,15.06
9893160,9969245,3890,1361500,11330745,13.66
9893161,9960816,1454,508900,10469716,5.11
9893162,9946880,3616,1265600,11212480,12.72
9893163,5541645,598,209300,5750945,3.78
9893164,9936808,3694,1292900,11229708,13.01
9893165,1133198,405,141750,1274948,12.51
9893166,9946388,3285,1149750,11096138,11.56
9893167,9929571,3730,1305500,11235071,13.15
9893168,9945848,4412,1544200,11490048,15.53
9893169,9754007,4090,1431500,11185507,14.68
9893170,418796,210,73500,492296,17.55
9893171,2338744,822,287700,2626444,12.30
9893172,9914869,3227,1129450,11044319,11.39
9893173,9925459,3387,1185450,11110909,11.94
9893175,9264258,2980,1043000,10307258,11.26
9893176,9900656,3086,1080100,10980756,10.91
9893177,9909900,4820,1687000,11596900,17.02
9893178,9928791,1550,542500,10471291,5.46
9893179,9917167,1727,604450,10521617,6.09
9893180,3055815,1153,403550,3459365,13.21
9893181,8259702,3413,1194550,9454252,14.46
9893182,9951957,5965,2087750,12039707,20.98
9893183,9946900,2162,756700,10703600,7.61
9893184,9962529,2735,957250,10919779,9.61
9893185,9968522,4346,1521100,11489622,15.26
9893186,4465050,1940,679000,5144050,15.21
9893187,9949610,2987,1045450,10995060,10.51
9893188,9948449,3423,1198050,11146499,12.04
9893189,9945947,3779,1322650,11268597,13.30
9893190,9941338,3185,1114750,11056088,11.21
9893191,5242393,1245,435750,5678143,8.31
9893193,9956830,4869,1704150,11660980,17.12
9893194,9931098,5267,1843450,11774548,18.56
9893195,9928986,4081,1428350,11357336,14.39
9893197,9933348,3943,1380050,11313398,13.89
9893198,9936934,3832,1341200,11278134,13.50
9893199,9933267,4240,1484000,11417267,14.94
9893200,9946096,6346,2221100,12167196,22.33
9893201,3560262,657,229950,3790212,6.46
9893202,9947133,4119,1441650,11388783,14.49
9893203,9931985,4933,1726550,11658535,17.38
9893204,9923564,4996,1748600,11672164,17.62
9893205,9933738,2869,1004150,10937888,10.11
9893206,9838740,5196,1818600,11657340,18.48
9893207,9892799,5770,2019500,11912299,20.41
9893208,9914914,2472,865200,10780114,8.73
9893209,9916787,3773,1320550,11237337,13.32
9893210,9920682,3718,1301300,11221982,13.12
9893211,775018,970,339500,1114518,43.81
9893213,9911050,4712,1649200,11560250,16.64
9893214,9910208,7383,2584050,12494258,26.07
9893215,9920491,3994,1397900,11318391,14.09
9893216,9933091,2029,710150,10643241,7.15
9893217,977799,437,152950,1130749,15.64
9893218,9907426,5191,1816850,11724276,18.34
9893219,9907338,3817,1335950,11243288,13.48
9893220,9895510,2688,940800,10836310,9.51
9893221,9885993,5066,1773100,11659093,17.94
9893223,798785,907,317450,1116235,39.74
9893224,9870668,4434,1551900,11422568,15.72
9893225,9878707,3744,1310400,11189107,13.26
9893226,9888515,3791,1326850,11215365,13.42
9893227,9881891,2268,793800,10675691,8.03
9893228,9890110,4257,1489950,11380060,15.07
9893229,9899070,4188,1465800,11364870,14.81
9893230,9904451,2867,1003450,10907901,10.13
9893231,8601566,2581,903350,9504916,10.50
9893232,9919767,4242,1484700,11404467,14.97
9893233,8927262,6470,2264500,11191762,25.37
9893234,9925332,3077,1076950,11002282,10.85
9893235,9935099,4722,1652700,11587799,16.63
9893236,9942402,3902,1365700,11308102,13.74
9893238,9709453,667,233450,9942903,2.40
9893239,9952641,4947,1731450,11684091,17.40
9893240,9932047,5302,1855700,11787747,18.68
9893241,9946103,2746,961100,10907203,9.66
9893242,9949911,4024,1408400,11358311,14.15
9893243,3649910,1420,497000,4146910,13.62
9893244,9950305,5025,1758750,11709055,17.68
9893245,9953327,1628,569800,10523127,5.72
9893246,9961711,2898,1014300,10976011,10.18
9893247,9958213,5096,1783600,11741813,17.91
9893248,9963958,600,210000,10173958,2.11
9893249,9958892,3537,1237950,11196842,12.43
9893250,9970000,2146,751100,10721100,7.53
9893251,884016,1263,442050,1326066,50.00
9893252,9953551,958,335300,10288851,3.37
9893253,9963054,2191,766850,10729904,7.70
9893254,9941686,917,320950,10262636,3.23
9893255,9961233,4689,1641150,11602383,16.48
9893256,9973585,2979,1042650,11016235,10.45
9893257,9950328,4552,1593200,11543528,16.01
9893258,810756,461,161350,972106,19.90
9893259,9939279,2909,1018150,10957429,10.24
9893260,9918764,4326,1514100,11432864,15.27
9893261,9944164,836,292600,10236764,2.94
9893262,9935922,3669,1284150,11220072,12.92
9893263,5014183,2627,919450,5933633,18.34
9893264,9936758,1712,599200,10535958,6.03
9893265,9955693,6069,2124150,12079843,21.34
9893266,9951902,3955,1384250,11336152,13.91
9893268,1669381,462,161700,1831081,9.69
9893269,9985573,4318,1511300,11496873,15.13
9893270,9993915,3490,1221500,11215415,12.22
9893271,9981059,4144,1450400,11431459,14.53
9893272,9984933,4850,1697500,11682433,17.00
9893273,2589310,930,325500,2914810,12.57
9893274,9954812,2130,745500,10700312,7.49
9893275,9942791,4835,1692250,11635041,17.02
9893276,4880348,1843,645050,5525398,13.22
9893278,9956326,3810,1333500,11289826,13.39
9893279,9583219,2850,997500,10580719,10.41
9893280,9969840,886,310100,10279940,3.11
9893281,9968760,3909,1368150,11336910,13.72
9893282,9972558,3150,1102500,11075058,11.06
9893283,9972715,3154,1103900,11076615,11.07
9893284,9967472,2998,1049300,11016772,10.53
9893285,9965769,4649,1627150,11592919,16.33
9893286,9992457,4959,1735650,11728107,17.37
9893287,4285249,236,82600,4367849,1.93
9893288,9963046,3850,1347500,11310546,13.52
9893289,9986497,5612,1964200,11950697,19.67
9893290,9994638,2912,1019200,11013838,10.20
9893291,9975866,3743,1310050,11285916,13.13
9893292,9969689,2656,929600,10899289,9.32
9893293,9981394,1410,493500,10474894,4.94
9893294,9978446,837,292950,10271396,2.94
9893295,4316001,1649,577150,4893151,13.37
9893296,8977908,3790,1326500,10304408,14.78
9893297,9980009,4908,1717800,11697809,17.21
9893298,9975729,2971,1039850,11015579,10.42
9893299,9985330,3788,1325800,11311130,13.28
9893300,9983679,2743,960050,10943729,9.62
9893301,9998679,4997,1748950,11747629,17.49
9893302,9983850,2421,847350,10831200,8.49
9893303,9994648,1225,428750,10423398,4.29
9893304,9988230,3699,1294650,11282880,12.96
9893305,9990055,2594,907900,10897955,9.09
9893306,9983152,3374,1180900,11164052,11.83
9893307,9998484,4152,1453200,11451684,14.53
9893308,9975327,2643,925050,10900377,9.27
9893309,2029503,572,200200,2229703,9.86
9893310,9960892,4201,1470350,11431242,14.76
9893311,9961695,2800,980000,10941695,9.84
9893312,9981915,4272,1495200,11477115,14.98
9893313,9992732,3459,1210650,11203382,12.12
9893314,9978705,4564,1597400,11576105,16.01
9893315,1555717,800,280000,1835717,18.00
9893316,3185427,581,203350,3388777,6.38
9893318,9964928,6471,2264850,12229778,22.73
9893319,9958505,1993,697550,10656055,7.00
9893320,9974631,3211,1123850,11098481,11.27
9893321,3604741,1805,631750,4236491,17.53
9893322,9959939,2799,979650,10939589,9.84
9893323,4239222,1041,364350,4603572,8.59
9893324,4574613,1234,431900,5006513,9.44
9893325,9971601,4732,1656200,11627801,16.61
9893326,9981602,5555,1944250,11925852,19.48
9893327,9986544,2797,978950,10965494,9.80
9893328,9803937,2610,913500,10717437,9.32
9893329,9985624,3789,1326150,11311774,13.28
9893330,888985,801,280350,1169335,31.54
9893331,9967608,2108,737800,10705408,7.40
9893332,9955686,5374,1880900,11836586,18.89
9893333,9966157,4366,1528100,11494257,15.33
9893334,9755890,905,316750,10072640,3.25
9893335,9961803,1958,685300,10647103,6.88
9893336,9967534,3473,1215550,11183084,12.20
9893337,9974446,4155,1454250,11428696,14.58
9893338,9968222,4059,1420650,11388872,14.25
9893339,9993428,4607,1612450,11605878,16.14
9893340,1201075,862,301700,1502775,25.12
9893341,9976390,4935,1727250,11703640,17.31
9893342,9998195,5481,1918350,11916545,19.19
9893343,2715768,1472,515200,3230968,18.97
9893344,9978867,2222,777700,10756567,7.79
9893345,9973216,2816,985600,10958816,9.88
9893346,9984152,4163,1457050,11441202,14.59
9893347,9986622,4245,1485750,11472372,14.88
9893348,9997402,3158,1105300,11102702,11.06
9893349,9985512,2750,962500,10948012,9.64
9893350,9978432,402,140700,10119132,1.41
9893351,917058,583,204050,1121108,22.25
9893352,9984205,1373,480550,10464755,4.81
9893353,9982788,2601,910350,10893138,9.12
9893354,9872920,4364,1527400,11400320,15.47
9893355,9930716,2593,907550,10838266,9.14
9893356,9967294,3320,1162000,11129294,11.66
9893357,1034462,522,182700,1217162,17.66
9893358,9964993,4782,1673700,11638693,16.80
9893359,1724229,406,142100,1866329,8.24
9893360,24650,17,5950,30600,24.14
9893361,9927090,4635,1622250,11549340,16.34
9893362,889801,483,169050,1058851,19.00
9893363,9937480,4172,1460200,11397680,14.69
9893364,9951239,1988,695800,10647039,6.99
9893365,9956570,3484,1219400,11175970,12.25
9893366,9961651,2792,977200,10938851,9.81
9893367,9957263,3008,1052800,11010063,10.57
9893368,9955745,2537,887950,10843695,8.92
9893369,9966360,4539,1588650,11555010,15.94
9893370,9962489,6095,2133250,12095739,21.41
9893371,9973804,3201,1120350,11094154,11.23
9893372,4309474,579,202650,4512124,4.70
9893373,9997882,8163,2857050,12854932,28.58
9893374,9995416,5761,2016350,12011766,20.17
9893375,9987036,2945,1030750,11017786,10.32
9893376,9988594,688,240800,10229394,2.41
9893377,9972287,856,299600,10271887,3.00
9893378,9951786,2456,859600,10811386,8.64
9893379,1013583,350,122500,1136083,12.09
9893380,9932878,3515,1230250,11163128,12.39
9893381,9923199,3136,1097600,11020799,11.06
9893382,9947961,6057,2119950,12067911,21.31
9893383,9946883,3161,1106350,11053233,11.12
9893384,5617350,1927,674450,6291800,12.01
9893385,9959753,4712,1649200,11608953,16.56
9893386,3406355,1002,350700,3757055,10.30
9893387,9959951,3842,1344700,11304651,13.50
9893388,9953061,3636,1272600,11225661,12.79
9893389,9952221,5102,1785700,11737921,17.94
9893390,5445610,4498,1574300,7019910,28.91
9893391,9975953,5241,1834350,11810303,18.39
9893392,9966756,5197,1818950,11785706,18.25
9893393,9986467,3823,1338050,11324517,13.40
9893394,9999405,7651,2677850,12677255,26.78
9893395,9992733,2811,983850,10976583,9.85
9893396,1994234,2072,725200,2719434,36.36
9893397,9970481,2886,1010100,10980581,10.13
9893398,9971339,3493,1222550,11193889,12.26
9893399,9982743,4666,1633100,11615843,16.36
9893400,9963382,4997,1748950,11712332,17.55
9893401,9979348,4458,1560300,11539648,15.64
9893402,9965033,2193,767550,10732583,7.70
9893403,4677899,2123,743050,5420949,15.88
9893404,9969141,4179,1462650,11431791,14.67
9893405,9977182,2252,788200,10765382,7.90
9893406,9975473,4255,1489250,11464723,14.93
9893407,9980320,4429,1550150,11530470,15.53
9893408,9984180,1965,687750,10671930,6.89
9893409,9987011,3332,1166200,11153211,11.68
9893410,1341626,311,108850,1450476,8.11
9893411,9979199,3001,1050350,11029549,10.53
9893412,2548955,1779,622650,3171605,24.43
9893413,2633359,1311,458850,3092209,17.42
9893414,9990919,2927,1024450,11015369,10.25
9893415,9712113,4398,1539300,11251413,15.85
9893416,9986488,3437,1202950,11189438,12.05
9893417,9973660,3026,1059100,11032760,10.62
9893418,9983601,3878,1357300,11340901,13.60
9893419,9992835,4714,1649900,11642735,16.51
9893420,9979697,2919,1021650,11001347,10.24
9893421,9977066,4029,1410150,11387216,14.13
9893422,9980252,5413,1894550,11874802,18.98
9893423,9975602,2892,1012200,10987802,10.15
9893425,9974336,2848,996800,10971136,9.99
9893428,9958669,953,333550,10292219,3.35
9893429,9952033,5367,1878450,11830483,18.88
9893430,9954478,1921,672350,10626828,6.75
9893432,9930716,3669,1284150,11214866,12.93
9893433,9941790,3455,1209250,11151040,12.16
9893434,9946685,3661,1281350,11228035,12.88
9893435,9958372,3426,1199100,11157472,12.04
9893436,9971769,4803,1681050,11652819,16.86
9893437,9960511,3605,1261750,11222261,12.67
9893438,9983377,5641,1974350,11957727,19.78
9893439,9981749,4223,1478050,11459799,14.81
9893440,9983814,4276,1496600,11480414,14.99
9893441,9997203,3728,1304800,11302003,13.05
9893442,4975288,2279,797650,5772938,16.03
9893443,1961495,595,208250,2169745,10.62
9893444,9975083,3134,1096900,11071983,11.00
9893445,9984096,4143,1450050,11434146,14.52
9893446,9983930,3991,1396850,11380780,13.99
9893447,9973665,2894,1012900,10986565,10.16
9893448,9994502,6644,2325400,12319902,23.27
9893449,9996269,4845,1695750,11692019,16.96
9893450,9980524,4393,1537550,11518074,15.41
9893451,9972971,4435,1552250,11525221,15.56
9893452,9546126,6015,2105250,11651376,22.05
9893453,3120624,1971,689850,3810474,22.11
9893454,9967277,5449,1907150,11874427,19.13
9893455,9972101,3258,1140300,11112401,11.43
9893456,9485599,4753,1663550,11149149,17.54
9893457,9978671,4199,1469650,11448321,14.73
9893458,9974893,4370,1529500,11504393,15.33
9893459,7846396,2908,1017800,8864196,12.97
9893460,9997592,3793,1327550,11325142,13.28
9893461,9882783,4478,1567300,11450083,15.86
9893462,9987531,3428,1199800,11187331,12.01
9893463,9992608,5309,1858150,11850758,18.60
9893464,9985591,5838,2043300,12028891,20.46
9893465,9975647,3593,1257550,11233197,12.61
9893466,9963938,3165,1107750,11071688,11.12
9893467,9807257,3120,1092000,10899257,11.13
9893468,9977294,3059,1070650,11047944,10.73
9893469,9998167,5193,1817550,11815717,18.18
9893470,9978646,3329,1165150,11143796,11.68
9893471,9992990,4794,1677900,11670890,16.79
9893472,9986821,3555,1244250,11231071,12.46
9893473,9969308,6125,2143750,12113058,21.50
9893474,9980336,3900,1365000,11345336,13.68
9893475,51827,18,6300,58127,12.16
9893476,9975418,5928,2074800,12050218,20.80
9893477,9985211,1772,620200,10605411,6.21
9893478,9969254,3649,1277150,11246404,12.81
9893479,9978054,1502,525700,10503754,5.27
9893480,9988219,957,334950,10323169,3.35
9893481,9009530,1039,363650,9373180,4.04
9893482,9987968,1063,372050,10360018,3.72
9893483,9973565,1666,583100,10556665,5.85
9893484,9984091,1184,414400,10398491,4.15
9893485,9983809,3174,1110900,11094709,11.13
9893486,9992906,1932,676200,10669106,6.77
9893487,9986386,1879,657650,10644036,6.59
9893488,9992914,2702,945700,10938614,9.46
9893489,9984759,1920,672000,10656759,6.73
9893490,9985507,1820,637000,10622507,6.38
9893491,9980158,2726,954100,10934258,9.56
9893492,4889182,2200,770000,5659182,15.75
9893493,9996664,4938,1728300,11724964,17.29
9893494,9982281,4932,1726200,11708481,17.29
9893495,9983120,2155,754250,10737370,7.56
9893496,9978908,4659,1630650,11609558,16.34
9893497,9994618,6067,2123450,12118068,21.25
9893498,9982903,3759,1315650,11298553,13.18
9893499,9987627,3673,1285550,11273177,12.87
9893500,1495905,1331,465850,1961755,31.14
9893501,9986936,3197,1118950,11105886,11.20
9893502,9979729,5215,1825250,11804979,18.29
9893503,9885220,4337,1517950,11403170,15.36
9893504,9864282,4843,1695050,11559332,17.18
9893505,9993598,2442,854700,10848298,8.55
9893506,1781026,1031,360850,2141876,20.26
9893507,9972824,4267,1493450,11466274,14.98
9893508,9948489,3828,1339800,11288289,13.47
9893509,9956032,4633,1621550,11577582,16.29
9893510,9961994,3835,1342250,11304244,13.47
9893511,4376910,3004,1051400,5428310,24.02
9893512,9972381,5065,1772750,11745131,17.78
9893513,2246248,652,228200,2474448,10.16
9893514,2598680,1802,630700,3229380,24.27
9893515,9977356,1815,635250,10612606,6.37
9893516,6311090,2137,747950,7059040,11.85
9893518,2555212,1283,449050,3004262,17.57
9893519,2948090,1269,444150,3392240,15.07
9893520,7991697,2660,931000,8922697,11.65
9893521,9947009,3171,1109850,11056859,11.16
9893522,9971056,3517,1230950,11202006,12.35
9893523,9959920,2555,894250,10854170,8.98
9893524,9951925,3441,1204350,11156275,12.10
9893525,9961609,2458,860300,10821909,8.64
9893526,9536930,2802,980700,10517630,10.28
9893527,9969388,2522,882700,10852088,8.85
9893528,9946114,4873,1705550,11651664,17.15
9893529,9968409,3603,1261050,11229459,12.65
9893530,3763988,2562,896700,4660688,23.82
9893531,9935993,3149,1102150,11038143,11.09
9893532,9930437,4469,1564150,11494587,15.75
9893533,9959125,3981,1393350,11352475,13.99
9893534,9980096,3851,1347850,11327946,13.51
9893535,1480939,646,226100,1707039,15.27
9893536,9980636,5084,1779400,11760036,17.83
9893537,9974466,4420,1547000,11521466,15.51
9893538,9978726,5920,2072000,12050726,20.76
9893539,1318730,996,348600,1667330,26.43
9893540,9995281,4811,1683850,11679131,16.85
9893541,9982910,5691,1991850,11974760,19.95
9893542,9993500,3165,1107750,11101250,11.08
9893543,9973412,2615,915250,10888662,9.18
9893544,9992551,3845,1345750,11338301,13.47
9893546,6414344,2839,993650,7407994,15.49
9893547,9970739,4158,1455300,11426039,14.60
9893548,9960250,4208,1472800,11433050,14.79
9893549,9978525,2510,878500,10857025,8.80
9893551,9986182,1331,465850,10452032,4.66
9893552,9987860,3049,1067150,11055010,10.68
9893553,9999854,3269,1144150,11144004,11.44
9893554,4319601,1922,672700,4992301,15.57
9893555,9967867,4694,1642900,11610767,16.48
9893556,1972116,537,187950,2160066,9.53
9893557,9973907,5211,1823850,11797757,18.29
9893558,3347975,1675,586250,3934225,17.51
9893559,9948135,3879,1357650,11305785,13.65
9893560,9969959,3330,1165500,11135459,11.69
9893561,2843464,1059,370650,3214114,13.04
9893562,9956873,4971,1739850,11696723,17.47
9893563,9975273,5025,1758750,11734023,17.63
9893564,4058826,1951,682850,4741676,16.82
9893565,9978065,5602,1960700,11938765,19.65
9893566,9964197,2564,897400,10861597,9.01
9893567,9764790,5144,1800400,11565190,18.44
9893568,9970753,1749,612150,10582903,6.14
9893569,9967612,3615,1265250,11232862,12.69
9893570,9971059,6450,2257500,12228559,22.64
9893571,9969311,5415,1895250,11864561,19.01
9893572,9957123,3175,1111250,11068373,11.16
9893573,9954794,2101,735350,10690144,7.39
9893574,9951120,4441,1554350,11505470,15.62
9893575,9960654,1636,572600,10533254,5.75
9893576,9969897,4090,1431500,11401397,14.36
9893577,9962397,5564,1947400,11909797,19.55
9893578,9963289,4389,1536150,11499439,15.42
9893579,9988430,2581,903350,10891780,9.04
9893580,9993848,3293,1152550,11146398,11.53
9893581,9982498,5202,1820700,11803198,18.24
9893582,8830480,2288,800800,9631280,9.07
9893583,9991149,2839,993650,10984799,9.95
9893584,9963354,2523,883050,10846404,8.86
9893585,9970192,3386,1185100,11155292,11.89
9893586,3328611,1333,466550,3795161,14.02
9893587,9951440,3779,1322650,11274090,13.29
9893588,9951318,3638,1273300,11224618,12.80
9893589,9934221,3019,1056650,10990871,10.64
9893590,2996310,2050,717500,3713810,23.95
9893591,9956310,4601,1610350,11566660,16.17
9893592,9951731,7642,2674700,12626431,26.88
9893593,9952410,3522,1232700,11185110,12.39
9893594,9929325,4544,1590400,11519725,16.02
9893596,9921939,2440,854000,10775939,8.61
9893597,9914562,3688,1290800,11205362,13.02
9893598,1070898,678,237300,1308198,22.16
9893599,9933657,4757,1664950,11598607,16.76
9893600,9932846,2577,901950,10834796,9.08
9893601,9922798,1631,570850,10493648,5.75
9893602,9925049,5058,1770300,11695349,17.84
9893603,9934373,2800,980000,10914373,9.86
9893604,7185304,3297,1153950,8339254,16.06
9893605,9954446,4175,1461250,11415696,14.68
9893606,9947270,2809,983150,10930420,9.88
9893607,3364299,1170,409500,3773799,12.17
9893608,9956174,3238,1133300,11089474,11.38
9893609,9963397,4847,1696450,11659847,17.03
9893610,9965890,759,265650,10231540,2.67
9893611,9978292,1778,622300,10600592,6.24
9893612,9985423,2877,1006950,10992373,10.08
9893613,9997074,1369,479150,10476224,4.79
9893614,9977299,3171,1109850,11087149,11.12
9893615,9971747,5498,1924300,11896047,19.30
9893616,385531,224,78400,463931,20.34
9893617,9803735,3279,1147650,10951385,11.71
9893618,9974480,258,90300,10064780,0.91
9893619,9892682,3627,1269450,11162132,12.83
9893620,9980832,3775,1321250,11302082,13.24
9893621,9972867,3827,1339450,11312317,13.43
9893622,9973421,3608,1262800,11236221,12.66
9893623,9963072,2987,1045450,11008522,10.49
9893624,4546266,1308,457800,5004066,10.07
9893625,9983990,3232,1131200,11115190,11.33
9893626,9543430,3198,1119300,10662730,11.73
9893627,9978350,3271,1144850,11123200,11.47
9893628,9984523,7099,2484650,12469173,24.89
9893629,1241563,279,97650,1339213,7.87
9893630,9980288,3863,1352050,11332338,13.55
9893631,9966395,2013,704550,10670945,7.07
9893632,9987012,4207,1472450,11459462,14.74
9893633,9997062,2884,1009400,11006462,10.10
9893634,3312909,2234,781900,4094809,23.60
9893635,2778070,1233,431550,3209620,15.53
9893636,9449268,2837,992950,10442218,10.51
9893637,9994296,2402,840700,10834996,8.41
9893638,9991133,4791,1676850,11667983,16.78
9893639,9988959,2136,747600,10736559,7.48
9893640,9980522,2867,1003450,10983972,10.05
9893641,9983621,3984,1394400,11378021,13.97
9893642,9983723,3100,1085000,11068723,10.87
9893644,4517144,1252,438200,4955344,9.70
9893645,9959307,5023,1758050,11717357,17.65
9893646,9976168,3920,1372000,11348168,13.75
9893647,9970491,4384,1534400,11504891,15.39
9893648,9991833,3263,1142050,11133883,11.43
9893649,9971491,4430,1550500,11521991,15.55
9893650,2757210,2552,893200,3650410,32.40
9893651,9969207,5709,1998150,11967357,20.04
9893653,9982538,2533,886550,10869088,8.88
9893654,1933021,562,196700,2129721,10.18
9893655,9979727,4626,1619100,11598827,16.22
9893656,7281515,4039,1413650,8695165,19.41
9893657,9988282,3321,1162350,11150632,11.64
9893658,1849122,709,248150,2097272,13.42
9893659,9983525,4754,1663900,11647425,16.67
9893660,5643457,2641,924350,6567807,16.38
9893661,669572,240,84000,753572,12.55
9893662,1361206,134,46900,1408106,3.45
9893663,9957150,3369,1179150,11136300,11.84
9893664,9971993,4678,1637300,11609293,16.42
9893665,9976860,5466,1913100,11889960,19.18
9893666,9976344,4219,1476650,11452994,14.80
9893667,9974574,5800,2030000,12004574,20.35
9893668,3065357,2420,847000,3912357,27.63
9893669,2330748,999,349650,2680398,15.00
9893670,9951398,3210,1123500,11074898,11.29
9893671,9977881,4148,1451800,11429681,14.55
9893672,9955681,3040,1064000,11019681,10.69
9893673,9964053,3549,1242150,11206203,12.47
9893674,9966254,2532,886200,10852454,8.89
9893675,9977555,2349,822150,10799705,8.24
9893676,9983055,3655,1279250,11262305,12.81
9893677,9979580,4310,1508500,11488080,15.12
9893678,936187,291,101850,1038037,10.88
9893679,9965055,3454,1208900,11173955,12.13
9893680,9968449,4103,1436050,11404499,14.41
9893681,9959931,2403,841050,10800981,8.44
9893682,9981811,3273,1145550,11127361,11.48
9893683,9973099,4039,1413650,11386749,14.17
9893684,9982582,3543,1240050,11222632,12.42
9893685,9990390,2725,953750,10944140,9.55
9893686,498121,229,80150,578271,16.09
9893687,9980255,3413,1194550,11174805,11.97
9893688,9993281,2198,769300,10762581,7.70
9893689,9996166,2177,761950,10758116,7.62
9893690,513368,337,117950,631318,22.98
9893691,9979364,4223,1478050,11457414,14.81
9893692,9976469,3379,1182650,11159119,11.85
9893693,9994521,2705,946750,10941271,9.47
9893694,9990908,5395,1888250,11879158,18.90
9893695,9986737,3027,1059450,11046187,10.61
9893696,9976363,2969,1039150,11015513,10.42
9893697,9961069,3036,1062600,11023669,10.67
9893698,9981624,1821,637350,10618974,6.39
9893699,9974729,4203,1471050,11445779,14.75
9893700,9986179,5114,1789900,11776079,17.92
9893701,1106620,316,110600,1217220,9.99
9893702,9975400,1729,605150,10580550,6.07
9893703,9993751,4423,1548050,11541801,15.49
9893704,9979210,2660,931000,10910210,9.33
9893705,9972883,5456,1909600,11882483,19.15
9893706,9992695,4216,1475600,11468295,14.77
9893707,9991059,4211,1473850,11464909,14.75
9893708,9983545,3778,1322300,11305845,13.24
9893709,9999854,4039,1413650,11413504,14.14
9893710,7307506,1968,688800,7996306,9.43
9893711,9972149,4813,1684550,11656699,16.89
9893712,9982366,5615,1965250,11947616,19.69
9893713,9976397,2690,941500,10917897,9.44
9893714,7747305,1244,435400,8182705,5.62
9893715,9989220,2364,827400,10816620,8.28
9893716,9999383,3316,1160600,11159983,11.61
9893717,1095403,774,270900,1366303,24.73
9893718,9970246,5152,1803200,11773446,18.09
9893719,9964852,3038,1063300,11028152,10.67
9893720,9960923,3553,1243550,11204473,12.48
9893721,9911108,2786,975100,10886208,9.84
9893722,9956460,4017,1405950,11362410,14.12
9893723,9956628,2219,776650,10733278,7.80
9893724,9956763,4922,1722700,11679463,17.30
9893725,9981524,3009,1053150,11034674,10.55
9893726,9974988,3392,1187200,11162188,11.90
9893727,9970358,2177,761950,10732308,7.64
9893728,7562780,1927,674450,8237230,8.92
9893729,8392320,4258,1490300,9882620,17.76
9893730,2657716,1048,366800,3024516,13.80
9893731,9928195,5112,1789200,11717395,18.02
9893732,106687,110,38500,145187,36.09
9893733,9927394,5293,1852550,11779944,18.66
9893734,9943306,2909,1018150,10961456,10.24
9893735,9934806,3321,1162350,11097156,11.70
9893736,9934820,2180,763000,10697820,7.68
9893737,9945028,3269,1144150,11089178,11.50
9893738,9942416,4381,1533350,11475766,15.42
9893739,9950161,3033,1061550,11011711,10.67
9893741,2476870,716,250600,2727470,10.12
9893742,9932874,4980,1743000,11675874,17.55
9893743,9942409,3576,1251600,11194009,12.59
9893744,3361000,1017,355950,3716950,10.59
9893745,9925762,2801,980350,10906112,9.88
9893746,9931124,2902,1015700,10946824,10.23
9893747,9930000,3352,1173200,11103200,11.81
9893748,9932417,2406,842100,10774517,8.48
9893749,9911033,4318,1511300,11422333,15.25
9893750,9945726,3202,1120700,11066426,11.27
9893751,9948777,3946,1381100,11329877,13.88
9893752,9949331,2765,967750,10917081,9.73
9893753,9969291,3015,1055250,11024541,10.59
9893754,9968029,2291,801850,10769879,8.04
9893755,2419006,519,181650,2600656,7.51
9893756,6721449,1547,541450,7262899,8.06
9893757,9985349,3920,1372000,11357349,13.74
9893758,9990512,3139,1098650,11089162,11.00
9893759,9969616,1762,616700,10586316,6.19
9893760,368725,225,78750,447475,21.36
9893761,9971686,3366,1178100,11149786,11.81
9893762,9988263,3265,1142750,11131013,11.44
9893763,9966052,4949,1732150,11698202,17.38
9893764,4617241,1898,664300,5281541,14.39
9893765,9972734,5683,1989050,11961784,19.94
9893766,9973479,4278,1497300,11470779,15.01
9893767,9990977,5026,1759100,11750077,17.61
9893768,9989147,2655,929250,10918397,9.30
9893769,432878,211,73850,506728,17.06
9893770,9971426,2441,854350,10825776,8.57
9893771,9663469,5042,1764700,11428169,18.26
9893772,9975846,4097,1433950,11409796,14.37
9893773,2155708,909,318150,2473858,14.76
9893774,9949577,3761,1316350,11265927,13.23
9893775,9933852,3674,1285900,11219752,12.94
9893777,9926228,2746,961100,10887328,9.68
9893778,9924159,893,312550,10236709,3.15
9893779,9919709,3195,1118250,11037959,11.27
9893780,9919714,1602,560700,10480414,5.65
9893781,211558,67,23450,235008,11.08
9893782,7762253,1067,373450,8135703,4.81
9893783,5200947,2192,767200,5968147,14.75
9893784,9929541,4980,1743000,11672541,17.55
9893785,9909570,4262,1491700,11401270,15.05
9893786,9926917,3958,1385300,11312217,13.95
9893787,9944350,3149,1102150,11046500,11.08
9893788,9929895,2478,867300,10797195,8.73
9893789,3061232,848,296800,3358032,9.70
9893790,9954188,5115,1790250,11744438,17.98
9893791,9963661,1804,631400,10595061,6.34
9893792,1311068,343,120050,1431118,9.16
9893793,9924059,3928,1374800,11298859,13.85
9893794,9967860,4809,1683150,11651010,16.89
9893795,9970811,3422,1197700,11168511,12.01
9893796,9976941,3158,1105300,11082241,11.08
9893798,7647365,4403,1541050,9188415,20.15
9893799,6460826,1966,688100,7148926,10.65
9893801,9983564,3334,1166900,11150464,11.69
9893802,9997491,3962,1386700,11384191,13.87
9893803,8852662,2149,752150,9604812,8.50
9893805,9974066,2501,875350,10849416,8.78
9893806,9940984,4122,1442700,11383684,14.51
9893807,9985025,1985,694750,10679775,6.96
9893808,9988303,2403,841050,10829353,8.42
9893809,9550483,4354,1523900,11074383,15.96
9893810,9985399,4088,1430800,11416199,14.33
9893811,9992605,3053,1068550,11061155,10.69
9893812,9782328,908,317800,10100128,3.25
9893813,9996004,2567,898450,10894454,8.99
9893814,3878893,2289,801150,4680043,20.65
9893815,6371706,2885,1009750,7381456,15.85
9893816,9962823,2141,749350,10712173,7.52
9893817,9272815,2700,945000,10217815,10.19
9893818,9978938,2550,892500,10871438,8.94
9893819,9995739,3730,1305500,11301239,13.06
9893820,9977107,3775,1321250,11298357,13.24
9893821,9972574,4183,1464050,11436624,14.68
9893822,9952275,95,33250,9985525,0.33
9893823,9976390,5107,1787450,11763840,17.92
9893824,9989196,4859,1700650,11689846,17.02
9893825,9988488,3819,1336650,11325138,13.38
9893826,9996831,3107,1087450,11084281,10.88
9893827,9993133,3544,1240400,11233533,12.41
9893828,9980849,3068,1073800,11054649,10.76
9893829,9986931,2506,877100,10864031,8.78
9893830,9973602,2294,802900,10776502,8.05
9893831,9987435,1614,564900,10552335,5.66
9893832,9970566,109,38150,10008716,0.38
9893833,9969238,2680,938000,10907238,9.41
9893834,9968357,1674,585900,10554257,5.88
9893835,9986219,2447,856450,10842669,8.58
9893836,9986038,4749,1662150,11648188,16.64
9893837,9980409,773,270550,10250959,2.71
9893838,9988879,924,323400,10312279,3.24
9893839,9983711,1359,475650,10459361,4.76
9893840,9972904,2856,999600,10972504,10.02
9893841,9972794,4168,1458800,11431594,14.63
9893842,106195,48,16800,122995,15.82
9893843,9976929,4190,1466500,11443429,14.70
9893844,9980922,1924,673400,10654322,6.75
9893845,9990514,1412,494200,10484714,4.95
9893846,3165094,1008,352800,3517894,11.15
9893847,473969,302,105700,579669,22.30
9893848,9981186,5356,1874600,11855786,18.78
9893849,9997140,4528,1584800,11581940,15.85
9893850,9977699,4085,1429750,11407449,14.33
9893851,9976865,5401,1890350,11867215,18.95
9893852,9979502,4630,1620500,11600002,16.24
9893853,9980471,4079,1427650,11408121,14.30
9893854,9979200,3985,1394750,11373950,13.98
9893855,9980653,4627,1619450,11600103,16.23
9893856,9976617,3503,1226050,11202667,12.29
9893857,9982137,2694,942900,10925037,9.45
9893858,4984076,930,325500,5309576,6.53
9893859,9974747,5437,1902950,11877697,19.08
9893860,9969514,3215,1125250,11094764,11.29
9893861,9967980,1404,491400,10459380,4.93
9893862,1678142,551,192850,1870992,11.49
9893863,1963038,1874,655900,2618938,33.41
9893864,9957567,4555,1594250,11551817,16.01
9893865,285346,128,44800,330146,15.70
9893866,9949475,5002,1750700,11700175,17.60
9893867,9951311,2289,801150,10752461,8.05
9893868,9960365,1217,425950,10386315,4.28
9893869,9958345,3341,1169350,11127695,11.74
9893870,4642999,1712,599200,5242199,12.91
9893871,9938581,2125,743750,10682331,7.48
9893872,9840691,2387,835450,10676141,8.49
9893873,9977359,2683,939050,10916409,9.41
9893874,9978487,1582,553700,10532187,5.55
9893875,9962207,5666,1983100,11945307,19.91
9893876,9968212,2796,978600,10946812,9.82
9893877,9983163,4631,1620850,11604013,16.24
9893878,9968750,3720,1302000,11270750,13.06
9893879,9994219,5030,1760500,11754719,17.62
9893880,9969518,4728,1654800,11624318,16.60
9893881,9978205,4352,1523200,11501405,15.27
9893882,9970317,3606,1262100,11232417,12.66
9893883,9956196,3135,1097250,11053446,11.02
9893884,9971313,3554,1243900,11215213,12.47
9893885,9977155,3309,1158150,11135305,11.61
9893886,9993004,2777,971950,10964954,9.73
9893887,9992519,5508,1927800,11920319,19.29
9893888,9979723,2987,1045450,11025173,10.48
9893889,9967943,146,51100,10019043,0.51
9893890,9979630,2985,1044750,11024380,10.47
9893891,9965948,4237,1482950,11448898,14.88
9893892,9972427,4757,1664950,11637377,16.70
9893893,9974720,3741,1309350,11284070,13.13
9893894,9984851,2510,878500,10863351,8.80
9893895,9999433,3143,1100050,11099483,11.00
9893896,9982994,5028,1759800,11742794,17.63
9893897,9979760,4101,1435350,11415110,14.38
9893898,6547457,3289,1151150,7698607,17.58
9893899,9964739,4975,1741250,11705989,17.47
9893900,9954123,2855,999250,10953373,10.04
9893901,846540,828,289800,1136340,34.23
9893902,9955925,3251,1137850,11093775,11.43
9893903,9962660,1588,555800,10518460,5.58
9893904,5979837,822,287700,6267537,4.81
9893905,9969646,3326,1164100,11133746,11.68
9893906,9971271,3915,1370250,11341521,13.74
9893907,9966620,3090,1081500,11048120,10.85
9893908,9991704,4513,1579550,11571254,15.81
9893909,9981100,4652,1628200,11609300,16.31
9893910,9982092,3907,1367450,11349542,13.70
9893911,9993933,5235,1832250,11826183,18.33
9893912,9987541,5525,1933750,11921291,19.36
9893913,596886,219,76650,673536,12.84
9893914,4663933,2240,784000,5447933,16.81
9893915,9989111,4285,1499750,11488861,15.01
9893916,9984322,3304,1156400,11140722,11.58
9893917,9979481,4361,1526350,11505831,15.29
9893918,1540460,616,215600,1756060,14.00
9893919,9998899,3660,1281000,11279899,12.81
9893920,9978001,3664,1282400,11260401,12.85
9893921,9962893,3407,1192450,11155343,11.97
9893922,9999932,3810,1333500,11333432,13.34
9893923,9983971,3419,1196650,11180621,11.99
9893924,9986708,3365,1177750,11164458,11.79
9893926,9975872,3308,1157800,11133672,11.61
9893927,9973169,3898,1364300,11337469,13.68
9893928,9984780,2671,934850,10919630,9.36
9893929,9979578,6666,2333100,12312678,23.38
9893930,533466,240,84000,617466,15.75
9893931,2991768,843,295050,3286818,9.86
9893932,9662577,1929,675150,10337727,6.99
9893933,9986591,3180,1113000,11099591,11.14
9893934,9982717,3017,1055950,11038667,10.58
9893935,9981356,2966,1038100,11019456,10.40
9893936,9982137,6036,2112600,12094737,21.16
9893937,9976779,3321,1162350,11139129,11.65
9893939,9977500,3991,1396850,11374350,14.00
9893940,9969438,3188,1115800,11085238,11.19
9893941,9963850,1865,652750,10616600,6.55
9893942,9536731,3964,1387400,10924131,14.55
9893944,9969921,3139,1098650,11068571,11.02
9893945,9955700,2266,793100,10748800,7.97
9893946,9977052,3913,1369550,11346602,13.73
9893947,1593182,578,202300,1795482,12.70
9893948,9947247,3891,1361850,11309097,13.69
9893949,9937624,5364,1877400,11815024,18.89
9893950,9956369,3089,1081150,11037519,10.86
9893951,9954432,3246,1136100,11090532,11.41
9893952,9954647,4386,1535100,11489747,15.42
9893953,9956450,3769,1319150,11275600,13.25
9893954,9941815,2909,1018150,10959965,10.24
9893955,9959315,3750,1312500,11271815,13.18
9893956,9965808,4396,1538600,11504408,15.44
9893957,9958051,3307,1157450,11115501,11.62
9893958,9956515,6349,2222150,12178665,22.32
9893959,9956934,2840,994000,10950934,9.98
9893960,9981059,3890,1361500,11342559,13.64
9893961,6257611,1725,603750,6861361,9.65
9893962,9957511,4364,1527400,11484911,15.34
9893963,844953,612,214200,1059153,25.35
9893964,9941913,5213,1824550,11766463,18.35
9893965,9971797,3332,1166200,11137997,11.69
9893966,2314988,974,340900,2655888,14.73
9893968,9950578,4615,1615250,11565828,16.23
9893969,9944602,4827,1689450,11634052,16.99
9893970,9938729,3621,1267350,11206079,12.75
9893971,9938684,4343,1520050,11458734,15.29
9893972,9917511,4119,1441650,11359161,14.54
9893973,9450700,4005,1401750,10852450,14.83
9893974,9832972,3844,1345400,11178372,13.68
9893975,9935797,5055,1769250,11705047,17.81
9893976,9910338,3483,1219050,11129388,12.30
9893977,3631370,941,329350,3960720,9.07
9893978,9908482,2579,902650,10811132,9.11
9893979,9908604,5262,1841700,11750304,18.59
9893980,2377289,1513,529550,2906839,22.28
9893981,9911736,4227,1479450,11391186,14.93
9893982,3005025,1230,430500,3435525,14.33
9893983,9879922,6514,2279900,12159822,23.08
9893984,9898239,5514,1929900,11828139,19.50
9893985,9882064,5696,1993600,11875664,20.17
9893986,9901401,4877,1706950,11608351,17.24
9893987,9875635,3489,1221150,11096785,12.37
9893988,9879159,4511,1578850,11458009,15.98
9893989,9884388,3640,1274000,11158388,12.89
9893990,9508557,4395,1538250,11046807,16.18
9893991,9896437,2438,853300,10749737,8.62
9893992,9904126,5324,1863400,11767526,18.81
9893993,9889654,3152,1103200,10992854,11.16
9893994,9895783,4071,1424850,11320633,14.40
9893995,9891654,6200,2170000,12061654,21.94
9893996,9909373,3396,1188600,11097973,11.99
9893997,4058294,2053,718550,4776844,17.71
9893998,9063928,4639,1623650,10687578,17.91
9893999,9892480,3627,1269450,11161930,12.83
9894000,9902126,3396,1188600,11090726,12.00
9894001,7139704,4773,1670550,8810254,23.40
9894002,9902952,5143,1800050,11703002,18.18
9894003,9905425,3000,1050000,10955425,10.60
9894004,9927031,4166,1458100,11385131,14.69
9894005,8597046,2492,872200,9469246,10.15
9894006,9910365,4502,1575700,11486065,15.90
9894007,9925712,2736,957600,10883312,9.65
9894008,9926756,2410,843500,10770256,8.50
9894009,9938059,4454,1558900,11496959,15.69
9894010,9930644,3424,1198400,11129044,12.07
9894011,9902490,473,165550,10068040,1.67
9894012,9924218,1525,533750,10457968,5.38
9894013,9920638,4846,1696100,11616738,17.10
9894014,9930295,4553,1593550,11523845,16.05
9894015,9928719,3923,1373050,11301769,13.83
9894016,9741906,3876,1356600,11098506,13.93
9894017,9971516,2928,1024800,10996316,10.28
9894018,9966352,4183,1464050,11430402,14.69
9894019,9982543,2425,848750,10831293,8.50
9894020,9970782,4503,1576050,11546832,15.81
9894022,9977127,4399,1539650,11516777,15.43
9894023,9989913,3414,1194900,11184813,11.96
9894024,9986618,4038,1413300,11399918,14.15
9894025,9986454,3259,1140650,11127104,11.42
9894026,9993298,4587,1605450,11598748,16.07
9894027,1308220,98,34300,1342520,2.62
9894028,9987003,3581,1253350,11240353,12.55
9894029,9974901,3696,1293600,11268501,12.97
9894030,9983269,2103,736050,10719319,7.37
9894031,9991086,4471,1564850,11555936,15.66
9894032,9991994,3919,1371650,11363644,13.73
9894033,9971155,4534,1586900,11558055,15.91
9894034,9986115,5137,1797950,11784065,18.00
9894035,9976402,5283,1849050,11825452,18.53
9894036,9974291,2624,918400,10892691,9.21
9894037,9956344,2719,951650,10907994,9.56
9894038,9976899,4758,1665300,11642199,16.69
9894039,9990070,2165,757750,10747820,7.59
9894040,9919454,3484,1219400,11138854,12.29
9894041,9976925,4252,1488200,11465125,14.92
9894042,8213561,3380,1183000,9396561,14.40
9894043,9971316,5052,1768200,11739516,17.73
9894044,417002,160,56000,473002,13.43
9894045,9958001,4154,1453900,11411901,14.60
9894046,9973805,6195,2168250,12142055,21.74
9894047,9955485,5030,1760500,11715985,17.68
9894048,9963139,3282,1148700,11111839,11.53
9894049,9971245,3666,1283100,11254345,12.87
9894050,9981917,4294,1502900,11484817,15.06
9894051,9983997,3830,1340500,11324497,13.43
9894052,9928652,2038,713300,10641952,7.18
9894053,9369485,2504,876400,10245885,9.35
9894054,9982924,3584,1254400,11237324,12.57
9894055,9984244,3469,1214150,11198394,12.16
9894056,9985893,3496,1223600,11209493,12.25
9894057,9986191,4781,1673350,11659541,16.76
9894058,9986075,5285,1849750,11835825,18.52
9894059,9996985,3400,1190000,11186985,11.90
9894060,9997304,6806,2382100,12379404,23.83
9894061,9975876,3272,1145200,11121076,11.48
9894062,9468377,4183,1464050,10932427,15.46
9894063,9978180,3151,1102850,11081030,11.05
9894064,9996591,2340,819000,10815591,8.19
9894065,9982682,3174,1110900,11093582,11.13
9894066,9974570,3085,1079750,11054320,10.83
9894067,9995508,3732,1306200,11301708,13.07
9894068,9983472,4367,1528450,11511922,15.31
9894069,9994910,4905,1716750,11711660,17.18
9894070,9984844,2406,842100,10826944,8.43
9894071,9982039,4148,1451800,11433839,14.54
9894072,9992641,2050,717500,10710141,7.18
9894073,9988527,3564,1247400,11235927,12.49
9894074,9987556,5047,1766450,11754006,17.69
9894075,9977663,2146,751100,10728763,7.53
9894076,9960751,4838,1693300,11654051,17.00
9894078,9954738,4278,1497300,11452038,15.04
9894079,9940827,3288,1150800,11091627,11.58
9894080,9954673,2882,1008700,10963373,10.13
9894081,9958858,5363,1877050,11835908,18.85
9894082,9972409,5057,1769950,11742359,17.75
9894083,9971318,4638,1623300,11594618,16.28
9894084,9982025,6334,2216900,12198925,22.21
9894085,9973900,3991,1396850,11370750,14.01
9894086,9967543,5175,1811250,11778793,18.17
9894087,9974048,4817,1685950,11659998,16.90
9894088,9986236,2827,989450,10975686,9.91
9894089,9980271,3938,1378300,11358571,13.81
9894090,9978540,2710,948500,10927040,9.51
9894091,9987750,5913,2069550,12057300,20.72
9894092,6463357,2925,1023750,7487107,15.84
9894093,9971589,4063,1422050,11393639,14.26
9894095,9956442,2968,1038800,10995242,10.43
9894096,9955301,3966,1388100,11343401,13.94
9894097,9975091,4560,1596000,11571091,16.00
9894098,9987304,3406,1192100,11179404,11.94
9894099,6067041,2395,838250,6905291,13.82
9894100,5602979,2495,873250,6476229,15.59
9894101,9980236,4879,1707650,11687886,17.11
9894102,3582290,1593,557550,4139840,15.56
9894103,9983927,4111,1438850,11422777,14.41
9894104,1359973,524,183400,1543373,13.49
9894105,9995284,3182,1113700,11108984,11.14
9894106,9996390,5595,1958250,11954640,19.59
9894108,609909,245,85750,695659,14.06
9894109,9980504,2071,724850,10705354,7.26
9894110,9980478,4264,1492400,11472878,14.95
9894111,9978142,1199,419650,10397792,4.21
9894112,9984291,2345,820750,10805041,8.22
9894113,9981259,5393,1887550,11868809,18.91
9894114,9984320,3743,1310050,11294370,13.12
9894115,9990553,3137,1097950,11088503,10.99
9894116,9980373,6117,2140950,12121323,21.45
9894117,9983210,2043,715050,10698260,7.16
9894118,9360628,3432,1201200,10561828,12.83
9894119,9985715,2269,794150,10779865,7.95
9894120,1846242,1373,480550,2326792,26.03
9894121,770856,596,208600,979456,27.06
9894122,9965423,2606,912100,10877523,9.15
9894123,2682338,1112,389200,3071538,14.51
9894124,9972485,3523,1233050,11205535,12.36
9894125,9979029,2149,752150,10731179,7.54
9894126,2908695,1996,698600,3607295,24.02
9894127,1641836,782,273700,1915536,16.67
9894128,9980837,3960,1386000,11366837,13.89
9894129,9982229,3424,1198400,11180629,12.01
9894130,9991735,1393,487550,10479285,4.88
9894131,2175384,1910,668500,2843884,30.73
9894132,2134240,753,263550,2397790,12.35
9894133,9989040,2511,878850,10867890,8.80
9894134,9968474,4297,1503950,11472424,15.09
9894135,9974183,4208,1472800,11446983,14.77
9894137,9981944,5221,1827350,11809294,18.31
9894138,9990546,4538,1588300,11578846,15.90
9894139,9969802,3859,1350650,11320452,13.55
9894141,9980673,2637,922950,10903623,9.25
9894142,9987255,4546,1591100,11578355,15.93
9894144,9983546,3028,1059800,11043346,10.62
9894145,9975486,4344,1520400,11495886,15.24
9894146,9986082,4502,1575700,11561782,15.78
9894147,9998794,4068,1423800,11422594,14.24
9894149,9482317,3280,1148000,10630317,12.11
9894150,9986704,3083,1079050,11065754,10.80
9894151,9988046,4640,1624000,11612046,16.26
9894152,9978388,4569,1599150,11577538,16.03
9894153,9977533,2013,704550,10682083,7.06
9894154,2108732,930,325500,2434232,15.44
9894155,9989404,2619,916650,10906054,9.18
9894156,9989231,4515,1580250,11569481,15.82
9894157,9950128,4425,1548750,11498878,15.57
9894158,9985759,3310,1158500,11144259,11.60
9894159,9995043,2285,799750,10794793,8.00
9894160,9979807,2815,985250,10965057,9.87
9894161,9977435,3063,1072050,11049485,10.74
9894162,1055021,142,49700,1104721,4.71
9894163,9957330,3622,1267700,11225030,12.73
9894164,9957455,4041,1414350,11371805,14.20
9894165,9958187,3807,1332450,11290637,13.38
9894166,9967274,6723,2353050,12320324,23.61
9894167,9962223,4418,1546300,11508523,15.52
9894168,9976703,3643,1275050,11251753,12.78
9894169,9979710,2448,856800,10836510,8.59
9894170,9995297,4369,1529150,11524447,15.30
9894171,9997893,1419,496650,10494543,4.97
9894173,9991971,3708,1297800,11289771,12.99
9894174,9990654,5278,1847300,11837954,18.49
9894175,9991022,2787,975450,10966472,9.76
9894176,9998639,2087,730450,10729089,7.31
9894177,9986312,5399,1889650,11875962,18.92
9894178,9971871,3810,1333500,11305371,13.37
9894179,9967581,3994,1397900,11365481,14.02
9894180,2140919,1667,583450,2724369,27.25
9894181,9948284,4338,1518300,11466584,15.26
9894182,9956700,3285,1149750,11106450,11.55
9894183,8664883,3761,1316350,9981233,15.19
9894184,9948224,3312,1159200,11107424,11.65
9894185,9964054,5069,1774150,11738204,17.81
9894186,9981125,1343,470050,10451175,4.71
9894187,9973029,2667,933450,10906479,9.36
9894188,9990872,6211,2173850,12164722,21.76
9894189,9987581,4397,1538950,11526531,15.41
9894190,9969084,4878,1707300,11676384,17.13
9894191,9963905,4683,1639050,11602955,16.45
9894192,9977321,3581,1253350,11230671,12.56
9894193,9956656,3019,1056650,11013306,10.61
9894194,132458,100,35000,167458,26.42
9894195,9965218,4105,1436750,11401968,14.42
9894196,9969558,3474,1215900,11185458,12.20
9894197,1767314,564,197400,1964714,11.17
9894198,9954641,5453,1908550,11863191,19.17
9894199,1962505,514,179900,2142405,9.17
9894200,9964022,4295,1503250,11467272,15.09
9894201,9970911,3237,1132950,11103861,11.36
9894202,6296822,3052,1068200,7365022,16.96
9894203,9989640,6055,2119250,12108890,21.21
9894204,9996328,4762,1666700,11663028,16.67
9894205,9987350,3240,1134000,11121350,11.35
9894206,9968682,4975,1741250,11709932,17.47
9894208,9963783,4457,1559950,11523733,15.66
9894209,9978383,5589,1956150,11934533,19.60
9894210,9982424,2533,886550,10868974,8.88
9894211,9979049,4477,1566950,11545999,15.70
9894212,9974861,3439,1203650,11178511,12.07
9894213,9992011,1710,598500,10590511,5.99
9894214,9968214,2957,1034950,11003164,10.38
9894215,9960743,3814,1334900,11295643,13.40
9894216,9972639,2764,967400,10940039,9.70
9894217,9973216,4559,1595650,11568866,16.00
9894218,731578,429,150150,881728,20.52
9894219,9971438,4949,1732150,11703588,17.37
9894220,9976864,4738,1658300,11635164,16.62
9894221,9958363,4953,1733550,11691913,17.41
9894222,9944216,4667,1633450,11577666,16.43
9894223,9964631,3249,1137150,11101781,11.41
9894224,9954214,3902,1365700,11319914,13.72
9894225,9959463,3605,1261750,11221213,12.67
9894226,9698036,1868,653800,10351836,6.74
9894227,9973278,4632,1621200,11594478,16.26
9894228,9963545,5629,1970150,11933695,19.77
9894229,9974147,1986,695100,10669247,6.97
9894230,6204052,1666,583100,6787152,9.40
9894231,9985943,4556,1594600,11580543,15.97
9894232,9973781,2548,891800,10865581,8.94
9894233,9886414,4312,1509200,11395614,15.27
9894234,9974103,4499,1574650,11548753,15.79
9894235,9981253,6248,2186800,12168053,21.91
9894236,3227657,1783,624050,3851707,19.33
9894237,9990913,3903,1366050,11356963,13.67
9894238,5192454,4084,1429400,6621854,27.53
9894239,813135,629,220150,1033285,27.07
9894240,2387899,537,187950,2575849,7.87
9894241,9976250,4351,1522850,11499100,15.26
9894242,9987914,3329,1165150,11153064,11.67
9894243,9993821,4482,1568700,11562521,15.70
9894244,9975710,3726,1304100,11279810,13.07
9894245,9962031,3911,1368850,11330881,13.74
9894246,9968748,5909,2068150,12036898,20.75
9894247,9982028,2546,891100,10873128,8.93
9894248,9975635,6514,2279900,12255535,22.85
9894249,9975263,5645,1975750,11951013,19.81
9894250,397091,158,55300,452391,13.93
9894251,9971321,3187,1115450,11086771,11.19
9894252,9981817,3735,1307250,11289067,13.10
9894253,9960972,3801,1330350,11291322,13.36
9894254,9968112,3735,1307250,11275362,13.11
9894255,9988744,5689,1991150,11979894,19.93
9894256,9783776,4049,1417150,11200926,14.48
9894258,9966453,2204,771400,10737853,7.74
9894259,9965683,2224,778400,10744083,7.81
9894260,9988151,4715,1650250,11638401,16.52
9894261,9973580,3723,1303050,11276630,13.07
9894262,9972703,3945,1380750,11353453,13.85
9894263,9965089,2468,863800,10828889,8.67
9894264,9968818,3797,1328950,11297768,13.33
9894265,9967433,2657,929950,10897383,9.33
9894266,9965790,4812,1684200,11649990,16.90
9894267,9957257,2884,1009400,10966657,10.14
9894268,9933881,3301,1155350,11089231,11.63
9894269,3645614,1455,509250,4154864,13.97
9894270,9954278,4864,1702400,11656678,17.10
9894271,9968490,2166,758100,10726590,7.60
9894272,4346441,1926,674100,5020541,15.51
9894274,9971952,4048,1416800,11388752,14.21
9894275,9975229,3102,1085700,11060929,10.88
9894276,3185199,967,338450,3523649,10.63
9894277,9965009,3375,1181250,11146259,11.85
9894278,9965458,7558,2645300,12610758,26.54
9894279,9974959,4694,1642900,11617859,16.47
9894280,9979664,2649,927150,10906814,9.29
9894281,9991253,2057,719950,10711203,7.21
9894282,9983049,2980,1043000,11026049,10.45
9894284,9976620,5133,1796550,11773170,18.01
9894285,9990178,3462,1211700,11201878,12.13
9894286,9996187,2813,984550,10980737,9.85
9894287,9971873,2743,960050,10931923,9.63
9894288,9974959,3017,1055950,11030909,10.59
9894289,9994636,3527,1234450,11229086,12.35
9894290,9985101,3098,1084300,11069401,10.86
9894291,9212395,982,343700,9556095,3.73
9894292,9969974,2989,1046150,11016124,10.49
9894293,9970112,3899,1364650,11334762,13.69
9894294,9984630,5185,1814750,11799380,18.18
9894295,9983003,3634,1271900,11254903,12.74
9894296,9982381,2957,1034950,11017331,10.37
9894297,9992397,1947,681450,10673847,6.82
9894298,9988406,2602,910700,10899106,9.12
9894299,9962920,2400,840000,10802920,8.43
9894300,9968048,5089,1781150,11749198,17.87
9894301,3707590,539,188650,3896240,5.09
9894302,9981843,6000,2100000,12081843,21.04
9894303,9970180,3877,1356950,11327130,13.61
9894304,9981468,4802,1680700,11662168,16.84
9894305,190361,71,24850,215211,13.05
9894306,9978330,3996,1398600,11376930,14.02
9894307,9977414,4883,1709050,11686464,17.13
9894308,9982051,4779,1672650,11654701,16.76
9894309,9962971,2545,890750,10853721,8.94
9894310,9981139,4110,1438500,11419639,14.41
9894311,9986120,2998,1049300,11035420,10.51
9894312,9973521,1756,614600,10588121,6.16
9894313,9989902,2899,1014650,11004552,10.16
9894314,3744918,2057,719950,4464868,19.22
9894315,311802,118,41300,353102,13.25
9894316,9980976,2203,771050,10752026,7.73
9894317,9983662,2453,858550,10842212,8.60
9894318,9985745,3815,1335250,11320995,13.37
9894319,9961273,2193,767550,10728823,7.71
9894320,9967044,2704,946400,10913444,9.50
9894321,6415644,3212,1124200,7539844,17.52
9894322,9966247,4156,1454600,11420847,14.60
9894323,9967513,4337,1517950,11485463,15.23
9894324,679795,300,105000,784795,15.45
9894325,9944225,3273,1145550,11089775,11.52
9894326,9979362,5800,2030000,12009362,20.34
9894327,9983778,593,207550,10191328,2.08
9894328,9980262,6851,2397850,12378112,24.03
9894329,9993600,2598,909300,10902900,9.10
9894330,9979538,4142,1449700,11429238,14.53
9894332,1878171,648,226800,2104971,12.08
9894333,9985561,5911,2068850,12054411,20.72
9894334,5501747,4238,1483300,6985047,26.96
9894335,9983227,6039,2113650,12096877,21.17
9894336,9989085,3286,1150100,11139185,11.51
9894337,9981320,2372,830200,10811520,8.32
9894338,9982481,3425,1198750,11181231,12.01
9894339,9986997,6570,2299500,12286497,23.02
9894340,9987328,3129,1095150,11082478,10.97
9894341,9999167,3670,1284500,11283667,12.85
9894342,9991347,1801,630350,10621697,6.31
9894343,6942419,1790,626500,7568919,9.02
9894344,3289606,1499,524650,3814256,15.95
9894345,1651220,1082,378700,2029920,22.93
9894346,4990084,1663,582050,5572134,11.66
9894347,9960586,4158,1455300,11415886,14.61
9894348,410387,332,116200,526587,28.31
9894349,9949042,3222,1127700,11076742,11.33
9894350,9959259,2622,917700,10876959,9.21
9894351,9952477,471,164850,10117327,1.66
9894352,9940119,1136,397600,10337719,4.00
9894353,2676391,1557,544950,3221341,20.36
9894354,9962828,2638,923300,10886128,9.27
9894355,9951879,1585,554750,10506629,5.57
9894356,9944009,2660,931000,10875009,9.36
9894357,9953874,2230,780500,10734374,7.84
9894358,9947832,821,287350,10235182,2.89
9894359,9940922,1439,503650,10444572,5.07
9894360,9922166,3869,1354150,11276316,13.65
9894361,9926095,3301,1155350,11081445,11.64
9894362,9938005,2771,969850,10907855,9.76
9894363,9938513,1990,696500,10635013,7.01
9894364,9931035,3739,1308650,11239685,13.18
9894365,8340719,3271,1144850,9485569,13.73
9894366,9951875,2485,869750,10821625,8.74
9894367,9953779,4714,1649900,11603679,16.58
9894368,9965169,3404,1191400,11156569,11.96
9894369,2041231,654,228900,2270131,11.21
9894370,9967975,4889,1711150,11679125,17.17
9894371,9984638,3221,1127350,11111988,11.29
9894372,9983435,4928,1724800,11708235,17.28
9894373,9979931,3180,1113000,11092931,11.15
9894375,9993015,3158,1105300,11098315,11.06
9894376,6426676,2726,954100,7380776,14.85
9894377,9960087,2851,997850,10957937,10.02
9894378,5246530,2585,904750,6151280,17.24
9894379,9736291,3670,1284500,11020791,13.19
9894381,5504381,3476,1216600,6720981,22.10
9894382,9996723,1981,693350,10690073,6.94
9894383,9993860,1230,430500,10424360,4.31
9894384,9992176,3133,1096550,11088726,10.97
9894385,9907442,5112,1789200,11696642,18.06
9894386,9983356,3785,1324750,11308106,13.27
9894387,2045172,727,254450,2299622,12.44
9894388,9691931,2941,1029350,10721281,10.62
9894389,9999749,3170,1109500,11109249,11.10
9894390,9973035,2689,941150,10914185,9.44
9894391,8878407,2301,805350,9683757,9.07
9894392,5020055,1956,684600,5704655,13.64
9894393,9973372,3619,1266650,11240022,12.70
9894394,1473537,513,179550,1653087,12.18
9894395,9948243,4965,1737750,11685993,17.47
9894396,9955111,3185,1114750,11069861,11.20
9894398,9952453,4347,1521450,11473903,15.29
9894399,2536050,473,165550,2701600,6.53
9894400,749461,107,37450,786911,5.00
9894401,2637810,730,255500,2893310,9.69
9894402,9941753,1973,690550,10632303,6.95
9894403,9942770,3796,1328600,11271370,13.36
9894404,9938654,2868,1003800,10942454,10.10
9894405,1937033,1220,427000,2364033,22.04
9894406,4677093,1276,446600,5123693,9.55
9894407,9961118,3317,1160950,11122068,11.65
9894408,9974697,4042,1414700,11389397,14.18
9894409,9963224,3303,1156050,11119274,11.60
9894410,9926691,3140,1099000,11025691,11.07
9894411,9978013,5148,1801800,11779813,18.06
9894412,9979581,2388,835800,10815381,8.38
9894413,9985695,4371,1529850,11515545,15.32
9894414,9989918,5324,1863400,11853318,18.65
9894415,9998217,4642,1624700,11622917,16.25
9894416,9988596,2582,903700,10892296,9.05
9894417,9999668,5157,1804950,11804618,18.05
9894418,3846818,866,303100,4149918,7.88
9894419,8391797,2017,705950,9097747,8.41
9894420,9978970,5206,1822100,11801070,18.26
9894421,9995312,4659,1630650,11625962,16.31
9894422,9987153,4633,1621550,11608703,16.24
9894423,9977953,2944,1030400,11008353,10.33
9894424,6809083,990,346500,7155583,5.09
9894425,9994045,3461,1211350,11205395,12.12
9894426,9981211,5474,1915900,11897111,19.20
9894427,9982660,3014,1054900,11037560,10.57
9894428,9979647,4643,1625050,11604697,16.28
9894429,9993445,3418,1196300,11189745,11.97
9894430,9992374,3289,1151150,11143524,11.52
9894431,9761177,2253,788550,10549727,8.08
9894432,9984979,4562,1596700,11581679,15.99
9894433,9982004,4111,1438850,11420854,14.41
9894434,9990883,2414,844900,10835783,8.46
9894435,6508323,3152,1103200,7611523,16.95
9894436,9979753,3982,1393700,11373453,13.97
9894438,9992476,3393,1187550,11180026,11.88
9894439,9968046,2421,847350,10815396,8.50
9894440,9985522,3703,1296050,11281572,12.98
9894441,9989936,4027,1409450,11399386,14.11
9894442,9978486,2588,905800,10884286,9.08
9894444,9961247,5373,1880550,11841797,18.88
9894445,9965143,4789,1676150,11641293,16.82
9894446,9975068,1921,672350,10647418,6.74
9894447,707479,265,92750,800229,13.11
9894448,9961611,4005,1401750,11363361,14.07
9894449,9968827,2575,901250,10870077,9.04
9894450,9970830,4491,1571850,11542680,15.76
9894451,9967956,4235,1482250,11450206,14.87
9894452,9968977,2578,902300,10871277,9.05
9894453,9980856,5464,1912400,11893256,19.16
9894454,9955479,1110,388500,10343979,3.90
9894455,8851176,2941,1029350,9880526,11.63
9894456,9976000,3815,1335250,11311250,13.38
9894457,9979937,3355,1174250,11154187,11.77
9894458,9589776,4042,1414700,11004476,14.75
9894459,9991111,1823,638050,10629161,6.39
9894460,9991263,3167,1108450,11099713,11.09
9894461,9979801,3223,1128050,11107851,11.30
9894462,9970780,3156,1104600,11075380,11.08
9894463,9979196,3473,1215550,11194746,12.18
9894464,9991685,2296,803600,10795285,8.04
9894465,9981967,3012,1054200,11036167,10.56
9894466,9978131,2672,935200,10913331,9.37
9894467,4753529,1324,463400,5216929,9.75
9894468,9962992,4086,1430100,11393092,14.35
9894469,9983095,2112,739200,10722295,7.40
9894470,9975986,2971,1039850,11015836,10.42
9894471,9974609,3004,1051400,11026009,10.54
9894472,9983051,4212,1474200,11457251,14.77
9894473,9990243,2515,880250,10870493,8.81
9894474,9974015,2561,896350,10870365,8.99
9894476,9971300,2634,921900,10893200,9.25
9894477,292935,151,52850,345785,18.04
9894478,9990455,4639,1623650,11614105,16.25
9894479,6479431,2479,867650,7347081,13.39
9894480,9988756,3509,1228150,11216906,12.30
9894481,1168905,401,140350,1309255,12.01
9894482,9963895,5651,1977850,11941745,19.85
9894483,9972161,1759,615650,10587811,6.17
9894484,9959219,2889,1011150,10970369,10.15
9894485,9962022,3470,1214500,11176522,12.19
9894486,9923284,3177,1111950,11035234,11.21
9894487,9973252,3341,1169350,11142602,11.72
9894488,9982736,4587,1605450,11588186,16.08
9894489,9981598,4576,1601600,11583198,16.05
9894491,9978242,2944,1030400,11008642,10.33
9894492,9975261,3181,1113350,11088611,11.16
9894494,9891124,2099,734650,10625774,7.43
9894495,9936086,2486,870100,10806186,8.76
9894496,9937593,3476,1216600,11154193,12.24
9894497,9934439,2481,868350,10802789,8.74
9894498,9948906,4189,1466150,11415056,14.74
9894499,9949191,2378,832300,10781491,8.37
9894500,4644837,707,247450,4892287,5.33
9894501,9917218,7323,2563050,12480268,25.84
9894502,9944140,1422,497700,10441840,5.00
9894503,7798586,1558,545300,8343886,6.99
9894504,9965798,2831,990850,10956648,9.94
9894505,3547921,585,204750,3752671,5.77
9894506,9963972,3057,1069950,11033922,10.74
9894507,9965923,3817,1335950,11301873,13.41
9894508,9979048,1635,572250,10551298,5.73
9894509,9997518,2380,833000,10830518,8.33
9894511,369212,337,117950,487162,31.95
9894512,9995147,4208,1472800,11467947,14.74
9894513,1638796,865,302750,1941546,18.47
9894514,9333272,4124,1443400,10776672,15.47
9894515,9980856,3692,1292200,11273056,12.95
9894516,9976543,4465,1562750,11539293,15.66
9894517,9977596,4085,1429750,11407346,14.33
9894518,9968865,2238,783300,10752165,7.86
9894519,9989151,4153,1453550,11442701,14.55
9894520,9997886,2545,890750,10888636,8.91
9894521,9983750,4046,1416100,11399850,14.18
9894522,9986013,2790,976500,10962513,9.78
9894523,3631211,1687,590450,4221661,16.26
9894524,9928086,5657,1979950,11908036,19.94
9894525,9970852,4945,1730750,11701602,17.36
9894526,9965348,2178,762300,10727648,7.65
9894527,9951383,3304,1156400,11107783,11.62
9894528,9963172,3944,1380400,11343572,13.86
9894529,9971634,2156,754600,10726234,7.57
9894530,9971553,1395,488250,10459803,4.90
9894531,9945430,4003,1401050,11346480,14.09
9894532,9967654,3832,1341200,11308854,13.46
9894533,9950389,3765,1317750,11268139,13.24
9894535,1628434,1229,430150,2058584,26.41
9894536,9976330,3029,1060150,11036480,10.63
9894537,1701308,959,335650,2036958,19.73
9894538,9978130,3929,1375150,11353280,13.78
9894539,9955698,3177,1111950,11067648,11.17
9894540,9973230,3157,1104950,11078180,11.08
9894541,9979309,3944,1380400,11359709,13.83
9894542,9974261,3471,1214850,11189111,12.18
9894544,9979013,3570,1249500,11228513,12.52
9894545,9989731,3893,1362550,11352281,13.64
9894546,9984289,4394,1537900,11522189,15.40
9894547,9999499,3861,1351350,11350849,13.51
9894548,9987142,1721,602350,10589492,6.03
9894549,9989731,3645,1275750,11265481,12.77
9894550,9975714,1812,634200,10609914,6.36
9894551,9984213,1591,556850,10541063,5.58
9894552,9981636,2273,795550,10777186,7.97
9894553,9980358,5367,1878450,11858808,18.82
9894554,9984740,3604,1261400,11246140,12.63
9894555,9991841,1210,423500,10415341,4.24
9894556,9986405,2078,727300,10713705,7.28
9894557,9980225,2033,711550,10691775,7.13
9894558,9980184,2004,701400,10681584,7.03
9894559,9993732,2974,1040900,11034632,10.42
9894560,9976689,1603,561050,10537739,5.62
9894561,9992890,4196,1468600,11461490,14.70
9894562,9983126,4457,1559950,11543076,15.63
9894563,9973394,6624,2318400,12291794,23.25
9894564,9975049,3967,1388450,11363499,13.92
9894565,9942470,3847,1346450,11288920,13.54
9894566,9981365,2437,852950,10834315,8.55
9894567,6297544,3182,1113700,7411244,17.68
9894569,9970131,3238,1133300,11103431,11.37
9894570,9972044,3426,1199100,11171144,12.02
9894571,9954132,3195,1118250,11072382,11.23
9894572,9971234,6618,2316300,12287534,23.23
9894573,3979912,5430,1900500,5880412,47.75
9894574,9980051,6479,2267650,12247701,22.72
9894575,9972755,3199,1119650,11092405,11.23
9894576,9975740,3534,1236900,11212640,12.40
9894577,9984275,3782,1323700,11307975,13.26
9894578,9975428,5714,1999900,11975328,20.05
9894579,9985476,5221,1827350,11812826,18.30
9894580,9985601,6013,2104550,12090151,21.08
9894581,9981957,3143,1100050,11082007,11.02
9894583,9989210,3544,1240400,11229610,12.42
9894584,2850750,792,277200,3127950,9.72
9894585,2147791,1360,476000,2623791,22.16
9894586,9979104,4632,1621200,11600304,16.25
9894587,232532,130,45500,278032,19.57
9894588,9971250,6451,2257850,12229100,22.64
9894589,9998610,1967,688450,10687060,6.89
9894590,832923,462,161700,994623,19.41
9894591,9494505,4087,1430450,10924955,15.07
9894592,9959808,4087,1430450,11390258,14.36
9894593,9949738,5015,1755250,11704988,17.64
9894594,4651363,557,194950,4846313,4.19
9894595,1494550,742,259700,1754250,17.38
9894596,9968068,3821,1337350,11305418,13.42
9894597,9949317,5892,2062200,12011517,20.73
9894598,9959825,1792,627200,10587025,6.30
9894599,9968194,4164,1457400,11425594,14.62
9894600,9976635,5200,1820000,11796635,18.24
9894601,9995455,4722,1652700,11648155,16.53
9894602,9982672,4479,1567650,11550322,15.70
9894603,9988248,4434,1551900,11540148,15.54
9894604,9989200,2949,1032150,11021350,10.33
9894605,9997910,1764,617400,10615310,6.18
9894606,9981752,4379,1532650,11514402,15.35
9894607,9937071,2340,819000,10756071,8.24
9894608,9964592,6469,2264150,12228742,22.72
9894609,9971708,2175,761250,10732958,7.63
9894610,9982965,5974,2090900,12073865,20.94
9894611,9970824,4206,1472100,11442924,14.76
9894612,9975829,3875,1356250,11332079,13.60
9894613,9958748,3385,1184750,11143498,11.90
9894614,6939893,2851,997850,7937743,14.38
9894615,9977228,4242,1484700,11461928,14.88
9894616,9987526,4426,1549100,11536626,15.51
9894617,9999746,4866,1703100,11702846,17.03
9894618,9993715,3587,1255450,11249165,12.56
9894619,9982718,2797,978950,10961668,9.81
9894620,9988193,4764,1667400,11655593,16.69
9894621,9963038,2977,1041950,11004988,10.46
9894622,9037182,4924,1723400,10760582,19.07
9894624,4882601,2902,1015700,5898301,20.80
9894625,9987261,3544,1240400,11227661,12.42
9894626,9959996,4527,1584450,11544446,15.91
9894627,9984784,5243,1835050,11819834,18.38
9894628,1135777,479,167650,1303427,14.76
9894629,6196309,1833,641550,6837859,10.35
9894630,189416,162,56700,246116,29.93
9894631,9986432,7341,2569350,12555782,25.73
9894632,9981385,3639,1273650,11255035,12.76
9894633,9946420,6619,2316650,12263070,23.29
9894634,9992466,4022,1407700,11400166,14.09
9894635,9984162,2038,713300,10697462,7.14
9894637,9968979,1137,397950,10366929,3.99
9894638,9547512,2534,886900,10434412,9.29
9894639,9973113,2818,986300,10959413,9.89
9894640,9983840,3855,1349250,11333090,13.51
9894641,9969671,2157,754950,10724621,7.57
9894642,9960983,3831,1340850,11301833,13.46
9894643,9965814,3507,1227450,11193264,12.32
9894644,9619309,3060,1071000,10690309,11.13
9894645,4201126,1641,574350,4775476,13.67
9894646,9973320,4262,1491700,11465020,14.96
9894647,9985702,4575,1601250,11586952,16.04
9894648,9990519,3134,1096900,11087419,10.98
9894649,9987726,2428,849800,10837526,8.51
9894650,6682633,1043,365050,7047683,5.46
9894651,6032925,1638,573300,6606225,9.50
9894652,9982086,3964,1387400,11369486,13.90
9894653,9978874,3857,1349950,11328824,13.53
9894654,9968389,2037,712950,10681339,7.15
9894655,9988190,4383,1534050,11522240,15.36
9894656,9989486,3458,1210300,11199786,12.12
9894657,1639778,844,295400,1935178,18.01
9894658,9976797,2827,989450,10966247,9.92
9894659,9969523,2621,917350,10886873,9.20
9894660,9976419,4845,1695750,11672169,17.00
9894661,9963488,4177,1461950,11425438,14.67
9894662,5565761,870,304500,5870261,5.47
9894663,9971080,4537,1587950,11559030,15.93
9894664,9970869,3824,1338400,11309269,13.42
9894665,9960982,4378,1532300,11493282,15.38
9894666,9954395,3520,1232000,11186395,12.38
9894667,1685164,925,323750,2008914,19.21
9894668,9981933,2744,960400,10942333,9.62
9894669,3937384,2234,781900,4719284,19.86
9894670,9984419,3897,1363950,11348369,13.66
9894671,9980561,5717,2000950,11981511,20.05
9894672,9993954,4711,1648850,11642804,16.50
9894673,9988674,2682,938700,10927374,9.40
9894674,9975295,1484,519400,10494695,5.21
9894675,9980290,2812,984200,10964490,9.86
9894676,9983590,3097,1083950,11067540,10.86
9894677,9916643,1412,494200,10410843,4.98
9894678,9978987,1949,682150,10661137,6.84
9894679,2648617,779,272650,2921267,10.29
9894680,9981061,2642,924700,10905761,9.26
9894681,9983271,2774,970900,10954171,9.73
9894682,9999754,2256,789600,10789354,7.90
9894683,2263764,589,206150,2469914,9.11
9894684,9968042,3272,1145200,11113242,11.49
9894686,9956917,2828,989800,10946717,9.94
9894687,9939109,2105,736750,10675859,7.41
9894689,9944247,4057,1419950,11364197,14.28
9894690,9944821,4407,1542450,11487271,15.51
9894691,9942018,2071,724850,10666868,7.29
9894692,9950647,2422,847700,10798347,8.52
9894693,9966309,4300,1505000,11471309,15.10
9894694,7420118,2862,1001700,8421818,13.50
9894695,9977291,2556,894600,10871891,8.97
9894696,9988794,3273,1145550,11134344,11.47
9894698,9982469,2869,1004150,10986619,10.06
9894699,9955995,8588,3005800,12961795,30.19
9894700,9966768,4473,1565550,11532318,15.71
9894701,9962766,1589,556150,10518916,5.58
9894702,9955956,2492,872200,10828156,8.76
9894703,9949370,272,95200,10044570,0.96
9894704,363808,256,89600,453408,24.63
9894705,9964994,2978,1042300,11007294,10.46
9894706,9937182,3450,1207500,11144682,12.15
9894707,9936178,4103,1436050,11372228,14.45
9894708,9936932,1577,551950,10488882,5.55
9894709,9954522,3905,1366750,11321272,13.73
9894710,9965065,3591,1256850,11221915,12.61
9894712,9942474,4290,1501500,11443974,15.10
9894713,9955433,3153,1103550,11058983,11.08
9894714,9951856,4064,1422400,11374256,14.29
9894715,9970748,4204,1471400,11442148,14.76
9894716,9972224,2096,733600,10705824,7.36
9894717,9983382,3695,1293250,11276632,12.95
9894718,4803445,3470,1214500,6017945,25.28
9894719,5747620,1074,375900,6123520,6.54
9894720,3213043,1196,418600,3631643,13.03
9894721,4868328,1289,451150,5319478,9.27
9894723,9969198,4393,1537550,11506748,15.42
9894724,9988337,4783,1674050,11662387,16.76
9894725,2366227,1826,639100,3005327,27.01
9894726,9964173,5435,1902250,11866423,19.09
9894727,9965140,2005,701750,10666890,7.04
9894728,9984954,2960,1036000,11020954,10.38
9894729,9974948,2409,843150,10818098,8.45
9894730,9992315,1186,415100,10407415,4.15
9894731,9982407,2837,992950,10975357,9.95
9894732,9983578,4737,1657950,11641528,16.61
9894733,9991070,3906,1367100,11358170,13.68
9894734,9977692,2839,993650,10971342,9.96
9894735,4792558,1058,370300,5162858,7.73
9894736,9976967,4444,1555400,11532367,15.59
9894737,9960742,2324,813400,10774142,8.17
9894738,9963857,3137,1097950,11061807,11.02
9894739,4690162,893,312550,5002712,6.66
9894740,9963679,6122,2142700,12106379,21.51
9894741,9970077,4073,1425550,11395627,14.30
9894742,9972773,5178,1812300,11785073,18.17
9894743,9978471,3543,1240050,11218521,12.43
9894744,9963039,4355,1524250,11487289,15.30
9894745,9961454,6181,2163350,12124804,21.72
9894746,9982082,2049,717150,10699232,7.18
9894747,9992348,6997,2448950,12441298,24.51
9894748,9981221,3011,1053850,11035071,10.56
9894749,9975826,638,223300,10199126,2.24
9894750,1845804,297,103950,1949754,5.63
9894751,9968188,2758,965300,10933488,9.68
9894752,3058702,850,297500,3356202,9.73
9894753,1498049,762,266700,1764749,17.80
9894754,9989979,2835,992250,10982229,9.93
9894755,9999051,4202,1470700,11469751,14.71
9894756,9984677,3200,1120000,11104677,11.22
9894757,9986079,574,200900,10186979,2.01
9894759,9988977,4622,1617700,11606677,16.19
9894760,9988600,1857,649950,10638550,6.51
9894761,9981271,1503,526050,10507321,5.27
9894762,9980584,880,308000,10288584,3.09
9894763,9960714,3046,1066100,11026814,10.70
9894764,9982478,2960,1036000,11018478,10.38
9894765,9984763,6453,2258550,12243313,22.62
9894766,9991999,4966,1738100,11730099,17.39
9894767,9993604,3682,1288700,11282304,12.90
9894768,9983839,2852,998200,10982039,10.00
9894769,9997735,1649,577150,10574885,5.77
9894770,9971800,1839,643650,10615450,6.45
9894771,9959854,3296,1153600,11113454,11.58
9894772,9952071,4599,1609650,11561721,16.17
9894773,9961560,2732,956200,10917760,9.60
9894774,9969663,2899,1014650,10984313,10.18
9894775,3337933,1210,423500,3761433,12.69
9894776,9968351,3622,1267700,11236051,12.72
9894777,9971343,3672,1285200,11256543,12.89
9894778,496911,217,75950,572861,15.28
9894779,9943918,3712,1299200,11243118,13.07
9894780,9954592,4729,1655150,11609742,16.63
9894781,2369856,752,263200,2633056,11.11
9894782,1721682,1330,465500,2187182,27.04
9894783,9519661,2423,848050,10367711,8.91
9894784,2800083,1547,541450,3341533,19.34
9894785,797905,201,70350,868255,8.82
9894786,9939404,1573,550550,10489954,5.54
9894787,9946034,3882,1358700,11304734,13.66
9894788,9949126,1832,641200,10590326,6.44
9894789,9936981,5605,1961750,11898731,19.74
9894790,9932789,4610,1613500,11546289,16.24
9894791,9935519,4154,1453900,11389419,14.63
9894792,9929698,4834,1691900,11621598,17.04
9894793,9939306,5225,1828750,11768056,18.40
9894794,9936663,5663,1982050,11918713,19.95
9894795,9935635,3055,1069250,11004885,10.76
9894796,9927259,4181,1463350,11390609,14.74
9894797,9944809,2598,909300,10854109,9.14
9894798,9939746,4170,1459500,11399246,14.68
9894799,9950675,3603,1261050,11211725,12.67
9894800,9935017,1903,666050,10601067,6.70
9894801,9936917,2782,973700,10910617,9.80
9894802,9943234,5348,1871800,11815034,18.82
9894803,9889774,4119,1441650,11331424,14.58
9894804,9948933,2787,975450,10924383,9.80
9894805,9953610,5592,1957200,11910810,19.66
9894806,9949649,3520,1232000,11181649,12.38
9894807,441305,205,71750,513055,16.26
9894809,9955587,3569,1249150,11204737,12.55
9894810,9943884,5331,1865850,11809734,18.76
9894811,9949878,3249,1137150,11087028,11.43
9894812,9946440,2499,874650,10821090,8.79
9894813,1940889,626,219100,2159989,11.29
9894814,9958604,4427,1549450,11508054,15.56
9894815,9961745,4921,1722350,11684095,17.29
9894817,9947808,1865,652750,10600558,6.56
9894818,981643,521,182350,1163993,18.58
9894819,9938694,4154,1453900,11392594,14.63
9894820,9952219,1369,479150,10431369,4.81
9894821,9940511,681,238350,10178861,2.40
9894822,1553201,648,226800,1780001,14.60
9894823,9950549,3232,1131200,11081749,11.37
9894824,366096,156,54600,420696,14.91
9894825,9918682,3933,1376550,11295232,13.88
9894826,2206437,244,85400,2291837,3.87
9894827,1957217,991,346850,2304067,17.72
9894828,9932461,2306,807100,10739561,8.13
9894829,9942224,2698,944300,10886524,9.50
9894830,1810004,1109,388150,2198154,21.44
9894831,9946037,3883,1359050,11305087,13.66
9894832,9952975,4662,1631700,11584675,16.39
9894833,2805982,1219,426650,3232632,15.21
9894834,9956810,3991,1396850,11353660,14.03
9894835,9954548,2650,927500,10882048,9.32
9894836,9962286,3240,1134000,11096286,11.38
9894837,9980302,4529,1585150,11565452,15.88
9894838,9975440,1327,464450,10439890,4.66
9894839,9989869,2897,1013950,11003819,10.15
9894840,9983142,1558,545300,10528442,5.46
9894841,9980299,2750,962500,10942799,9.64
9894842,9984094,1240,434000,10418094,4.35
9894843,9974444,385,134750,10109194,1.35
9894844,9970125,4219,1476650,11446775,14.81
9894845,9980664,2538,888300,10868964,8.90
9894846,9978418,3542,1239700,11218118,12.42
9894847,6761013,3516,1230600,7991613,18.20
9894848,9968926,3123,1093050,11061976,10.96
9894849,9985256,3346,1171100,11156356,11.73
9894850,9969990,4810,1683500,11653490,16.89
9894851,2674455,760,266000,2940455,9.95
9894852,9950749,4907,1717450,11668199,17.26
9894853,9960713,5379,1882650,11843363,18.90
9894854,9947568,2396,838600,10786168,8.43
9894855,9969010,4602,1610700,11579710,16.16
9894856,9971621,3606,1262100,11233721,12.66
9894857,2018532,883,309050,2327582,15.31
9894858,7570441,2733,956550,8526991,12.64
9894859,9947221,3375,1181250,11128471,11.88
9894860,3411553,1004,351400,3762953,10.30
9894861,9965655,4482,1568700,11534355,15.74
9894862,9977932,4528,1584800,11562732,15.88
9894863,9988083,3651,1277850,11265933,12.79
9894864,9991624,2178,762300,10753924,7.63
9894865,9987546,6011,2103850,12091396,21.06
9894866,9980211,3731,1305850,11286061,13.08
9894867,2079207,443,155050,2234257,7.46
9894868,9984705,2855,999250,10983955,10.01
9894869,9965018,3821,1337350,11302368,13.42
9894870,1621035,1011,353850,1974885,21.83
9894871,9984946,3304,1156400,11141346,11.58
9894872,9954455,2638,923300,10877755,9.28
9894873,9972767,3612,1264200,11236967,12.68
9894874,9976664,2746,961100,10937764,9.63
9894875,9978538,3906,1367100,11345638,13.70
9894876,9951245,3250,1137500,11088745,11.43
9894877,9959630,2192,767200,10726830,7.70
9894878,9980615,4393,1537550,11518165,15.41
9894879,9958546,1872,655200,10613746,6.58
9894880,9968174,3466,1213100,11181274,12.17
9894881,9957520,6604,2311400,12268920,23.21
9894882,9967778,2837,992950,10960728,9.96
9894883,9040948,4897,1713950,10754898,18.96
9894884,9973577,3357,1174950,11148527,11.78
9894885,9973609,2734,956900,10930509,9.59
9894886,9982352,2041,714350,10696702,7.16
9894887,9981784,2720,952000,10933784,9.54
9894888,9957276,3134,1096900,11054176,11.02
9894889,9974338,4277,1496950,11471288,15.01
9894890,9988569,2334,816900,10805469,8.18
9894891,8944043,3091,1081850,10025893,12.10
9894892,9980480,3382,1183700,11164180,11.86
9894893,9999326,4541,1589350,11588676,15.89
9894895,9985672,2882,1008700,10994372,10.10
9894896,9487961,3576,1251600,10739561,13.19
9894897,9987841,2298,804300,10792141,8.05
9894898,9977543,4572,1600200,11577743,16.04
9894899,9984299,2276,796600,10780899,7.98
9894900,9982132,7175,2511250,12493382,25.16
9894901,9995563,3529,1235150,11230713,12.36
9894902,9989101,3867,1353450,11342551,13.55
9894903,9989395,4410,1543500,11532895,15.45
9894904,9995872,3302,1155700,11151572,11.56
9894905,9969798,2469,864150,10833948,8.67
9894906,9980968,2761,966350,10947318,9.68
9894907,9970833,4849,1697150,11667983,17.02
9894908,9992105,4624,1618400,11610505,16.20
9894909,9987944,3488,1220800,11208744,12.22
9894910,1677469,1245,435750,2113219,25.98
9894911,3769079,1994,697900,4466979,18.52
9894912,9976182,3520,1232000,11208182,12.35
9894913,2458494,686,240100,2698594,9.77
9894914,9969682,2053,718550,10688232,7.21
9894915,2490662,508,177800,2668462,7.14
9894916,9958160,4257,1489950,11448110,14.96
9894917,9980920,4726,1654100,11635020,16.57
9894918,9984523,5323,1863050,11847573,18.66
9894919,9985224,5118,1791300,11776524,17.94
9894920,7042924,3710,1298500,8341424,18.44
9894921,3187012,1456,509600,3696612,15.99
9894922,9975339,3169,1109150,11084489,11.12
9894923,9961692,5320,1862000,11823692,18.69
9894924,9966988,3475,1216250,11183238,12.20
9894925,526274,223,78050,604324,14.83
9894927,9959204,4642,1624700,11583904,16.31
9894928,9953583,5055,1769250,11722833,17.78
9894929,9945705,2164,757400,10703105,7.62
9894930,287021,42,14700,301721,5.12
9894931,9949846,3944,1380400,11330246,13.87
9894932,9959414,5200,1820000,11779414,18.27
9894933,9939981,5720,2002000,11941981,20.14
9894934,9925461,3625,1268750,11194211,12.78
9894935,9926209,2940,1029000,10955209,10.37
9894936,9929221,4878,1707300,11636521,17.19
9894937,9945864,3817,1335950,11281814,13.43
9894938,9952222,5095,1783250,11735472,17.92
9894939,9937422,2380,833000,10770422,8.38
9894940,9934396,3213,1124550,11058946,11.32
9894941,9938761,3253,1138550,11077311,11.46
9894942,9934986,2177,761950,10696936,7.67
9894943,9938424,3004,1051400,10989824,10.58
9894944,9958999,3269,1144150,11103149,11.49
9894945,9967152,4332,1516200,11483352,15.21
9894946,995543,487,170450,1165993,17.12
9894947,9946806,4792,1677200,11624006,16.86
9894948,9927490,2468,863800,10791290,8.70
9894949,9941915,3835,1342250,11284165,13.50
9894950,9957148,2709,948150,10905298,9.52
9894952,7455659,1677,586950,8042609,7.87
9894953,7457585,3672,1285200,8742785,17.23
9894954,9951641,2858,1000300,10951941,10.05
9894955,9953510,3079,1077650,11031160,10.83
9894956,9963019,3458,1210300,11173319,12.15
9894957,9981300,2539,888650,10869950,8.90
9894958,9972967,2147,751450,10724417,7.53
9894959,9978215,5517,1930950,11909165,19.35
9894960,9987621,4928,1724800,11712421,17.27
9894961,9975819,3753,1313550,11289369,13.17
9894962,9983062,3945,1380750,11363812,13.83
9894964,9979411,3151,1102850,11082261,11.05
9894965,9980592,4692,1642200,11622792,16.45
9894966,9972962,4104,1436400,11409362,14.40
9894967,9977285,4401,1540350,11517635,15.44
9894968,9984201,3655,1279250,11263451,12.81
9894969,9959748,5714,1999900,11959648,20.08
9894970,5180658,1691,591850,5772508,11.42
9894972,9941638,5943,2080050,12021688,20.92
9894973,9951403,2342,819700,10771103,8.24
9894974,9951419,1513,529550,10480969,5.32
9894975,9955068,5455,1909250,11864318,19.18
9894976,9972836,2099,734650,10707486,7.37
9894977,7909433,2335,817250,8726683,10.33
9894978,9935180,2964,1037400,10972580,10.44
9894979,1602577,334,116900,1719477,7.29
9894980,9935697,2313,809550,10745247,8.15
9894981,9951739,2369,829150,10780889,8.33
9894982,9958605,3852,1348200,11306805,13.54
9894983,9940653,2202,770700,10711353,7.75
9894984,9942054,4327,1514450,11456504,15.23
9894985,9951270,1651,577850,10529120,5.81
9894986,9950771,3587,1255450,11206221,12.62
9894987,9950993,4184,1464400,11415393,14.72
9894988,9952599,2853,998550,10951149,10.03
9894989,9967545,3715,1300250,11267795,13.04
9894990,9956496,2175,761250,10717746,7.65
9894991,9950752,2466,863100,10813852,8.67
9894993,9934922,2382,833700,10768622,8.39
9894994,9924215,2827,989450,10913665,9.97
9894995,9925893,3814,1334900,11260793,13.45
9894996,9944229,4446,1556100,11500329,15.65
9894997,9942500,4759,1665650,11608150,16.75
9894998,9960004,2913,1019550,10979554,10.24
9894999,9745029,3504,1226400,10971429,12.58
9895000,9951601,4032,1411200,11362801,14.18
9895001,4304262,1686,590100,4894362,13.71
9895002,7715322,2866,1003100,8718422,13.00
9895004,9942285,3222,1127700,11069985,11.34
9895005,9953601,2207,772450,10726051,7.76
9895006,9950031,1610,563500,10513531,5.66
9895007,9951310,3388,1185800,11137110,11.92
9895008,9964385,4920,1722000,11686385,17.28
9895009,4783750,1761,616350,5400100,12.88
9895010,3773641,1269,444150,4217791,11.77
9895011,9966237,4050,1417500,11383737,14.22
9895012,9974029,3082,1078700,11052729,10.82
9895013,9972486,4700,1645000,11617486,16.50
9895014,9972451,4514,1579900,11552351,15.84
9895015,3390274,1856,649600,4039874,19.16
9895016,9960648,2298,804300,10764948,8.07
9895017,9959963,4016,1405600,11365563,14.11
9895018,9964013,3418,1196300,11160313,12.01
9895019,2890086,855,299250,3189336,10.35
9895020,9949241,4184,1464400,11413641,14.72
9895021,9963804,3857,1349950,11313754,13.55
9895022,9974261,4224,1478400,11452661,14.82
9895023,9984687,3048,1066800,11051487,10.68
9895024,2844171,1456,509600,3353771,17.92
9895025,9979514,3453,1208550,11188064,12.11
9895026,9971895,3782,1323700,11295595,13.27
9895027,9972741,3674,1285900,11258641,12.89
9895028,9964185,4628,1619800,11583985,16.26
9895029,9967853,4448,1556800,11524653,15.62
9895030,9970653,1777,621950,10592603,6.24
9895031,9972293,2070,724500,10696793,7.27
9895032,9967107,3808,1332800,11299907,13.37
9895033,9964135,2490,871500,10835635,8.75
9895034,9970020,3267,1143450,11113470,11.47
9895035,9968196,2123,743050,10711246,7.45
9895036,198271,55,19250,217521,9.71
9895038,9959647,1537,537950,10497597,5.40
9895039,9967914,4257,1489950,11457864,14.95
9895040,9975508,2220,777000,10752508,7.79
9895041,9980835,2612,914200,10895035,9.16
9895042,1405327,450,157500,1562827,11.21
9895043,1808213,664,232400,2040613,12.85
9895044,9434879,3214,1124900,10559779,11.92
9895045,9994191,3460,1211000,11205191,12.12
9895046,9973211,2928,1024800,10998011,10.28
9895047,9975315,2355,824250,10799565,8.26
9895048,9986413,3504,1226400,11212813,12.28
9895049,936023,702,245700,1181723,26.25
9895051,9967775,3354,1173900,11141675,11.78
9895052,2652163,472,165200,2817363,6.23
9895053,147120,70,24500,171620,16.65
9895054,9964084,1886,660100,10624184,6.62
9895055,5475731,2237,782950,6258681,14.30
9895056,9993312,3591,1256850,11250162,12.58
9895057,9974867,4696,1643600,11618467,16.48
9895058,9961760,2533,886550,10848310,8.90
9895059,9959626,4815,1685250,11644876,16.92
9895060,9975540,3121,1092350,11067890,10.95
9895061,1364295,392,137200,1501495,10.06
9895062,833061,22,7700,840761,0.92
9895063,9968188,3585,1254750,11222938,12.59
9895064,9956625,4696,1643600,11600225,16.51
9895065,3497071,505,176750,3673821,5.05
9895066,9949472,2231,780850,10730322,7.85
9895067,3437058,344,120400,3557458,3.50
9895068,9937875,2110,738500,10676375,7.43
9895069,9950956,3383,1184050,11135006,11.90
9895070,9444689,4456,1559600,11004289,16.51
9895071,9949112,3033,1061550,11010662,10.67
9895072,9933479,5483,1919050,11852529,19.32
9895073,5209244,2139,748650,5957894,14.37
9895074,9943928,4045,1415750,11359678,14.24
9895075,9951203,4098,1434300,11385503,14.41
9895076,9965012,2059,720650,10685662,7.23
9895077,3134801,1152,403200,3538001,12.86
9895078,9956035,1998,699300,10655335,7.02
9895079,9963702,2424,848400,10812102,8.51
9895080,9956816,2531,885850,10842666,8.90
9895081,9515163,3364,1177400,10692563,12.37
9895082,9960658,2244,785400,10746058,7.89
9895083,9966765,4663,1632050,11598815,16.37
9895084,2710456,1075,376250,3086706,13.88
9895085,9950144,2945,1030750,10980894,10.36
9895086,1223429,613,214550,1437979,17.54
9895087,9981470,3006,1052100,11033570,10.54
9895088,9968645,4434,1551900,11520545,15.57
9895089,9974899,2396,838600,10813499,8.41
9895090,9980154,3079,1077650,11057804,10.80
9895091,9981421,4453,1558550,11539971,15.61
9895092,510993,220,77000,587993,15.07
9895093,9985023,4925,1723750,11708773,17.26
9895094,9988452,4607,1612450,11600902,16.14
9895095,9974518,3441,1204350,11178868,12.07
9895096,9971568,6482,2268700,12240268,22.75
9895097,6201910,1388,485800,6687710,7.83
9895098,9962079,4080,1428000,11390079,14.33
9895099,519118,311,108850,627968,20.97
9895100,9949438,336,117600,10067038,1.18
9895101,2648323,849,297150,2945473,11.22
9895102,2772083,1177,411950,3184033,14.86
9895103,1198859,466,163100,1361959,13.60
9895104,9999754,3090,1081500,11081254,10.82
9895105,9990140,4869,1704150,11694290,17.06
9895106,9979137,3361,1176350,11155487,11.79
9895108,9981110,4601,1610350,11591460,16.13
9895109,9996760,3097,1083950,11080710,10.84
9895110,3518953,1564,547400,4066353,15.56
9895111,9971495,3307,1157450,11128945,11.61
9895112,9966948,3686,1290100,11257048,12.94
9895113,9972166,3632,1271200,11243366,12.75
9895114,9970377,4408,1542800,11513177,15.47
9895115,9964230,2128,744800,10709030,7.47
9895116,9961637,2105,736750,10698387,7.40
9895117,9973128,3238,1133300,11106428,11.36
9895118,9968444,5891,2061850,12030294,20.68
9895119,9976045,5278,1847300,11823345,18.52
9895120,9983910,4797,1678950,11662860,16.82
9895121,9987053,2679,937650,10924703,9.39
9895122,9995270,4247,1486450,11481720,14.87
9895123,9992196,3640,1274000,11266196,12.75
9895124,9996138,5266,1843100,11839238,18.44
9895125,9984773,3902,1365700,11350473,13.68
9895126,9992449,5020,1757000,11749449,17.58
9895127,9979560,3731,1305850,11285410,13.09
9895128,2876944,1028,359800,3236744,12.51
9895129,9978456,5992,2097200,12075656,21.02
9895130,9989064,4465,1562750,11551814,15.64
9895131,9971016,4762,1666700,11637716,16.72
9895132,9982236,3897,1363950,11346186,13.66
9895133,9981095,4855,1699250,11680345,17.02
9895134,1256313,526,184100,1440413,14.65
9895135,9966859,3403,1191050,11157909,11.95
9895136,9973526,5540,1939000,11912526,19.44
9895137,9977313,3942,1379700,11357013,13.83
9895138,412425,144,50400,462825,12.22
9895139,9972063,1881,658350,10630413,6.60
9895140,9957095,3109,1088150,11045245,10.93
9895141,9950741,3393,1187550,11138291,11.93
9895143,9946115,2967,1038450,10984565,10.44
9895144,9937631,5274,1845900,11783531,18.57
9895145,9941252,3172,1110200,11051452,11.17
9895146,9955949,2558,895300,10851249,8.99
9895147,2094936,532,186200,2281136,8.89
9895148,799397,192,67200,866597,8.41
9895149,9946162,4598,1609300,11555462,16.18
9895150,9947699,4692,1642200,11589899,16.51
9895151,1224496,376,131600,1356096,10.75
9895152,8901118,1857,649950,9551068,7.30
9895153,9820058,2859,1000650,10820708,10.19
9895154,9922998,2830,990500,10913498,9.98
9895155,9932470,3697,1293950,11226420,13.03
9895156,9939653,3959,1385650,11325303,13.94
9895157,9937658,5275,1846250,11783908,18.58
9895158,7460616,1191,416850,7877466,5.59
9895159,224836,42,14700,239536,6.54
9895160,9935049,3783,1324050,11259099,13.33
9895161,7935200,4418,1546300,9481500,19.49
9895162,9932303,5246,1836100,11768403,18.49
9895163,9937632,1563,547050,10484682,5.50
9895164,9948462,4898,1714300,11662762,17.23
9895165,421102,73,25550,446652,6.07
9895166,1663926,912,319200,1983126,19.18
9895167,602413,182,63700,666113,10.57
9895168,9907293,3515,1230250,11137543,12.42
9895169,830295,373,130550,960845,15.72
9895170,9906162,1959,685650,10591812,6.92
9895171,9895821,3684,1289400,11185221,13.03
9895172,9229419,2977,1041950,10271369,11.29
9895173,9917464,3240,1134000,11051464,11.43
9895174,9916768,2716,950600,10867368,9.59
9895176,9938752,3400,1190000,11128752,11.97
9895177,8890543,3933,1376550,10267093,15.48
9895178,9938292,3965,1387750,11326042,13.96
9895179,9945040,2286,800100,10745140,8.05
9895180,9940577,1109,388150,10328727,3.90
9895181,2217301,904,316400,2533701,14.27
9895183,9959651,4313,1509550,11469201,15.16
9895184,9956494,3209,1123150,11079644,11.28
9895185,9966733,3633,1271550,11238283,12.76
9895186,9962952,2281,798350,10761302,8.01
9895187,9975129,3603,1261050,11236179,12.64
9895188,9961563,2514,879900,10841463,8.83
9895189,9991590,3019,1056650,11048240,10.58
9895190,9982916,1189,416150,10399066,4.17
9895191,9980714,4869,1704150,11684864,17.07
9895192,9999877,3278,1147300,11147177,11.47
9895193,9994862,4818,1686300,11681162,16.87
9895194,9983316,2225,778750,10762066,7.80
9895195,9988626,3807,1332450,11321076,13.34
9895196,9984732,2527,884450,10869182,8.86
9895197,9973978,4475,1566250,11540228,15.70
9895198,3058107,1143,400050,3458157,13.08
9895199,9975281,2217,775950,10751231,7.78
9895200,3932751,1422,497700,4430451,12.66
9895201,9987023,3060,1071000,11058023,10.72
9895202,9990950,3184,1114400,11105350,11.15
9895204,9992388,3920,1372000,11364388,13.73
9895205,9990781,3577,1251950,11242731,12.53
9895206,9978442,2655,929250,10907692,9.31
9895207,6317775,1391,486850,6804625,7.71
9895208,9996582,4351,1522850,11519432,15.23
9895209,3113391,925,323750,3437141,10.40
9895210,9966765,2910,1018500,10985265,10.22
9895211,9987467,5817,2035950,12023417,20.39
9895212,9998627,3767,1318450,11317077,13.19
9895213,209824,42,14700,224524,7.01
9895214,9959630,3179,1112650,11072280,11.17
9895215,9974512,4095,1433250,11407762,14.37
9895216,9983505,1613,564550,10548055,5.65
9895217,9971819,2550,892500,10864319,8.95
9895218,9980018,2117,740950,10720968,7.42
9895219,9860635,2096,733600,10594235,7.44
9895220,9988614,1564,547400,10536014,5.48
9895221,9997218,2734,956900,10954118,9.57
9895222,8760305,2207,772450,9532755,8.82
9895223,9892294,2390,836500,10728794,8.46
9895224,9951102,2783,974050,10925152,9.79
9895225,9987274,2663,932050,10919324,9.33
9895226,9987069,3740,1309000,11296069,13.11
9895227,9987455,3196,1118600,11106055,11.20
9895228,9991622,4026,1409100,11400722,14.10
9895229,1587875,553,193550,1781425,12.19
9895230,9996153,3923,1373050,11369203,13.74
9895231,9983198,3116,1090600,11073798,10.92
9895232,9989173,5807,2032450,12021623,20.35
9895233,9998947,2854,998900,10997847,9.99
9895234,9981366,4424,1548400,11529766,15.51
9895235,9983186,3610,1263500,11246686,12.66
9895236,9985171,2275,796250,10781421,7.97
9895237,1054383,391,136850,1191233,12.98
9895238,9984966,2949,1032150,11017116,10.34
9895239,9987041,3589,1256150,11243191,12.58
9895240,9996795,4368,1528800,11525595,15.29
9895241,6504589,1299,454650,6959239,6.99
9895242,9976012,3049,1067150,11043162,10.70
9895243,5349028,981,343350,5692378,6.42
9895244,9985771,4389,1536150,11521921,15.38
9895245,9987693,5302,1855700,11843393,18.58
9895246,9979773,3708,1297800,11277573,13.00
9895247,9975079,2262,791700,10766779,7.94
9895248,9991470,4164,1457400,11448870,14.59
9895249,8700312,2995,1048250,9748562,12.05
9895250,9964773,3681,1288350,11253123,12.93
9895251,9984409,1028,359800,10344209,3.60
9895252,9973101,3545,1240750,11213851,12.44
9895254,9969461,2815,985250,10954711,9.88
9895255,9987605,6691,2341850,12329455,23.45
9895256,3187578,498,174300,3361878,5.47
9895257,9957114,5807,2032450,11989564,20.41
9895258,9950366,3698,1294300,11244666,13.01
9895259,9971539,3499,1224650,11196189,12.28
9895260,9954529,3393,1187550,11142079,11.93
9895261,9962123,3190,1116500,11078623,11.21
9895262,9956884,3986,1395100,11351984,14.01
9895263,9942263,4582,1603700,11545963,16.13
9895264,9984983,2505,876750,10861733,8.78
9895265,9972518,2174,760900,10733418,7.63
9895266,9973163,2586,905100,10878263,9.08
9895267,9977137,4869,1704150,11681287,17.08
9895268,9987129,2980,1043000,11030129,10.44
9895269,9990821,2294,802900,10793721,8.04
9895270,9992850,3294,1152900,11145750,11.54
9895271,9990220,2661,931350,10921570,9.32
9895272,94043,31,10850,104893,11.54
9895273,9954524,5128,1794800,11749324,18.03
9895274,9941206,3601,1260350,11201556,12.68
9895275,9952737,3227,1129450,11082187,11.35
9895276,9943083,3367,1178450,11121533,11.85
9895277,9931003,2076,726600,10657603,7.32
9895278,9935065,3672,1285200,11220265,12.94
9895279,9926077,4123,1443050,11369127,14.54
9895280,2603746,359,125650,2729396,4.83
9895281,9934714,4791,1676850,11611564,16.88
9895282,9944197,4237,1482950,11427147,14.91
9895283,9944865,3849,1347150,11292015,13.55
9895284,9949581,3635,1272250,11221831,12.79
9895285,9947609,4290,1501500,11449109,15.09
9895286,9955256,3861,1351350,11306606,13.57
9895288,9950409,4887,1710450,11660859,17.19
9895289,9957341,4301,1505350,11462691,15.12
9895290,9956363,1543,540050,10496413,5.42
9895291,9964169,5263,1842050,11806219,18.49
9895292,9948465,5246,1836100,11784565,18.46
9895293,9961538,2623,918050,10879588,9.22
9895294,9958815,6312,2209200,12168015,22.18
9895295,9976645,3907,1367450,11344095,13.71
9895296,9975821,3847,1346450,11322271,13.50
9895297,9984450,3198,1119300,11103750,11.21
9895298,8829619,2653,928550,9758169,10.52
9895299,8912560,3174,1110900,10023460,12.46
9895300,9971992,2282,798700,10770692,8.01
9895302,9982217,2118,741300,10723517,7.43
9895303,2281623,447,156450,2438073,6.86
9895304,9958563,4727,1654450,11613013,16.61
9895305,9969815,2690,941500,10911315,9.44
9895306,3321511,983,344050,3665561,10.36
9895307,4456888,1203,421050,4877938,9.45
9895308,9971231,4346,1521100,11492331,15.25
9895309,2778646,530,185500,2964146,6.68
9895310,9970785,4886,1710100,11680885,17.15
9895311,9967493,3442,1204700,11172193,12.09
9895312,6718375,1358,475300,7193675,7.07
9895313,9982724,3858,1350300,11333024,13.53
9895314,9986085,2007,702450,10688535,7.03
9895315,9960538,293,102550,10063088,1.03
9895316,9950557,5287,1850450,11801007,18.60
9895319,9929590,2936,1027600,10957190,10.35
9895320,9937982,2624,918400,10856382,9.24
9895321,9949635,4524,1583400,11533035,15.91
9895322,9928752,4014,1404900,11333652,14.15
9895323,9930028,4638,1623300,11553328,16.35
9895324,9925284,3277,1146950,11072234,11.56
9895325,9935069,3511,1228850,11163919,12.37
9895326,9940395,1804,631400,10571795,6.35
9895327,9935509,2695,943250,10878759,9.49
9895328,9947209,3889,1361150,11308359,13.68
9895329,2091067,663,232050,2323117,11.10
9895330,9925763,2029,710150,10635913,7.15
9895331,9949545,3911,1368850,11318395,13.76
9895332,9929472,4035,1412250,11341722,14.22
9895333,9959567,2234,781900,10741467,7.85
9895334,9969490,4585,1604750,11574240,16.10
9895335,9957745,4153,1453550,11411295,14.60
9895336,9944189,3325,1163750,11107939,11.70
9895337,9955211,4823,1688050,11643261,16.96
9895338,9943237,3930,1375500,11318737,13.83
9895339,9961891,3324,1163400,11125291,11.68
9895340,3121243,1870,654500,3775743,20.97
9895341,9953013,4296,1503600,11456613,15.11
9895342,9966818,4716,1650600,11617418,16.56
9895343,9967034,4482,1568700,11535734,15.74
9895344,9989302,2274,795900,10785202,7.97
9895345,1902962,398,139300,2042262,7.32
9895346,9971741,3329,1165150,11136891,11.68
9895347,9901487,3875,1356250,11257737,13.70
9895348,9965803,4273,1495550,11461353,15.01
9895349,9953445,4826,1689100,11642545,16.97
9895350,9953419,4223,1478050,11431469,14.85
9895351,9953906,1596,558600,10512506,5.61
9895352,9971490,4244,1485400,11456890,14.90
9895354,5826290,3304,1156400,6982690,19.85
9895355,9969092,2008,702800,10671892,7.05
9895356,9972297,3505,1226750,11199047,12.30
9895357,4383396,2790,976500,5359896,22.28
9895358,2305435,899,314650,2620085,13.65
9895359,219724,88,30800,250524,14.02
9895360,9982182,3268,1143800,11125982,11.46
9895361,9986417,2241,784350,10770767,7.85
9895362,5204008,1257,439950,5643958,8.45
9895363,9971964,1762,616700,10588664,6.18
9895364,9980543,4087,1430450,11410993,14.33
9895365,9979085,2733,956550,10935635,9.59
9895366,9993506,2142,749700,10743206,7.50
9895367,9985017,1806,632100,10617117,6.33
9895368,9980591,5776,2021600,12002191,20.26
9895369,9989047,2281,798350,10787397,7.99
9895370,9988847,2604,911400,10900247,9.12
9895371,9969000,4361,1526350,11495350,15.31
9895372,9972068,2961,1036350,11008418,10.39
9895374,9855418,3709,1298150,11153568,13.17
9895375,9982327,2385,834750,10817077,8.36
9895376,4412631,2207,772450,5185081,17.51
9895377,9987797,3598,1259300,11247097,12.61
9895378,9989734,4501,1575350,11565084,15.77
9895379,9981044,4675,1636250,11617294,16.39
9895380,9986728,3232,1131200,11117928,11.33
9895381,9978542,3997,1398950,11377492,14.02
9895382,9990167,1863,652050,10642217,6.53
9895383,9977090,3629,1270150,11247240,12.73
9895384,9994571,7166,2508100,12502671,25.09
9895385,9998899,2291,801850,10800749,8.02
9895386,9991790,3236,1132600,11124390,11.34
9895387,9984185,2950,1032500,11016685,10.34
9895388,9993272,3837,1342950,11336222,13.44
9895389,9984699,3488,1220800,11205499,12.23
9895390,9991211,3563,1247050,11238261,12.48
9895391,9969859,4243,1485050,11454909,14.90
9895393,9958805,1990,696500,10655305,6.99
9895394,5214911,2014,704900,5919811,13.52
9895395,9402839,3845,1345750,10748589,14.31
9895396,9962651,2441,854350,10817001,8.58
9895397,2691494,1625,568750,3260244,21.13
9895398,9941225,2863,1002050,10943275,10.08
9895399,9954596,2728,954800,10909396,9.59
9895400,9966603,3472,1215200,11181803,12.19
9895401,9973191,2236,782600,10755791,7.85
9895402,9949257,2272,795200,10744457,7.99
9895403,9944781,2408,842800,10787581,8.47
9895404,9970716,5539,1938650,11909366,19.44
9895405,9957188,2391,836850,10794038,8.40
9895406,2803170,806,282100,3085270,10.06
9895407,1938189,486,170100,2108289,8.78
9895408,9968273,3281,1148350,11116623,11.52
9895409,9975343,2929,1025150,11000493,10.28
9895410,9972853,2487,870450,10843303,8.73
9895411,9963942,4367,1528450,11492392,15.34
9895412,9980115,3819,1336650,11316765,13.39
9895413,9987437,3885,1359750,11347187,13.61
9895414,9986344,2441,854350,10840694,8.56
9895415,9977078,5746,2011100,11988178,20.16
9895416,9987934,4873,1705550,11693484,17.08
9895417,9985903,4582,1603700,11589603,16.06
9895418,927772,333,116550,1044322,12.56
9895419,9982275,3364,1177400,11159675,11.79
9895420,9994398,1237,432950,10427348,4.33
9895421,9982971,3709,1298150,11281121,13.00
9895422,9984693,2878,1007300,10991993,10.09
9895423,9985708,1613,564550,10550258,5.65
9895424,1390436,1257,439950,1830386,31.64
9895425,9963181,3580,1253000,11216181,12.58
9895426,9977283,2235,782250,10759533,7.84
9895427,9974732,874,305900,10280632,3.07
9895428,9976413,3549,1242150,11218563,12.45
9895429,9973313,3521,1232350,11205663,12.36
9895430,4487394,1741,609350,5096744,13.58
9895431,9932346,2473,865550,10797896,8.71
9895432,9958040,4689,1641150,11599190,16.48
9895433,9946863,3079,1077650,11024513,10.83
9895434,9936180,4637,1622950,11559130,16.33
9895435,9939740,2553,893550,10833290,8.99
9895436,9963642,2952,1033200,10996842,10.37
9895437,9956417,3897,1363950,11320367,13.70
9895438,9965352,4328,1514800,11480152,15.20
9895439,9985393,2584,904400,10889793,9.06
9895440,9982403,3593,1257550,11239953,12.60
9895441,9986841,3728,1304800,11291641,13.07
9895442,4937828,3389,1186150,6123978,24.02
9895443,9950825,2452,858200,10809025,8.62
9895444,9705667,1254,438900,10144567,4.52
9895445,9968073,2993,1047550,11015623,10.51
9895446,9951812,2889,1011150,10962962,10.16
9895447,1049647,435,152250,1201897,14.50
9895448,636800,183,64050,700850,10.06
9895449,9966681,3584,1254400,11221081,12.59
9895450,9854328,3104,1086400,10940728,11.02
9895451,9960577,3320,1162000,11122577,11.67
9895452,9956987,2526,884100,10841087,8.88
9895453,9971218,4689,1641150,11612368,16.46
9895455,9936794,4799,1679650,11616444,16.90
9895456,9973221,2940,1029000,11002221,10.32
9895457,9903807,3726,1304100,11207907,13.17
9895458,3537567,1631,570850,4108417,16.14
9895459,9951286,3343,1170050,11121336,11.76
9895460,9968352,3248,1136800,11105152,11.40
9895461,9962574,2885,1009750,10972324,10.14
9895462,9974982,5104,1786400,11761382,17.91
9895463,9974204,2128,744800,10719004,7.47
9895464,8830539,2688,940800,9771339,10.65
9895465,9993579,2979,1042650,11036229,10.43
9895466,9983142,1376,481600,10464742,4.82
9895467,9955370,2912,1019200,10974570,10.24
9895468,9971114,3348,1171800,11142914,11.75
9895469,9980472,3589,1256150,11236622,12.59
9895470,9974136,4847,1696450,11670586,17.01
9895471,9951492,1728,604800,10556292,6.08
9895472,9966386,3015,1055250,11021636,10.59
9895473,9926032,2451,857850,10783882,8.64
9895474,9963311,2851,997850,10961161,10.02
9895475,9977893,4850,1697500,11675393,17.01
9895476,1354300,294,102900,1457200,7.60
9895477,9965328,4562,1596700,11562028,16.02
9895478,4113193,2034,711900,4825093,17.31
9895479,4393262,1419,496650,4889912,11.30
9895480,9971962,3898,1364300,11336262,13.68
9895481,2871937,1644,575400,3447337,20.04
9895482,9961671,4295,1503250,11464921,15.09
9895483,2977869,1696,593600,3571469,19.93
9895484,9923682,5689,1991150,11914832,20.06
9895485,9937091,1645,575750,10512841,5.79
9895486,9848194,1674,585900,10434094,5.95
9895487,9934221,4328,1514800,11449021,15.25
9895488,9947091,4906,1717100,11664191,17.26
9895489,595596,117,40950,636546,6.88
9895490,9953766,2400,840000,10793766,8.44
9895492,9928008,5328,1864800,11792808,18.78
9895493,9925761,2829,990150,10915911,9.98
9895494,9923434,2262,791700,10715134,7.98
9895495,9910231,6596,2308600,12218831,23.30
9895496,9902909,3166,1108100,11011009,11.19
9895497,9912440,1669,584150,10496590,5.89
9895498,9909024,1689,591150,10500174,5.97
9895499,9918293,2175,761250,10679543,7.68
9895500,9923266,3636,1272600,11195866,12.82
9895501,9920272,1825,638750,10559022,6.44
9895502,5830544,1871,654850,6485394,11.23
9895503,9936830,3893,1362550,11299380,13.71
9895504,9918564,2615,915250,10833814,9.23
9895505,9408606,4125,1443750,10852356,15.34
9895506,9947185,2274,795900,10743085,8.00
9895507,9947216,3299,1154650,11101866,11.61
9895508,9961666,6796,2378600,12340266,23.88
9895509,2025333,468,163800,2189133,8.09
9895511,9973207,3016,1055600,11028807,10.58
9895512,9929879,4736,1657600,11587479,16.69
9895513,9973082,4083,1429050,11402132,14.33
9895514,9954620,3273,1145550,11100170,11.51
9895515,9958821,3882,1358700,11317521,13.64
9895516,9984515,2009,703150,10687665,7.04
9895517,9982864,3425,1198750,11181614,12.01
9895518,9976979,4024,1408400,11385379,14.12
9895519,9971600,2228,779800,10751400,7.82
9895520,9982409,4290,1501500,11483909,15.04
9895521,9989462,3087,1080450,11069912,10.82
9895522,9998919,2261,791350,10790269,7.91
9895523,9982327,4178,1462300,11444627,14.65
9895524,9978658,3295,1153250,11131908,11.56
9895525,9981925,4093,1432550,11414475,14.35
9895526,4546663,1596,558600,5105263,12.29
9895527,9980306,1833,641550,10621856,6.43
9895528,4256092,1638,573300,4829392,13.47
9895529,9967574,2029,710150,10677724,7.12
9895530,9984442,4085,1429750,11414192,14.32
9895531,9985269,3244,1135400,11120669,11.37
9895532,9975384,1175,411250,10386634,4.12
9895533,9966299,5045,1765750,11732049,17.72
9895534,9960008,2743,960050,10920058,9.64
9895535,9965236,3084,1079400,11044636,10.83
9895536,9961872,3316,1160600,11122472,11.65
9895537,9941756,3478,1217300,11159056,12.24
9895538,3745283,1242,434700,4179983,11.61
9895539,9930344,7611,2663850,12594194,26.83
9895540,9958961,2533,886550,10845511,8.90
9895541,9940901,3458,1210300,11151201,12.17
9895543,9954846,2331,815850,10770696,8.20
9895544,4358055,3126,1094100,5452155,25.11
9895545,9957380,3322,1162700,11120080,11.68
9895546,9962366,2636,922600,10884966,9.26
9895547,9969959,3581,1253350,11223309,12.57
9895548,9972965,1970,689500,10662465,6.91
9895549,9981846,2676,936600,10918446,9.38
9895551,9968570,2151,752850,10721420,7.55
9895552,9971725,3478,1217300,11189025,12.21
9895553,9954733,2945,1030750,10985483,10.35
9895554,5436134,1353,473550,5909684,8.71
9895555,9951257,3886,1360100,11311357,13.67
9895556,9969416,2333,816550,10785966,8.19
9895557,9977622,3114,1089900,11067522,10.92
9895558,9976778,1836,642600,10619378,6.44
9895559,9983886,4276,1496600,11480486,14.99
9895560,9986830,2828,989800,10976630,9.91
9895561,9990131,3118,1091300,11081431,10.92
9895562,9984903,2915,1020250,11005153,10.22
9895563,9989122,5226,1829100,11818222,18.31
9895564,5625300,1167,408450,6033750,7.26
9895565,9988612,993,347550,10336162,3.48
9895566,9990168,2887,1010450,11000618,10.11
9895567,9983678,4454,1558900,11542578,15.61
9895568,9976792,2979,1042650,11019442,10.45
9895569,9933374,2997,1048950,10982324,10.56
9895570,9985997,4160,1456000,11441997,14.58
9895571,9993779,3636,1272600,11266379,12.73
9895572,9983077,3526,1234100,11217177,12.36
9895573,8301246,3393,1187550,9488796,14.31
9895574,9986853,3515,1230250,11217103,12.32
9895575,9973952,2340,819000,10792952,8.21
9895576,9996369,3771,1319850,11316219,13.20
9895577,9981159,3025,1058750,11039909,10.61
9895578,9996167,3733,1306550,11302717,13.07
9895579,9779071,4027,1409450,11188521,14.41
9895580,9992905,3514,1229900,11222805,12.31
9895581,7246525,3473,1215550,8462075,16.77
9895582,7259670,2506,877100,8136770,12.08
9895583,1958952,617,215950,2174902,11.02
9895584,9979153,3681,1288350,11267503,12.91
9895585,9887522,4689,1641150,11528672,16.60
9895586,9989455,2948,1031800,11021255,10.33
9895587,9977711,3729,1305150,11282861,13.08
9895588,9989359,3508,1227800,11217159,12.29
9895589,9988893,4375,1531250,11520143,15.33
9895590,9976402,2729,955150,10931552,9.57
9895591,9977000,2792,977200,10954200,9.79
9895592,9987982,2148,751800,10739782,7.53
9895593,9983088,3184,1114400,11097488,11.16
9895594,9961080,3563,1247050,11208130,12.52
9895595,9971123,4158,1455300,11426423,14.60
9895596,9981117,3102,1085700,11066817,10.88
9895597,9994943,3120,1092000,11086943,10.93
9895598,9979116,1600,560000,10539116,5.61
9895599,9975894,2039,713650,10689544,7.15
9895600,9979666,3003,1051050,11030716,10.53
9895601,9974835,4536,1587600,11562435,15.92
9895602,9957792,2669,934150,10891942,9.38
9895603,9923462,1282,448700,10372162,4.52
9895604,3643315,1358,475300,4118615,13.05
9895605,9983619,2240,784000,10767619,7.85
9895606,9999019,6094,2132900,12131919,21.33
9895607,9984711,3306,1157100,11141811,11.59
9895608,9986424,3129,1095150,11081574,10.97
9895609,9974070,3203,1121050,11095120,11.24
9895610,9976931,3903,1366050,11342981,13.69
9895611,9980511,4119,1441650,11422161,14.44
9895612,9872034,2669,934150,10806184,9.46
9895613,9975562,2607,912450,10888012,9.15
9895614,9667714,3986,1395100,11062814,14.43
9895615,3204988,1521,532350,3737338,16.61
9895616,9951684,3005,1051750,11003434,10.57
9895617,9941969,3454,1208900,11150869,12.16
9895618,9965322,2998,1049300,11014622,10.53
9895619,9634368,4268,1493800,11128168,15.50
9895620,9981912,2119,741650,10723562,7.43
9895621,9995437,4138,1448300,11443737,14.49
9895622,9972766,3813,1334550,11307316,13.38
9895623,9997332,1885,659750,10657082,6.60
9895624,9986660,3861,1351350,11338010,13.53
9895625,9984840,3098,1084300,11069140,10.86
9895626,9981869,4470,1564500,11546369,15.67
9895628,9977554,4875,1706250,11683804,17.10
9895629,9980598,909,318150,10298748,3.19
9895630,9989827,1534,536900,10526727,5.37
9895631,9981940,3752,1313200,11295140,13.16
9895632,9993672,3345,1170750,11164422,11.71
9895633,9985447,4460,1561000,11546447,15.63
9895634,9991210,1395,488250,10479460,4.89
9895635,9984594,4712,1649200,11633794,16.52
9895636,9990569,4609,1613150,11603719,16.15
9895637,3749575,2684,939400,4688975,25.05
9895638,9989341,2582,903700,10893041,9.05
9895639,9990843,3192,1117200,11108043,11.18
9895640,3763897,889,311150,4075047,8.27
9895641,9996927,4383,1534050,11530977,15.35
9895642,9999717,3166,1108100,11107817,11.08
9895643,9988591,3892,1362200,11350791,13.64
9895644,9984032,3988,1395800,11379832,13.98
9895645,9975384,2890,1011500,10986884,10.14
9895646,9954010,3631,1270850,11224860,12.77
9895647,9986630,3193,1117550,11104180,11.19
9895648,9767637,4020,1407000,11174637,14.40
9895649,9988568,3661,1281350,11269918,12.83
9895650,9979850,3122,1092700,11072550,10.95
9895651,9444452,2149,752150,10196602,7.96
9895652,9978582,4641,1624350,11602932,16.28
9895653,9986580,3701,1295350,11281930,12.97
9895654,1824114,2146,751100,2575214,41.18
9895656,9991456,1716,600600,10592056,6.01
9895657,9972033,3836,1342600,11314633,13.46
9895658,9991782,5726,2004100,11995882,20.06
9895659,9981678,3361,1176350,11158028,11.79
9895660,9970501,3530,1235500,11206001,12.39
9895661,9976148,3911,1368850,11344998,13.72
9895662,9980565,2642,924700,10905265,9.27
9895663,9984804,4308,1507800,11492604,15.10
9895664,9997806,3972,1390200,11388006,13.91
9895665,9990080,3105,1086750,11076830,10.88
9895666,9983573,3014,1054900,11038473,10.57
9895667,9990393,4802,1680700,11671093,16.82
9895669,9995861,3955,1384250,11380111,13.85
9895670,9983702,3708,1297800,11281502,13.00
9895671,9981088,4296,1503600,11484688,15.06
9895672,9999310,3228,1129800,11129110,11.30
9895673,2534174,672,235200,2769374,9.28
9895674,9603703,3033,1061550,10665253,11.05
9895675,9710597,1694,592900,10303497,6.11
9895676,9757621,4474,1565900,11323521,16.05
9895677,9980209,4160,1456000,11436209,14.59
9895679,9996924,2709,948150,10945074,9.48
9895680,9984693,4208,1472800,11457493,14.75
9895681,9977945,3696,1293600,11271545,12.96
9895683,9966129,3714,1299900,11266029,13.04
9895684,5782053,1335,467250,6249303,8.08
9895685,9949472,6323,2213050,12162522,22.24
9895686,9970973,2973,1040550,11011523,10.44
9895687,9977266,4032,1411200,11388466,14.14
9895688,9960480,1873,655550,10616030,6.58
9895689,9953721,5350,1872500,11826221,18.81
9895690,9947311,4112,1439200,11386511,14.47
9895691,9927416,4601,1610350,11537766,16.22
9895692,9942632,2831,990850,10933482,9.97
9895693,9948794,4977,1741950,11690744,17.51
9895694,9938626,4772,1670200,11608826,16.81
9895695,9939888,2418,846300,10786188,8.51
9895696,9929733,3148,1101800,11031533,11.10
9895697,9943886,3440,1204000,11147886,12.11
9895698,9963355,5596,1958600,11921955,19.66
9895699,9935126,4279,1497650,11432776,15.07
9895701,9940344,3058,1070300,11010644,10.77
9895702,9953664,4467,1563450,11517114,15.71
9895703,9952763,3771,1319850,11272613,13.26
9895704,9937050,3656,1279600,11216650,12.88
9895705,9951100,4335,1517250,11468350,15.25
9895706,9947948,1535,537250,10485198,5.40
9895708,9959276,1955,684250,10643526,6.87
9895709,9933901,3857,1349950,11283851,13.59
9895710,9927429,2589,906150,10833579,9.13
9895711,9917825,4157,1454950,11372775,14.67
9895712,9929757,3332,1166200,11095957,11.74
9895713,9917621,4011,1403850,11321471,14.16
9895714,9920412,2903,1016050,10936462,10.24
9895715,9937162,2618,916300,10853462,9.22
9895716,9948419,3292,1152200,11100619,11.58
9895717,9939553,2416,845600,10785153,8.51
9895719,9964023,3710,1298500,11262523,13.03
9895720,9954613,6322,2212700,12167313,22.23
9895721,9965903,1951,682850,10648753,6.85
9895722,9973175,4385,1534750,11507925,15.39
9895723,9951658,4759,1665650,11617308,16.74
9895724,9962806,4173,1460550,11423356,14.66
9895725,9944750,4601,1610350,11555100,16.19
9895726,9937833,3979,1392650,11330483,14.01
9895727,9920389,3992,1397200,11317589,14.08
9895728,3241786,824,288400,3530186,8.90
9895729,9954788,3806,1332100,11286888,13.38
9895730,9953015,3739,1308650,11261665,13.15
9895731,9972023,3030,1060500,11032523,10.63
9895732,9938690,4872,1705200,11643890,17.16
9895734,9971573,4044,1415400,11386973,14.19
9895735,9681577,2344,820400,10501977,8.47
9895736,9992159,2143,750050,10742209,7.51
9895737,9968136,3250,1137500,11105636,11.41
9895738,1395886,867,303450,1699336,21.74
9895739,9970133,3020,1057000,11027133,10.60
9895740,910090,492,172200,1082290,18.92
9895741,9916426,2863,1002050,10918476,10.10
9895742,9906949,1230,430500,10337449,4.35
9895743,9945031,4936,1727600,11672631,17.37
9895744,9944423,1455,509250,10453673,5.12
9895745,2647202,1550,542500,3189702,20.49
9895746,9956697,2646,926100,10882797,9.30
9895747,9971843,3630,1270500,11242343,12.74
9895748,9987850,3162,1106700,11094550,11.08
9895749,9985143,4097,1433950,11419093,14.36
9895750,9990106,4463,1562050,11552156,15.64
9895751,9993636,4221,1477350,11470986,14.78
9895752,2497223,836,292600,2789823,11.72
9895753,9969465,2823,988050,10957515,9.91
9895754,9977271,4132,1446200,11423471,14.49
9895755,524572,88,30800,555372,5.87
9895756,9985162,891,311850,10297012,3.12
9895757,9992439,1215,425250,10417689,4.26
9895758,9993206,757,264950,10258156,2.65
9895759,9973302,926,324100,10297402,3.25
9895760,9871645,722,252700,10124345,2.56
9895761,9978881,1335,467250,10446131,4.68
9895762,9972393,621,217350,10189743,2.18
9895763,9991883,174,60900,10052783,0.61
9895764,9998309,557,194950,10193259,1.95
9895766,9967136,966,338100,10305236,3.39
9895767,9973405,2165,757750,10731155,7.60
9895768,9960875,2121,742350,10703225,7.45
9895769,1450181,706,247100,1697281,17.04
9895770,9962651,2438,853300,10815951,8.56
9895771,9964817,3030,1060500,11025317,10.64
9895772,9969083,3116,1090600,11059683,10.94
9895773,6804922,2804,981400,7786322,14.42
9895774,9978915,3822,1337700,11316615,13.41
9895775,9869056,4549,1592150,11461206,16.13
9895776,9824031,4509,1578150,11402181,16.06
9895777,9986236,3512,1229200,11215436,12.31
9895778,9989657,2917,1020950,11010607,10.22
9895779,9989485,3769,1319150,11308635,13.21
9895780,9528379,4084,1429400,10957779,15.00
9895781,3920833,2040,714000,4634833,18.21
9895782,9983711,3474,1215900,11199611,12.18
9895783,9987310,4519,1581650,11568960,15.84
9895784,9980578,1530,535500,10516078,5.37
9895785,9951191,3708,1297800,11248991,13.04
9895786,9962445,2654,928900,10891345,9.32
9895788,9964060,3229,1130150,11094210,11.34
9895789,9974881,4363,1527050,11501931,15.31
9895790,9982061,3733,1306550,11288611,13.09
9895791,9976797,2997,1048950,11025747,10.51
9895792,9996716,2167,758450,10755166,7.59
9895793,9986755,3746,1311100,11297855,13.13
9895794,9973117,3095,1083250,11056367,10.86
9895795,9984146,2117,740950,10725096,7.42
9895796,9950530,6129,2145150,12095680,21.56
9895797,9959460,3977,1391950,11351410,13.98
9895798,9965086,4420,1547000,11512086,15.52
9895799,9779853,3252,1138200,10918053,11.64
9895800,9992786,2830,990500,10983286,9.91
9895801,9903146,3249,1137150,11040296,11.48
9895802,9980928,4847,1696450,11677378,17.00
9895803,9982096,5107,1787450,11769546,17.91
9895804,9981170,2899,1014650,10995820,10.17
9895805,9993703,2325,813750,10807453,8.14
9895806,9985241,3204,1121400,11106641,11.23
9895807,9977127,2637,922950,10900077,9.25
9895808,9974363,3131,1095850,11070213,10.99
9895809,9259240,5920,2072000,11331240,22.38
9895810,9981735,3878,1357300,11339035,13.60
9895811,4511899,2168,758800,5270699,16.82
9895812,3770745,1092,382200,4152945,10.14
9895813,9962259,4647,1626450,11588709,16.33
9895814,9961059,3954,1383900,11344959,13.89
9895815,8728473,3387,1185450,9913923,13.58
9895816,9984014,2306,807100,10791114,8.08
9895817,9981626,4451,1557850,11539476,15.61
9895818,8465665,3269,1144150,9609815,13.52
9895819,9985698,3032,1061200,11046898,10.63
9895820,8786669,3227,1129450,9916119,12.85
9895821,9999543,2980,1043000,11042543,10.43
9895822,9995491,1519,531650,10527141,5.32
9895823,9980554,3656,1279600,11260154,12.82
9895824,9981965,2872,1005200,10987165,10.07
9895825,9980774,5239,1833650,11814424,18.37
9895826,9992921,2355,824250,10817171,8.25
9895827,9984215,3915,1370250,11354465,13.72
9895828,9971311,3031,1060850,11032161,10.64
9895829,9992595,3643,1275050,11267645,12.76
9895830,7657926,2858,1000300,8658226,13.06
9895831,9990320,3002,1050700,11041020,10.52
9895832,9976343,3361,1176350,11152693,11.79
9895833,9991947,4756,1664600,11656547,16.66
9895834,9969587,3842,1344700,11314287,13.49
9895835,9977108,3217,1125950,11103058,11.29
9895836,9973955,3093,1082550,11056505,10.85
9895837,9975610,3650,1277500,11253110,12.81
9895838,9991153,2296,803600,10794753,8.04
9895839,9993298,4411,1543850,11537148,15.45
9895840,9986273,3560,1246000,11232273,12.48
9895841,9979986,4145,1450750,11430736,14.54
9895842,9970482,3390,1186500,11156982,11.90
9895843,9965811,3468,1213800,11179611,12.18
9895844,9969767,3143,1100050,11069817,11.03
9895845,9956423,2564,897400,10853823,9.01
9895846,9959186,4198,1469300,11428486,14.75
9895847,9938423,3265,1142750,11081173,11.50
9895848,9966162,1555,544250,10510412,5.46
9895849,7006683,1303,456050,7462733,6.51
9895850,9953226,5210,1823500,11776726,18.32
9895851,9964807,1051,367850,10332657,3.69
9895852,9979848,4034,1411900,11391748,14.15
9895853,9980762,1658,580300,10561062,5.81
9895854,9968318,2606,912100,10880418,9.15
9895855,9946170,3688,1290800,11236970,12.98
9895856,8092505,1911,668850,8761355,8.27
9895857,9999707,4363,1527050,11526757,15.27
9895858,9970428,4015,1405250,11375678,14.09
9895859,3693401,1208,422800,4116201,11.45
9895860,9979798,3186,1115100,11094898,11.17
9895861,9970167,4219,1476650,11446817,14.81
9895862,9983067,1396,488600,10471667,4.89
9895863,9986813,2418,846300,10833113,8.47
9895864,9984026,3353,1173550,11157576,11.75
9895865,9983517,3277,1146950,11130467,11.49
9895866,2476770,790,276500,2753270,11.16
9895867,1813557,497,173950,1987507,9.59
9895868,9977864,3297,1153950,11131814,11.57
9895869,9984691,3304,1156400,11141091,11.58
9895870,9991062,3549,1242150,11233212,12.43
9895871,224555,136,47600,272155,21.20
9895872,9965168,4573,1600550,11565718,16.06
9895873,9966752,6016,2105600,12072352,21.13
9895874,9988282,2202,770700,10758982,7.72
9895876,9856009,5205,1821750,11677759,18.48
9895877,7473963,3136,1097600,8571563,14.69
9895878,9988593,4831,1690850,11679443,16.93
9895879,9987383,4585,1604750,11592133,16.07
9895880,9983435,4955,1734250,11717685,17.37
9895881,9998234,3113,1089550,11087784,10.90
9895882,9990047,2520,882000,10872047,8.83
9895883,8808112,2405,841750,9649862,9.56
9895884,9985842,2678,937300,10923142,9.39
9895885,9978723,4348,1521800,11500523,15.25
9895886,9979155,4217,1475950,11455105,14.79
9895887,9981506,4481,1568350,11549856,15.71
9895888,9990751,3698,1294300,11285051,12.95
9895889,9965939,4536,1587600,11553539,15.93
9895890,9994246,3211,1123850,11118096,11.24
9895891,9984823,3721,1302350,11287173,13.04
9895892,9984489,5011,1753850,11738339,17.57
9895893,2466982,1311,458850,2925832,18.60
9895894,9970892,6694,2342900,12313792,23.50
9895895,6346514,2880,1008000,7354514,15.88
9895896,9978061,5675,1986250,11964311,19.91
9895897,1060680,366,128100,1188780,12.08
9895898,9953494,4490,1571500,11524994,15.79
9895899,9975548,705,246750,10222298,2.47
9895900,9983387,2861,1001350,10984737,10.03
9895901,9963441,3273,1145550,11108991,11.50
9895902,9970442,2322,812700,10783142,8.15
9895903,9988098,1484,519400,10507498,5.20
9895904,9970797,1310,458500,10429297,4.60
9895905,9979827,361,126350,10106177,1.27
9895906,9973723,3329,1165150,11138873,11.68
9895907,9985155,1622,567700,10552855,5.69
9895908,9991834,2832,991200,10983034,9.92
9895909,9975585,2505,876750,10852335,8.79
9895910,9994097,1861,651350,10645447,6.52
9895911,9991407,2553,893550,10884957,8.94
9895912,9987756,5230,1830500,11818256,18.33
9895913,9988854,3644,1275400,11264254,12.77
9895914,9985880,3747,1311450,11297330,13.13
9895915,9969445,7324,2563400,12532845,25.71
9895917,9966562,3224,1128400,11094962,11.32
9895918,9979717,4733,1656550,11636267,16.60
9895919,9976883,4918,1721300,11698183,17.25
9895920,9980007,4423,1548050,11528057,15.51
9895921,4004870,3077,1076950,5081820,26.89
9895922,9967893,3460,1211000,11178893,12.15
9895923,9962488,3406,1192100,11154588,11.97
9895924,3097814,1192,417200,3515014,13.47
9895925,9977126,3019,1056650,11033776,10.59
9895926,984573,575,201250,1185823,20.44
9895927,8337106,2744,960400,9297506,11.52
9895928,9698315,3725,1303750,11002065,13.44
9895929,9708343,2791,976850,10685193,10.06
9895930,9974093,3911,1368850,11342943,13.72
9895931,9978124,5896,2063600,12041724,20.68
9895932,9985295,2902,1015700,11000995,10.17
9895933,9981160,3513,1229550,11210710,12.32
9895934,9975580,3548,1241800,11217380,12.45
9895935,1472522,404,141400,1613922,9.60
9895936,9951112,4323,1513050,11464162,15.20
9895937,9944950,3459,1210650,11155600,12.17
9895938,9954850,4613,1614550,11569400,16.22
9895939,9964022,5505,1926750,11890772,19.34
9895940,9969914,4731,1655850,11625764,16.61
9895941,9980360,3229,1130150,11110510,11.32
9895942,9962682,3028,1059800,11022482,10.64
9895943,9946703,4926,1724100,11670803,17.33
9895944,2784872,1701,595350,3380222,21.38
9895945,9952731,4921,1722350,11675081,17.31
9895946,9932645,2988,1045800,10978445,10.53
9895947,9952611,4519,1581650,11534261,15.89
9895948,9948709,4270,1494500,11443209,15.02
9895949,9956980,5245,1835750,11792730,18.44
9895950,7132887,2762,966700,8099587,13.55
9895951,9961064,4175,1461250,11422314,14.67
9895952,9952683,5786,2025100,11977783,20.35
9895953,9963430,3132,1096200,11059630,11.00
9895954,1041405,364,127400,1168805,12.23
9895955,9979592,4194,1467900,11447492,14.71
9895956,9983381,3926,1374100,11357481,13.76
9895957,3136102,343,120050,3256152,3.83
9895958,3829305,1734,606900,4436205,15.85
9895959,9978316,4140,1449000,11427316,14.52
9895960,9983522,5175,1811250,11794772,18.14
9895961,9971695,3666,1283100,11254795,12.87
9895962,9972239,3109,1088150,11060389,10.91
9895963,9992288,4445,1555750,11548038,15.57
9895964,9995568,3927,1374450,11370018,13.75
9895965,9997994,4496,1573600,11571594,15.74
9895966,9989202,2521,882350,10871552,8.83
9895967,9970547,945,330750,10301297,3.32
9895968,9966886,4456,1559600,11526486,15.65
9895969,9987959,2983,1044050,11032009,10.45
9895970,2572129,986,345100,2917229,13.42
9895971,9986854,1720,602000,10588854,6.03
9895972,9965455,1264,442400,10407855,4.44
9895973,9981709,4268,1493800,11475509,14.97
9895974,9971498,3560,1246000,11217498,12.50
9895975,4861998,1610,563500,5425498,11.59
9895976,9953462,4565,1597750,11551212,16.05
9895977,9962801,3373,1180550,11143351,11.85
9895978,9957386,4379,1532650,11490036,15.39
9895979,9974606,5079,1777650,11752256,17.82
9895980,2246313,715,250250,2496563,11.14
9895981,9948207,2991,1046850,10995057,10.52
9895982,338318,61,21350,359668,6.31
9895983,4373528,2166,758100,5131628,17.33
9895984,9907024,3916,1370600,11277624,13.83
9895985,9975471,2451,857850,10833321,8.60
9895986,9984728,3829,1340150,11324878,13.42
9895987,9979936,4115,1440250,11420186,14.43
9895988,895391,906,317100,1212491,35.41
9895989,9986388,4775,1671250,11657638,16.74
9895991,9987873,3192,1117200,11105073,11.19
9895992,4269949,2692,942200,5212149,22.07
9895994,9969126,2379,832650,10801776,8.35
9895995,9966915,4344,1520400,11487315,15.25
9895996,9984095,5462,1911700,11895795,19.15
9895997,4062846,722,252700,4315546,6.22
9895998,5415959,1989,696150,6112109,12.85
9895999,9970956,5386,1885100,11856056,18.91
9896000,9986724,4524,1583400,11570124,15.86
9896001,3469444,1411,493850,3963294,14.23
9896002,9981119,2540,889000,10870119,8.91
9896003,9964948,2852,998200,10963148,10.02
9896004,9976362,2754,963900,10940262,9.66
9896005,9984886,1717,600950,10585836,6.02
9896006,9994552,2734,956900,10951452,9.57
9896007,9989328,3786,1325100,11314428,13.27
9896008,9977039,1008,352800,10329839,3.54
9896009,9975388,5287,1850450,11825838,18.55
9896010,5748278,2912,1019200,6767478,17.73
9896011,9892996,3752,1313200,11206196,13.27
9896012,9993917,3785,1324750,11318667,13.26
9896013,9980985,4771,1669850,11650835,16.73
9896014,6969471,2523,883050,7852521,12.67
9896015,9975329,1288,450800,10426129,4.52
9896016,9950713,4579,1602650,11553363,16.11
9896017,9968462,5256,1839600,11808062,18.45
9896018,9963225,4623,1618050,11581275,16.24
9896019,9962908,2948,1031800,10994708,10.36
9896020,9972353,2549,892150,10864503,8.95
9896021,6234130,4115,1440250,7674380,23.10
9896022,9960051,3179,1112650,11072701,11.17
9896023,9966900,1869,654150,10621050,6.56
9896024,9966742,3559,1245650,11212392,12.50
9896025,9971735,4424,1548400,11520135,15.53
9896026,9999564,2949,1032150,11031714,10.32
9896027,9998844,4141,1449350,11448194,14.50
9896028,9993225,3430,1200500,11193725,12.01
9896029,2934050,1966,688100,3622150,23.45
9896030,9991724,3535,1237250,11228974,12.38
9896031,9988120,5414,1894900,11883020,18.97
9896032,5818325,2111,738850,6557175,12.70
9896033,9993651,3564,1247400,11241051,12.48
9896034,9979581,3398,1189300,11168881,11.92
9896035,9979633,3478,1217300,11196933,12.20
9896036,359771,168,58800,418571,16.34
9896037,9961342,4732,1656200,11617542,16.63
9896038,9972202,3744,1310400,11282602,13.14
9896039,9916298,6117,2140950,12057248,21.59
9896040,9968281,1463,512050,10480331,5.14
9896041,9972306,4612,1614200,11586506,16.19
9896042,9989205,2387,835450,10824655,8.36
9896043,9784277,826,289100,10073377,2.95
9896044,9998735,1899,664650,10663385,6.65
9896045,9986689,3160,1106000,11092689,11.07
9896046,9885894,3032,1061200,10947094,10.73
9896048,9970734,4623,1618050,11588784,16.23
9896049,9977004,3307,1157450,11134454,11.60
9896050,9983273,1649,577150,10560423,5.78
9896051,1543932,957,334950,1878882,21.69
9896052,1341399,1078,377300,1718699,28.13
9896053,9962753,2842,994700,10957453,9.98
9896054,9967126,3181,1113350,11080476,11.17
9896055,9900030,4986,1745100,11645130,17.63
9896056,2365007,546,191100,2556107,8.08
9896057,9973747,4771,1669850,11643597,16.74
9896058,9956095,4247,1486450,11442545,14.93
9896059,4945390,481,168350,5113740,3.40
9896060,9949912,4562,1596700,11546612,16.05
9896061,1444979,72,25200,1470179,1.74
9896062,9956951,4543,1590050,11547001,15.97
9896063,9937464,2278,797300,10734764,8.02
9896065,9943594,2931,1025850,10969444,10.32
9896066,9926368,2426,849100,10775468,8.55
9896067,2320059,507,177450,2497509,7.65
9896068,3042393,969,339150,3381543,11.15
9896069,9946637,2077,726950,10673587,7.31
9896070,9948397,3525,1233750,11182147,12.40
9896071,9959222,1159,405650,10364872,4.07
9896072,9965948,3015,1055250,11021198,10.59
9896073,9960316,1502,525700,10486016,5.28
9896074,9973936,1438,503300,10477236,5.05
9896075,9988256,3790,1326500,11314756,13.28
9896076,9975323,3332,1166200,11141523,11.69
9896077,9986438,4594,1607900,11594338,16.10
9896078,9990070,1737,607950,10598020,6.09
9896079,9981116,980,343000,10324116,3.44
9896080,9977478,3889,1361150,11338628,13.64
9896081,6259575,1643,575050,6834625,9.19
9896082,2586713,614,214900,2801613,8.31
9896083,9977779,3864,1352400,11330179,13.55
9896084,9991321,2110,738500,10729821,7.39
9896085,3824799,1832,641200,4465999,16.76
9896086,4893524,1684,589400,5482924,12.04
9896087,9988284,4954,1733900,11722184,17.36
9896089,9967474,3656,1279600,11247074,12.84
9896090,9973976,4207,1472450,11446426,14.76
9896091,9988711,4631,1620850,11609561,16.23
9896092,4135056,870,304500,4439556,7.36
9896093,1072069,704,246400,1318469,22.98
9896094,9965007,4326,1514100,11479107,15.19
9896095,9974025,3210,1123500,11097525,11.26
9896096,9977803,3981,1393350,11371153,13.96
9896097,9969227,3003,1051050,11020277,10.54
9896098,9376442,2293,802550,10178992,8.56
9896099,9971031,3580,1253000,11224031,12.57
9896100,9971499,5810,2033500,12004999,20.39
9896101,4859769,1846,646100,5505869,13.29
9896102,9969146,2748,961800,10930946,9.65
9896103,9961575,5179,1812650,11774225,18.20
9896104,9952311,2470,864500,10816811,8.69
9896105,9952477,4722,1652700,11605177,16.61
9896106,9947408,4358,1525300,11472708,15.33
9896107,9949460,1564,547400,10496860,5.50
9896108,9959646,4412,1544200,11503846,15.50
9896109,9963327,1404,491400,10454727,4.93
9896110,9974366,3091,1081850,11056216,10.85
9896111,9978673,2392,837200,10815873,8.39
9896113,9963019,3340,1169000,11132019,11.73
9896114,9980100,4341,1519350,11499450,15.22
9896115,9962079,3456,1209600,11171679,12.14
9896117,9960136,3635,1272250,11232386,12.77
9896118,9951063,2169,759150,10710213,7.63
9896119,9960975,2296,803600,10764575,8.07
9896120,9968539,5280,1848000,11816539,18.54
9896121,9964832,4349,1522150,11486982,15.28
9896123,9963020,2509,878150,10841170,8.81
9896124,9977789,4338,1518300,11496089,15.22
9896125,9980566,3699,1294650,11275216,12.97
9896126,9992312,3878,1357300,11349612,13.58
9896127,9983195,2237,782950,10766145,7.84
9896128,2536186,336,117600,2653786,4.64
9896129,3418192,1714,599900,4018092,17.55
9896130,9976308,3257,1139950,11116258,11.43
9896131,9981534,3925,1373750,11355284,13.76
9896132,9980974,3611,1263850,11244824,12.66
9896133,9998334,3282,1148700,11147034,11.49
9896134,9989015,7045,2465750,12454765,24.68
9896135,9981466,4755,1664250,11645716,16.67
9896136,8747981,2334,816900,9564881,9.34
9896137,9979966,3743,1310050,11290016,13.13
9896138,9995697,3996,1398600,11394297,13.99
9896139,9989647,1178,412300,10401947,4.13
9896140,9980241,3344,1170400,11150641,11.73
9896141,3902754,1126,394100,4296854,10.10
9896142,4222564,1203,421050,4643614,9.97
9896143,9990974,5510,1928500,11919474,19.30
9896144,9972409,4604,1611400,11583809,16.16
9896145,9989701,3795,1328250,11317951,13.30
9896146,9979864,5303,1856050,11835914,18.60
9896147,9986961,3359,1175650,11162611,11.77
9896148,9986781,4993,1747550,11734331,17.50
9896149,9993716,1974,690900,10684616,6.91
9896150,9981233,3259,1140650,11121883,11.43
9896151,9975839,2788,975800,10951639,9.78
9896152,9980056,7599,2659650,12639706,26.65
9896153,203444,116,40600,244044,19.96
9896154,9955710,5675,1986250,11941960,19.95
9896155,4699137,1272,445200,5144337,9.47
9896156,905525,360,126000,1031525,13.91
9896157,9946801,3546,1241100,11187901,12.48
9896158,9939278,4378,1532300,11471578,15.42
9896159,9947209,3756,1314600,11261809,13.22
9896160,9579814,1802,630700,10210514,6.58
9896161,9955446,2994,1047900,11003346,10.53
9896162,8967333,1446,506100,9473433,5.64
9896163,9653697,3523,1233050,10886747,12.77
9896164,9993436,2654,928900,10922336,9.30
9896165,9936844,4567,1598450,11535294,16.09
9896166,9989415,6096,2133600,12123015,21.36
9896167,9992727,3887,1360450,11353177,13.61
9896168,3848567,1703,596050,4444617,15.49
9896169,1696245,1657,579950,2276195,34.19
9896170,9978332,7366,2578100,12556432,25.84
9896171,9979809,4293,1502550,11482359,15.06
9896172,603539,719,251650,855189,41.70
9896173,9976998,7290,2551500,12528498,25.57
9896174,9971675,3866,1353100,11324775,13.57
9896175,9980641,1968,688800,10669441,6.90
9896176,8985975,4826,1689100,10675075,18.80
9896177,9979733,2852,998200,10977933,10.00
9896178,7979465,4366,1528100,9507565,19.15
9896179,9969919,4621,1617350,11587269,16.22
9896180,685866,353,123550,809416,18.01
9896181,9949213,4434,1551900,11501113,15.60
9896182,672044,263,92050,764094,13.70
9896183,9937223,481,168350,10105573,1.69
9896184,5096137,2509,878150,5974287,17.23
9896185,9930387,3256,1139600,11069987,11.48
9896186,9936814,2304,806400,10743214,8.12
9896187,9946695,2872,1005200,10951895,10.11
9896188,472911,868,303800,776711,64.24
9896189,9936533,2727,954450,10890983,9.61
9896190,9937821,2721,952350,10890171,9.58
9896191,9923256,1297,453950,10377206,4.57
9896192,9688781,3190,1116500,10805281,11.52
9896193,9940410,2820,987000,10927410,9.93
9896194,72273,19,6650,78923,9.20
9896195,9928668,2403,841050,10769718,8.47
9896196,9923897,7348,2571800,12495697,25.92
9896197,1309330,810,283500,1592830,21.65
9896198,9927875,3486,1220100,11147975,12.29
9896199,1550763,612,214200,1764963,13.81
9896200,9917321,2202,770700,10688021,7.77
9896201,9925805,2985,1044750,10970555,10.53
9896202,9939810,4252,1488200,11428010,14.97
9896203,9927916,455,159250,10087166,1.60
9896204,2977508,1085,379750,3357258,12.75
9896205,9933694,4080,1428000,11361694,14.38
9896206,9939691,2740,959000,10898691,9.65
9896207,5056142,1937,677950,5734092,13.41
9896208,5102040,1611,563850,5665890,11.05
9896209,9953722,3885,1359750,11313472,13.66
9896210,9969909,5238,1833300,11803209,18.39
9896211,9749586,2890,1011500,10761086,10.37
9896212,9945935,3626,1269100,11215035,12.76
9896213,9964318,1490,521500,10485818,5.23
9896214,9973541,2416,845600,10819141,8.48
9896215,9977110,2398,839300,10816410,8.41
9896216,9985932,1630,570500,10556432,5.71
9896218,3347204,2437,852950,4200154,25.48
9896219,9989103,4114,1439900,11429003,14.41
9896220,9970151,2947,1031450,11001601,10.35
9896221,9984409,3365,1177750,11162159,11.80
9896222,9977149,3911,1368850,11345999,13.72
9896223,9971462,4386,1535100,11506562,15.39
9896224,1058550,411,143850,1202400,13.59
9896225,9989934,5208,1822800,11812734,18.25
9896226,9999821,3044,1065400,11065221,10.65
9896227,9969400,4183,1464050,11433450,14.69
9896228,9959702,1483,519050,10478752,5.21
9896229,9977968,4185,1464750,11442718,14.68
9896230,9975735,1033,361550,10337285,3.62
9896231,9989906,4568,1598800,11588706,16.00
9896232,9998100,4274,1495900,11494000,14.96
9896233,9978066,2942,1029700,11007766,10.32
9896234,9979759,3364,1177400,11157159,11.80
9896235,9996000,8888,3110800,13106800,31.12
9896236,9046232,3020,1057000,10103232,11.68
9896238,1574059,1246,436100,2010159,27.71
9896239,9228225,2346,821100,10049325,8.90
9896240,9962801,3715,1300250,11263051,13.05
9896242,9976927,4734,1656900,11633827,16.61
9896243,9964387,5275,1846250,11810637,18.53
9896244,9985583,3268,1143800,11129383,11.45
9896245,7816095,2512,879200,8695295,11.25
9896246,9989893,4406,1542100,11531993,15.44
9896247,9823979,4896,1713600,11537579,17.44
9896248,9996269,2748,961800,10958069,9.62
9896249,9939642,4264,1492400,11432042,15.01
9896250,2507614,705,246750,2754364,9.84
9896251,1139545,431,150850,1290395,13.24
9896252,9947066,4322,1512700,11459766,15.21
9896253,9974791,3529,1235150,11209941,12.38
9896254,5342409,2624,918400,6260809,17.19
9896255,9971098,4535,1587250,11558348,15.92
9896256,9968040,3233,1131550,11099590,11.35
9896257,9970339,3319,1161650,11131989,11.65
9896258,3239572,955,334250,3573822,10.32
9896259,9989758,4461,1561350,11551108,15.63
9896260,1514301,629,220150,1734451,14.54
9896261,1500973,1336,467600,1968573,31.15
9896262,9942352,4429,1550150,11492502,15.59
9896263,9957496,3667,1283450,11240946,12.89
9896264,642334,393,137550,779884,21.41
9896265,9953917,4272,1495200,11449117,15.02
9896266,9960484,3504,1226400,11186884,12.31
9896267,9951513,5523,1933050,11884563,19.42
9896268,9974850,4373,1530550,11505400,15.34
9896269,9973915,3655,1279250,11253165,12.83
9896270,2115428,669,234150,2349578,11.07
9896272,9959485,5722,2002700,11962185,20.11
9896273,1426705,974,340900,1767605,23.89
9896274,9965260,3237,1132950,11098210,11.37
9896275,9962075,2427,849450,10811525,8.53
9896276,9952269,261,91350,10043619,0.92
9896277,9694862,2283,799050,10493912,8.24
9896278,9940319,5146,1801100,11741419,18.12
9896279,9939154,3550,1242500,11181654,12.50
9896280,9961999,2096,733600,10695599,7.36
9896281,2106620,850,297500,2404120,14.12
9896282,9955103,5133,1796550,11751653,18.05
9896283,680319,522,182700,863019,26.86
9896284,9936783,4616,1615600,11552383,16.26
9896285,9936641,3889,1361150,11297791,13.70
9896286,9943050,3593,1257550,11200600,12.65
9896287,9943391,7376,2581600,12524991,25.96
9896288,9957178,2604,911400,10868578,9.15
9896289,9955519,4938,1728300,11683819,17.36
9896290,9963528,2780,973000,10936528,9.77
9896291,9953728,2752,963200,10916928,9.68
9896292,9979405,3424,1198400,11177805,12.01
9896293,9980080,3930,1375500,11355580,13.78
9896294,4293979,1007,352450,4646429,8.21
9896295,9985688,3475,1216250,11201938,12.18
9896296,5874459,1095,383250,6257709,6.52
9896297,2960889,680,238000,3198889,8.04
9896299,9976559,3650,1277500,11254059,12.81
9896300,9906758,2163,757050,10663808,7.64
9896301,9963393,2810,983500,10946893,9.87
9896302,9969272,4125,1443750,11413022,14.48
9896303,9970113,2705,946750,10916863,9.50
9896304,9988997,5161,1806350,11795347,18.08
9896305,9992917,4959,1735650,11728567,17.37
9896306,9985578,5474,1915900,11901478,19.19
9896307,9996270,4158,1455300,11451570,14.56
9896308,9981769,5390,1886500,11868269,18.90
9896309,9986619,3444,1205400,11192019,12.07
9896310,9984553,4352,1523200,11507753,15.26
9896311,9992272,2439,853650,10845922,8.54
9896312,9989748,5357,1874950,11864698,18.77
9896314,9980607,6244,2185400,12166007,21.90
9896315,4037929,2508,877800,4915729,21.74
9896316,9985339,3853,1348550,11333889,13.51
9896317,9991472,6803,2381050,12372522,23.83
9896318,9980764,1940,679000,10659764,6.80
9896319,9997542,3841,1344350,11341892,13.45
9896321,2337261,1641,574350,2911611,24.57
9896322,9995735,2531,885850,10881585,8.86
9896323,9977470,5276,1846600,11824070,18.51
9896324,9994096,5402,1890700,11884796,18.92
9896325,9985430,3891,1361850,11347280,13.64
9896326,9999702,7374,2580900,12580602,25.81
9896327,9991004,2243,785050,10776054,7.86
9896328,9976981,3820,1337000,11313981,13.40
9896329,5191234,2597,908950,6100184,17.51
9896331,9920173,3950,1382500,11302673,13.94
9896332,9992959,4645,1625750,11618709,16.27
9896333,9990926,5084,1779400,11770326,17.81
9896334,9970621,4158,1455300,11425921,14.60
9896335,9959528,2096,733600,10693128,7.37
9896336,9978386,4016,1405600,11383986,14.09
9896337,9970800,2930,1025500,10996300,10.29
9896338,9983330,4925,1723750,11707080,17.27
9896339,9988305,4787,1675450,11663755,16.77
9896340,4508145,2230,780500,5288645,17.31
9896341,6853412,5199,1819650,8673062,26.55
9896342,9966887,4920,1722000,11688887,17.28
9896343,9985501,2688,940800,10926301,9.42
9896344,1260952,1321,462350,1723302,36.67
9896345,9937888,4011,1403850,11341738,14.13
9896346,9968179,3901,1365350,11333529,13.70
9896347,9986242,3680,1288000,11274242,12.90
9896348,9962917,2528,884800,10847717,8.88
9896349,9979600,3003,1051050,11030650,10.53
9896350,2031174,1055,369250,2400424,18.18
9896351,9965949,5030,1760500,11726449,17.67
9896353,4030128,2635,922250,4952378,22.88
9896354,9957589,6043,2115050,12072639,21.24
9896355,9952672,3673,1285550,11238222,12.92
9896356,9953196,3406,1192100,11145296,11.98
9896357,9933570,5354,1873900,11807470,18.86
9896358,9931866,2099,734650,10666516,7.40
9896359,9947015,3661,1281350,11228365,12.88
9896360,9967193,3147,1101450,11068643,11.05
9896361,9961772,2921,1022350,10984122,10.26
9896362,9973191,3437,1202950,11176141,12.06
9896363,9982577,3874,1355900,11338477,13.58
9896364,9979649,2205,771750,10751399,7.73
9896365,9986964,5379,1882650,11869614,18.85
9896366,9980541,3623,1268050,11248591,12.71
9896367,716232,184,64400,780632,8.99
9896368,9951348,5004,1751400,11702748,17.60
9896369,9983465,6548,2291800,12275265,22.96
9896370,9976957,3995,1398250,11375207,14.01
9896371,9966258,4750,1662500,11628758,16.68
9896372,9945570,2998,1049300,10994870,10.55
9896373,1762250,381,133350,1895600,7.57
9896374,9965359,2307,807450,10772809,8.10
9896375,9978093,5316,1860600,11838693,18.65
9896376,9985511,4792,1677200,11662711,16.80
9896377,594928,166,58100,653028,9.77
9896378,9963744,5254,1838900,11802644,18.46
9896380,9948006,3091,1081850,11029856,10.88
9896381,9937997,2208,772800,10710797,7.78
9896382,9948841,4496,1573600,11522441,15.82
9896383,9957166,4262,1491700,11448866,14.98
9896384,9947540,3153,1103550,11051090,11.09
9896385,9965637,3239,1133650,11099287,11.38
9896386,9974697,3523,1233050,11207747,12.36
9896387,9982129,6300,2205000,12187129,22.09
9896388,9980518,2912,1019200,10999718,10.21
9896389,9987620,2838,993300,10980920,9.95
9896390,9997182,1800,630000,10627182,6.30
9896391,6342832,1991,696850,7039682,10.99
9896392,6910993,2034,711900,7622893,10.30
9896393,8877734,4088,1430800,10308534,16.12
9896394,1858506,511,178850,2037356,9.62
9896395,9981433,3077,1076950,11058383,10.79
9896396,9978732,3602,1260700,11239432,12.63
9896397,107050,74,25900,132950,24.19
9896398,9990336,2536,887600,10877936,8.88
9896399,9980913,3123,1093050,11073963,10.95
9896400,9997130,2899,1014650,11011780,10.15
9896402,9956348,2946,1031100,10987448,10.36
9896403,9964439,1463,512050,10476489,5.14
9896404,9978530,4318,1511300,11489830,15.15
9896405,9989554,4510,1578500,11568054,15.80
9896406,9980840,6151,2152850,12133690,21.57
9896407,4096030,2529,885150,4981180,21.61
9896408,9982415,3664,1282400,11264815,12.85
9896410,799888,261,91350,891238,11.42
9896411,9882634,3467,1213450,11096084,12.28
9896413,9980617,6505,2276750,12257367,22.81
9896414,9965655,2799,979650,10945305,9.83
9896415,9969545,3559,1245650,11215195,12.49
9896416,9965045,396,138600,10103645,1.39
9896417,9957183,335,117250,10074433,1.18
9896418,9957195,3025,1058750,11015945,10.63
9896419,9963171,4246,1486100,11449271,14.92
9896420,9719399,4000,1400000,11119399,14.40
9896421,3135131,1606,562100,3697231,17.93
9896422,9983348,2444,855400,10838748,8.57
9896423,9971311,4181,1463350,11434661,14.68
9896424,9981409,2498,874300,10855709,8.76
9896425,9970235,5242,1834700,11804935,18.40
9896426,9981303,5571,1949850,11931153,19.54
9896427,9986210,4662,1631700,11617910,16.34
9896428,9975544,3768,1318800,11294344,13.22
9896429,9979431,3093,1082550,11061981,10.85
9896430,9358996,3538,1238300,10597296,13.23
9896431,9978910,4311,1508850,11487760,15.12
9896432,9969045,4503,1576050,11545095,15.81
9896433,9956649,3883,1359050,11315699,13.65
9896434,9961897,3914,1369900,11331797,13.75
9896435,9958903,3563,1247050,11205953,12.52
9896436,9966965,4737,1657950,11624915,16.63
9896437,438094,194,67900,505994,15.50
9896438,1854344,1186,415100,2269444,22.39
9896439,9961740,2409,843150,10804890,8.46
9896440,9971932,3520,1232000,11203932,12.35
9896441,9982650,2871,1004850,10987500,10.07
9896442,9972785,4280,1498000,11470785,15.02
9896443,9979889,3378,1182300,11162189,11.85
9896444,9976471,2810,983500,10959971,9.86
9896445,9984314,3853,1348550,11332864,13.51
9896446,9981538,3124,1093400,11074938,10.95
9896447,9983306,1796,628600,10611906,6.30
9896448,9991455,3347,1171450,11162905,11.72
9896449,9971855,5879,2057650,12029505,20.63
9896450,9976007,3125,1093750,11069757,10.96
9896451,9109714,3078,1077300,10187014,11.83
9896452,9997354,2937,1027950,11025304,10.28
9896453,9995365,3330,1165500,11160865,11.66
9896454,9996829,4155,1454250,11451079,14.55
9896455,9988142,4336,1517600,11505742,15.19
9896456,9995585,4066,1423100,11418685,14.24
9896457,2566605,1108,387800,2954405,15.11
9896458,7461610,2972,1040200,8501810,13.94
9896459,9986337,3870,1354500,11340837,13.56
9896460,9973520,5288,1850800,11824320,18.56
9896461,9984564,2620,917000,10901564,9.18
9896462,9999349,2070,724500,10723849,7.25
9896463,9970251,1897,663950,10634201,6.66
9896464,363213,290,101500,464713,27.95
9896465,4191187,2273,795550,4986737,18.98
9896466,9994260,2950,1032500,11026760,10.33
9896467,2346120,3355,1174250,3520370,50.05
9896468,9964252,4187,1465450,11429702,14.71
9896469,9975705,4975,1741250,11716955,17.45
9896470,9985592,3154,1103900,11089492,11.05
9896471,9948152,3314,1159900,11108052,11.66
9896472,9987616,3786,1325100,11312716,13.27
9896473,9977984,4168,1458800,11436784,14.62
9896474,9992178,2688,940800,10932978,9.42
9896475,9742260,3133,1096550,10838810,11.26
9896476,9988415,3823,1338050,11326465,13.40
9896477,944551,301,105350,1049901,11.15
9896478,9969763,3308,1157800,11127563,11.61
9896479,9966756,6698,2344300,12311056,23.52
9896480,9982763,4791,1676850,11659613,16.80
9896481,9983126,4068,1423800,11406926,14.26
9896483,9981061,3047,1066450,11047511,10.68
9896484,9995004,3328,1164800,11159804,11.65
9896485,9992616,3959,1385650,11378266,13.87
9896486,9972365,2505,876750,10849115,8.79
9896487,3819337,1883,659050,4478387,17.26
9896488,9990939,3191,1116850,11107789,11.18
9896489,9996471,3796,1328600,11325071,13.29
9896490,9987012,3808,1332800,11319812,13.35
9896491,9988150,3551,1242850,11231000,12.44
9896492,9980742,5324,1863400,11844142,18.67
9896493,9994955,2854,998900,10993855,9.99
9896494,2267168,1432,501200,2768368,22.11
9896495,9970251,3953,1383550,11353801,13.88
9896498,9966017,4197,1468950,11434967,14.74
9896499,9962248,3022,1057700,11019948,10.62
9896500,6340618,2048,716800,7057418,11.30
9896501,9955891,3065,1072750,11028641,10.78
9896502,9980797,3032,1061200,11041997,10.63
9896503,6098017,2548,891800,6989817,14.62
9896504,6482122,2575,901250,7383372,13.90
9896505,9989010,3378,1182300,11171310,11.84
9896506,9989221,4009,1403150,11392371,14.05
9896507,9997000,4222,1477700,11474700,14.78
9896508,7283843,2420,847000,8130843,11.63
9896509,9970315,4060,1421000,11391315,14.25
9896510,9988324,3801,1330350,11318674,13.32
9896511,9991940,4529,1585150,11577090,15.86
9896512,9971340,4277,1496950,11468290,15.01
9896513,9965858,4413,1544550,11510408,15.50
9896514,9953620,4376,1531600,11485220,15.39
9896515,9972187,4388,1535800,11507987,15.40
9896516,9815306,4890,1711500,11526806,17.44
9896517,9986867,3986,1395100,11381967,13.97
9896518,9992798,3000,1050000,11042798,10.51
9896519,9968474,2414,844900,10813374,8.48
9896520,9980302,3734,1306900,11287202,13.09
9896521,9985815,2721,952350,10938165,9.54
9896522,9991027,4532,1586200,11577227,15.88
9896523,9998273,5919,2071650,12069923,20.72
9896524,9989865,2938,1028300,11018165,10.29
9896525,9989605,4198,1469300,11458905,14.71
9896526,9975078,2473,865550,10840628,8.68
9896527,9989155,5181,1813350,11802505,18.15
9896528,9970609,4493,1572550,11543159,15.77
9896529,5990411,2783,974050,6964461,16.26
9896530,689544,460,161000,850544,23.35
9896531,9989656,6362,2226700,12216356,22.29
9896533,9971944,4191,1466850,11438794,14.71
9896535,9955419,5597,1958950,11914369,19.68
9896536,9980234,5027,1759450,11739684,17.63
9896537,9976469,5407,1892450,11868919,18.97
9896538,9982403,3470,1214500,11196903,12.17
9896539,9994265,3843,1345050,11339315,13.46
9896540,9988109,4534,1586900,11575009,15.89
9896541,9990674,4776,1671600,11662274,16.73
9896542,9979123,2776,971600,10950723,9.74
9896543,9969917,4514,1579900,11549817,15.85
9896544,9954444,4064,1422400,11376844,14.29
9896545,9963430,4602,1610700,11574130,16.17
9896546,9974443,6635,2322250,12296693,23.28
9896547,9970483,4548,1591800,11562283,15.97
9896548,9970436,4454,1558900,11529336,15.64
9896549,9983872,6210,2173500,12157372,21.77
9896550,9977026,4386,1535100,11512126,15.39
9896551,9990281,5472,1915200,11905481,19.17
9896552,9988117,4218,1476300,11464417,14.78
9896553,9969729,5238,1833300,11803029,18.39
9896554,9953243,2655,929250,10882493,9.34
9896555,9975651,3759,1315650,11291301,13.19
9896556,9979196,4963,1737050,11716246,17.41
9896557,9989674,3348,1171800,11161474,11.73
9896558,9981679,3095,1083250,11064929,10.85
9896559,9946453,3113,1089550,11036003,10.95
9896560,9977183,4101,1435350,11412533,14.39
9896561,9950845,5423,1898050,11848895,19.07
9896562,9961721,4445,1555750,11517471,15.62
9896563,9969284,4422,1547700,11516984,15.52
9896564,9975008,4687,1640450,11615458,16.45
9896565,9978838,4055,1419250,11398088,14.22
9896566,9978064,4547,1591450,11569514,15.95
9896567,9979747,5898,2064300,12044047,20.68
9896568,9987337,2269,794150,10781487,7.95
9896569,9926616,5788,2025800,11952416,20.41
9896570,9970463,5470,1914500,11884963,19.20
9896571,9980101,5822,2037700,12017801,20.42
9896572,9994661,2080,728000,10722661,7.28
9896573,9970849,4665,1632750,11603599,16.38
9896574,9973228,6213,2174550,12147778,21.80
9896575,9987165,6782,2373700,12360865,23.77
9896576,9998282,4528,1584800,11583082,15.85
9896577,9985286,4522,1582700,11567986,15.85
9896578,9990237,5243,1835050,11825287,18.37
9896579,9999464,2918,1021300,11020764,10.21
9896580,9984508,4565,1597750,11582258,16.00
9896581,9990490,4186,1465100,11455590,14.66
9896582,9972655,5532,1936200,11908855,19.42
9896583,9978790,4243,1485050,11463840,14.88
9896584,9993569,4519,1581650,11575219,15.83
9896585,9998540,3653,1278550,11277090,12.79
9896586,9259093,4256,1489600,10748693,16.09
9896587,9999711,5824,2038400,12038111,20.38
9896588,9992764,5846,2046100,12038864,20.48
9896589,9990097,6869,2404150,12394247,24.07
9896590,9959876,4020,1407000,11366876,14.13
9896591,9989538,2545,890750,10880288,8.92
9896592,9977463,4594,1607900,11585363,16.12
9896593,9980395,3578,1252300,11232695,12.55
9896594,9970270,5455,1909250,11879520,19.15
9896595,9977605,4756,1664600,11642205,16.68
9896596,9980074,2493,872550,10852624,8.74
9896597,9976468,4774,1670900,11647368,16.75
9896598,9975838,2217,775950,10751788,7.78
9896599,9999452,3772,1320200,11319652,13.20
9896600,9982839,4782,1673700,11656539,16.77
9896602,9988958,4644,1625400,11614358,16.27
9896603,9988698,4901,1715350,11704048,17.17
9896604,9982381,7309,2558150,12540531,25.63
9896605,9993407,3944,1380400,11373807,13.81
9896606,9983689,2084,729400,10713089,7.31
9896607,9993037,4047,1416450,11409487,14.17
9896608,9989297,2361,826350,10815647,8.27
9896609,9992309,5061,1771350,11763659,17.73
9896610,9978194,4806,1682100,11660294,16.86
9896612,9988732,4429,1550150,11538882,15.52
9896615,9986491,4412,1544200,11530691,15.46
9896616,9986786,4031,1410850,11397636,14.13
9896617,9989147,7013,2454550,12443697,24.57
9896618,9887443,6241,2184350,12071793,22.09
9896619,9985196,2631,920850,10906046,9.22
9896620,9971204,4289,1501150,11472354,15.05
9896621,9974265,3552,1243200,11217465,12.46
9896623,9973476,4493,1572550,11546026,15.77
9896625,9982994,4601,1610350,11593344,16.13
9896626,9972400,5449,1907150,11879550,19.12
9896627,9953858,4129,1445150,11399008,14.52
9896628,9957653,3913,1369550,11327203,13.75
9896629,9960547,4490,1571500,11532047,15.78
9896630,9938063,4200,1470000,11408063,14.79
9896631,9944362,4401,1540350,11484712,15.49
9896632,9952029,5104,1786400,11738429,17.95
9896633,9956386,5685,1989750,11946136,19.98
9896634,9968648,3917,1370950,11339598,13.75
9896635,9966537,5506,1927100,11893637,19.34
9896636,9984662,6156,2154600,12139262,21.58
9896637,9991246,6648,2326800,12318046,23.29
9896638,9982982,4416,1545600,11528582,15.48
9896639,9970991,4853,1698550,11669541,17.03
9896640,9965520,5689,1991150,11956670,19.98
9896641,9964751,6661,2331350,12296101,23.40
9896642,9981402,4131,1445850,11427252,14.49
9896643,8884205,5283,1849050,10733255,20.81
9896645,9970771,6186,2165100,12135871,21.71
9896646,9965265,4781,1673350,11638615,16.79
9896647,9957205,4622,1617700,11574905,16.25
9896648,9978885,4828,1689800,11668685,16.93
9896649,9967038,3119,1091650,11058688,10.95
9896650,9947519,4832,1691200,11638719,17.00
9896651,9938175,4647,1626450,11564625,16.37
9896652,9930760,5135,1797250,11728010,18.10
9896653,9928947,4436,1552600,11481547,15.64
9896654,9923566,5353,1873550,11797116,18.88
9896655,9912529,2964,1037400,10949929,10.47
9896656,9928226,4720,1652000,11580226,16.64
9896657,9939198,6531,2285850,12225048,23.00
9896658,9933726,4928,1724800,11658526,17.36
9896659,9940926,4332,1516200,11457126,15.25
9896660,9951445,5116,1790600,11742045,17.99
9896661,9954318,3728,1304800,11259118,13.11
9896662,9954052,3160,1106000,11060052,11.11
9896663,9956123,5792,2027200,11983323,20.36
9896664,9976527,6819,2386650,12363177,23.92
9896665,9970174,5144,1800400,11770574,18.06
9896666,9975589,3319,1161650,11137239,11.64
9896667,9997614,6783,2374050,12371664,23.75
9896668,9977121,5675,1986250,11963371,19.91
9896669,9968134,3977,1391950,11360084,13.96
9896670,9978133,6498,2274300,12252433,22.79
9896671,9967687,4311,1508850,11476537,15.14
9896672,1568426,1389,486150,2054576,31.00
9896673,9979484,4331,1515850,11495334,15.19
9896674,9967219,4179,1462650,11429869,14.67
9896675,9970318,5574,1950900,11921218,19.57
9896676,9970866,4065,1422750,11393616,14.27
9896677,9980198,2892,1012200,10992398,10.14
9896678,9979463,5314,1859900,11839363,18.64
9896679,9976552,5909,2068150,12044702,20.73
9896680,9987645,3597,1258950,11246595,12.61
9896681,9983130,5753,2013550,11996680,20.17
9896682,9977409,3515,1230250,11207659,12.33
9896683,9988274,3016,1055600,11043874,10.57
9896684,9989637,3778,1322300,11311937,13.24
9896685,9985679,4816,1685600,11671279,16.88
9896686,9990632,4570,1599500,11590132,16.01
9896687,9982563,3366,1178100,11160663,11.80
9896688,9972434,5974,2090900,12063334,20.97
9896690,9958062,6222,2177700,12135762,21.87
9896691,9982053,5674,1985900,11967953,19.89
9896692,9968226,4498,1574300,11542526,15.79
9896693,9964908,4490,1571500,11536408,15.77
9896694,9974843,5591,1956850,11931693,19.62
9896695,9980927,5474,1915900,11896827,19.20
9896696,9988022,5071,1774850,11762872,17.77
9896697,9980813,3974,1390900,11371713,13.94
9896698,5021152,2215,775250,5796402,15.44
9896699,9979725,2258,790300,10770025,7.92
9896700,9998918,4203,1471050,11469968,14.71
9896701,9985308,3917,1370950,11356258,13.73
9896702,9961304,6215,2175250,12136554,21.84
9896703,9911692,4473,1565550,11477242,15.79
9896704,9975138,6080,2128000,12103138,21.33
9896705,9984197,6825,2388750,12372947,23.93
9896706,9975554,6689,2341150,12316704,23.47
9896707,9974316,5484,1919400,11893716,19.24
9896708,9993391,4544,1590400,11583791,15.91
9896709,9996491,4551,1592850,11589341,15.93
9896710,9500025,1998,699300,10199325,7.36
9896711,9984368,5207,1822450,11806818,18.25
9896712,9987319,4284,1499400,11486719,15.01
9896713,9987490,6376,2231600,12219090,22.34
9896714,9985718,4377,1531950,11517668,15.34
9896715,9973169,4410,1543500,11516669,15.48
9896716,9972083,5038,1763300,11735383,17.68
9896717,9967338,2917,1020950,10988288,10.24
9896718,9975791,3033,1061550,11037341,10.64
9896719,9986258,5609,1963150,11949408,19.66
9896720,9964079,4166,1458100,11422179,14.63
9896721,9966383,6370,2229500,12195883,22.37
9896722,9954594,5102,1785700,11740294,17.94
9896723,9976051,3636,1272600,11248651,12.76
9896724,9985116,3896,1363600,11348716,13.66
9896725,9981101,4857,1699950,11681051,17.03
9896726,9969213,4199,1469650,11438863,14.74
9896727,9955013,6253,2188550,12143563,21.98
9896728,4611102,1746,611100,5222202,13.25
9896729,9970635,3082,1078700,11049335,10.82
9896730,9971843,5470,1914500,11886343,19.20
9896731,9969597,4258,1490300,11459897,14.95
9896732,9971787,4521,1582350,11554137,15.87
9896733,9954118,4653,1628550,11582668,16.36
9896734,9964618,6349,2222150,12186768,22.30
9896736,9957220,5688,1990800,11948020,19.99
9896737,9970026,3684,1289400,11259426,12.93
9896738,9967195,7161,2506350,12473545,25.15
9896739,9978683,8471,2964850,12943533,29.71
9896740,9959853,4245,1485750,11445603,14.92
9896741,9955177,5469,1914150,11869327,19.23
9896742,9971154,3851,1347850,11319004,13.52
9896743,9972400,7605,2661750,12634150,26.69
9896744,9987118,3586,1255100,11242218,12.57
9896745,9979514,9455,3309250,13288764,33.16
9896746,9973349,4755,1664250,11637599,16.69
9896747,9975117,6235,2182250,12157367,21.88
9896748,9982641,5050,1767500,11750141,17.71
9896749,9987375,5358,1875300,11862675,18.78
9896750,9976984,3858,1350300,11327284,13.53
9896751,9971913,4685,1639750,11611663,16.44
9896752,9990144,5871,2054850,12044994,20.57
9896753,9988128,3929,1375150,11363278,13.77
9896754,9982492,6496,2273600,12256092,22.78
9896755,9984531,5677,1986950,11971481,19.90
9896756,9974258,5908,2067800,12042058,20.73
9896757,9975840,4026,1409100,11384940,14.13
9896758,9985862,3862,1351700,11337562,13.54
9896759,9978714,3694,1292900,11271614,12.96
9896760,9981415,5706,1997100,11978515,20.01
9896761,9993680,2159,755650,10749330,7.56
9896762,9988208,4667,1633450,11621658,16.35
9896763,9981128,6442,2254700,12235828,22.59
9896764,9980432,3871,1354850,11335282,13.58
9896765,9971123,5685,1989750,11960873,19.96
9896766,9992162,6139,2148650,12140812,21.50
9896767,9980494,5090,1781500,11761994,17.85
9896768,9973433,4505,1576750,11550183,15.81
9896770,9973729,4607,1612450,11586179,16.17
9896771,9978772,5008,1752800,11731572,17.57
9896772,9999751,4851,1697850,11697601,16.98
9896773,9987437,3250,1137500,11124937,11.39
9896774,9988234,5393,1887550,11875784,18.90
9896775,9993423,4173,1460550,11453973,14.62
9896776,9991708,6455,2259250,12250958,22.61
9896777,9990218,3341,1169350,11159568,11.70
9896778,9989144,5480,1918000,11907144,19.20
9896779,9986079,4971,1739850,11725929,17.42
9896780,9987348,5357,1874950,11862298,18.77
9896781,9996925,5087,1780450,11777375,17.81
9896782,9994175,6869,2404150,12398325,24.06
9896783,9990087,3834,1341900,11331987,13.43
9896784,9940299,6383,2234050,12174349,22.47
9896785,9983427,4942,1729700,11713127,17.33
9896786,9988250,4738,1658300,11646550,16.60
9896787,9971398,6372,2230200,12201598,22.37
9896788,9977491,5429,1900150,11877641,19.04
9896789,9981692,3898,1364300,11345992,13.67
9896790,9978352,3090,1081500,11059852,10.84
9896791,9986158,4600,1610000,11596158,16.12
9896792,9982939,3995,1398250,11381189,14.01
9896793,9999452,5990,2096500,12095952,20.97
9896794,9974841,8068,2823800,12798641,28.31
9896795,9950928,5254,1838900,11789828,18.48
9896796,9994512,3883,1359050,11353562,13.60
9896797,9976806,4761,1666350,11643156,16.70
9896798,9988719,5955,2084250,12072969,20.87
9896799,9988008,6459,2260650,12248658,22.63
9896800,9979646,5535,1937250,11916896,19.41
9896801,9976856,5722,2002700,11979556,20.07
9896802,9975209,3775,1321250,11296459,13.25
9896803,9976349,5896,2063600,12039949,20.68
9896804,9972534,3246,1136100,11108634,11.39
9896805,9972000,5182,1813700,11785700,18.19
9896806,9981535,4223,1478050,11459585,14.81
9896807,9980929,4754,1663900,11644829,16.67
9896808,9991083,4317,1510950,11502033,15.12
9896809,9983348,4452,1558200,11541548,15.61
9896810,9984141,2691,941850,10925991,9.43
9896811,9824900,4342,1519700,11344600,15.47
9896812,9977504,5044,1765400,11742904,17.69
9896813,9560393,3674,1285900,10846293,13.45
9896814,9984870,4551,1592850,11577720,15.95
9896815,9979683,4068,1423800,11403483,14.27
9896816,9983809,3008,1052800,11036609,10.55
9896818,9982640,4421,1547350,11529990,15.50
9896819,9987331,2700,945000,10932331,9.46
9896820,9975697,4804,1681400,11657097,16.85
9896821,9993047,3185,1114750,11107797,11.16
9896822,9982833,4411,1543850,11526683,15.47
9896823,9988583,5797,2028950,12017533,20.31
9896824,9970445,3746,1311100,11281545,13.15
9896826,9969197,4505,1576750,11545947,15.82
9896827,9839623,6687,2340450,12180073,23.79
9896828,9833137,7221,2527350,12360487,25.70
9896829,9984104,5503,1926050,11910154,19.29
9896830,9992055,4836,1692600,11684655,16.94
9896831,9988417,6450,2257500,12245917,22.60
9896832,9957159,5628,1969800,11926959,19.78
9896833,9978481,1545,540750,10519231,5.42
9896834,9986082,2536,887600,10873682,8.89
9896835,9970511,5040,1764000,11734511,17.69
9896836,9988129,6007,2102450,12090579,21.05
9896837,9995481,3339,1168650,11164131,11.69
9896838,9986079,4650,1627500,11613579,16.30
9896839,9983671,4354,1523900,11507571,15.26
9896840,9974685,6033,2111550,12086235,21.17
9896841,9996877,4920,1722000,11718877,17.23
9896842,9983798,5522,1932700,11916498,19.36
9896843,9974926,3745,1310750,11285676,13.14
9896844,9998356,4753,1663550,11661906,16.64
9896845,9973075,4912,1719200,11692275,17.24
9896846,9967085,2778,972300,10939385,9.76
9896847,9978286,4938,1728300,11706586,17.32
9896848,9978836,3619,1266650,11245486,12.69
9896850,9978870,4438,1553300,11532170,15.57
9896851,9984843,4939,1728650,11713493,17.31
9896852,9994091,3163,1107050,11101141,11.08
9896853,9995652,3687,1290450,11286102,12.91
9896854,9989207,5369,1879150,11868357,18.81
9896855,9990808,4599,1609650,11600458,16.11
9896856,9969552,3211,1123850,11093402,11.27
9896857,9992448,4762,1666700,11659148,16.68
9896858,9984089,2823,988050,10972139,9.90
9896859,9978327,1866,653100,10631427,6.55
9896860,9973479,5433,1901550,11875029,19.07
9896861,9971979,3769,1319150,11291129,13.23
9896862,9946670,7120,2492000,12438670,25.05
9896863,9964853,4016,1405600,11370453,14.11
9896864,9966619,4374,1530900,11497519,15.36
9896866,9941382,5486,1920100,11861482,19.31
9896867,9945458,6135,2147250,12092708,21.59
9896868,9942962,3134,1096900,11039862,11.03
9896869,9647869,5274,1845900,11493769,19.13
9896870,9955537,5018,1756300,11711837,17.64
9896871,9962221,5073,1775550,11737771,17.82
9896872,9959089,5339,1868650,11827739,18.76
9896873,9961138,4470,1564500,11525638,15.71
9896874,9943769,4859,1700650,11644419,17.10
9896875,9960309,4528,1584800,11545109,15.91
9896876,9951070,4767,1668450,11619520,16.77
9896877,9969882,3970,1389500,11359382,13.94
9896878,9979522,5909,2068150,12047672,20.72
9896879,9970153,6265,2192750,12162903,21.99
9896880,9984422,4814,1684900,11669322,16.88
9896881,9963049,4662,1631700,11594749,16.38
9896882,9987103,6370,2229500,12216603,22.32
9896883,9958110,1822,637700,10595810,6.40
9896884,9961255,6952,2433200,12394455,24.43
9896885,9979414,5543,1940050,11919464,19.44
9896886,9999024,6193,2167550,12166574,21.68
9896887,9983551,4651,1627850,11611401,16.31
9896889,9994194,4346,1521100,11515294,15.22
9896890,9990717,4209,1473150,11463867,14.75
9896891,9983393,6127,2144450,12127843,21.48
9896892,9977765,3921,1372350,11350115,13.75
9896893,9987128,6381,2233350,12220478,22.36
9896894,9991557,2998,1049300,11040857,10.50
9896895,9993329,4730,1655500,11648829,16.57
9896896,9983231,5271,1844850,11828081,18.48
9896897,9939138,3133,1096550,11035688,11.03
9896898,9978971,4144,1450400,11429371,14.53
9896899,9982110,5222,1827700,11809810,18.31
9896900,9979433,4010,1403500,11382933,14.06
9896901,9988396,6470,2264500,12252896,22.67
9896902,9977962,2793,977550,10955512,9.80
9896903,9999973,6034,2111900,12111873,21.12
9896904,9985910,4671,1634850,11620760,16.37
9896905,9998752,4189,1466150,11464902,14.66
9896907,9979219,4740,1659000,11638219,16.62
9896908,9950256,4788,1675800,11626056,16.84
9896909,9994104,3681,1288350,11282454,12.89
9896910,9965058,5444,1905400,11870458,19.12
9896911,9985851,2859,1000650,10986501,10.02
9896912,9985116,4893,1712550,11697666,17.15
9896913,9971265,5863,2052050,12023315,20.58
9896914,9990431,5690,1991500,11981931,19.93
9896915,9911954,5428,1899800,11811754,19.17
9896916,9981146,4372,1530200,11511346,15.33
9896917,8966864,4235,1482250,10449114,16.53
9896918,9973467,4025,1408750,11382217,14.12
9896919,9990195,6932,2426200,12416395,24.29
9896920,9988219,6215,2175250,12163469,21.78
9896921,9989066,7045,2465750,12454816,24.68
9896922,9982166,5006,1752100,11734266,17.55
9896923,9996792,5106,1787100,11783892,17.88
9896924,9972289,4481,1568350,11540639,15.73
9896925,4470793,1644,575400,5046193,12.87
9896926,9961666,3224,1128400,11090066,11.33
9896927,9455274,3962,1386700,10841974,14.67
9896928,9964440,4579,1602650,11567090,16.08
9896929,9954784,4059,1420650,11375434,14.27
9896930,9969411,6352,2223200,12192611,22.30
9896931,9980073,2685,939750,10919823,9.42
9896932,9983665,5007,1752450,11736115,17.55
9896933,9987065,6275,2196250,12183315,21.99
9896934,9979943,4842,1694700,11674643,16.98
9896935,9988290,6158,2155300,12143590,21.58
9896936,9976649,1099,384650,10361299,3.86
9896938,9991972,5163,1807050,11799022,18.09
9896939,9971150,4597,1608950,11580100,16.14
9896940,9972429,4826,1689100,11661529,16.94
9896941,9982618,6233,2181550,12164168,21.85
9896944,9968601,6080,2128000,12096601,21.35
9896945,9953002,5660,1981000,11934002,19.90
9896946,9986235,2144,750400,10736635,7.51
9896947,9976768,3954,1383900,11360668,13.87
9896948,9973548,4357,1524950,11498498,15.29
9896949,9985979,3710,1298500,11284479,13.00
9896950,9983852,7255,2539250,12523102,25.43
9896951,9775666,2616,915600,10691266,9.37
9896952,9984681,2899,1014650,10999331,10.16
9896953,9990341,4379,1532650,11522991,15.34
9896954,9962786,2295,803250,10766036,8.06
9896955,9993574,4812,1684200,11677774,16.85
9896956,9942099,3931,1375850,11317949,13.84
9896957,9987068,3232,1131200,11118268,11.33
9896958,9985531,5137,1797950,11783481,18.01
9896959,9996637,4965,1737750,11734387,17.38
9896960,9974213,4867,1703450,11677663,17.08
9896961,9988160,2760,966000,10954160,9.67
9896962,9995441,3874,1355900,11351341,13.57
9896963,9986678,2533,886550,10873228,8.88
9896964,9891479,3604,1261400,11152879,12.75
9896965,9970598,3837,1342950,11313548,13.47
9896966,9995494,5041,1764350,11759844,17.65
9896967,9989362,4398,1539300,11528662,15.41
9896968,9997708,3352,1173200,11170908,11.73
9896969,9990132,3370,1179500,11169632,11.81
9896970,646991,262,91700,738691,14.17
9896971,9966798,3504,1226400,11193198,12.30
9896972,1119547,453,158550,1278097,14.16
9896973,9948945,4805,1681750,11630695,16.90
9896974,9946946,6869,2404150,12351096,24.17
9896975,9971112,2803,981050,10952162,9.84
9896976,9955547,5746,2011100,11966647,20.20
9896977,9973544,3515,1230250,11203794,12.34
9896978,9980689,2680,938000,10918689,9.40
9896981,9934482,6269,2194150,12128632,22.09
9896982,9958098,5197,1818950,11777048,18.27
9896983,9938929,2353,823550,10762479,8.29
9896984,9939886,3688,1290800,11230686,12.99
9896985,9741911,3863,1352050,11093961,13.88
9896986,9959715,2317,810950,10770665,8.14
9896987,9977086,5059,1770650,11747736,17.75
9896988,9983615,5990,2096500,12080115,21.00
9896989,9995436,3624,1268400,11263836,12.69
9896990,9976619,4900,1715000,11691619,17.19
9896992,9953521,6738,2358300,12311821,23.69
9896993,9971611,5773,2020550,11992161,20.26
9896994,9967376,5127,1794450,11761826,18.00
9896995,9979421,5247,1836450,11815871,18.40
9896996,9979349,5537,1937950,11917299,19.42
9896997,9985583,3810,1333500,11319083,13.35
9896998,9985768,4898,1714300,11700068,17.17
9896999,9983428,3918,1371300,11354728,13.74
9897000,9973919,4950,1732500,11706419,17.37
9897001,9981206,6046,2116100,12097306,21.20
9897003,9989167,7135,2497250,12486417,25.00
9897004,9992624,4552,1593200,11585824,15.94
9897005,9987867,5495,1923250,11911117,19.26
9897006,9985493,4837,1692950,11678443,16.95
9897007,9995131,6379,2232650,12227781,22.34
9897008,9987228,4094,1432900,11420128,14.35
9897009,9971389,5046,1766100,11737489,17.71
9897010,9976942,5853,2048550,12025492,20.53
9897011,9980187,2134,746900,10727087,7.48
9897012,9985915,3940,1379000,11364915,13.81
9897013,9994358,5924,2073400,12067758,20.75
9897014,9970657,5787,2025450,11996107,20.31
9897016,9966280,3210,1123500,11089780,11.27
9897017,9974536,3539,1238650,11213186,12.42
9897018,9954743,4904,1716400,11671143,17.24
9897019,9962259,5526,1934100,11896359,19.41
9897020,9969190,2870,1004500,10973690,10.08
9897021,9952995,2660,931000,10883995,9.35
9897022,9965489,4664,1632400,11597889,16.38
9897023,9965500,4241,1484350,11449850,14.89
9897024,9966889,6021,2107350,12074239,21.14
9897025,9967516,4678,1637300,11604816,16.43
9897026,9948439,4794,1677900,11626339,16.87
9897027,9962463,4172,1460200,11422663,14.66
9897028,9960153,2615,915250,10875403,9.19
9897029,9956765,4204,1471400,11428165,14.78
9897030,9916916,4419,1546650,11463566,15.60
9897031,9947862,2350,822500,10770362,8.27
9897033,9947649,4379,1532650,11480299,15.41
9897034,9962360,4322,1512700,11475060,15.18
9897035,9962530,6010,2103500,12066030,21.11
9897037,9952522,4408,1542800,11495322,15.50
9897038,9972547,4068,1423800,11396347,14.28
9897039,9977697,4352,1523200,11500897,15.27
9897040,9983811,5780,2023000,12006811,20.26
9897041,9983692,3557,1244950,11228642,12.47
9897042,589869,42,14700,604569,2.49
9897043,9966443,4202,1470700,11437143,14.76
9897044,9984810,4675,1636250,11621060,16.39
9897045,9968501,4461,1561350,11529851,15.66
9897046,9971330,3963,1387050,11358380,13.91
9897047,9968218,3627,1269450,11237668,12.73
9897048,9968038,4238,1483300,11451338,14.88
9897049,9924919,5769,2019150,11944069,20.34
9897050,9951378,4670,1634500,11585878,16.42
9897051,9763281,5164,1807400,11570681,18.51
9897052,9983998,4976,1741600,11725598,17.44
9897053,9984425,4005,1401750,11386175,14.04
9897054,9979521,5333,1866550,11846071,18.70
9897055,9988207,5495,1923250,11911457,19.26
9897056,9972353,3911,1368850,11341203,13.73
9897057,9807600,3326,1164100,10971700,11.87
9897058,9985309,4611,1613850,11599159,16.16
9897059,9993924,5656,1979600,11973524,19.81
9897060,9995615,4539,1588650,11584265,15.89
9897061,9979654,1962,686700,10666354,6.88
9897062,9984857,3447,1206450,11191307,12.08
9897063,9974970,4907,1717450,11692420,17.22
9897064,9988877,5084,1779400,11768277,17.81
9897065,9972027,2889,1011150,10983177,10.14
9897066,9980688,3115,1090250,11070938,10.92
9897067,9967455,5259,1840650,11808105,18.47
9897068,9965359,4314,1509900,11475259,15.15
9897069,9960032,3715,1300250,11260282,13.05
9897070,9968481,4884,1709400,11677881,17.15
9897071,9965610,2331,815850,10781460,8.19
9897072,9951920,2437,852950,10804870,8.57
9897073,9945178,4271,1494850,11440028,15.03
9897074,9976312,4853,1698550,11674862,17.03
9897075,9973775,2933,1026550,11000325,10.29
9897076,9989858,5619,1966650,11956508,19.69
9897077,9977385,3546,1241100,11218485,12.44
9897078,9984067,4443,1555050,11539117,15.58
9897079,9998290,6582,2303700,12301990,23.04
9897081,9983127,5476,1916600,11899727,19.20
9897082,9991331,3172,1110200,11101531,11.11
9897083,9989154,4705,1646750,11635904,16.49
9897084,9994309,5636,1972600,11966909,19.74
9897085,9985095,4777,1671950,11657045,16.74
9897086,9979060,4823,1688050,11667110,16.92
9897087,9992753,5738,2008300,12001053,20.10
9897089,9982626,2867,1003450,10986076,10.05
9897090,9991806,4577,1601950,11593756,16.03
9897091,9986593,2872,1005200,10991793,10.07
9897092,9969952,4462,1561700,11531652,15.66
9897093,9986213,4375,1531250,11517463,15.33
9897094,9984677,3619,1266650,11251327,12.69
9897095,9981013,3675,1286250,11267263,12.89
9897096,9981252,3696,1293600,11274852,12.96
9897098,9989104,2559,895650,10884754,8.97
9897099,9979683,4036,1412600,11392283,14.15
9897100,9982022,3674,1285900,11267922,12.88
9897101,9964633,3613,1264550,11229183,12.69
9897102,9962265,3226,1129100,11091365,11.33
9897103,9965933,3268,1143800,11109733,11.48
9897104,9970199,5236,1832600,11802799,18.38
9897106,9957739,5097,1783950,11741689,17.92
9897107,9942121,5080,1778000,11720121,17.88
9897108,9960143,4577,1601950,11562093,16.08
9897109,9852570,5860,2051000,11903570,20.82
9897110,7460653,1663,582050,8042703,7.80
9897111,7454024,1906,667100,8121124,8.95
9897112,9956448,5135,1797250,11753698,18.05
9897113,9945525,2986,1045100,10990625,10.51
9897114,9958096,5758,2015300,11973396,20.24
9897115,9988732,2595,908250,10896982,9.09
9897116,9991229,3654,1278900,11270129,12.80
9897117,9979590,4724,1653400,11632990,16.57
9897118,9972260,5025,1758750,11731010,17.64
9897119,9975486,3358,1175300,11150786,11.78
9897120,9976108,5830,2040500,12016608,20.45
9897121,9966161,2847,996450,10962611,10.00
9897122,9966335,5503,1926050,11892385,19.33
9897123,9976409,2863,1002050,10978459,10.04
9897124,9971849,4288,1500800,11472649,15.05
9897125,9962707,4532,1586200,11548907,15.92
9897126,9948980,4423,1548050,11497030,15.56
9897127,9971432,2790,976500,10947932,9.79
9897128,9964430,3008,1052800,11017230,10.57
9897130,9988846,4871,1704850,11693696,17.07
9897131,9985649,2404,841400,10827049,8.43
9897132,9983735,4253,1488550,11472285,14.91
9897133,9984311,1181,413350,10397661,4.14
9897134,9967457,3194,1117900,11085357,11.22
9897135,9966280,2996,1048600,11014880,10.52
9897136,9965849,3408,1192800,11158649,11.97
9897137,9971260,5073,1775550,11746810,17.81
9897138,9961957,3809,1333150,11295107,13.38
9897139,9970813,6351,2222850,12193663,22.29
9897140,9964790,3649,1277150,11241940,12.82
9897141,9948806,3440,1204000,11152806,12.10
9897142,9968677,3191,1116850,11085527,11.20
9897143,9949546,5414,1894900,11844446,19.05
9897144,9962986,4047,1416450,11379436,14.22
9897145,9971555,2904,1016400,10987955,10.19
9897146,9961357,3523,1233050,11194407,12.38
9897148,9937634,4991,1746850,11684484,17.58
9897149,9933541,4324,1513400,11446941,15.24
9897150,9945952,4751,1662850,11608802,16.72
9897151,9939774,4372,1530200,11469974,15.39
9897152,9945643,3007,1052450,10998093,10.58
9897153,9928608,2391,836850,10765458,8.43
9897154,9936521,4090,1431500,11368021,14.41
9897155,9936531,5810,2033500,11970031,20.46
9897156,9951239,3384,1184400,11135639,11.90
9897157,9949398,3485,1219750,11169148,12.26
9897158,9953950,4985,1744750,11698700,17.53
9897159,9975356,3974,1390900,11366256,13.94
9897160,9978374,3926,1374100,11352474,13.77
9897161,9975116,3886,1360100,11335216,13.63
9897162,9980678,2640,924000,10904678,9.26
9897163,9966364,3468,1213800,11180164,12.18
9897164,9963940,4087,1430450,11394390,14.36
9897165,9364970,4572,1600200,10965170,17.09
9897166,9973413,2564,897400,10870813,9.00
9897167,9983795,3024,1058400,11042195,10.60
9897168,9990499,5281,1848350,11838849,18.50
9897169,9979568,4006,1402100,11381668,14.05
9897170,9987380,4478,1567300,11554680,15.69
9897171,9981248,3172,1110200,11091448,11.12
9897172,9982913,2673,935550,10918463,9.37
9897173,9999530,2164,757400,10756930,7.57
9897174,9972868,2913,1019550,10992418,10.22
9897175,9978832,4880,1708000,11686832,17.12
9897176,9970115,2702,945700,10915815,9.49
9897177,9807048,1826,639100,10446148,6.52
9897178,9976490,3406,1192100,11168590,11.95
9897179,2533429,748,261800,2795229,10.33
9897180,9989263,4760,1666000,11655263,16.68
9897181,9988413,2847,996450,10984863,9.98
9897182,9954147,5645,1975750,11929897,19.85
9897183,9974830,4493,1572550,11547380,15.77
9897185,9973128,5536,1937600,11910728,19.43
9897186,9974244,3975,1391250,11365494,13.95
9897187,9945252,4603,1611050,11556302,16.20
9897188,9982733,2993,1047550,11030283,10.49
9897189,9968859,3879,1357650,11326509,13.62
9897190,9972922,3441,1204350,11177272,12.08
9897191,9975164,3960,1386000,11361164,13.89
9897192,9989427,6525,2283750,12273177,22.86
9897193,9971820,3605,1261750,11233570,12.65
9897194,9975202,3875,1356250,11331452,13.60
9897195,9995423,4304,1506400,11501823,15.07
9897196,9172980,4165,1457750,10630730,15.89
9897197,9967240,2819,986650,10953890,9.90
9897198,9973134,7683,2689050,12662184,26.96
9897199,9988830,3127,1094450,11083280,10.96
9897200,9967416,5145,1800750,11768166,18.07
9897201,9973218,5609,1963150,11936368,19.68
9897202,9949697,2742,959700,10909397,9.65
9897203,9993750,5667,1983450,11977200,19.85
9897204,9830973,4401,1540350,11371323,15.67
9897205,9979444,3972,1390200,11369644,13.93
9897206,9984544,3881,1358350,11342894,13.60
9897207,9983895,4597,1608950,11592845,16.12
9897208,9983345,3965,1387750,11371095,13.90
9897209,9689836,4163,1457050,11146886,15.04
9897210,9999747,3319,1161650,11161397,11.62
9897212,9968452,4046,1416100,11384552,14.21
9897213,9983491,4942,1729700,11713191,17.33
9897214,9963830,4941,1729350,11693180,17.36
9897215,9981572,4263,1492050,11473622,14.95
9897216,4157204,2220,777000,4934204,18.69
9897217,9984515,4269,1494150,11478665,14.96
9897218,9983607,2517,880950,10864557,8.82
9897219,9991862,5601,1960350,11952212,19.62
9897220,9980044,2758,965300,10945344,9.67
9897221,9977098,4166,1458100,11435198,14.61
9897222,9935294,1665,582750,10518044,5.87
9897223,9974177,3204,1121400,11095577,11.24
9897224,9967623,3664,1282400,11250023,12.87
9897225,9971110,3627,1269450,11240560,12.73
9897226,9949020,3567,1248450,11197470,12.55
9897227,9972842,2815,985250,10958092,9.88
9897228,9971291,405,141750,10113041,1.42
9897229,9964202,1335,467250,10431452,4.69
9897230,9931992,2166,758100,10690092,7.63
9897231,9965753,2996,1048600,11014353,10.52
9897232,9965920,3235,1132250,11098170,11.36
9897233,9959862,1384,484400,10444262,4.86
9897234,9946286,530,185500,10131786,1.87
9897235,9939551,1773,620550,10560101,6.24
9897236,401591,110,38500,440091,9.59
9897237,9932927,799,279650,10212577,2.82
9897238,9926683,2261,791350,10718033,7.97
9897239,9929716,1700,595000,10524716,5.99
9897240,9944727,4627,1619450,11564177,16.28
9897241,9951012,3956,1384600,11335612,13.91
9897242,9940956,5412,1894200,11835156,19.05
9897243,9940938,4899,1714650,11655588,17.25
9897244,9926443,4797,1678950,11605393,16.91
9897245,9922725,3625,1268750,11191475,12.79
9897246,9927618,5327,1864450,11792068,18.78
9897247,9908815,3632,1271200,11180015,12.83
9897248,9921970,6239,2183650,12105620,22.01
9897249,9925193,4673,1635550,11560743,16.48
9897250,9936411,3875,1356250,11292661,13.65
9897252,9941613,3567,1248450,11190063,12.56
9897253,9936890,3754,1313900,11250790,13.22
9897254,9929424,4951,1732850,11662274,17.45
9897255,9922122,3310,1158500,11080622,11.68
9897256,9943348,2275,796250,10739598,8.01
9897257,9956968,6049,2117150,12074118,21.26
9897258,9961656,971,339850,10301506,3.41
9897259,9975666,6354,2223900,12199566,22.29
9897260,9968073,3546,1241100,11209173,12.45
9897261,9975277,4396,1538600,11513877,15.42
9897262,9981868,4028,1409800,11391668,14.12
9897263,9981787,3326,1164100,11145887,11.66
9897264,9990815,3673,1285550,11276365,12.87
9897265,9971703,2178,762300,10734003,7.64
9897266,9959549,3942,1379700,11339249,13.85
9897267,9971528,5503,1926050,11897578,19.32
9897268,9358012,4801,1680350,11038362,17.96
9897269,9967320,5297,1853950,11821270,18.60
9897270,9989381,3318,1161300,11150681,11.63
9897271,9977067,4502,1575700,11552767,15.79
9897272,9971729,5091,1781850,11753579,17.87
9897273,9984353,3908,1367800,11352153,13.70
9897274,9998007,4282,1498700,11496707,14.99
9897275,9966289,3827,1339450,11305739,13.44
9897276,9978515,6553,2293550,12272065,22.98
9897277,9980793,5028,1759800,11740593,17.63
9897278,9993498,5987,2095450,12088948,20.97
9897279,9978980,4129,1445150,11424130,14.48
9897280,9974984,1969,689150,10664134,6.91
9897281,9990930,5479,1917650,11908580,19.19
9897282,9960128,5766,2018100,11978228,20.26
9897283,9971515,5421,1897350,11868865,19.03
9897284,9997907,3648,1276800,11274707,12.77
9897285,9987781,5835,2042250,12030031,20.45
9897286,8720514,2503,876050,9596564,10.05
9897287,9981173,4035,1412250,11393423,14.15
9897288,9972046,3799,1329650,11301696,13.33
9897289,9976802,3409,1193150,11169952,11.96
9897290,9965832,4739,1658650,11624482,16.64
9897291,9969953,897,313950,10283903,3.15
9897292,9556856,2838,993300,10550156,10.39
9897293,3271896,2598,909300,4181196,27.79
9897294,3551006,1364,477400,4028406,13.44
9897295,9932045,5920,2072000,12004045,20.86
9897296,9925907,4120,1442000,11367907,14.53
9897297,9921143,3391,1186850,11107993,11.96
9897298,9914678,4417,1545950,11460628,15.59
9897299,3881170,1900,665000,4546170,17.13
9897300,9890057,4755,1664250,11554307,16.83
9897301,9886770,5715,2000250,11887020,20.23
9897302,9892220,4134,1446900,11339120,14.63
9897303,9878164,5744,2010400,11888564,20.35
9897304,9902011,3734,1306900,11208911,13.20
9897305,9820078,4730,1655500,11475578,16.86
9897306,8991926,3826,1339100,10331026,14.89
9897309,9893658,5240,1834000,11727658,18.54
9897310,9904109,7656,2679600,12583709,27.06
9897311,9901291,2531,885850,10787141,8.95
9897312,9900893,4455,1559250,11460143,15.75
9897313,9767772,5278,1847300,11615072,18.91
9897314,9929548,4482,1568700,11498248,15.80
9897317,9913814,3430,1200500,11114314,12.11
9897318,9399433,3330,1165500,10564933,12.40
9897319,8918728,2856,999600,9918328,11.21
9897320,9929176,5215,1825250,11754426,18.38
9897321,9929931,4304,1506400,11436331,15.17
9897322,9894671,4441,1554350,11449021,15.71
9897323,9880544,4436,1552600,11433144,15.71
9897324,9937179,3564,1247400,11184579,12.55
9897325,9952514,5879,2057650,12010164,20.67
9897326,9734860,2574,900900,10635760,9.25
9897327,9943267,6720,2352000,12295267,23.65
9897328,9952854,5951,2082850,12035704,20.93
9897330,9965478,4142,1449700,11415178,14.55
9897331,9966042,4464,1562400,11528442,15.68
9897332,9726352,3098,1084300,10810652,11.15
9897333,7002942,3294,1152900,8155842,16.46
9897334,9965072,4681,1638350,11603422,16.44
9897335,9958515,3680,1288000,11246515,12.93
9897336,9985277,2748,961800,10947077,9.63
9897337,9996300,3951,1382850,11379150,13.83
9897338,9982960,6362,2226700,12209660,22.31
9897339,9987482,3352,1173200,11160682,11.75
9897340,9992552,3626,1269100,11261652,12.70
9897341,9983947,4910,1718500,11702447,17.21
9897342,9990977,3558,1245300,11236277,12.46
9897343,9986110,5104,1786400,11772510,17.89
9897344,9973384,4942,1729700,11703084,17.34
9897345,9960315,435,152250,10112565,1.53
9897346,9950375,4180,1463000,11413375,14.70
9897347,9963107,4617,1615950,11579057,16.22
9897349,9978199,4465,1562750,11540949,15.66
9897351,9992942,4626,1619100,11612042,16.20
9897352,9993878,3379,1182650,11176528,11.83
9897353,9978594,3908,1367800,11346394,13.71
9897354,9977229,4421,1547350,11524579,15.51
9897355,9963529,4856,1699600,11663129,17.06
9897356,9958588,4872,1705200,11663788,17.12
9897357,9951251,5197,1818950,11770201,18.28
9897358,9960963,6079,2127650,12088613,21.36
9897359,9983600,5604,1961400,11945000,19.65
9897360,9975266,5215,1825250,11800516,18.30
9897361,9994948,6734,2356900,12351848,23.58
9897362,9985676,3918,1371300,11356976,13.73
9897363,9998431,3954,1383900,11382331,13.84
9897364,9979408,3761,1316350,11295758,13.19
9897365,9979528,4642,1624700,11604228,16.28
9897366,9974772,4694,1642900,11617672,16.47
9897367,9971974,4424,1548400,11520374,15.53
9897368,9981745,4776,1671600,11653345,16.75
9897369,9996197,3449,1207150,11203347,12.08
9897370,9983118,4232,1481200,11464318,14.84
9897371,9994467,5132,1796200,11790667,17.97
9897372,9971217,4393,1537550,11508767,15.42
9897373,9989766,5717,2000950,11990716,20.03
9897374,9979801,5080,1778000,11757801,17.82
9897375,9973179,4798,1679300,11652479,16.84
9897376,9922282,3954,1383900,11306182,13.95
9897377,9967673,6126,2144100,12111773,21.51
9897378,9946180,3691,1291850,11238030,12.99
9897380,9962080,2619,916650,10878730,9.20
9897381,9965706,3046,1066100,11031806,10.70
9897382,9986973,4469,1564150,11551123,15.66
9897383,9962029,2818,986300,10948329,9.90
9897384,9978946,3179,1112650,11091596,11.15
9897385,9981134,2407,842450,10823584,8.44
9897386,9980924,2552,893200,10874124,8.95
9897387,9989259,3636,1272600,11261859,12.74
9897388,9983890,3969,1389150,11373040,13.91
9897389,9984389,2278,797300,10781689,7.99
9897390,9967094,6025,2108750,12075844,21.16
9897391,9978078,3541,1239350,11217428,12.42
9897392,9804773,6149,2152150,11956923,21.95
9897393,9978742,3487,1220450,11199192,12.23
9897394,9672895,3604,1261400,10934295,13.04
9897395,9985265,1462,511700,10496965,5.12
9897396,9988917,2040,714000,10702917,7.15
9897397,9993477,1983,694050,10687527,6.95
9897398,9959997,1680,588000,10547997,5.90
9897400,9978780,1447,506450,10485230,5.08
9897401,9971897,1022,357700,10329597,3.59
9897402,9957231,3957,1384950,11342181,13.91
9897403,9939298,534,186900,10126198,1.88
9897404,9949369,1543,540050,10489419,5.43
9897405,9940829,5087,1780450,11721279,17.91
9897406,9937726,3919,1371650,11309376,13.80
9897407,9927221,779,272650,10199871,2.75
9897408,9907440,3720,1302000,11209440,13.14
9897409,9908924,2961,1036350,10945274,10.46
9897410,9930624,3607,1262450,11193074,12.71
9897411,9908360,4274,1495900,11404260,15.10
9897412,9869552,3276,1146600,11016152,11.62
9897413,9898470,1417,495950,10394420,5.01
9897414,9889583,4640,1624000,11513583,16.42
9897415,3321493,1728,604800,3926293,18.21
9897416,9868441,3724,1303400,11171841,13.21
9897417,9877324,3383,1184050,11061374,11.99
9897418,9892747,1797,628950,10521697,6.36
9897419,9880163,4522,1582700,11462863,16.02
9897421,9868670,3830,1340500,11209170,13.58
9897422,9882789,5386,1885100,11767889,19.07
9897423,9862377,4762,1666700,11529077,16.90
9897424,9866767,3490,1221500,11088267,12.38
9897425,9861111,4491,1571850,11432961,15.94
9897426,9867320,4131,1445850,11313170,14.65
9897427,9856930,3387,1185450,11042380,12.03
9897428,9878147,7295,2553250,12431397,25.85
9897429,9882758,5959,2085650,11968408,21.10
9897430,9878290,4788,1675800,11554090,16.96
9897431,9871929,4624,1618400,11490329,16.39
9897432,9714708,4374,1530900,11245608,15.76
9897433,9841475,4458,1560300,11401775,15.85
9897434,9873727,4319,1511650,11385377,15.31
9897435,9891430,4024,1408400,11299830,14.24
9897436,9892990,5788,2025800,11918790,20.48
9897437,9899126,6585,2304750,12203876,23.28
9897438,9878976,5612,1964200,11843176,19.88
9897439,9884331,3297,1153950,11038281,11.67
9897440,9886397,4273,1495550,11381947,15.13
9897441,9879485,3714,1299900,11179385,13.16
9897442,9895891,3258,1140300,11036191,11.52
9897443,9893719,4039,1413650,11307369,14.29
9897444,3443624,3557,1244950,4688574,36.15
9897445,9883257,5627,1969450,11852707,19.93
9897446,9903116,4721,1652350,11555466,16.69
9897448,9923552,5271,1844850,11768402,18.59
9897449,9924466,4562,1596700,11521166,16.09
9897450,9930327,4610,1613500,11543827,16.25
9897451,9907614,3942,1379700,11287314,13.93
9897452,9915853,4571,1599850,11515703,16.13
9897453,9896854,3051,1067850,10964704,10.79
9897454,9882886,5396,1888600,11771486,19.11
9897455,9892923,5111,1788850,11681773,18.08
9897456,9898869,4233,1481550,11380419,14.97
9897457,9894813,7149,2502150,12396963,25.29
9897458,9911932,5094,1782900,11694832,17.99
9897459,9914791,6989,2446150,12360941,24.67
9897460,9908183,4269,1494150,11402333,15.08
9897461,9906073,5087,1780450,11686523,17.97
9897462,9891105,5851,2047850,11938955,20.70
9897463,9916983,3118,1091300,11008283,11.00
9897464,9896018,3724,1303400,11199418,13.17
9897465,9913558,5425,1898750,11812308,19.15
9897466,9923081,2695,943250,10866331,9.51
9897467,9928221,7289,2551150,12479371,25.70
9897468,9944619,4440,1554000,11498619,15.63
9897469,9928744,5181,1813350,11742094,18.26
9897470,9909943,3500,1225000,11134943,12.36
9897471,9912470,3356,1174600,11087070,11.85
9897472,9916791,4919,1721650,11638441,17.36
9897473,9939379,3346,1171100,11110479,11.78
9897474,9946401,4909,1718150,11664551,17.27
9897475,9941900,4339,1518650,11460550,15.28
9897476,9927058,5180,1813000,11740058,18.26
9897477,9940298,3801,1330350,11270648,13.38
9897478,9951638,5975,2091250,12042888,21.01
9897479,9954743,5430,1900500,11855243,19.09
9897480,9936859,2698,944300,10881159,9.50
9897481,9940987,4206,1472100,11413087,14.81
9897482,9937092,5573,1950550,11887642,19.63
9897483,9953042,3012,1054200,11007242,10.59
9897484,9955992,4530,1585500,11541492,15.93
9897485,9949812,1414,494900,10444712,4.97
9897487,9953008,3628,1269800,11222808,12.76
9897488,9960102,5987,2095450,12055552,21.04
9897489,9959170,4573,1600550,11559720,16.07
9897490,9965661,2808,982800,10948461,9.86
9897491,9974810,1736,607600,10582410,6.09
9897492,9962856,3221,1127350,11090206,11.32
9897493,9978513,3097,1083950,11062463,10.86
9897494,9990674,923,323050,10313724,3.23
9897495,9981995,2559,895650,10877645,8.97
9897496,9988935,2470,864500,10853435,8.65
9897497,9982758,1028,359800,10342558,3.60
9897498,9992913,2686,940100,10933013,9.41
9897499,9974884,2070,724500,10699384,7.26
9897500,9991686,2505,876750,10868436,8.77
9897501,9979989,1673,585550,10565539,5.87
9897502,9994843,2546,891100,10885943,8.92
9897503,9984138,3436,1202600,11186738,12.05
9897504,9988018,1629,570150,10558168,5.71
9897505,9982687,4018,1406300,11388987,14.09
9897506,9976470,4921,1722350,11698820,17.26
9897507,9968792,5443,1905050,11873842,19.11
9897508,9956662,3833,1341550,11298212,13.47
9897510,9971547,5115,1790250,11761797,17.95
9897511,8792809,3163,1107050,9899859,12.59
9897512,9994179,6276,2196600,12190779,21.98
9897513,9980457,3188,1115800,11096257,11.18
9897514,9984734,5209,1823150,11807884,18.26
9897515,9976516,921,322350,10298866,3.23
9897516,9987883,3707,1297450,11285333,12.99
9897517,9988290,4242,1484700,11472990,14.86
9897518,9977651,1016,355600,10333251,3.56
9897519,9983967,3244,1135400,11119367,11.37
9897520,9981411,3381,1183350,11164761,11.86
9897521,9971580,4076,1426600,11398180,14.31
9897522,9931588,2911,1018850,10950438,10.26
9897523,9936093,2358,825300,10761393,8.31
9897524,9730619,3947,1381450,11112069,14.20
9897525,405101,93,32550,437651,8.04
9897526,9998168,3959,1385650,11383818,13.86
9897527,9982964,4046,1416100,11399064,14.19
9897528,9843462,2370,829500,10672962,8.43
9897529,9951354,4635,1622250,11573604,16.30
9897530,9982723,4766,1668100,11650823,16.71
9897531,9971828,2533,886550,10858378,8.89
9897532,9988971,3869,1354150,11343121,13.56
9897533,9980618,3921,1372350,11352968,13.75
9897534,9980856,5185,1814750,11795606,18.18
9897535,9992768,5655,1979250,11972018,19.81
9897536,2826547,1406,492100,3318647,17.41
9897537,9965870,5545,1940750,11906620,19.47
9897538,9981268,4252,1488200,11469468,14.91
9897539,9992570,3387,1185450,11178020,11.86
9897540,9579688,5519,1931650,11511338,20.16
9897541,9987709,3792,1327200,11314909,13.29
9897542,9974439,2413,844550,10818989,8.47
9897543,6858315,3888,1360800,8219115,19.84
9897545,9952809,5007,1752450,11705259,17.61
9897546,6515357,1643,575050,7090407,8.83
9897547,9949942,3502,1225700,11175642,12.32
9897548,9968909,4513,1579550,11548459,15.84
9897549,9602158,2255,789250,10391408,8.22
9897550,7875738,2404,841400,8717138,10.68
9897551,9962567,2729,955150,10917717,9.59
9897552,9974744,3281,1148350,11123094,11.51
9897553,9974031,4958,1735300,11709331,17.40
9897554,9984431,2388,835800,10820231,8.37
9897555,9974357,3317,1160950,11135307,11.64
9897556,9968640,3672,1285200,11253840,12.89
9897557,9978770,2576,901600,10880370,9.04
9897558,9982258,4050,1417500,11399758,14.20
9897559,9983144,3253,1138550,11121694,11.40
9897560,9982965,4617,1615950,11598915,16.19
9897562,9973911,2215,775250,10749161,7.77
9897563,9972716,1418,496300,10469016,4.98
9897564,6266354,1994,697900,6964254,11.14
9897565,9761730,3362,1176700,10938430,12.05
9897566,9971455,5312,1859200,11830655,18.65
9897568,9969697,3415,1195250,11164947,11.99
9897569,7960740,1159,405650,8366390,5.10
9897570,9963669,3577,1251950,11215619,12.57
9897571,8496232,2548,891800,9388032,10.50
9897572,9959274,3555,1244250,11203524,12.49
9897573,9949990,3500,1225000,11174990,12.31
9897574,9958576,2100,735000,10693576,7.38
9897576,6848433,461,161350,7009783,2.36
9897577,9970115,4013,1404550,11374665,14.09
9897578,9959414,4205,1471750,11431164,14.78
9897579,9972096,5136,1797600,11769696,18.03
9897580,9975102,2822,987700,10962802,9.90
9897581,5700645,1547,541450,6242095,9.50
9897582,9957781,5027,1759450,11717231,17.67
9897583,9881032,6343,2220050,12101082,22.47
9897584,9978274,4778,1672300,11650574,16.76
9897585,9962239,3046,1066100,11028339,10.70
9897586,9982229,5457,1909950,11892179,19.13
9897587,9983198,4279,1497650,11480848,15.00
9897588,9977063,5018,1756300,11733363,17.60
9897589,9981558,4193,1467550,11449108,14.70
9897590,9978810,2757,964950,10943760,9.67
9897591,9984268,3334,1166900,11151168,11.69
9897592,9991091,4695,1643250,11634341,16.45
9897593,9976097,4906,1717100,11693197,17.21
9897594,9990109,2931,1025850,11015959,10.27
9897595,9713338,2267,793450,10506788,8.17
9897596,9982273,4859,1700650,11682923,17.04
9897597,9963898,6292,2202200,12166098,22.10
9897598,9954751,2072,725200,10679951,7.28
9897599,9967271,4619,1616650,11583921,16.22
9897600,9974192,2985,1044750,11018942,10.47
9897601,9992286,3701,1295350,11287636,12.96
9897602,9972241,5009,1753150,11725391,17.58
9897603,9985569,1373,480550,10466119,4.81
9897604,8214736,1425,498750,8713486,6.07
9897605,9980665,2651,927850,10908515,9.30
9897607,9989179,4581,1603350,11592529,16.05
9897608,9993297,5362,1876700,11869997,18.78
9897609,9974003,2818,986300,10960303,9.89
9897610,9998629,1880,658000,10656629,6.58
9897611,9986475,5433,1901550,11888025,19.04
9897612,9975753,4327,1514450,11490203,15.18
9897613,9977289,4162,1456700,11433989,14.60
9897614,9984995,2065,722750,10707745,7.24
9897615,603086,602,210700,813786,34.94
9897616,9935596,5369,1879150,11814746,18.91
9897617,9969607,4499,1574650,11544257,15.79
9897618,9956299,2995,1048250,11004549,10.53
9897619,9969175,818,286300,10255475,2.87
9897620,9972990,6206,2172100,12145090,21.78
9897621,9980553,2566,898100,10878653,9.00
9897622,9972564,1843,645050,10617614,6.47
9897623,9954055,1011,353850,10307905,3.55
9897624,9954617,1704,596400,10551017,5.99
9897625,4679402,1576,551600,5231002,11.79
9897626,9978139,3553,1243550,11221689,12.46
9897627,9956262,4152,1453200,11409462,14.60
9897628,9964702,4140,1449000,11413702,14.54
9897629,9983545,2807,982450,10965995,9.84
9897630,9987860,2094,732900,10720760,7.34
9897632,9983932,2616,915600,10899532,9.17
9897633,9967305,4401,1540350,11507655,15.45
9897634,9985895,3864,1352400,11338295,13.54
9897635,9981707,3527,1234450,11216157,12.37
9897636,9979783,6016,2105600,12085383,21.10
9897637,9985438,4068,1423800,11409238,14.26
9897639,9974631,4247,1486450,11461081,14.90
9897640,9977737,5416,1895600,11873337,19.00
9897643,9948654,3646,1276100,11224754,12.83
9897644,9956133,4226,1479100,11435233,14.86
9897645,9957753,3203,1121050,11078803,11.26
9897646,9944452,3259,1140650,11085102,11.47
9897647,9936277,4597,1608950,11545227,16.19
9897648,8761359,4655,1629250,10390609,18.60
9897649,9935167,4582,1603700,11538867,16.14
9897650,9944702,2347,821450,10766152,8.26
9897651,9931838,3452,1208200,11140038,12.16
9897652,9952675,3587,1255450,11208125,12.61
9897653,9943926,2428,849800,10793726,8.55
9897654,9941224,3387,1185450,11126674,11.92
9897655,9948560,3257,1139950,11088510,11.46
9897656,9941462,4953,1733550,11675012,17.44
9897657,9938406,4953,1733550,11671956,17.44
9897658,9960986,3559,1245650,11206636,12.51
9897659,9944397,3032,1061200,11005597,10.67
9897660,9954504,4118,1441300,11395804,14.48
9897661,9934738,3760,1316000,11250738,13.25
9897662,9830364,4279,1497650,11328014,15.23
9897663,9952884,4876,1706600,11659484,17.15
9897664,9940064,3439,1203650,11143714,12.11
9897665,9935205,3997,1398950,11334155,14.08
9897666,9912781,4966,1738100,11650881,17.53
9897667,9930004,4313,1509550,11439554,15.20
9897668,9934364,5278,1847300,11781664,18.60
9897669,5728354,3513,1229550,6957904,21.46
9897670,9949963,3248,1136800,11086763,11.43
9897671,9957657,2256,789600,10747257,7.93
9897672,9970127,5396,1888600,11858727,18.94
9897673,9957246,5330,1865500,11822746,18.74
9897674,9949712,3860,1351000,11300712,13.58
9897675,9974581,1939,678650,10653231,6.80
9897676,9279820,3644,1275400,10555220,13.74
9897677,9989457,1123,393050,10382507,3.93
9897678,9999404,5130,1795500,11794904,17.96
9897679,9980103,649,227150,10207253,2.28
9897680,9948572,1338,468300,10416872,4.71
9897681,596642,228,79800,676442,13.37
9897682,3847415,1957,684950,4532365,17.80
9897684,9922898,5114,1789900,11712798,18.04
9897685,9941945,3283,1149050,11090995,11.56
9897686,9930296,4351,1522850,11453146,15.34
9897687,9936404,3809,1333150,11269554,13.42
9897688,9930405,1380,483000,10413405,4.86
9897689,9950230,4026,1409100,11359330,14.16
9897690,9863717,6229,2180150,12043867,22.10
9897691,9945726,4488,1570800,11516526,15.79
9897692,9797427,3750,1312500,11109927,13.40
9897693,9937597,3467,1213450,11151047,12.21
9897694,9926158,4431,1550850,11477008,15.62
9897695,9939543,5155,1804250,11743793,18.15
9897696,9950368,1871,654850,10605218,6.58
9897697,9950118,2674,935900,10886018,9.41
9897698,9964008,2547,891450,10855458,8.95
9897699,9955349,3689,1291150,11246499,12.97
9897700,9954198,4868,1703800,11657998,17.12
9897702,9965969,1869,654150,10620119,6.56
9897703,9974637,5278,1847300,11821937,18.52
9897704,9967577,3462,1211700,11179277,12.16
9897705,9972693,3865,1352750,11325443,13.56
9897706,9987798,3679,1287650,11275448,12.89
9897707,9988368,4655,1629250,11617618,16.31
9897708,9975598,3681,1288350,11263948,12.92
9897709,2776909,1543,540050,3316959,19.45
9897710,9984831,4386,1535100,11519931,15.37
9897711,9994896,1767,618450,10613346,6.19
9897712,9983197,3280,1148000,11131197,11.50
9897713,9968871,2221,777350,10746221,7.80
9897714,9970479,3833,1341550,11312029,13.46
9897715,9963739,2917,1020950,10984689,10.25
9897716,9979881,1507,527450,10507331,5.29
9897717,9981968,1618,566300,10548268,5.67
9897718,9964447,2543,890050,10854497,8.93
9897719,9974758,1526,534100,10508858,5.35
9897720,9993286,8231,2880850,12874136,28.83
9897721,9996658,3834,1341900,11338558,13.42
9897722,9980886,3761,1316350,11297236,13.19
9897723,9979621,4237,1482950,11462571,14.86
9897724,9985188,2195,768250,10753438,7.69
9897725,8406183,2228,779800,9185983,9.28
9897726,9966772,2376,831600,10798372,8.34
9897727,9970962,2159,755650,10726612,7.58
9897728,9981848,1960,686000,10667848,6.87
9897729,9993945,5384,1884400,11878345,18.86
9897730,9970319,5168,1808800,11779119,18.14
9897731,9994854,2366,828100,10822954,8.29
9897732,9989628,1927,674450,10664078,6.75
9897733,9971790,2913,1019550,10991340,10.22
9897734,9978860,4129,1445150,11424010,14.48
9897735,9993457,2584,904400,10897857,9.05
9897736,9981692,3309,1158150,11139842,11.60
9897737,9972804,3002,1050700,11023504,10.54
9897738,9965736,4420,1547000,11512736,15.52
9897739,9957500,3597,1258950,11216450,12.64
9897740,9947476,4498,1574300,11521776,15.83
9897741,9921255,4188,1465800,11387055,14.77
9897742,9926824,3183,1114050,11040874,11.22
9897743,9926207,2300,805000,10731207,8.11
9897744,9927130,2402,840700,10767830,8.47
9897745,9905393,5746,2011100,11916493,20.30
9897746,8910285,4014,1404900,10315185,15.77
9897747,9930304,4022,1407700,11338004,14.18
9897748,9937323,3844,1345400,11282723,13.54
9897749,9919846,4440,1554000,11473846,15.67
9897750,9906041,5863,2052050,11958091,20.72
9897751,9913491,5292,1852200,11765691,18.68
9897752,9924778,4781,1673350,11598128,16.86
9897753,9926925,2033,711550,10638475,7.17
9897754,9954965,4127,1444450,11399415,14.51
9897755,9958716,4785,1674750,11633466,16.82
9897756,9965563,4147,1451450,11417013,14.56
9897757,9961681,4615,1615250,11576931,16.21
9897758,9750222,5858,2050300,11800522,21.03
9897759,9982011,4071,1424850,11406861,14.27
9897760,9971942,1201,420350,10392292,4.22
9897761,1922425,961,336350,2258775,17.50
9897762,9993439,3040,1064000,11057439,10.65
9897763,9986323,4111,1438850,11425173,14.41
9897764,9898044,2050,717500,10615544,7.25
9897765,9984657,1279,447650,10432307,4.48
9897766,9978295,3818,1336300,11314595,13.39
9897767,9980572,4516,1580600,11561172,15.84
9897768,9980456,2455,859250,10839706,8.61
9897769,9996507,3997,1398950,11395457,13.99
9897770,9982901,4434,1551900,11534801,15.55
9897771,9993907,5291,1851850,11845757,18.53
9897772,9986067,1192,417200,10403267,4.18
9897773,9993865,4458,1560300,11554165,15.61
9897774,9983976,3690,1291500,11275476,12.94
9897775,9981901,2155,754250,10736151,7.56
9897776,9986303,2211,773850,10760153,7.75
9897777,4982076,668,233800,5215876,4.69
9897778,9978351,2450,857500,10835851,8.59
9897779,9987372,1249,437150,10424522,4.38
9897780,9988625,3248,1136800,11125425,11.38
9897781,9976927,2912,1019200,10996127,10.22
9897782,9966932,4387,1535450,11502382,15.41
9897783,9987194,5322,1862700,11849894,18.65
9897784,9968341,4472,1565200,11533541,15.70
9897785,9974313,4014,1404900,11379213,14.09
9897786,9989256,3130,1095500,11084756,10.97
9897787,9983353,4675,1636250,11619603,16.39
9897788,9986929,1107,387450,10374379,3.88
9897789,9984938,5408,1892800,11877738,18.96
9897790,9987765,4174,1460900,11448665,14.63
9897791,9986728,4863,1702050,11688778,17.04
9897792,9987309,5487,1920450,11907759,19.23
9897793,9993612,3814,1334900,11328512,13.36
9897794,9987283,3733,1306550,11293833,13.08
9897795,9980638,3614,1264900,11245538,12.67
9897796,9749864,5069,1774150,11524014,18.20
9897797,9970197,3673,1285550,11255747,12.89
9897798,9975324,3153,1103550,11078874,11.06
9897799,9980617,3178,1112300,11092917,11.14
9897800,9981688,3917,1370950,11352638,13.73
9897801,9991287,5744,2010400,12001687,20.12
9897802,9995138,3175,1111250,11106388,11.12
9897803,9992769,4602,1610700,11603469,16.12
9897804,9979116,4241,1484350,11463466,14.87
9897805,9979457,1829,640150,10619607,6.41
9897806,9970437,3702,1295700,11266137,13.00
9897807,9979533,5589,1956150,11935683,19.60
9897808,9968186,3637,1272950,11241136,12.77
9897809,9961967,2545,890750,10852717,8.94
9897810,9970940,5821,2037350,12008290,20.43
9897811,209629,130,45500,255129,21.71
9897812,9974175,1849,647150,10621325,6.49
9897813,9966433,2302,805700,10772133,8.08
9897814,9959410,2816,985600,10945010,9.90
9897815,9949216,3736,1307600,11256816,13.14
9897816,9969628,6031,2110850,12080478,21.17
9897817,906695,368,128800,1035495,14.21
9897818,9988002,4597,1608950,11596952,16.11
9897819,9992926,4296,1503600,11496526,15.05
9897820,9998521,4165,1457750,11456271,14.58
9897821,9989864,4389,1536150,11526014,15.38
9897823,9968979,2929,1025150,10994129,10.28
9897824,9950259,3194,1117900,11068159,11.23
9897825,9965009,5615,1965250,11930259,19.72
9897826,9972939,5476,1916600,11889539,19.22
9897827,9974224,2744,960400,10934624,9.63
9897828,9979796,3260,1141000,11120796,11.43
9897829,9973679,2360,826000,10799679,8.28
9897830,9969506,3719,1301650,11271156,13.06
9897831,9982093,4086,1430100,11412193,14.33
9897832,9980278,4957,1734950,11715228,17.38
9897833,9963613,2728,954800,10918413,9.58
9897834,9961405,3602,1260700,11222105,12.66
9897835,9972138,3237,1132950,11105088,11.36
9897836,9963524,5371,1879850,11843374,18.87
9897837,9979372,3006,1052100,11031472,10.54
9897838,9987085,2575,901250,10888335,9.02
9897839,9993820,4230,1480500,11474320,14.81
9897840,7958695,1439,503650,8462345,6.33
9897841,9976152,4888,1710800,11686952,17.15
9897842,2414813,1783,624050,3038863,25.84
9897843,1258457,624,218400,1476857,17.35
9897844,9970773,3944,1380400,11351173,13.84
9897845,9965186,3248,1136800,11101986,11.41
9897846,9983622,2926,1024100,11007722,10.26
9897847,9934559,3774,1320900,11255459,13.30
9897848,9114810,1524,533400,9648210,5.85
9897849,9984211,5434,1901900,11886111,19.05
9897850,9993284,3203,1121050,11114334,11.22
9897851,9986059,4150,1452500,11438559,14.55
9897852,6930176,175,61250,6991426,0.88
9897853,9980767,1785,624750,10605517,6.26
9897854,9980313,3884,1359400,11339713,13.62
9897855,9977809,3709,1298150,11275959,13.01
9897856,7946898,2292,802200,8749098,10.09
9897858,9973818,4800,1680000,11653818,16.84
9897859,9984666,4933,1726550,11711216,17.29
9897860,9992112,4728,1654800,11646912,16.56
9897861,1090622,634,221900,1312522,20.35
9897862,9980228,3654,1278900,11259128,12.81
9897863,9974441,4930,1725500,11699941,17.30
9897864,9986007,5570,1949500,11935507,19.52
9897865,9994907,4366,1528100,11523007,15.29
9897866,9987144,4172,1460200,11447344,14.62
9897867,9980141,5172,1810200,11790341,18.14
9897868,9982829,3903,1366050,11348879,13.68
9897869,9980033,3655,1279250,11259283,12.82
9897870,9987855,1217,425950,10413805,4.26
9897871,9979936,3099,1084650,11064586,10.87
9897872,9957059,3498,1224300,11181359,12.30
9897873,9966952,4440,1554000,11520952,15.59
9897874,9971847,4103,1436050,11407897,14.40
9897875,2877207,1047,366450,3243657,12.74
9897876,9994876,3965,1387750,11382626,13.88
9897877,9970882,2923,1023050,10993932,10.26
9897878,1572870,748,261800,1834670,16.64
9897879,537309,262,91700,629009,17.07
9897880,9962678,4864,1702400,11665078,17.09
9897881,9972573,2952,1033200,11005773,10.36
9897882,9980299,3212,1124200,11104499,11.26
9897884,9970535,3057,1069950,11040485,10.73
9897885,9989514,5065,1772750,11762264,17.75
9897886,9996540,2262,791700,10788240,7.92
9897887,9971393,1527,534450,10505843,5.36
9897888,2588407,1470,514500,3102907,19.88
9897889,9957760,156,54600,10012360,0.55
9897890,9968660,2808,982800,10951460,9.86
9897891,9962643,2893,1012550,10975193,10.16
9897894,9922138,2700,945000,10867138,9.52
9897895,9944030,3420,1197000,11141030,12.04
9897896,9945525,2462,861700,10807225,8.66
9897897,9942725,2745,960750,10903475,9.66
9897898,9947466,2630,920500,10867966,9.25
9897899,9935284,3463,1212050,11147334,12.20
9897900,9940057,2632,921200,10861257,9.27
9897901,9931462,2580,903000,10834462,9.09
9897902,9932905,3614,1264900,11197805,12.73
9897903,9898424,2912,1019200,10917624,10.30
9897904,9955581,1914,669900,10625481,6.73
9897905,9967546,4886,1710100,11677646,17.16
9897907,9946486,2439,853650,10800136,8.58
9897908,9938800,2895,1013250,10952050,10.19
9897909,9691898,4389,1536150,11228048,15.85
9897910,9941291,3772,1320200,11261491,13.28
9897911,9965093,3101,1085350,11050443,10.89
9897912,9950311,2086,730100,10680411,7.34
9897913,9960561,4146,1451100,11411661,14.57
9897914,9983715,2266,793100,10776815,7.94
9897915,9960997,3718,1301300,11262297,13.06
9897916,9989823,2401,840350,10830173,8.41
9897917,9976605,2256,789600,10766205,7.91
9897918,9990242,4439,1553650,11543892,15.55
9897919,9985032,4986,1745100,11730132,17.48
9897920,9978809,2330,815500,10794309,8.17
9897921,9980153,5550,1942500,11922653,19.46
9897922,9978726,2462,861700,10840426,8.64
9897923,9982693,3654,1278900,11261593,12.81
9897924,9980875,3148,1101800,11082675,11.04
9897925,9972699,3364,1177400,11150099,11.81
9897926,9977633,4441,1554350,11531983,15.58
9897927,9954519,1880,658000,10612519,6.61
9897928,9973010,4445,1555750,11528760,15.60
9897929,393411,90,31500,424911,8.01
9897931,9958917,4323,1513050,11471967,15.19
9897932,9937759,2186,765100,10702859,7.70
9897933,9939959,5390,1886500,11826459,18.98
9897934,9964351,3506,1227100,11191451,12.31
9897935,9948250,3951,1382850,11331100,13.90
9897936,9946924,2659,930650,10877574,9.36
9897937,9939711,4310,1508500,11448211,15.18
9897938,9936659,2607,912450,10849109,9.18
9897939,9913476,2689,941150,10854626,9.49
9897940,9926775,406,142100,10068875,1.43
9897941,9921546,1634,571900,10493446,5.76
9897942,9943133,4256,1489600,11432733,14.98
9897943,9965714,2507,877450,10843164,8.80
9897944,4544453,1602,560700,5105153,12.34
9897945,9972631,5542,1939700,11912331,19.45
9897946,9958312,4636,1622600,11580912,16.29
9897947,9986903,4380,1533000,11519903,15.35
9897948,9980929,3757,1314950,11295879,13.17
9897949,9986271,2950,1032500,11018771,10.34
9897950,9972999,2325,813750,10786749,8.16
9897951,9992877,4957,1734950,11727827,17.36
9897952,9980005,5232,1831200,11811205,18.35
9897953,9985760,3265,1142750,11128510,11.44
9897954,9983748,3795,1328250,11311998,13.30
9897955,8046090,688,240800,8286890,2.99
9897956,7417106,582,203700,7620806,2.75
9897957,9967526,5200,1820000,11787526,18.26
9897958,8405624,1014,354900,8760524,4.22
9897960,9967341,4333,1516550,11483891,15.22
9897961,9983511,3214,1124900,11108411,11.27
9897962,9988133,4779,1672650,11660783,16.75
9897963,221231,101,35350,256581,15.98
9897964,9966887,4957,1734950,11701837,17.41
9897965,9960056,3530,1235500,11195556,12.40
9897966,9974757,316,110600,10085357,1.11
9897968,9995893,4358,1525300,11521193,15.26
9897970,9985765,6240,2184000,12169765,21.87
9897971,9970236,5198,1819300,11789536,18.25
9897972,9966639,4888,1710800,11677439,17.17
9897973,7305190,2409,843150,8148340,11.54
9897974,9985646,1436,502600,10488246,5.03
9897975,9995828,4258,1490300,11486128,14.91
9897976,9986266,7378,2582300,12568566,25.86
9897977,9997725,2030,710500,10708225,7.11
9897978,9983800,5773,2020550,12004350,20.24
9897979,9765934,5711,1998850,11764784,20.47
9897980,9981462,2494,872900,10854362,8.75
9897981,9989145,1435,502250,10491395,5.03
9897982,9991292,5048,1766800,11758092,17.68
9897983,9984188,2915,1020250,11004438,10.22
9897984,9999307,4336,1517600,11516907,15.18
9897985,9976684,2657,929950,10906634,9.32
9897986,9981451,6295,2203250,12184701,22.07
9897987,7410093,1625,568750,7978843,7.68
9897988,9962106,4036,1412600,11374706,14.18
9897989,9965816,1306,457100,10422916,4.59
9897990,6579203,1011,353850,6933053,5.38
9897991,8265054,3274,1145900,9410954,13.86
9897992,4006030,1376,481600,4487630,12.02
9897993,9953338,6340,2219000,12172338,22.29
9897994,9961188,4040,1414000,11375188,14.20
9897995,9968734,6386,2235100,12203834,22.42
9897996,9982070,427,149450,10131520,1.50
9897997,9984513,6328,2214800,12199313,22.18
9897998,9984839,2680,938000,10922839,9.39
9897999,9990917,2496,873600,10864517,8.74
9898001,9963337,3853,1348550,11311887,13.54
9898002,947144,244,85400,1032544,9.02
9898003,9959966,4072,1425200,11385166,14.31
9898004,9952128,500,175000,10127128,1.76
9898005,9968223,5848,2046800,12015023,20.53
9898006,9950224,3714,1299900,11250124,13.06
9898007,9959547,4712,1649200,11608747,16.56
9898008,9962855,4570,1599500,11562355,16.05
9898009,9958730,2139,748650,10707380,7.52
9898010,9973883,4634,1621900,11595783,16.26
9898011,7885026,3891,1361850,9246876,17.27
9898012,961744,459,160650,1122394,16.70
9898013,9998244,5042,1764700,11762944,17.65
9898014,9983356,3897,1363950,11347306,13.66
9898016,9982636,3960,1386000,11368636,13.88
9898017,9960387,5187,1815450,11775837,18.23
9898018,9819442,3921,1372350,11191792,13.98
9898019,9964664,4518,1581300,11545964,15.87
9898020,9947162,3318,1161300,11108462,11.67
9898021,9961461,1312,459200,10420661,4.61
9898022,1794890,624,218400,2013290,12.17
9898023,9960119,4332,1516200,11476319,15.22
9898024,9987561,2984,1044400,11031961,10.46
9898025,9986417,3560,1246000,11232417,12.48
9898026,9971309,3348,1171800,11143109,11.75
9898027,98815,65,22750,121565,23.02
9898028,9984602,3490,1221500,11206102,12.23
9898029,9988680,2543,890050,10878730,8.91
9898031,9968847,5107,1787450,11756297,17.93
9898032,9897334,5694,1992900,11890234,20.14
9898034,9971393,445,155750,10127143,1.56
9898035,9974170,3126,1094100,11068270,10.97
9898036,9837048,4144,1450400,11287448,14.74
9898037,9975572,979,342650,10318222,3.43
9898038,9981932,4510,1578500,11560432,15.81
9898039,9983897,2856,999600,10983497,10.01
9898040,9975842,4539,1588650,11564492,15.92
9898041,2330351,727,254450,2584801,10.92
9898042,9977500,5235,1832250,11809750,18.36
9898043,9983317,2857,999950,10983267,10.02
9898044,9983464,3158,1105300,11088764,11.07
9898045,9977520,1086,380100,10357620,3.81
9898046,9991907,2549,892150,10884057,8.93
9898047,6801969,550,192500,6994469,2.83
9898048,9963987,6547,2291450,12255437,23.00
9898049,9971617,2111,738850,10710467,7.41
9898050,9977633,2109,738150,10715783,7.40
9898051,9967328,3951,1382850,11350178,13.87
9898052,9963143,4344,1520400,11483543,15.26
9898053,9978167,4104,1436400,11414567,14.40
9898054,9980259,4500,1575000,11555259,15.78
9898055,8159385,889,311150,8470535,3.81
9898056,9974212,2855,999250,10973462,10.02
9898057,9986412,2081,728350,10714762,7.29
9898058,9979438,5499,1924650,11904088,19.29
9898059,9970190,4037,1412950,11383140,14.17
9898060,9481471,1415,495250,9976721,5.22
9898061,9999493,2234,781900,10781393,7.82
9898062,9697356,1735,607250,10304606,6.26
9898063,9994626,3453,1208550,11203176,12.09
9898064,9993268,1261,441350,10434618,4.42
9898065,9890263,7088,2480800,12371063,25.08
9898066,8825754,1435,502250,9328004,5.69
9898067,9987236,3870,1354500,11341736,13.56
9898068,9892567,2349,822150,10714717,8.31
9898069,9974087,4687,1640450,11614537,16.45
9898070,9997652,4167,1458450,11456102,14.59
9898071,9987997,3456,1209600,11197597,12.11
9898072,9198426,2644,925400,10123826,10.06
9898073,9998632,3747,1311450,11310082,13.12
9898074,9991970,3504,1226400,11218370,12.27
9898075,9980012,2866,1003100,10983112,10.05
9898077,9091096,3232,1131200,10222296,12.44
9898078,9982701,4460,1561000,11543701,15.64
9898079,9981371,6089,2131150,12112521,21.35
9898080,3075832,849,297150,3372982,9.66
9898081,9793138,4189,1466150,11259288,14.97
9898082,9971898,5792,2027200,11999098,20.33
9898084,9976984,6197,2168950,12145934,21.74
9898085,9986339,3336,1167600,11153939,11.69
9898086,9765548,4409,1543150,11308698,15.80
9898087,9996143,5840,2044000,12040143,20.45
9898088,9982100,5200,1820000,11802100,18.23
9898089,9976692,1822,637700,10614392,6.39
9898090,9706633,4199,1469650,11176283,15.14
9898091,8972686,3198,1119300,10091986,12.47
9898092,9983714,3157,1104950,11088664,11.07
9898093,9966557,2277,796950,10763507,8.00
9898094,9961734,5394,1887900,11849634,18.95
9898095,9971485,3043,1065050,11036535,10.68
9898096,9182467,888,310800,9493267,3.38
9898097,9976058,5562,1946700,11922758,19.51
9898098,9992417,4662,1631700,11624117,16.33
9898099,9999395,4228,1479800,11479195,14.80
9898100,9976538,2439,853650,10830188,8.56
9898101,9987186,5955,2084250,12071436,20.87
9898102,9983158,1693,592550,10575708,5.94
9898103,9991335,3682,1288700,11280035,12.90
9898104,9969734,1521,532350,10502084,5.34
9898105,9967412,4716,1650600,11618012,16.56
9898106,554434,271,94850,649284,17.11
9898108,9980374,3418,1196300,11176674,11.99
9898109,9983290,336,117600,10100890,1.18
9898110,9984798,1346,471100,10455898,4.72
9898111,9976309,3442,1204700,11181009,12.08
9898112,9995826,2971,1039850,11035676,10.40
9898113,9998019,1077,376950,10374969,3.77
9898114,9987023,2226,779100,10766123,7.80
9898116,9695304,2244,785400,10480704,8.10
9898118,9959432,3811,1333850,11293282,13.39
9898119,9987141,2283,799050,10786191,8.00
9898120,9983273,997,348950,10332223,3.50
9898121,9996863,2626,919100,10915963,9.19
9898122,9972657,4245,1485750,11458407,14.90
9898123,9999848,2094,732900,10732748,7.33
9898124,9979577,2669,934150,10913727,9.36
9898125,9980039,3727,1304450,11284489,13.07
9898126,9965423,2555,894250,10859673,8.97
9898127,9971961,4097,1433950,11405911,14.38
9898128,6005880,1126,394100,6399980,6.56
9898129,9970108,2833,991550,10961658,9.95
9898130,9963958,5832,2041200,12005158,20.49
9898131,9976564,2158,755300,10731864,7.57
9898132,9370380,1544,540400,9910780,5.77
9898133,9976352,2815,985250,10961602,9.88
9898134,9979877,2094,732900,10712777,7.34
9898135,9972799,2841,994350,10967149,9.97
9898136,9973488,3489,1221150,11194638,12.24
9898137,9961354,3417,1195950,11157304,12.01
9898138,9977219,3817,1335950,11313169,13.39
9898139,9974345,4219,1476650,11450995,14.80
9898140,9976692,4156,1454600,11431292,14.58
9898141,9974452,4202,1470700,11445152,14.74
9898143,9963160,4122,1442700,11405860,14.48
9898144,9947257,2963,1037050,10984307,10.43
9898145,9943022,865,302750,10245772,3.04
9898146,9650278,4544,1590400,11240678,16.48
9898147,9920069,1708,597800,10517869,6.03
9898148,9937619,4407,1542450,11480069,15.52
9898149,9596034,3184,1114400,10710434,11.61
9898150,9937248,3410,1193500,11130748,12.01
9898151,9940435,1168,408800,10349235,4.11
9898152,9961337,5212,1824200,11785537,18.31
9898153,9956451,2985,1044750,11001201,10.49
9898154,9972875,720,252000,10224875,2.53
9898155,9953165,4549,1592150,11545315,16.00
9898156,9966902,5570,1949500,11916402,19.56
9898157,3951933,141,49350,4001283,1.25
9898158,946071,549,192150,1138221,20.31
9898159,4506415,2834,991900,5498315,22.01
9898160,9940200,3820,1337000,11277200,13.45
9898161,9945594,2724,953400,10898994,9.59
9898162,9959626,3159,1105650,11065276,11.10
9898163,9957938,3372,1180200,11138138,11.85
9898164,9965030,2549,892150,10857180,8.95
9898166,1916523,465,162750,2079273,8.49
9898167,9951064,1080,378000,10329064,3.80
9898168,9959211,2074,725900,10685111,7.29
9898169,9954763,3437,1202950,11157713,12.08
9898170,9950627,2407,842450,10793077,8.47
9898171,9961609,4333,1516550,11478159,15.22
9898172,9968430,4582,1603700,11572130,16.09
9898173,9964470,4820,1687000,11651470,16.93
9898174,9973683,3303,1156050,11129733,11.59
9898175,9991025,5797,2028950,12019975,20.31
9898176,9980600,3022,1057700,11038300,10.60
9898177,9992171,3245,1135750,11127921,11.37
9898178,9984795,2580,903000,10887795,9.04
9898179,9976888,3649,1277150,11254038,12.80
9898180,9999388,2248,786800,10786188,7.87
9898182,3208172,1597,558950,3767122,17.42
9898183,9991077,4274,1495900,11486977,14.97
9898184,9993383,5980,2093000,12086383,20.94
9898185,9979935,3291,1151850,11131785,11.54
9898186,9983498,3541,1239350,11222848,12.41
9898187,9988756,3473,1215550,11204306,12.17
9898188,9950348,4625,1618750,11569098,16.27
9898189,9996723,3186,1115100,11111823,11.15
9898191,9970822,4417,1545950,11516772,15.50
9898192,9970133,4126,1444100,11414233,14.48
9898193,9956712,1346,471100,10427812,4.73
9898194,9961137,4079,1427650,11388787,14.33
9898195,9962903,3726,1304100,11267003,13.09
9898196,9960109,3997,1398950,11359059,14.05
9898197,9951660,4771,1669850,11621510,16.78
9898198,9345447,3952,1383200,10728647,14.80
9898199,9949647,2091,731850,10681497,7.36
9898200,8884440,2432,851200,9735640,9.58
9898201,6361379,1695,593250,6954629,9.33
9898202,9930011,5458,1910300,11840311,19.24
9898203,2717209,1010,353500,3070709,13.01
9898204,9941705,4889,1711150,11652855,17.21
9898205,8932774,4207,1472450,10405224,16.48
9898206,9955778,4370,1529500,11485278,15.36
9898207,9956479,6936,2427600,12384079,24.38
9898208,9954879,4918,1721300,11676179,17.29
9898209,9967645,4210,1473500,11441145,14.78
9898210,9976983,5951,2082850,12059833,20.88
9898211,9973136,4798,1679300,11652436,16.84
9898212,9981801,4532,1586200,11568001,15.89
9898213,9982086,3135,1097250,11079336,10.99
9898214,2421512,377,131950,2553462,5.45
9898215,9953125,4748,1661800,11614925,16.70
9898216,8961006,3256,1139600,10100606,12.72
9898217,9983427,4393,1537550,11520977,15.40
9898218,9729683,3667,1283450,11013133,13.19
9898219,9982596,4031,1410850,11393446,14.13
9898220,9493111,3196,1118600,10611711,11.78
9898221,9979755,2072,725200,10704955,7.27
9898222,9979393,3136,1097600,11076993,11.00
9898223,9997766,4081,1428350,11426116,14.29
9898224,9979914,5385,1884750,11864664,18.89
9898225,7056944,4346,1521100,8578044,21.55
9898226,9989415,3173,1110550,11099965,11.12
9898227,9962891,3857,1349950,11312841,13.55
9898228,2711669,864,302400,3014069,11.15
9898229,9971095,3941,1379350,11350445,13.83
9898230,9964944,3341,1169350,11134294,11.73
9898231,9579199,6113,2139550,11718749,22.34
9898232,9988198,3720,1302000,11290198,13.04
9898233,9991423,5539,1938650,11930073,19.40
9898235,9978687,5211,1823850,11802537,18.28
9898236,9972661,1633,571550,10544211,5.73
9898238,9966860,4211,1473850,11440710,14.79
9898239,9976684,3923,1373050,11349734,13.76
9898240,9990283,4681,1638350,11628633,16.40
9898241,9982733,2903,1016050,10998783,10.18
9898242,9985048,7020,2457000,12442048,24.61
9898243,9972906,3391,1186850,11159756,11.90
9898244,4505594,1894,662900,5168494,14.71
9898245,9986217,5352,1873200,11859417,18.76
9898247,9986734,4544,1590400,11577134,15.93
9898248,9981523,3442,1204700,11186223,12.07
9898249,9969828,4237,1482950,11452778,14.87
9898250,9969123,2703,946050,10915173,9.49
9898251,9970068,4859,1700650,11670718,17.06
9898252,9979538,4145,1450750,11430288,14.54
9898253,9985368,2888,1010800,10996168,10.12
9898254,9999504,3627,1269450,11268954,12.70
9898255,8929163,1553,543550,9472713,6.09
9898256,9063878,4598,1609300,10673178,17.76
9898257,9983968,4359,1525650,11509618,15.28
9898258,342197,96,33600,375797,9.82
9898259,9958384,3840,1344000,11302384,13.50
9898260,9951859,5359,1875650,11827509,18.85
9898263,9967787,3223,1128050,11095837,11.32
9898264,9966757,5881,2058350,12025107,20.65
9898265,9972153,5333,1866550,11838703,18.72
9898266,9998415,4424,1548400,11546815,15.49
9898267,9991162,3367,1178450,11169612,11.79
9898269,9990036,5610,1963500,11953536,19.65
9898270,9975050,3210,1123500,11098550,11.26
9898271,1295674,1603,561050,1856724,43.30
9898272,9987076,3755,1314250,11301326,13.16
9898273,9991144,3801,1330350,11321494,13.32
9898274,9958104,4795,1678250,11636354,16.85
9898275,9989488,5441,1904350,11893838,19.06
9898276,9988524,3152,1103200,11091724,11.04
9898277,9979027,4137,1447950,11426977,14.51
9898278,9965151,2500,875000,10840151,8.78
9898279,9990302,2705,946750,10937052,9.48
9898280,9997159,3095,1083250,11080409,10.84
9898281,9986683,3968,1388800,11375483,13.91
9898282,9990575,3138,1098300,11088875,10.99
9898283,9984968,3066,1073100,11058068,10.75
9898284,9979894,4681,1638350,11618244,16.42
9898285,9978588,3665,1282750,11261338,12.86
9898286,9964346,3848,1346800,11311146,13.52
9898287,9974461,5806,2032100,12006561,20.37
9898288,9981557,5541,1939350,11920907,19.43
9898289,9996938,4288,1500800,11497738,15.01
9898290,9978702,5173,1810550,11789252,18.14
9898291,9986772,3589,1256150,11242922,12.58
9898292,1703532,757,264950,1968482,15.55
9898293,3208317,1287,450450,3658767,14.04
9898294,9969343,3683,1289050,11258393,12.93
9898295,9982594,4287,1500450,11483044,15.03
9898296,9994065,3431,1200850,11194915,12.02
9898297,9997680,3281,1148350,11146030,11.49
9898298,9473812,3778,1322300,10796112,13.96
9898299,1850473,491,171850,2022323,9.29
9898300,3685082,1647,576450,4261532,15.64
9898301,9980863,4268,1493800,11474663,14.97
9898302,9981219,4803,1681050,11662269,16.84
9898303,9994542,4523,1583050,11577592,15.84
9898304,3946645,1136,397600,4344245,10.07
9898305,9978429,3835,1342250,11320679,13.45
9898306,9984165,3982,1393700,11377865,13.96
9898307,9984520,3831,1340850,11325370,13.43
9898308,9976784,5520,1932000,11908784,19.36
9898309,9328484,4468,1563800,10892284,16.76
9898310,9972733,3167,1108450,11081183,11.11
9898311,9960900,2462,861700,10822600,8.65
9898312,8961611,3571,1249850,10211461,13.95
9898313,9958400,1916,670600,10629000,6.73
9898314,9962049,4000,1400000,11362049,14.05
9898315,9963262,5876,2056600,12019862,20.64
9898316,9958968,4652,1628200,11587168,16.35
9898317,9971537,4328,1514800,11486337,15.19
9898318,9987348,3026,1059100,11046448,10.60
9898319,9996644,3090,1081500,11078144,10.82
9898320,9980293,2702,945700,10925993,9.48
9898321,6084065,289,101150,6185215,1.66
9898322,9974674,2927,1024450,10999124,10.27
9898323,9980818,5178,1812300,11793118,18.16
9898324,1316693,563,197050,1513743,14.97
9898325,9986828,5228,1829800,11816628,18.32
9898326,9974890,4409,1543150,11518040,15.47
9898327,9976954,5680,1988000,11964954,19.93
9898328,9988654,5315,1860250,11848904,18.62
9898329,9964769,4910,1718500,11683269,17.25
9898330,9955240,3223,1128050,11083290,11.33
9898331,5238698,299,104650,5343348,2.00
9898332,9969944,4856,1699600,11669544,17.05
9898333,5710784,898,314300,6025084,5.50
9898334,9973721,3157,1104950,11078671,11.08
9898335,3294517,198,69300,3363817,2.10
9898336,348287,145,50750,399037,14.57
9898337,9954057,4564,1597400,11551457,16.05
9898338,9952157,1891,661850,10614007,6.65
9898339,9957722,3031,1060850,11018572,10.65
9898340,9963910,2770,969500,10933410,9.73
9898341,9949441,5376,1881600,11831041,18.91
9898342,9946931,2836,992600,10939531,9.98
9898343,9945154,3802,1330700,11275854,13.38
9898344,9948438,3705,1296750,11245188,13.03
9898345,559038,247,86450,645488,15.46
9898346,9951389,2494,872900,10824289,8.77
9898347,9942144,2036,712600,10654744,7.17
9898348,9934623,2544,890400,10825023,8.96
9898350,9954035,5090,1781500,11735535,17.90
9898351,9959783,5092,1782200,11741983,17.89
9898352,5258909,511,178850,5437759,3.40
9898353,9963557,3252,1138200,11101757,11.42
9898354,9958490,2059,720650,10679140,7.24
9898355,136135,20,7000,143135,5.14
9898356,9959164,4995,1748250,11707414,17.55
9898357,9965414,2682,938700,10904114,9.42
9898358,9964622,5471,1914850,11879472,19.22
9898359,9939177,2978,1042300,10981477,10.49
9898360,9928764,4657,1629950,11558714,16.42
9898362,9914672,2108,737800,10652472,7.44
9898363,9918549,5135,1797250,11715799,18.12
9898364,9931965,3084,1079400,11011365,10.87
9898365,9916200,1958,685300,10601500,6.91
9898366,7427886,385,134750,7562636,1.81
9898367,9942598,3075,1076250,11018848,10.82
9898368,9925120,4669,1634150,11559270,16.46
9898369,9947040,5064,1772400,11719440,17.82
9898370,9945165,5020,1757000,11702165,17.67
9898371,9917720,3889,1361150,11278870,13.72
9898372,9952676,4067,1423450,11376126,14.30
9898373,9961930,3345,1170750,11132680,11.75
9898374,9943658,3357,1174950,11118608,11.82
9898375,9952774,4353,1523550,11476324,15.31
9898376,9948361,3662,1281700,11230061,12.88
9898377,9959453,1974,690900,10650353,6.94
9898378,9970587,4230,1480500,11451087,14.85
9898380,9961751,2673,935550,10897301,9.39
9898381,9967043,5022,1757700,11724743,17.64
9898382,9980775,4893,1712550,11693325,17.16
9898384,9977598,1854,648900,10626498,6.50
9898385,9989106,1468,513800,10502906,5.14
9898386,4285341,685,239750,4525091,5.59
9898387,9992142,3956,1384600,11376742,13.86
9898388,9978021,3420,1197000,11175021,12.00
9898389,9976642,4445,1555750,11532392,15.59
9898390,9980508,5007,1752450,11732958,17.56
9898391,9976651,3047,1066450,11043101,10.69
9898392,9990580,3520,1232000,11222580,12.33
9898393,9979265,5953,2083550,12062815,20.88
9898394,9999587,4669,1634150,11633737,16.34
9898395,9897010,1353,473550,10370560,4.78
9898396,9980946,4275,1496250,11477196,14.99
9898397,9808718,193,67550,9876268,0.69
9898398,9972031,2955,1034250,11006281,10.37
9898399,734582,697,243950,978532,33.21
9898400,9951806,3524,1233400,11185206,12.39
9898401,9946315,2597,908950,10855265,9.14
9898402,9956709,6102,2135700,12092409,21.45
9898403,9953533,4773,1670550,11624083,16.78
9898404,9953834,4710,1648500,11602334,16.56
9898405,9944935,4489,1571150,11516085,15.80
9898406,9962119,4236,1482600,11444719,14.88
9898407,9974382,1426,499100,10473482,5.00
9898408,9960599,5388,1885800,11846399,18.93
9898409,9964336,3754,1313900,11278236,13.19
9898410,1512991,287,100450,1613441,6.64
9898411,9975783,4487,1570450,11546233,15.74
9898412,9985111,3582,1253700,11238811,12.56
9898413,3709154,1578,552300,4261454,14.89
9898414,9978439,2423,848050,10826489,8.50
9898415,9980090,3818,1336300,11316390,13.39
9898416,9979504,3114,1089900,11069404,10.92
9898417,9989103,5537,1937950,11927053,19.40
9898418,9981271,2943,1030050,11011321,10.32
9898419,9980950,3969,1389150,11370100,13.92
9898420,9983879,3080,1078000,11061879,10.80
9898421,9986851,3809,1333150,11320001,13.35
9898422,9985085,4638,1623300,11608385,16.26
9898423,9967437,4575,1601250,11568687,16.06
9898424,9967371,5827,2039450,12006821,20.46
9898425,9947147,3888,1360800,11307947,13.68
9898426,9964605,4074,1425900,11390505,14.31
9898427,1690883,586,205100,1895983,12.13
9898428,6396862,6394,2237900,8634762,34.98
9898429,9957634,4301,1505350,11462984,15.12
9898430,9945924,4361,1526350,11472274,15.35
9898432,6308129,2344,820400,7128529,13.01
9898433,9947506,4741,1659350,11606856,16.68
9898436,9939271,3275,1146250,11085521,11.53
9898437,9928090,5534,1936900,11864990,19.51
9898438,9926510,3760,1316000,11242510,13.26
9898439,9937493,3756,1314600,11252093,13.23
9898440,9928221,3161,1106350,11034571,11.14
9898441,9936208,4891,1711850,11648058,17.23
9898442,9940925,1754,613900,10554825,6.18
9898443,9932745,3948,1381800,11314545,13.91
9898444,9920379,4864,1702400,11622779,17.16
9898445,9927706,4801,1680350,11608056,16.93
9898446,787557,401,140350,927907,17.82
9898447,9933643,2940,1029000,10962643,10.36
9898448,9936975,5111,1788850,11725825,18.00
9898449,9956731,5237,1832950,11789681,18.41
9898450,9951191,2347,821450,10772641,8.25
9898451,9966622,2099,734650,10701272,7.37
9898452,1853100,479,167650,2020750,9.05
9898453,9966257,622,217700,10183957,2.18
9898454,9988531,2170,759500,10748031,7.60
9898455,9979092,6686,2340100,12319192,23.45
9898456,9981767,1695,593250,10575017,5.94
9898457,9980203,3635,1272250,11252453,12.75
9898458,9971936,3204,1121400,11093336,11.25
9898459,442905,158,55300,498205,12.49
9898460,9977217,3234,1131900,11109117,11.34
9898461,9957238,3877,1356950,11314188,13.63
9898462,5588082,1483,519050,6107132,9.29
9898463,9975525,3551,1242850,11218375,12.46
9898464,9978085,2902,1015700,10993785,10.18
9898465,9978906,4677,1636950,11615856,16.40
9898466,9992673,3504,1226400,11219073,12.27
9898467,9987663,3703,1296050,11283713,12.98
9898468,9987464,4569,1599150,11586614,16.01
9898469,9979815,2856,999600,10979415,10.02
9898471,9965964,4184,1464400,11430364,14.69
9898472,9970399,5703,1996050,11966449,20.02
9898473,9958341,4147,1451450,11409791,14.58
9898474,9981678,3687,1290450,11272128,12.93
9898475,9984042,5064,1772400,11756442,17.75
9898476,9982685,5062,1771700,11754385,17.75
9898477,2454272,747,261450,2715722,10.65
9898478,9980650,2529,885150,10865800,8.87
9898479,1458844,399,139650,1598494,9.57
9898480,9982035,4176,1461600,11443635,14.64
9898481,9964340,1766,618100,10582440,6.20
9898482,9945835,4344,1520400,11466235,15.29
9898483,9964752,3894,1362900,11327652,13.68
9898484,8085284,2084,729400,8814684,9.02
9898485,9981398,3915,1370250,11351648,13.73
9898486,9974239,4639,1623650,11597889,16.28
9898487,9974870,643,225050,10199920,2.26
9898488,9964018,4299,1504650,11468668,15.10
9898489,9959530,3139,1098650,11058180,11.03
9898491,9956737,2894,1012900,10969637,10.17
9898492,9965190,3249,1137150,11102340,11.41
9898493,9965825,3677,1286950,11252775,12.91
9898494,7035030,1677,586950,7621980,8.34
9898495,9991839,3578,1252300,11244139,12.53
9898496,152870,72,25200,178070,16.48
9898497,9958531,4008,1402800,11361331,14.09
9898498,9965911,2912,1019200,10985111,10.23
9898499,9986048,3276,1146600,11132648,11.48
9898500,9990810,4602,1610700,11601510,16.12
9898501,9985873,5528,1934800,11920673,19.38
9898502,2190660,1811,633850,2824510,28.93
9898503,9978090,3220,1127000,11105090,11.29
9898504,9974172,2658,930300,10904472,9.33
9898505,9992615,2354,823900,10816515,8.25
9898506,9975085,3413,1194550,11169635,11.98
9898507,9971076,3117,1090950,11062026,10.94
9898508,2903706,810,283500,3187206,9.76
9898509,938360,393,137550,1075910,14.66
9898510,9958546,3843,1345050,11303596,13.51
9898511,4595416,1764,617400,5212816,13.44
9898512,9965981,7641,2674350,12640331,26.83
9898513,9969376,4453,1558550,11527926,15.63
9898514,1135340,918,321300,1456640,28.30
9898515,9954645,2650,927500,10882145,9.32
9898516,9960619,3518,1231300,11191919,12.36
9898517,9946095,1785,624750,10570845,6.28
9898518,9953949,3036,1062600,11016549,10.68
9898519,9935775,3615,1265250,11201025,12.73
9898520,2402636,1398,489300,2891936,20.37
9898521,9943618,4104,1436400,11380018,14.45
9898522,2775893,2806,982100,3757993,35.38
9898523,9953955,5937,2077950,12031905,20.88
9898524,9957604,4342,1519700,11477304,15.26
9898525,9959890,2835,992250,10952140,9.96
9898526,9986388,7482,2618700,12605088,26.22
9898527,9973353,2136,747600,10720953,7.50
9898528,765621,999,349650,1115271,45.67
9898529,9972472,5980,2093000,12065472,20.99
9898530,2144220,1524,533400,2677620,24.88
9898531,9988602,4930,1725500,11714102,17.27
9898532,9995392,5315,1860250,11855642,18.61
9898533,9993420,4620,1617000,11610420,16.18
9898534,9987290,4927,1724450,11711740,17.27
9898535,9911100,4090,1431500,11342600,14.44
9898536,9990807,5322,1862700,11853507,18.64
9898537,9976526,3993,1397550,11374076,14.01
9898538,1165306,84,29400,1194706,2.52
9898539,9972162,5937,2077950,12050112,20.84
9898540,9982434,2823,988050,10970484,9.90
9898541,588294,189,66150,654444,11.24
9898542,9971652,4703,1646050,11617702,16.51
9898543,1885026,716,250600,2135626,13.29
9898544,9978037,5419,1896650,11874687,19.01
9898545,9993320,2362,826700,10820020,8.27
9898546,5092746,3089,1081150,6173896,21.23
9898547,9978861,2263,792050,10770911,7.94
9898548,266835,103,36050,302885,13.51
9898549,9987541,2953,1033550,11021091,10.35
9898550,9974868,2403,841050,10815918,8.43
9898551,9986464,4207,1472450,11458914,14.74
9898552,9998066,1593,557550,10555616,5.58
9898553,9971239,3395,1188250,11159489,11.92
9898554,9855980,3898,1364300,11220280,13.84
9898555,9980984,3114,1089900,11070884,10.92
9898556,9982563,3527,1234450,11217013,12.37
9898557,9975847,1843,645050,10620897,6.47
9898558,9991661,1178,412300,10403961,4.13
9898559,1966640,1007,352450,2319090,17.92
9898560,9970508,1173,410550,10381058,4.12
9898561,4940944,2148,751800,5692744,15.22
9898562,9982415,3516,1230600,11213015,12.33
9898564,1894137,1014,354900,2249037,18.74
9898565,9983648,4763,1667050,11650698,16.70
9898566,9989357,3656,1279600,11268957,12.81
9898567,9980570,4203,1471050,11451620,14.74
9898568,9990527,5937,2077950,12068477,20.80
9898569,9984160,3259,1140650,11124810,11.42
9898570,9999755,4548,1591800,11591555,15.92
9898571,4908341,2061,721350,5629691,14.70
9898572,9981625,3673,1285550,11267175,12.88
9898573,1633862,1872,655200,2289062,40.10
9898574,9975786,5527,1934450,11910236,19.39
9898575,9985995,4503,1576050,11562045,15.78
9898576,9996406,1507,527450,10523856,5.28
9898578,9980101,4072,1425200,11405301,14.28
9898579,9981838,660,231000,10212838,2.31
9898580,9985427,2227,779450,10764877,7.81
9898581,9995722,2280,798000,10793722,7.98
9898582,9998791,1168,408800,10407591,4.09
9898583,1278497,200,70000,1348497,5.48
9898585,9966529,5306,1857100,11823629,18.63
9898586,9974194,426,149100,10123294,1.49
9898587,9968905,1662,581700,10550605,5.84
9898588,687993,583,204050,892043,29.66
9898589,1527632,587,205450,1733082,13.45
9898590,1113637,888,310800,1424437,27.91
9898591,9979619,2973,1040550,11020169,10.43
9898592,9976621,5431,1900850,11877471,19.05
9898593,9979571,3308,1157800,11137371,11.60
9898594,9989801,2249,787150,10776951,7.88
9898595,998826,607,212450,1211276,21.27
9898596,9992242,4444,1555400,11547642,15.57
9898597,9998099,3419,1196650,11194749,11.97
9898598,9979761,2453,858550,10838311,8.60
9898599,9988490,4030,1410500,11398990,14.12
9898600,2063090,1733,606550,2669640,29.40
9898601,9774199,3632,1271200,11045399,13.01
9898602,9990063,3183,1114050,11104113,11.15
9898604,1703423,277,96950,1800373,5.69
9898605,9998908,2906,1017100,11016008,10.17
9898606,9987705,2052,718200,10705905,7.19
9898607,154293,117,40950,195243,26.54
9898608,9974537,2339,818650,10793187,8.21
9898609,9974493,2168,758800,10733293,7.61
9898610,9953989,3889,1361150,11315139,13.67
9898611,9147957,3878,1357300,10505257,14.84
9898612,9948600,3341,1169350,11117950,11.75
9898613,4820929,1928,674800,5495729,14.00
9898614,9937134,1606,562100,10499234,5.66
9898615,9924203,3825,1338750,11262953,13.49
9898616,9951907,4004,1401400,11353307,14.08
9898617,9942052,1476,516600,10458652,5.20
9898618,9955728,4522,1582700,11538428,15.90
9898619,9950121,2390,836500,10786621,8.41
9898620,9943852,1409,493150,10437002,4.96
9898622,9943329,6960,2436000,12379329,24.50
9898623,3666954,2654,928900,4595854,25.33
9898624,9956879,3695,1293250,11250129,12.99
9898625,9967415,1736,607600,10575015,6.10
9898626,9989202,1991,696850,10686052,6.98
9898627,9985645,4505,1576750,11562395,15.79
9898628,9988779,4178,1462300,11451079,14.64
9898629,140209,42,14700,154909,10.48
9898630,9978106,2605,911750,10889856,9.14
9898631,9986856,2570,899500,10886356,9.01
9898632,9991447,3379,1182650,11174097,11.84
9898633,9983912,3017,1055950,11039862,10.58
9898634,9986959,1183,414050,10401009,4.15
9898635,9996207,3095,1083250,11079457,10.84
9898636,9998600,3687,1290450,11289050,12.91
9898637,9994893,3358,1175300,11170193,11.76
9898638,9997257,2040,714000,10711257,7.14
9898639,9978437,2328,814800,10793237,8.17
9898640,248846,123,43050,291896,17.30
9898641,1183992,324,113400,1297392,9.58
9898642,9977273,2643,925050,10902323,9.27
9898643,9979353,880,308000,10287353,3.09
9898644,9988156,2785,974750,10962906,9.76
9898645,9994830,5732,2006200,12001030,20.07
9898646,9971082,3047,1066450,11037532,10.70
9898647,9976032,2438,853300,10829332,8.55
9898648,9979391,1156,404600,10383991,4.05
9898649,9971661,4367,1528450,11500111,15.33
9898650,9997085,2198,769300,10766385,7.70
9898652,8563199,4541,1589350,10152549,18.56
9898653,9985871,2439,853650,10839521,8.55
9898654,9994350,4044,1415400,11409750,14.16
9898655,9994531,5415,1895250,11889781,18.96
9898656,9971845,2797,978950,10950795,9.82
9898657,9963077,5158,1805300,11768377,18.12
9898658,2172151,1413,494550,2666701,22.77
9898659,9978748,3383,1184050,11162798,11.87
9898660,9981877,4893,1712550,11694427,17.16
9898661,9992405,5250,1837500,11829905,18.39
9898662,438685,198,69300,507985,15.80
9898663,9987404,3938,1378300,11365704,13.80
9898664,221623,92,32200,253823,14.53
9898665,388702,110,38500,427202,9.90
9898666,9989413,3940,1379000,11368413,13.80
9898667,9972226,2795,978250,10950476,9.81
9898668,9974886,3062,1071700,11046586,10.74
9898669,9981811,4941,1729350,11711161,17.33
9898670,645181,262,91700,736881,14.21
9898671,9978492,4419,1546650,11525142,15.50
9898672,9973703,5749,2012150,11985853,20.17
9898673,9965394,4301,1505350,11470744,15.11
9898674,9965571,3621,1267350,11232921,12.72
9898675,9964428,1839,643650,10608078,6.46
9898676,9957966,4028,1409800,11367766,14.16
9898677,9956932,1129,395150,10352082,3.97
9898679,9958243,5644,1975400,11933643,19.84
9898680,9968965,2473,865550,10834515,8.68
9898682,9957501,4860,1701000,11658501,17.08
9898683,9974550,4489,1571150,11545700,15.75
9898684,9968555,3662,1281700,11250255,12.86
9898685,9975842,4208,1472800,11448642,14.76
9898686,9968834,5793,2027550,11996384,20.34
9898687,9970902,557,194950,10165852,1.96
9898688,9979734,2881,1008350,10988084,10.10
9898689,733050,325,113750,846800,15.52
9898690,364368,172,60200,424568,16.52
9898691,9968182,3182,1113700,11081882,11.17
9898692,9973269,3282,1148700,11121969,11.52
9898693,9962263,2175,761250,10723513,7.64
9898694,9981738,3154,1103900,11085638,11.06
9898695,9986188,5801,2030350,12016538,20.33
9898696,9980730,3113,1089550,11070280,10.92
9898697,9971558,4268,1493800,11465358,14.98
9898698,789163,533,186550,975713,23.64
9898699,9970753,2889,1011150,10981903,10.14
9898700,9967361,3130,1095500,11062861,10.99
9898701,9971674,3312,1159200,11130874,11.62
9898702,1749205,1084,379400,2128605,21.69
9898703,9973125,4256,1489600,11462725,14.94
9898704,9976741,1779,622650,10599391,6.24
9898705,9972386,4117,1440950,11413336,14.45
9898706,9973358,4688,1640800,11614158,16.45
9898707,9994160,2597,908950,10903110,9.09
9898708,9976855,2541,889350,10866205,8.91
9898709,9958461,6020,2107000,12065461,21.16
9898710,2985014,1743,610050,3595064,20.44
9898711,9763616,1610,563500,10327116,5.77
9898712,9997481,2676,936600,10934081,9.37
9898713,9979283,7876,2756600,12735883,27.62
9898714,9877231,3269,1144150,11021381,11.58
9898716,9980625,5449,1907150,11887775,19.11
9898717,9981594,4012,1404200,11385794,14.07
9898718,9977458,4416,1545600,11523058,15.49
9898719,267003,163,57050,324053,21.37
9898720,3149146,1204,421400,3570546,13.38
9898721,3432486,1276,446600,3879086,13.01
9898722,9989647,4808,1682800,11672447,16.85
9898723,9975924,2241,784350,10760274,7.86
9898724,9984648,3725,1303750,11288398,13.06
9898725,272825,83,29050,301875,10.65
9898726,9976129,4691,1641850,11617979,16.46
9898727,9961370,5322,1862700,11824070,18.70
9898728,9957324,5588,1955800,11913124,19.64
9898729,9967817,3899,1364650,11332467,13.69
9898730,3804620,1662,581700,4386320,15.29
9898731,9978392,7375,2581250,12559642,25.87
9898732,9969011,5456,1909600,11878611,19.16
9898733,9993077,2688,940800,10933877,9.41
9898734,9995225,3045,1065750,11060975,10.66
9898735,9984771,2478,867300,10852071,8.69
9898736,9975357,3370,1179500,11154857,11.82
9898737,9966681,4079,1427650,11394331,14.32
9898738,9986799,2227,779450,10766249,7.80
9898739,9986582,3258,1140300,11126882,11.42
9898740,9998952,4566,1598100,11597052,15.98
9898741,9997314,2814,984900,10982214,9.85
9898742,9982735,3114,1089900,11072635,10.92
9898743,9999729,4459,1560650,11560379,15.61
9898744,56221,42,14700,70921,26.15
9898745,9963188,2123,743050,10706238,7.46
9898746,9961235,4706,1647100,11608335,16.54
9898747,9964380,2417,845950,10810330,8.49
9898748,9965640,3605,1261750,11227390,12.66
9898749,9976175,3049,1067150,11043325,10.70
9898750,9973099,2810,983500,10956599,9.86
9898751,9983345,5723,2003050,11986395,20.06
9898752,9986440,1418,496300,10482740,4.97
9898753,9977565,3110,1088500,11066065,10.91
9898754,9964812,3520,1232000,11196812,12.36
9898755,9974763,3513,1229550,11204313,12.33
9898756,9979438,2198,769300,10748738,7.71
9898757,1665247,332,116200,1781447,6.98
9898758,915858,325,113750,1029608,12.42
9898759,1136514,805,281750,1418264,24.79
9898760,9982033,6033,2111550,12093583,21.15
9898761,1894472,852,298200,2192672,15.74
9898762,9974880,2859,1000650,10975530,10.03
9898763,9983996,2945,1030750,11014746,10.32
9898764,9984077,4966,1738100,11722177,17.41
9898765,9993034,3343,1170050,11163084,11.71
9898766,9987904,4580,1603000,11590904,16.05
9898767,9976698,4374,1530900,11507598,15.34
9898768,9965069,3453,1208550,11173619,12.13
9898769,9951703,3074,1075900,11027603,10.81
9898770,5943536,3354,1173900,7117436,19.75
9898771,9976026,5421,1897350,11873376,19.02
9898772,9982144,3265,1142750,11124894,11.45
9898773,9970293,4923,1723050,11693343,17.28
9898774,3477145,3138,1098300,4575445,31.59
9898775,9978604,5513,1929550,11908154,19.34
9898776,277221,109,38150,315371,13.76
9898777,9984636,6185,2164750,12149386,21.68
9898778,1545615,381,133350,1678965,8.63
9898780,9962765,2952,1033200,10995965,10.37
9898781,9942427,4891,1711850,11654277,17.22
9898783,9929334,2584,904400,10833734,9.11
9898784,9856593,5193,1817550,11674143,18.44
9898785,970962,941,329350,1300312,33.92
9898786,5891136,2154,753900,6645036,12.80
9898787,9940885,2263,792050,10732935,7.97
9898788,2193476,1145,400750,2594226,18.27
9898789,9921665,5098,1784300,11705965,17.98
9898790,9924716,3545,1240750,11165466,12.50
9898791,9927608,5270,1844500,11772108,18.58
9898792,9920408,3725,1303750,11224158,13.14
9898793,9898484,6096,2133600,12032084,21.55
9898794,9923915,1021,357350,10281265,3.60
9898795,9920262,5503,1926050,11846312,19.42
9898796,1367870,281,98350,1466220,7.19
9898797,9922321,3408,1192800,11115121,12.02
9898798,9933804,4337,1517950,11451754,15.28
9898800,9927901,5238,1833300,11761201,18.47
9898801,9924013,5510,1928500,11852513,19.43
9898803,9959928,5679,1987650,11947578,19.96
9898804,2337249,688,240800,2578049,10.30
9898805,9925048,2409,843150,10768198,8.50
9898806,9949557,2503,876050,10825607,8.80
9898807,9935950,5047,1766450,11702400,17.78
9898808,9941353,5892,2062200,12003553,20.74
9898809,9953104,6949,2432150,12385254,24.44
9898810,9936201,1852,648200,10584401,6.52
9898811,9944851,4745,1660750,11605601,16.70
9898812,9947743,3458,1210300,11158043,12.17
9898813,9946896,1513,529550,10476446,5.32
9898814,2553363,1237,432950,2986313,16.96
9898815,9934134,4869,1704150,11638284,17.15
9898816,9954180,4657,1629950,11584130,16.37
9898817,9951969,1106,387100,10339069,3.89
9898819,9972805,3111,1088850,11061655,10.92
9898820,9978446,2965,1037750,11016196,10.40
9898821,9968252,2083,729050,10697302,7.31
9898822,1874764,1019,356650,2231414,19.02
9898823,6948372,1477,516950,7465322,7.44
9898824,9983974,2668,933800,10917774,9.35
9898825,9980215,3084,1079400,11059615,10.82
9898826,2699602,692,242200,2941802,8.97
9898828,9982668,4516,1580600,11563268,15.83
9898829,9975507,4162,1456700,11432207,14.60
9898831,9983638,3515,1230250,11213888,12.32
9898832,9983835,6078,2127300,12111135,21.31
9898833,9984665,5218,1826300,11810965,18.29
9898834,9894477,3998,1399300,11293777,14.14
9898835,9997618,4269,1494150,11491768,14.95
9898836,9968250,3741,1309350,11277600,13.14
9898837,9984269,4338,1518300,11502569,15.21
9898838,9983649,4810,1683500,11667149,16.86
9898839,9982111,3865,1352750,11334861,13.55
9898840,9968188,5287,1850450,11818638,18.56
9898841,9960332,3374,1180900,11141232,11.86
9898842,9978015,4258,1490300,11468315,14.94
9898843,9952723,3809,1333150,11285873,13.39
9898844,9958683,427,149450,10108133,1.50
9898845,9933019,4781,1673350,11606369,16.85
9898846,9940874,3292,1152200,11093074,11.59
9898847,9943346,3368,1178800,11122146,11.86
9898848,9965221,4173,1460550,11425771,14.66
9898849,1297045,1450,507500,1804545,39.13
9898850,9965765,2205,771750,10737515,7.74
9898851,9965702,2260,791000,10756702,7.94
9898852,9966810,4379,1532650,11499460,15.38
9898853,9986391,2666,933100,10919491,9.34
9898854,9974927,4830,1690500,11665427,16.95
9898856,9992548,4482,1568700,11561248,15.70
9898857,9199788,3925,1373750,10573538,14.93
9898858,9995636,2837,992950,10988586,9.93
9898859,9997621,7778,2722300,12719921,27.23
9898860,1077719,2192,767200,1844919,71.19
9898861,9825205,4929,1725150,11550355,17.56
9898862,9982727,4098,1434300,11417027,14.37
9898864,3130041,2466,863100,3993141,27.57
9898865,9990079,3307,1157450,11147529,11.59
9898866,9995241,3232,1131200,11126441,11.32
9898867,9988001,2755,964250,10952251,9.65
9898869,1428768,1398,489300,1918068,34.25
9898870,9997086,3952,1383200,11380286,13.84
9898871,9972896,3128,1094800,11067696,10.98
9898872,9993680,6097,2133950,12127630,21.35
9898873,9980866,3275,1146250,11127116,11.48
9898874,9986533,4836,1692600,11679133,16.95
9898875,589849,200,70000,659849,11.87
9898876,1832914,1407,492450,2325364,26.87
9898877,2073529,614,214900,2288429,10.36
9898878,9983251,3304,1156400,11139651,11.58
9898879,9981255,1590,556500,10537755,5.58
9898880,9990307,2074,725900,10716207,7.27
9898881,9998205,2159,755650,10753855,7.56
9898882,9990037,2044,715400,10705437,7.16
9898883,9982597,2046,716100,10698697,7.17
9898884,9991256,3908,1367800,11359056,13.69
9898885,9989964,4627,1619450,11609414,16.21
9898886,2454984,1203,421050,2876034,17.15
9898887,9510975,4166,1458100,10969075,15.33
9898888,3560323,2776,971600,4531923,27.29
9898889,9972833,5613,1964550,11937383,19.70
9898890,9961377,3066,1073100,11034477,10.77
9898891,9980277,7060,2471000,12451277,24.76
9898892,9960725,3099,1084650,11045375,10.89
9898893,9975173,3240,1134000,11109173,11.37
9898894,861737,277,96950,958687,11.25
9898896,9847081,6601,2310350,12157431,23.46
9898897,9947802,4052,1418200,11366002,14.26
9898898,9940909,3591,1256850,11197759,12.64
9898899,801505,385,134750,936255,16.81
9898900,9936392,3736,1307600,11243992,13.16
9898901,9911026,4231,1480850,11391876,14.94
9898902,9919315,5736,2007600,11926915,20.24
9898903,1022102,410,143500,1165602,14.04
9898904,9922699,4675,1636250,11558949,16.49
9898905,9917425,3232,1131200,11048625,11.41
9898906,9924263,5330,1865500,11789763,18.80
9898908,9933735,3523,1233050,11166785,12.41
9898909,9916556,2481,868350,10784906,8.76
9898910,9932885,2145,750750,10683635,7.56
9898911,9919406,2203,771050,10690456,7.77
9898912,9927942,2261,791350,10719292,7.97
9898913,9927854,3226,1129100,11056954,11.37
9898914,9931061,3985,1394750,11325811,14.04
9898915,9934237,3880,1358000,11292237,13.67
9898916,9936548,1808,632800,10569348,6.37
9898917,9942953,3713,1299550,11242503,13.07
9898918,9965562,3822,1337700,11303262,13.42
9898919,9964993,1135,397250,10362243,3.99
9898920,634246,326,114100,748346,17.99
9898922,9968056,6121,2142350,12110406,21.49
9898923,9949328,3483,1219050,11168378,12.25
9898924,1891061,1960,686000,2577061,36.28
9898925,9951003,3809,1333150,11284153,13.40
9898926,4269896,2030,710500,4980396,16.64
9898927,2342024,1193,417550,2759574,17.83
9898928,9966215,6651,2327850,12294065,23.36
9898929,9969683,3804,1331400,11301083,13.35
9898930,9967037,4060,1421000,11388037,14.26
9898931,9973765,5295,1853250,11827015,18.58
9898932,286521,98,34300,320821,11.97
9898933,9954625,3811,1333850,11288475,13.40
9898934,9955895,3251,1137850,11093745,11.43
9898935,9952653,2984,1044400,10997053,10.49
9898936,9952181,2263,792050,10744231,7.96
9898937,9943622,4217,1475950,11419572,14.84
9898938,9940343,5709,1998150,11938493,20.10
9898939,9940874,3975,1391250,11332124,14.00
9898940,9931285,4784,1674400,11605685,16.86
9898942,2442818,871,304850,2747668,12.48
9898943,9937224,4444,1555400,11492624,15.65
9898944,9941575,4002,1400700,11342275,14.09
9898945,9964053,3367,1178450,11142503,11.83
9898946,9959028,3280,1148000,11107028,11.53
9898947,9971648,4154,1453900,11425548,14.58
9898948,3650472,2363,827050,4477522,22.66
9898949,9980472,3246,1136100,11116572,11.38
9898950,877375,289,101150,978525,11.53
9898951,3048192,2669,934150,3982342,30.65
9898952,94809,47,16450,111259,17.35
9898953,1111823,1561,546350,1658173,49.14
9898954,9950249,3483,1219050,11169299,12.25
9898955,3806465,2335,817250,4623715,21.47
9898956,9951544,6218,2176300,12127844,21.87
9898957,9951963,1836,642600,10594563,6.46
9898958,9946362,4330,1515500,11461862,15.24
9898959,9947864,3662,1281700,11229564,12.88
9898960,9955298,1616,565600,10520898,5.68
9898961,9955785,3302,1155700,11111485,11.61
9898962,9944018,2881,1008350,10952368,10.14
9898963,9948559,3521,1232350,11180909,12.39
9898964,9909916,3994,1397900,11307816,14.11
9898965,9974589,6063,2122050,12096639,21.27
9898966,9970629,6279,2197650,12168279,22.04
9898967,3128614,750,262500,3391114,8.39
9898968,1042845,764,267400,1310245,25.64
9898969,9973750,3303,1156050,11129800,11.59
9898970,9988094,4593,1607550,11595644,16.09
9898971,9969902,4865,1702750,11672652,17.08
9898972,9975563,4260,1491000,11466563,14.95
9898973,9988652,4482,1568700,11557352,15.70
9898974,9964040,5659,1980650,11944690,19.88
9898976,9970121,4208,1472800,11442921,14.77
9898977,9988823,3658,1280300,11269123,12.82
9898978,9980700,5729,2005150,11985850,20.09
9898979,7624107,866,303100,7927207,3.98
9898980,9974266,4778,1672300,11646566,16.77
9898983,2901386,837,292950,3194336,10.10
9898984,9969430,2741,959350,10928780,9.62
9898985,3809918,1413,494550,4304468,12.98
9898986,9981626,4858,1700300,11681926,17.03
9898987,9965564,3093,1082550,11048114,10.86
9898988,4345165,2427,849450,5194615,19.55
9898989,9988925,2982,1043700,11032625,10.45
9898990,9997661,5412,1894200,11891861,18.95
9898991,9996442,5558,1945300,11941742,19.46
9898992,5408247,3097,1083950,6492197,20.04
9898993,1892885,1736,607600,2500485,32.10
9898994,9956542,2606,912100,10868642,9.16
9898996,8714719,1482,518700,9233419,5.95
9898997,9976377,4761,1666350,11642727,16.70
9898999,9963431,5612,1964200,11927631,19.71
9899000,9981716,6674,2335900,12317616,23.40
9899001,9988581,3696,1293600,11282181,12.95
9899002,9993675,4807,1682450,11676125,16.84
9899003,9983809,3754,1313900,11297709,13.16
9899004,9971070,3271,1144850,11115920,11.48
9899005,9991038,4109,1438150,11429188,14.39
9899006,3330428,1054,368900,3699328,11.08
9899007,9974641,5163,1807050,11781691,18.12
9899008,9983676,5986,2095100,12078776,20.99
9899009,9981286,4085,1429750,11411036,14.32
9899010,9995103,4179,1462650,11457753,14.63
9899011,9986196,4944,1730400,11716596,17.33
9899012,9993261,5525,1933750,11927011,19.35
9899013,9979103,2792,977200,10956303,9.79
9899014,9988766,5446,1906100,11894866,19.08
9899015,9979098,2771,969850,10948948,9.72
9899016,9975833,1205,421750,10397583,4.23
9899017,9979561,2914,1019900,10999461,10.22
9899018,9984000,4449,1557150,11541150,15.60
9899019,9977994,2731,955850,10933844,9.58
9899020,9988998,2061,721350,10710348,7.22
9899021,3472085,842,294700,3766785,8.49
9899022,9988246,5014,1754900,11743146,17.57
9899023,9993648,6420,2247000,12240648,22.48
9899024,9971283,3351,1172850,11144133,11.76
9899025,9986249,3479,1217650,11203899,12.19
9899026,9962865,3486,1220100,11182965,12.25
9899027,9977608,4415,1545250,11522858,15.49
9899028,9981579,4131,1445850,11427429,14.49
9899029,9981396,3647,1276450,11257846,12.79
9899030,9990074,5857,2049950,12040024,20.52
9899031,1538246,609,213150,1751396,13.86
9899032,125596,26,9100,134696,7.25
9899033,9964320,4775,1671250,11635570,16.77
9899034,9960916,3703,1296050,11256966,13.01
9899035,666564,216,75600,742164,11.34
9899036,9961024,4367,1528450,11489474,15.34
9899037,3119330,964,337400,3456730,10.82
9899038,9982623,4132,1446200,11428823,14.49
9899039,9971353,3807,1332450,11303803,13.36
9899041,9998346,3820,1337000,11335346,13.37
9899042,9995731,3934,1376900,11372631,13.77
9899043,9976959,7237,2532950,12509909,25.39
9899044,1510922,796,278600,1789522,18.44
9899045,9980585,4503,1576050,11556635,15.79
9899046,8978131,2726,954100,9932231,10.63
9899047,8971108,3783,1324050,10295158,14.76
9899048,1358384,935,327250,1685634,24.09
9899049,383934,133,46550,430484,12.12
9899050,9983141,4517,1580950,11564091,15.84
9899051,9994860,3675,1286250,11281110,12.87
9899052,9984913,2174,760900,10745813,7.62
9899053,9975225,3538,1238300,11213525,12.41
9899055,9991547,3679,1287650,11279197,12.89
9899056,9989915,3130,1095500,11085415,10.97
9899058,1207871,417,145950,1353821,12.08
9899059,9964651,3841,1344350,11309001,13.49
9899060,9373184,3521,1232350,10605534,13.15
9899061,1775978,852,298200,2074178,16.79
9899062,7579304,4214,1474900,9054204,19.46
9899063,9981819,4385,1534750,11516569,15.38
9899064,9968529,4459,1560650,11529179,15.66
9899066,9973635,5587,1955450,11929085,19.61
9899067,1239294,1432,501200,1740494,40.44
9899068,9943444,4246,1486100,11429544,14.95
9899069,9952964,4683,1639050,11592014,16.47
9899070,9945243,4388,1535800,11481043,15.44
9899071,4880145,2212,774200,5654345,15.86
9899072,9953610,5952,2083200,12036810,20.93
9899073,9981917,4488,1570800,11552717,15.74
9899074,9955780,2646,926100,10881880,9.30
9899075,567614,12,4200,571814,0.74
9899076,9982936,4852,1698200,11681136,17.01
9899077,5281272,3112,1089200,6370472,20.62
9899078,9987881,7311,2558850,12546731,25.62
9899079,9977138,5951,2082850,12059988,20.88
9899080,9997287,4612,1614200,11611487,16.15
9899081,9980392,6148,2151800,12132192,21.56
9899084,741967,465,162750,904717,21.93
9899085,9983920,3088,1080800,11064720,10.83
9899086,9985308,6345,2220750,12206058,22.24
9899087,9983534,5821,2037350,12020884,20.41
9899088,9985067,3174,1110900,11095967,11.13
9899089,9985430,2874,1005900,10991330,10.07
9899090,9983123,6389,2236150,12219273,22.40
9899091,1260782,1187,415450,1676232,32.95
9899092,9993832,5623,1968050,11961882,19.69
9899093,9989870,3176,1111600,11101470,11.13
9899094,9995365,4098,1434300,11429665,14.35
9899095,9996438,4113,1439550,11435988,14.40
9899096,9983806,4703,1646050,11629856,16.49
9899097,1796018,693,242550,2038568,13.50
9899098,9962995,5869,2054150,12017145,20.62
9899099,9980992,2329,815150,10796142,8.17
9899100,9993564,4514,1579900,11573464,15.81
9899101,9967668,3571,1249850,11217518,12.54
9899102,9990026,3635,1272250,11262276,12.74
9899103,9983248,5434,1901900,11885148,19.05
9899104,273957,131,45850,319807,16.74
9899105,4694384,2755,964250,5658634,20.54
9899106,9986489,5097,1783950,11770439,17.86
9899107,380819,158,55300,436119,14.52
9899108,9967391,3750,1312500,11279891,13.17
9899109,9973198,5792,2027200,12000398,20.33
9899110,9967808,3895,1363250,11331058,13.68
9899111,9983084,5105,1786750,11769834,17.90
9899112,9987394,1906,667100,10654494,6.68
9899113,9975625,5299,1854650,11830275,18.59
9899114,9967820,3321,1162350,11130170,11.66
9899115,9973594,3345,1170750,11144344,11.74
9899116,9817114,5711,1998850,11815964,20.36
9899117,9819882,2739,958650,10778532,9.76
9899118,9999068,2329,815150,10814218,8.15
9899119,9986516,6843,2395050,12381566,23.98
9899120,9988896,4456,1559600,11548496,15.61
9899121,9984198,4065,1422750,11406948,14.25
9899122,1402707,1203,421050,1823757,30.02
9899123,7271329,3800,1330000,8601329,18.29
9899124,9972975,5411,1893850,11866825,18.99
9899125,9995041,3682,1288700,11283741,12.89
9899126,9979846,7358,2575300,12555146,25.81
9899127,9972158,3109,1088150,11060308,10.91
9899128,9974656,3126,1094100,11068756,10.97
9899129,9984521,5500,1925000,11909521,19.28
9899130,9984647,4062,1421700,11406347,14.24
9899131,9982128,6129,2145150,12127278,21.49
9899132,3541169,2937,1027950,4569119,29.03
9899133,9976610,5243,1835050,11811660,18.39
9899134,9975755,5413,1894550,11870305,18.99
9899135,9960413,6979,2442650,12403063,24.52
9899136,9953914,6666,2333100,12287014,23.44
9899137,9973963,7330,2565500,12539463,25.72
9899138,9977255,5040,1764000,11741255,17.68
9899139,9972305,5201,1820350,11792655,18.25
9899140,9958245,5653,1978550,11936795,19.87
9899142,9960614,1545,540750,10501364,5.43
9899143,9975439,1870,654500,10629939,6.56
9899144,9981873,3930,1375500,11357373,13.78
9899145,9974682,7067,2473450,12448132,24.80
9899146,9983606,5398,1889300,11872906,18.92
9899147,9977954,6175,2161250,12139204,21.66
9899148,9994743,7268,2543800,12538543,25.45
9899149,9982387,6448,2256800,12239187,22.61
9899150,3404210,2327,814450,4218660,23.92
9899151,9979942,5516,1930600,11910542,19.34
9899152,9957298,6234,2181900,12139198,21.91
9899153,9964450,5465,1912750,11877200,19.20
9899154,9971187,6807,2382450,12353637,23.89
9899155,9978207,5785,2024750,12002957,20.29
9899156,9997349,3604,1261400,11258749,12.62
9899157,9987836,4162,1456700,11444536,14.58
9899158,9990769,4431,1550850,11541619,15.52
9899159,9990922,4815,1685250,11676172,16.87
9899160,9996399,4619,1616650,11613049,16.17
9899162,9979216,4749,1662150,11641366,16.66
9899163,9970544,5422,1897700,11868244,19.03
9899164,9966316,3573,1250550,11216866,12.55
9899165,8383681,4271,1494850,9878531,17.83
9899166,9959805,4349,1522150,11481955,15.28
9899167,9955541,5164,1807400,11762941,18.15
9899168,9908817,3387,1185450,11094267,11.96
9899169,6966677,4897,1713950,8680627,24.60
9899170,9965932,4249,1487150,11453082,14.92
9899171,3374773,2357,824950,4199723,24.44
9899172,9967862,7322,2562700,12530562,25.71
9899173,9977170,7133,2496550,12473720,25.02
9899174,2366793,266,93100,2459893,3.93
9899175,9320885,4192,1467200,10788085,15.74
9899176,4953441,3238,1133300,6086741,22.88
9899177,9944208,7484,2619400,12563608,26.34
9899178,9971660,7149,2502150,12473810,25.09
9899179,9964895,4204,1471400,11436295,14.77
9899180,9951157,3616,1265600,11216757,12.72
9899181,9969609,4250,1487500,11457109,14.92
9899182,9959671,6381,2233350,12193021,22.42
9899183,9950198,3448,1206800,11156998,12.13
9899184,7134944,1544,540400,7675344,7.57
9899185,9969057,6998,2449300,12418357,24.57
9899186,9984090,7643,2675050,12659140,26.79
9899187,9984780,7603,2661050,12645830,26.65
9899188,9991615,3332,1166200,11157815,11.67
9899189,9997598,5391,1886850,11884448,18.87
9899190,9985781,6238,2183300,12169081,21.86
9899191,9981099,3837,1342950,11324049,13.45
9899192,9948898,6922,2422700,12371598,24.35
9899193,1889963,1378,482300,2372263,25.52
9899194,9968936,6532,2286200,12255136,22.93
9899195,9982044,5975,2091250,12073294,20.95
9899196,5400303,3172,1110200,6510503,20.56
9899197,9989582,5353,1873550,11863132,18.76
9899198,9981170,6568,2298800,12279970,23.03
9899199,9985801,6458,2260300,12246101,22.64
9899200,9973846,8229,2880150,12853996,28.88
9899201,9983671,5614,1964900,11948571,19.68
9899202,9979560,5451,1907850,11887410,19.12
9899203,9973627,4847,1696450,11670077,17.01
9899204,9983737,4102,1435700,11419437,14.38
9899205,9997338,3720,1302000,11299338,13.02
9899206,9976707,5593,1957550,11934257,19.62
9899207,4672121,4182,1463700,6135821,31.33
9899208,9971679,4664,1632400,11604079,16.37
9899209,9978921,2875,1006250,10985171,10.08
9899210,9991314,5973,2090550,12081864,20.92
9899211,9962937,3074,1075900,11038837,10.80
9899212,9976928,4918,1721300,11698228,17.25
9899213,3140722,2786,975100,4115822,31.05
9899214,9984221,5844,2045400,12029621,20.49
9899215,1048764,960,336000,1384764,32.04
9899216,9983275,5268,1843800,11827075,18.47
9899217,9999506,6003,2101050,12100556,21.01
9899218,9988099,6365,2227750,12215849,22.30
9899220,9991011,5338,1868300,11859311,18.70
9899221,9970271,6480,2268000,12238271,22.75
9899222,8985685,5750,2012500,10998185,22.40
9899223,9972262,6604,2311400,12283662,23.18
9899224,9985678,4786,1675100,11660778,16.78
9899225,9972218,3492,1222200,11194418,12.26
9899226,9988546,5563,1947050,11935596,19.49
9899227,9984111,8114,2839900,12824011,28.44
9899228,9975753,7043,2465050,12440803,24.71
9899229,9983676,4015,1405250,11388926,14.08
9899230,9980048,2701,945350,10925398,9.47
9899231,9996635,3384,1184400,11181035,11.85
9899232,9984120,4836,1692600,11676720,16.95
9899233,9971564,7506,2627100,12598664,26.35
9899234,9981955,5546,1941100,11923055,19.45
9899235,9979881,6383,2234050,12213931,22.39
9899236,9992064,8595,3008250,13000314,30.11
9899237,9983377,4122,1442700,11426077,14.45
9899238,9978719,5175,1811250,11789969,18.15
9899239,9963952,7793,2727550,12691502,27.37
9899240,9974876,3949,1382150,11357026,13.86
9899241,9973023,6852,2398200,12371223,24.05
9899243,9976094,6296,2203600,12179694,22.09
9899244,9984825,6271,2194850,12179675,21.98
9899245,9994185,4840,1694000,11688185,16.95
9899246,9987692,5822,2037700,12025392,20.40
9899247,9985528,3567,1248450,11233978,12.50
9899248,9973070,3515,1230250,11203320,12.34
9899249,9979612,2442,854700,10834312,8.56
9899250,9995104,6701,2345350,12340454,23.46
9899251,4350504,2715,950250,5300754,21.84
9899252,9979665,5674,1985900,11965565,19.90
9899253,9959214,4391,1536850,11496064,15.43
9899254,9957550,7866,2753100,12710650,27.65
9899255,9976258,5694,1992900,11969158,19.98
9899256,4048731,2263,792050,4840781,19.56
9899257,9990143,7389,2586150,12576293,25.89
9899258,9986972,5792,2027200,12014172,20.30
9899259,9988942,5609,1963150,11952092,19.65
9899260,9991867,6790,2376500,12368367,23.78
9899261,9981102,4819,1686650,11667752,16.90
9899262,9998281,5101,1785350,11783631,17.86
9899263,7094930,3244,1135400,8230330,16.00
9899264,1275501,1078,377300,1652801,29.58
9899265,9858942,5742,2009700,11868642,20.38
9899266,9751646,6102,2135700,11887346,21.90
9899267,9963721,5610,1963500,11927221,19.71
9899268,9605633,6416,2245600,11851233,23.38
9899269,9982076,5316,1860600,11842676,18.64
9899270,9987618,4770,1669500,11657118,16.72
9899271,1580763,840,294000,1874763,18.60
9899272,9964558,4472,1565200,11529758,15.71
9899273,9951695,10270,3594500,13546195,36.12
9899274,9935047,4467,1563450,11498497,15.74
9899275,9965050,7588,2655800,12620850,26.65
9899276,7252827,4197,1468950,8721777,20.25
9899277,9969476,5392,1887200,11856676,18.93
9899278,9989335,4983,1744050,11733385,17.46
9899279,8193644,2032,711200,8904844,8.68
9899280,9975141,4664,1632400,11607541,16.36
9899281,9992223,7534,2636900,12629123,26.39
9899282,4369433,1454,508900,4878333,11.65
9899283,158297,93,32550,190847,20.56
9899284,9997803,3966,1388100,11385903,13.88
9899285,9979424,5626,1969100,11948524,19.73
9899286,9979573,5570,1949500,11929073,19.53
9899287,9994094,7617,2665950,12660044,26.68
9899288,9971096,5640,1974000,11945096,19.80
9899289,9987872,3437,1202950,11190822,12.04
9899290,2055977,1637,572950,2628927,27.87
9899291,9958909,6146,2151100,12110009,21.60
9899292,9970517,4208,1472800,11443317,14.77
9899293,9981603,3540,1239000,11220603,12.41
9899294,3972199,1532,536200,4508399,13.50
9899295,9961965,5942,2079700,12041665,20.88
9899296,9978741,3935,1377250,11355991,13.80
9899297,9453809,2694,942900,10396709,9.97
9899298,9969844,4036,1412600,11382444,14.17
9899299,9989136,3591,1256850,11245986,12.58
9899300,9990858,5022,1757700,11748558,17.59
9899301,9996672,4193,1467550,11464222,14.68
9899302,9968215,5746,2011100,11979315,20.18
9899303,9988930,4648,1626800,11615730,16.29
9899304,9994970,4124,1443400,11438370,14.44
9899305,9980148,4303,1506050,11486198,15.09
9899306,9910496,4876,1706600,11617096,17.22
9899307,9990307,5452,1908200,11898507,19.10
9899308,9976425,4343,1520050,11496475,15.24
9899309,9971458,2355,824250,10795708,8.27
9899310,9960833,7712,2699200,12660033,27.10
9899311,9941924,5365,1877750,11819674,18.89
9899312,9941004,5040,1764000,11705004,17.74
9899313,9933518,3258,1140300,11073818,11.48
9899314,6664503,3345,1170750,7835253,17.57
9899315,9924333,4772,1670200,11594533,16.83
9899316,9938001,5554,1943900,11881901,19.56
9899317,9954222,4647,1626450,11580672,16.34
9899318,2672475,1950,682500,3354975,25.54
9899319,9495420,5387,1885450,11380870,19.86
9899320,9936116,3402,1190700,11126816,11.98
9899321,4960420,2626,919100,5879520,18.53
9899322,9921637,5427,1899450,11821087,19.14
9899323,9908892,5264,1842400,11751292,18.59
9899324,9924620,3960,1386000,11310620,13.97
9899325,9932108,3940,1379000,11311108,13.88
9899326,9917489,5815,2035250,11952739,20.52
9899327,9914894,4380,1533000,11447894,15.46
9899328,9937498,2410,843500,10780998,8.49
9899329,5463872,3925,1373750,6837622,25.14
9899330,9933326,3738,1308300,11241626,13.17
9899331,9910646,3838,1343300,11253946,13.55
9899332,9902571,5602,1960700,11863271,19.80
9899333,9899564,4059,1420650,11320214,14.35
9899334,5765569,5064,1772400,7537969,30.74
9899335,9888244,5025,1758750,11646994,17.79
9899336,1466712,781,273350,1740062,18.64
9899337,9896247,7498,2624300,12520547,26.52
9899338,9524084,5894,2062900,11586984,21.66
9899339,9888218,2889,1011150,10899368,10.23
9899340,8897710,4889,1711150,10608860,19.23
9899341,9892912,5612,1964200,11857112,19.85
9899342,9880602,5338,1868300,11748902,18.91
9899343,9894262,6153,2153550,12047812,21.77
9899344,9900368,4305,1506750,11407118,15.22
9899345,9916170,4457,1559950,11476120,15.73
9899346,9908690,6414,2244900,12153590,22.66
9899347,9904055,4546,1591100,11495155,16.07
9899348,9919325,2170,759500,10678825,7.66
9899349,9901173,5507,1927450,11828623,19.47
9899350,9881073,3055,1069250,10950323,10.82
9899351,9896273,6956,2434600,12330873,24.60
9899352,9902071,4384,1534400,11436471,15.50
9899353,9779682,3829,1340150,11119832,13.70
9899354,9908618,3075,1076250,10984868,10.86
9899355,1836930,1580,553000,2389930,30.10
9899356,9911090,3585,1254750,11165840,12.66
9899357,9922719,5042,1764700,11687419,17.78
9899358,9937110,5812,2034200,11971310,20.47
9899359,9924282,5367,1878450,11802732,18.93
9899360,9927736,2251,787850,10715586,7.94
9899361,9931916,2535,887250,10819166,8.93
9899362,9951612,5305,1856750,11808362,18.66
9899363,9936389,4230,1480500,11416889,14.90
9899364,9939486,5114,1789900,11729386,18.01
9899365,9939587,4640,1624000,11563587,16.34
9899366,9934923,4056,1419600,11354523,14.29
9899367,9941751,4487,1570450,11512201,15.80
9899368,9931143,3961,1386350,11317493,13.96
9899369,9956097,3688,1290800,11246897,12.96
9899370,9943772,3943,1380050,11323822,13.88
9899371,9949096,5574,1950900,11899996,19.61
9899372,9945216,3656,1279600,11224816,12.87
9899373,9951901,4698,1644300,11596201,16.52
9899374,9605912,6951,2432850,12038762,25.33
9899375,9940220,5282,1848700,11788920,18.60
9899376,9941221,873,305550,10246771,3.07
9899377,7973363,3279,1147650,9121013,14.39
9899378,9943944,5321,1862350,11806294,18.73
9899379,9941231,4317,1510950,11452181,15.20
9899380,9952738,5250,1837500,11790238,18.46
9899381,2491291,860,301000,2792291,12.08
9899382,9936138,5257,1839950,11776088,18.52
9899383,9941714,3995,1398250,11339964,14.06
9899384,4534019,1324,463400,4997419,10.22
9899385,9939030,5832,2041200,11980230,20.54
9899386,9949217,4377,1531950,11481167,15.40
9899387,9956988,5618,1966300,11923288,19.75
9899388,9944361,1090,381500,10325861,3.84
9899389,9952400,5264,1842400,11794800,18.51
9899390,9958794,6051,2117850,12076644,21.27
9899391,9967022,2366,828100,10795122,8.31
9899392,471992,103,36050,508042,7.64
9899393,8119099,2605,911750,9030849,11.23
9899394,9988069,5324,1863400,11851469,18.66
9899395,9978222,2675,936250,10914472,9.38
9899396,9980705,6022,2107700,12088405,21.12
9899397,1320341,1027,359450,1679791,27.22
9899398,9991043,6166,2158100,12149143,21.60
9899399,9985370,6163,2157050,12142420,21.60
9899401,6483226,486,170100,6653326,2.62
9899403,9952474,4416,1545600,11498074,15.53
9899405,9907538,5463,1912050,11819588,19.30
9899406,9966258,3684,1289400,11255658,12.94
9899407,9968564,6160,2156000,12124564,21.63
9899408,9976963,5767,2018450,11995413,20.23
9899409,1614835,1037,362950,1977785,22.48
9899410,9948268,5861,2051350,11999618,20.62
9899411,7075100,3958,1385300,8460400,19.58
9899412,9942069,3790,1326500,11268569,13.34
9899413,9949382,7169,2509150,12458532,25.22
9899414,9955173,5079,1777650,11732823,17.86
9899415,9959061,4336,1517600,11476661,15.24
9899416,9948837,4208,1472800,11421637,14.80
9899417,9957263,3332,1166200,11123463,11.71
9899418,9970155,7552,2643200,12613355,26.51
9899419,9981437,4488,1570800,11552237,15.74
9899420,9984736,6130,2145500,12130236,21.49
9899421,9964814,4305,1506750,11471564,15.12
9899422,1351609,427,149450,1501059,11.06
9899424,9998246,5955,2084250,12082496,20.85
9899425,9984935,3701,1295350,11280285,12.97
9899426,9545871,3253,1138550,10684421,11.93
9899427,9973479,6336,2217600,12191079,22.23
9899428,9752680,3037,1062950,10815630,10.90
9899429,9985981,4473,1565550,11551531,15.68
9899430,3042028,386,135100,3177128,4.44
9899431,9988228,3721,1302350,11290578,13.04
9899432,310620,116,40600,351220,13.07
9899433,9969891,4382,1533700,11503591,15.38
9899434,2774260,1030,360500,3134760,12.99
9899435,6426207,1953,683550,7109757,10.64
9899436,9975895,3813,1334550,11310445,13.38
9899437,9979365,5933,2076550,12055915,20.81
9899438,9978070,5203,1821050,11799120,18.25
9899439,9983347,4265,1492750,11476097,14.95
9899440,9993225,4288,1500800,11494025,15.02
9899441,9983543,5393,1887550,11871093,18.91
9899443,9986662,4509,1578150,11564812,15.80
9899444,9985092,5460,1911000,11896092,19.14
9899445,9979366,5014,1754900,11734266,17.59
9899446,9984320,5162,1806700,11791020,18.10
9899447,9976950,4832,1691200,11668150,16.95
9899448,9998929,7176,2511600,12510529,25.12
9899449,9993653,5527,1934450,11928103,19.36
9899450,704404,781,273350,977754,38.81
9899451,9985894,4589,1606150,11592044,16.08
9899452,9863916,4157,1454950,11318866,14.75
9899453,9554348,5193,1817550,11371898,19.02
9899454,9986725,4915,1720250,11706975,17.23
9899455,9981528,2854,998900,10980428,10.01
9899456,9996976,4290,1501500,11498476,15.02
9899457,9974399,4972,1740200,11714599,17.45
9899458,9708883,4442,1554700,11263583,16.01
9899459,9953818,3301,1155350,11109168,11.61
9899460,9952564,4623,1618050,11570614,16.26
9899461,9947507,4222,1477700,11425207,14.85
9899462,9961519,6663,2332050,12293569,23.41
9899463,9948226,4646,1626100,11574326,16.35
9899464,9968557,5712,1999200,11967757,20.06
9899465,9956124,5692,1992200,11948324,20.01
9899466,392152,382,133700,525852,34.09
9899467,5955945,2611,913850,6869795,15.34
9899468,73696,112,39200,112896,53.19
9899469,9937717,3897,1363950,11301667,13.72
9899470,9940210,6692,2342200,12282410,23.56
9899471,9908147,3140,1099000,11007147,11.09
9899472,9930781,4731,1655850,11586631,16.67
9899473,9935664,5753,2013550,11949214,20.27
9899474,9937804,4005,1401750,11339554,14.11
9899475,9926537,6318,2211300,12137837,22.28
9899476,9945182,2863,1002050,10947232,10.08
9899477,9949091,5057,1769950,11719041,17.79
9899478,9957053,3775,1321250,11278303,13.27
9899479,9953525,4076,1426600,11380125,14.33
9899480,9951464,4639,1623650,11575114,16.32
9899482,9962654,2295,803250,10765904,8.06
9899483,9952588,1831,640850,10593438,6.44
9899484,9973598,3016,1055600,11029198,10.58
9899485,9984568,3226,1129100,11113668,11.31
9899486,9981316,3350,1172500,11153816,11.75
9899488,5041275,3069,1074150,6115425,21.31
9899489,9979739,1295,453250,10432989,4.54
9899490,9983767,1236,432600,10416367,4.33
9899491,9977002,4763,1667050,11644052,16.71
9899492,9098003,833,291550,9389553,3.20
9899493,9993538,5040,1764000,11757538,17.65
9899494,9972328,5018,1756300,11728628,17.61
9899495,4646558,1767,618450,5265008,13.31
9899496,9997949,3796,1328600,11326549,13.29
9899497,9979818,6014,2104900,12084718,21.09
9899498,9993368,899,314650,10308018,3.15
9899500,9973176,6218,2176300,12149476,21.82
9899501,9955047,4630,1620500,11575547,16.28
9899502,9950679,3742,1309700,11260379,13.16
9899503,9950696,5726,2004100,11954796,20.14
9899504,9954435,4503,1576050,11530485,15.83
9899505,9960415,5508,1927800,11888215,19.35
9899506,9963604,3817,1335950,11299554,13.41
9899507,9964335,4790,1676500,11640835,16.83
9899508,9977098,1953,683550,10660648,6.85
9899509,2393643,843,295050,2688693,12.33
9899510,9987092,3514,1229900,11216992,12.31
9899511,3272361,2249,787150,4059511,24.05
9899512,9974550,5728,2004800,11979350,20.10
9899513,8301893,3745,1310750,9612643,15.79
9899514,9992477,3805,1331750,11324227,13.33
9899515,9979764,5266,1843100,11822864,18.47
9899516,9980680,3398,1189300,11169980,11.92
9899517,9989161,4646,1626100,11615261,16.28
9899518,9982432,5144,1800400,11782832,18.04
9899519,9982736,3360,1176000,11158736,11.78
9899520,9984797,4775,1671250,11656047,16.74
9899521,9973971,3157,1104950,11078921,11.08
9899522,9980532,4375,1531250,11511782,15.34
9899523,9988262,6583,2304050,12292312,23.07
9899524,9779018,3417,1195950,10974968,12.23
9899525,9981467,3759,1315650,11297117,13.18
9899526,9989004,5330,1865500,11854504,18.68
9899527,9950395,5030,1760500,11710895,17.69
9899528,9955567,2227,779450,10735017,7.83
9899529,9990153,4732,1656200,11646353,16.58
9899531,9979855,3475,1216250,11196105,12.19
9899532,9961828,3816,1335600,11297428,13.41
9899533,9979564,4205,1471750,11451314,14.75
9899534,9965179,5085,1779750,11744929,17.86
9899535,8850323,3533,1236550,10086873,13.97
9899536,9979303,3428,1199800,11179103,12.02
9899537,9985355,5257,1839950,11825305,18.43
9899538,9990585,2011,703850,10694435,7.05
9899539,1082128,370,129500,1211628,11.97
9899540,9961428,4864,1702400,11663828,17.09
9899541,9986243,4785,1674750,11660993,16.77
9899542,9993549,6646,2326100,12319649,23.28
9899543,5541749,2596,908600,6450349,16.40
9899544,9994071,3245,1135750,11129821,11.36
9899545,9979966,4970,1739500,11719466,17.43
9899546,9978889,4716,1650600,11629489,16.54
9899547,9982807,2331,815850,10798657,8.17
9899548,9985757,6077,2126950,12112707,21.30
9899549,9980798,4046,1416100,11396898,14.19
9899550,9983065,3800,1330000,11313065,13.32
9899551,7730838,2858,1000300,8731138,12.94
9899552,9967911,3328,1164800,11132711,11.69
9899553,9961407,3663,1282050,11243457,12.87
9899554,9971948,5275,1846250,11818198,18.51
9899555,1913383,2664,932400,2845783,48.73
9899556,976867,1020,357000,1333867,36.55
9899557,9945470,4153,1453550,11399020,14.62
9899558,9953279,4061,1421350,11374629,14.28
9899559,9941446,4395,1538250,11479696,15.47
9899560,9655212,3833,1341550,10996762,13.89
9899561,7594402,3191,1116850,8711252,14.71
9899562,9966565,3250,1137500,11104065,11.41
9899563,9969814,3385,1184750,11154564,11.88
9899564,9755177,4917,1720950,11476127,17.64
9899565,4136530,2078,727300,4863830,17.58
9899566,9966298,5426,1899100,11865398,19.06
9899567,9961204,5558,1945300,11906504,19.53
9899568,9978763,7955,2784250,12763013,27.90
9899569,9980616,1950,682500,10663116,6.84
9899570,9982542,5340,1869000,11851542,18.72
9899571,9977317,3390,1186500,11163817,11.89
9899572,9984202,3212,1124200,11108402,11.26
9899573,9981699,5440,1904000,11885699,19.07
9899574,9974881,4685,1639750,11614631,16.44
9899575,9984397,4876,1706600,11690997,17.09
9899576,9991470,4487,1570450,11561920,15.72
9899577,9978763,4796,1678600,11657363,16.82
9899578,563153,475,166250,729403,29.52
9899579,504713,723,253050,757763,50.14
9899580,9989466,6756,2364600,12354066,23.67
9899581,9984869,5414,1894900,11879769,18.98
9899582,9982772,7114,2489900,12472672,24.94
9899583,9981195,4131,1445850,11427045,14.49
9899584,3106040,1907,667450,3773490,21.49
9899585,9981576,2747,961450,10943026,9.63
9899586,9985686,5803,2031050,12016736,20.34
9899587,9966034,280,98000,10064034,0.98
9899588,9966830,5061,1771350,11738180,17.77
9899589,9960904,2326,814100,10775004,8.17
9899590,9968621,4045,1415750,11384371,14.20
9899591,9972945,4187,1465450,11438395,14.69
9899592,9988898,3550,1242500,11231398,12.44
9899593,5636065,1931,675850,6311915,11.99
9899594,9971633,5826,2039100,12010733,20.45
9899595,9899484,4619,1616650,11516134,16.33
9899596,9985538,3194,1117900,11103438,11.20
9899597,9980682,4737,1657950,11638632,16.61
9899598,9980288,4257,1489950,11470238,14.93
9899599,9992377,3902,1365700,11358077,13.67
9899601,9962562,4365,1527750,11490312,15.33
9899602,9984506,5568,1948800,11933306,19.52
9899603,9982554,6294,2202900,12185454,22.07
9899604,9993045,2828,989800,10982845,9.90
9899605,9895293,5346,1871100,11766393,18.91
9899606,9976407,3574,1250900,11227307,12.54
9899607,9993983,2744,960400,10954383,9.61
9899608,9992741,4761,1666350,11659091,16.68
9899609,9969467,5025,1758750,11728217,17.64
9899610,9979336,4574,1600900,11580236,16.04
9899611,9996003,5143,1800050,11796053,18.01
9899612,9996504,2308,807800,10804304,8.08
9899613,9986901,6109,2138150,12125051,21.41
9899614,5041100,1300,455000,5496100,9.03
9899615,8066548,2443,855050,8921598,10.60
9899616,346556,197,68950,415506,19.90
9899617,9834634,4204,1471400,11306034,14.96
9899618,8766825,4325,1513750,10280575,17.27
9899619,9963267,3475,1216250,11179517,12.21
9899620,9973735,2474,865900,10839635,8.68
9899621,9982335,3350,1172500,11154835,11.75
9899622,9983272,5046,1766100,11749372,17.69
9899623,907531,257,89950,997481,9.91
9899624,9969776,2959,1035650,11005426,10.39
9899625,4803627,1319,461650,5265277,9.61
9899626,9990111,3550,1242500,11232611,12.44
9899627,9993885,4495,1573250,11567135,15.74
9899628,9999944,3197,1118950,11118894,11.19
9899629,9985694,2887,1010450,10996144,10.12
9899630,9972575,3840,1344000,11316575,13.48
9899631,9980798,2329,815150,10795948,8.17
9899632,9996074,4768,1668800,11664874,16.69
9899633,9974973,3230,1130500,11105473,11.33
9899634,5535284,933,326550,5861834,5.90
9899635,9982491,3524,1233400,11215891,12.36
9899636,9980327,3794,1327900,11308227,13.31
9899637,5112635,1565,547750,5660385,10.71
9899638,9999049,4050,1417500,11416549,14.18
9899639,9984246,3517,1230950,11215196,12.33
9899640,9998961,2808,982800,10981761,9.83
9899641,9984521,3086,1080100,11064621,10.82
9899642,9968790,2882,1008700,10977490,10.12
9899643,6460875,2415,845250,7306125,13.08
9899644,1399478,712,249200,1648678,17.81
9899645,9971983,6288,2200800,12172783,22.07
9899646,6660171,2654,928900,7589071,13.95
9899647,9982340,3639,1273650,11255990,12.76
9899648,9969580,5559,1945650,11915230,19.52
9899649,5435291,956,334600,5769891,6.16
9899650,9936702,5402,1890700,11827402,19.03
9899651,9950105,3976,1391600,11341705,13.99
9899652,2333320,917,320950,2654270,13.76
9899653,9555946,2923,1023050,10578996,10.71
9899654,9979838,5058,1770300,11750138,17.74
9899655,9965986,5137,1797950,11763936,18.04
9899656,9972027,3332,1166200,11138227,11.69
9899657,9972259,4023,1408050,11380309,14.12
9899658,9963435,5268,1843800,11807235,18.51
9899659,9984536,2098,734300,10718836,7.35
9899660,9961978,2916,1020600,10982578,10.24
9899661,6518636,2707,947450,7466086,14.53
9899662,9976978,3435,1202250,11179228,12.05
9899663,9975380,2403,841050,10816430,8.43
9899664,9985839,5830,2040500,12026339,20.43
9899665,9996345,3897,1363950,11360295,13.64
9899666,9986176,4039,1413650,11399826,14.16
9899667,9989624,4132,1446200,11435824,14.48
9899668,9984883,4509,1578150,11563033,15.81
9899669,9998740,2469,864150,10862890,8.64
9899670,9979207,1428,499800,10479007,5.01
9899671,9959633,3332,1166200,11125833,11.71
9899672,9978673,1658,580300,10558973,5.82
9899673,9978499,4716,1650600,11629099,16.54
9899674,9975349,4690,1641500,11616849,16.46
9899675,9999423,2988,1045800,11045223,10.46
9899676,9984832,3360,1176000,11160832,11.78
9899677,9970778,2121,742350,10713128,7.45
9899678,9975172,4253,1488550,11463722,14.92
9899679,9989394,3092,1082200,11071594,10.83
9899681,9973358,3918,1371300,11344658,13.75
9899682,9986668,5695,1993250,11979918,19.96
9899683,9999467,3865,1352750,11352217,13.53
9899684,9977341,4389,1536150,11513491,15.40
9899685,9989831,2964,1037400,11027231,10.38
9899686,9969200,3321,1162350,11131550,11.66
9899687,9724560,2947,1031450,10756010,10.61
9899689,9985543,3952,1383200,11368743,13.85
9899690,9975427,2483,869050,10844477,8.71
9899691,9984923,4604,1611400,11596323,16.14
9899692,9999989,3184,1114400,11114389,11.14
9899693,9989479,3581,1253350,11242829,12.55
9899694,9987651,5216,1825600,11813251,18.28
9899695,6306056,2173,760550,7066606,12.06
9899696,9995585,1799,629650,10625235,6.30
9899697,9987509,715,250250,10237759,2.51
9899698,9979970,5618,1966300,11946270,19.70
9899699,9984003,3532,1236200,11220203,12.38
9899700,9994717,6490,2271500,12266217,22.73
9899701,9992974,5402,1890700,11883674,18.92
9899702,9986623,4316,1510600,11497223,15.13
9899703,9992182,5069,1774150,11766332,17.76
9899704,9969561,3015,1055250,11024811,10.58
9899705,1181498,632,221200,1402698,18.72
9899706,9955840,3051,1067850,11023690,10.73
9899707,9960154,3806,1332100,11292254,13.37
9899708,9959912,5295,1853250,11813162,18.61
9899709,9979115,2546,891100,10870215,8.93
9899710,9988365,6354,2223900,12212265,22.26
9899711,9983112,4269,1494150,11477262,14.97
9899712,9989342,3199,1119650,11108992,11.21
9899713,9982447,4111,1438850,11421297,14.41
9899714,9981859,3230,1130500,11112359,11.33
9899715,9975202,2659,930650,10905852,9.33
9899716,9996247,5742,2009700,12005947,20.10
9899717,9970233,3144,1100400,11070633,11.04
9899718,9963285,4342,1519700,11482985,15.25
9899719,9967527,4083,1429050,11396577,14.34
9899720,9982519,3301,1155350,11137869,11.57
9899721,9964225,4073,1425550,11389775,14.31
9899722,9985212,3135,1097250,11082462,10.99
9899723,9992077,5574,1950900,11942977,19.52
9899725,9974831,3867,1353450,11328281,13.57
9899726,9985283,3686,1290100,11275383,12.92
9899727,9978991,5096,1783600,11762591,17.87
9899728,9494431,2955,1034250,10528681,10.89
9899729,9979200,3943,1380050,11359250,13.83
9899730,4979375,557,194950,5174325,3.92
9899731,9969060,3591,1256850,11225910,12.61
9899732,9373334,3428,1199800,10573134,12.80
9899733,9976411,5296,1853600,11830011,18.58
9899734,4590231,2014,704900,5295131,15.36
9899735,9976178,4477,1566950,11543128,15.71
9899736,9980553,4352,1523200,11503753,15.26
9899737,381640,192,67200,448840,17.61
9899738,9992693,4006,1402100,11394793,14.03
9899739,9984100,5503,1926050,11910150,19.29
9899740,9986097,2269,794150,10780247,7.95
9899741,5967684,3730,1305500,7273184,21.88
9899742,9979553,4815,1685250,11664803,16.89
9899743,9965970,3044,1065400,11031370,10.69
9899744,9963728,3968,1388800,11352528,13.94
9899745,9979929,4994,1747900,11727829,17.51
9899746,9979930,4656,1629600,11609530,16.33
9899747,9987356,5038,1763300,11750656,17.66
9899748,9994967,6413,2244550,12239517,22.46
9899749,9975499,6390,2236500,12211999,22.42
9899750,9983160,2967,1038450,11021610,10.40
9899751,9996923,4224,1478400,11475323,14.79
9899752,9986810,5056,1769600,11756410,17.72
9899753,9994357,3339,1168650,11163007,11.69
9899754,9978619,3508,1227800,11206419,12.30
9899755,9975918,2577,901950,10877868,9.04
9899756,9995922,4297,1503950,11499872,15.05
9899757,9999275,4740,1659000,11658275,16.59
9899758,9975439,3689,1291150,11266589,12.94
9899759,9991819,2386,835100,10826919,8.36
9899761,9973267,5109,1788150,11761417,17.93
9899762,9928431,3353,1173550,11101981,11.82
9899763,9980892,7400,2590000,12570892,25.95
9899765,9976180,2453,858550,10834730,8.61
9899766,9980763,4615,1615250,11596013,16.18
9899767,9979629,4216,1475600,11455229,14.79
9899768,9994129,4985,1744750,11738879,17.46
9899769,9983551,3524,1233400,11216951,12.35
9899770,9971829,4206,1472100,11443929,14.76
9899771,9990862,2989,1046150,11037012,10.47
9899772,566927,247,86450,653377,15.25
9899773,9975170,3397,1188950,11164120,11.92
9899774,9993327,3705,1296750,11290077,12.98
9899775,9979828,3890,1361500,11341328,13.64
9899776,9981674,2918,1021300,11002974,10.23
9899777,9986293,4888,1710800,11697093,17.13
9899778,9984909,4791,1676850,11661759,16.79
9899779,6074950,3109,1088150,7163100,17.91
9899780,7825806,5186,1815100,9640906,23.19
9899781,9996819,4027,1409450,11406269,14.10
9899782,9510675,3150,1102500,10613175,11.59
9899783,9974720,2867,1003450,10978170,10.06
9899785,9982534,5713,1999550,11982084,20.03
9899786,9990246,4380,1533000,11523246,15.34
9899787,9987193,3300,1155000,11142193,11.56
9899788,9746342,4823,1688050,11434392,17.32
9899789,9816064,4909,1718150,11534214,17.50
9899790,9991505,4105,1436750,11428255,14.38
9899791,9988009,4912,1719200,11707209,17.21
9899792,9970620,3186,1115100,11085720,11.18
9899793,9985953,3949,1382150,11368103,13.84
9899794,9970973,3564,1247400,11218373,12.51
9899795,1396755,435,152250,1549005,10.90
9899796,9962407,2526,884100,10846507,8.87
9899797,9979405,3495,1223250,11202655,12.26
9899798,5572342,844,295400,5867742,5.30
9899799,9960238,2243,785050,10745288,7.88
9899800,9961653,3980,1393000,11354653,13.98
9899801,9958508,2749,962150,10920658,9.66
9899802,9970099,6047,2116450,12086549,21.23
9899803,9951794,5113,1789550,11741344,17.98
9899805,9967269,6379,2232650,12199919,22.40
9899806,9983578,5905,2066750,12050328,20.70
9899807,9989750,3945,1380750,11370500,13.82
9899808,9997497,4259,1490650,11488147,14.91
9899809,9985258,2134,746900,10732158,7.48
9899810,9988026,1866,653100,10641126,6.54
9899811,9982506,1168,408800,10391306,4.10
9899812,9984645,2028,709800,10694445,7.11
9899813,9989965,4361,1526350,11516315,15.28
9899814,9979983,4099,1434650,11414633,14.38
9899815,9954166,2271,794850,10749016,7.99
9899816,9946090,4079,1427650,11373740,14.35
9899817,9969760,2919,1021650,10991410,10.25
9899818,1178462,253,88550,1267012,7.51
9899819,2857928,415,145250,3003178,5.08
9899820,9955631,1343,470050,10425681,4.72
9899821,9953496,4316,1510600,11464096,15.18
9899822,9944573,4310,1508500,11453073,15.17
9899824,9940678,4062,1421700,11362378,14.30
9899825,9947595,4023,1408050,11355645,14.15
9899826,9952288,2175,761250,10713538,7.65
9899827,2213901,971,339850,2553751,15.35
9899828,9941560,4943,1730050,11671610,17.40
9899829,9947285,3216,1125600,11072885,11.32
9899830,9948219,3176,1111600,11059819,11.17
9899831,9952949,3931,1375850,11328799,13.82
9899832,9961335,1623,568050,10529385,5.70
9899833,5317686,2286,800100,6117786,15.05
9899834,4888543,2047,716450,5604993,14.66
9899835,9992695,4244,1485400,11478095,14.86
9899836,9983036,4083,1429050,11412086,14.31
9899837,9982601,3895,1363250,11345851,13.66
9899838,9998018,2252,788200,10786218,7.88
9899839,9994967,3143,1100050,11095017,11.01
9899840,9979876,3570,1249500,11229376,12.52
9899841,9982131,4195,1468250,11450381,14.71
9899842,2828289,881,308350,3136639,10.90
9899843,9974221,4314,1509900,11484121,15.14
9899844,9957431,4655,1629250,11586681,16.36
9899845,9957976,2802,980700,10938676,9.85
9899846,9959984,1041,364350,10324334,3.66
9899847,9968289,3990,1396500,11364789,14.01
9899848,9950452,4039,1413650,11364102,14.21
9899849,9938554,2171,759850,10698404,7.65
9899850,9960675,3326,1164100,11124775,11.69
9899851,9961851,166,58100,10019951,0.58
9899852,9970530,3548,1241800,11212330,12.45
9899853,9914155,4374,1530900,11445055,15.44
9899854,9945725,2460,861000,10806725,8.66
9899855,9959577,4213,1474550,11434127,14.81
9899856,9967417,4501,1575350,11542767,15.80
9899857,9435584,1689,591150,10026734,6.27
9899858,9970921,4087,1430450,11401371,14.35
9899859,9979551,1771,619850,10599401,6.21
9899860,9183561,3398,1189300,10372861,12.95
9899861,9971836,3415,1195250,11167086,11.99
9899862,9978521,4011,1403850,11382371,14.07
9899863,9966047,3635,1272250,11238297,12.77
9899864,9985561,3930,1375500,11361061,13.77
9899865,9838525,3408,1192800,11031325,12.12
9899866,9983156,5629,1970150,11953306,19.73
9899867,9980239,3395,1188250,11168489,11.91
9899868,9988970,3586,1255100,11244070,12.56
9899869,9992657,3394,1187900,11180557,11.89
9899870,9971514,6584,2304400,12275914,23.11
9899871,3114230,1715,600250,3714480,19.27
9899872,9983912,4883,1709050,11692962,17.12
9899873,9965533,1498,524300,10489833,5.26
9899874,9973937,3217,1125950,11099887,11.29
9899875,9994067,3834,1341900,11335967,13.43
9899876,9967366,3405,1191750,11159116,11.96
9899877,9962726,2466,863100,10825826,8.66
9899878,9968772,2836,992600,10961372,9.96
9899879,9975862,4975,1741250,11717112,17.45
9899880,9998113,5753,2013550,12011663,20.14
9899881,9749879,1465,512750,10262629,5.26
9899882,9983724,3984,1394400,11378124,13.97
9899883,9997124,3763,1317050,11314174,13.17
9899884,2078897,2663,932050,3010947,44.83
9899885,9977958,4311,1508850,11486808,15.12
9899886,9968273,3471,1214850,11183123,12.19
9899887,989766,721,252350,1242116,25.50
9899888,9970604,3756,1314600,11285204,13.18
9899889,9968114,4005,1401750,11369864,14.06
9899890,8444929,3847,1346450,9791379,15.94
9899892,9972622,3994,1397900,11370522,14.02
9899893,9968165,5053,1768550,11736715,17.74
9899894,9957640,3856,1349600,11307240,13.55
9899895,9972312,4934,1726900,11699212,17.32
9899896,9972612,2368,828800,10801412,8.31
9899897,9962620,5889,2061150,12023770,20.69
9899898,9971644,2892,1012200,10983844,10.15
9899899,9961303,2351,822850,10784153,8.26
9899900,9961549,4398,1539300,11500849,15.45
9899901,9905784,3021,1057350,10963134,10.67
9899902,9991327,5064,1772400,11763727,17.74
9899903,9981937,3338,1168300,11150237,11.70
9899904,9980748,4937,1727950,11708698,17.31
9899905,9984865,3328,1164800,11149665,11.67
9899906,9997705,4222,1477700,11475405,14.78
9899907,9979186,2409,843150,10822336,8.45
9899908,9997614,6096,2133600,12131214,21.34
9899909,9997412,4164,1457400,11454812,14.58
9899912,9964572,3437,1202950,11167522,12.07
9899914,8719555,2654,928900,9648455,10.65
9899915,9976148,3164,1107400,11083548,11.10
9899916,9953053,3471,1214850,11167903,12.21
9899917,9965068,3947,1381450,11346518,13.86
9899918,9977943,4328,1514800,11492743,15.18
9899919,9983131,2966,1038100,11021231,10.40
9899920,9972234,4263,1492050,11464284,14.96
9899921,7483536,3671,1284850,8768386,17.17
9899922,9969913,4551,1592850,11562763,15.98
9899923,9983868,2919,1021650,11005518,10.23
9899924,9998379,2456,859600,10857979,8.60
9899925,9988056,1731,605850,10593906,6.07
9899926,9998292,4460,1561000,11559292,15.61
9899927,9994717,1070,374500,10369217,3.75
9899928,9978880,4193,1467550,11446430,14.71
9899929,9996051,5152,1803200,11799251,18.04
9899930,9985136,3648,1276800,11261936,12.79
9899931,9983693,3983,1394050,11377743,13.96
9899932,9998710,3322,1162700,11161410,11.63
9899933,9969688,6485,2269750,12239438,22.77
9899934,9992451,3226,1129100,11121551,11.30
9899935,9999858,4875,1706250,11706108,17.06
9899937,9992424,6412,2244200,12236624,22.46
9899938,6537083,5514,1929900,8466983,29.52
9899939,9971026,2320,812000,10783026,8.14
9899940,9975226,4142,1449700,11424926,14.53
9899941,9973275,5369,1879150,11852425,18.84
9899942,6544010,4544,1590400,8134410,24.30
9899943,9982889,4937,1727950,11710839,17.31
9899944,9987984,5418,1896300,11884284,18.99
9899945,9982742,5009,1753150,11735892,17.56
9899946,9979027,4084,1429400,11408427,14.32
9899947,9972785,1940,679000,10651785,6.81
9899948,9967998,5015,1755250,11723248,17.61
9899949,9973405,4168,1458800,11432205,14.63
9899950,537921,538,188300,726221,35.01
9899951,9972588,5038,1763300,11735888,17.68
9899952,9979569,4220,1477000,11456569,14.80
9899953,9990130,5458,1910300,11900430,19.12
9899954,9084905,6302,2205700,11290605,24.28
9899955,9987974,1990,696500,10684474,6.97
9899957,9954172,1263,442050,10396222,4.44
9899958,9973607,1053,368550,10342157,3.70
9899959,9976739,2567,898450,10875189,9.01
9899960,9984341,5544,1940400,11924741,19.43
9899961,9971647,4822,1687700,11659347,16.92
9899962,4720708,1756,614600,5335308,13.02
9899963,3131424,699,244650,3376074,7.81
9899964,9983031,4580,1603000,11586031,16.06
9899965,9984374,6756,2364600,12348974,23.68
9899966,9069110,4887,1710450,10779560,18.86
9899967,9974424,4347,1521450,11495874,15.25
9899968,9962996,3485,1219750,11182746,12.24
9899969,9966045,5694,1992900,11958945,20.00
9899970,3203003,1489,521150,3724153,16.27
9899971,9970721,4947,1731450,11702171,17.37
9899972,9965324,6032,2111200,12076524,21.19
9899973,9965642,5124,1793400,11759042,18.00
9899974,9951878,5907,2067450,12019328,20.77
9899975,9966194,4073,1425550,11391744,14.30
9899976,9950422,2394,837900,10788322,8.42
9899977,9963192,4412,1544200,11507392,15.50
9899978,9978359,3727,1304450,11282809,13.07
9899979,2945537,2344,820400,3765937,27.85
9899980,9953243,3035,1062250,11015493,10.67
9899981,9958494,3928,1374800,11333294,13.81
9899982,9955559,5085,1779750,11735309,17.88
9899983,9968134,4716,1650600,11618734,16.56
9899984,9978320,5555,1944250,11922570,19.48
9899985,9971786,2112,739200,10710986,7.41
9899986,9964934,6175,2161250,12126184,21.69
9899987,9971422,7827,2739450,12710872,27.47
9899988,1092042,1297,453950,1545992,41.57
9899989,3995848,2319,811650,4807498,20.31
9899990,9985832,2954,1033900,11019732,10.35
9899991,9974524,3868,1353800,11328324,13.57
9899992,9979588,4426,1549100,11528688,15.52
9899993,9998532,4138,1448300,11446832,14.49
9899994,9970554,4111,1438850,11409404,14.43
9899995,3217332,1396,488600,3705932,15.19
9899996,9955184,4433,1551550,11506734,15.59
9899997,9972982,4434,1551900,11524882,15.56
9899998,9964493,5837,2042950,12007443,20.50
9899999,9941095,2854,998900,10939995,10.05
9900000,9996466,2356,824600,10821066,8.25
9900001,9971561,4539,1588650,11560211,15.93
9900002,9964506,3611,1263850,11228356,12.68
9900003,9973222,4521,1582350,11555572,15.87
9900004,9943601,4363,1527050,11470651,15.36
9900005,9951256,4326,1514100,11465356,15.22
9900006,9973514,4051,1417850,11391364,14.22
9900007,9955250,3750,1312500,11267750,13.18
9900008,9967004,3758,1315300,11282304,13.20
9900009,9954583,5102,1785700,11740283,17.94
9900011,9967516,3499,1224650,11192166,12.29
9900013,9977927,3525,1233750,11211677,12.36
9900014,9984261,4754,1663900,11648161,16.67
9900015,9981367,3477,1216950,11198317,12.19
9900016,9994946,3181,1113350,11108296,11.14
9900018,9968861,3684,1289400,11258261,12.93
9900019,9979473,4878,1707300,11686773,17.11
9900020,9988506,2789,976150,10964656,9.77
9900021,9970842,2967,1038450,11009292,10.41
9900022,9973754,3250,1137500,11111254,11.40
9900023,9974017,6107,2137450,12111467,21.43
9900024,9973610,2928,1024800,10998410,10.28
9900025,9988662,3584,1254400,11243062,12.56
9900026,9992278,3199,1119650,11111928,11.21
9900027,9984006,2631,920850,10904856,9.22
9900028,9980398,4806,1682100,11662498,16.85
9900029,9988840,4273,1495550,11484390,14.97
9900030,9998792,4531,1585850,11584642,15.86
9900031,9975323,3787,1325450,11300773,13.29
9900033,9969876,1254,438900,10408776,4.40
9900034,9988597,3120,1092000,11080597,10.93
9900035,9978407,1754,613900,10592307,6.15
9900036,9988241,3166,1108100,11096341,11.09
9900037,9997404,3586,1255100,11252504,12.55
9900038,9987883,3376,1181600,11169483,11.83
9900039,9981920,2600,910000,10891920,9.12
9900040,9976179,2656,929600,10905779,9.32
9900041,9976367,3976,1391600,11367967,13.95
9900042,9962888,2994,1047900,11010788,10.52
9900043,9967025,3303,1156050,11123075,11.60
9900045,9941033,3771,1319850,11260883,13.28
9900046,9927074,4027,1409450,11336524,14.20
9900047,9942808,4641,1624350,11567158,16.34
9900048,9945290,5998,2099300,12044590,21.11
9900050,9935664,6066,2123100,12058764,21.37
9900051,9946896,4304,1506400,11453296,15.14
9900052,9967103,3171,1109850,11076953,11.14
9900053,9954259,5056,1769600,11723859,17.78
9900054,9956287,3692,1292200,11248487,12.98
9900055,9958466,4121,1442350,11400816,14.48
9900056,9977185,2876,1006600,10983785,10.09
9900057,9972667,3863,1352050,11324717,13.56
9900058,9974734,3875,1356250,11330984,13.60
9900059,9874712,2976,1041600,10916312,10.55
9900060,9974345,6008,2102800,12077145,21.08
9900061,9981560,4620,1617000,11598560,16.20
9900062,9974998,5284,1849400,11824398,18.54
9900063,9970221,4107,1437450,11407671,14.42
9900064,9979766,3916,1370600,11350366,13.73
9900065,9973440,3663,1282050,11255490,12.85
9900066,9973193,2967,1038450,11011643,10.41
9900067,9972341,5471,1914850,11887191,19.20
9900068,9971102,2846,996100,10967202,9.99
9900069,9994935,734,256900,10251835,2.57
9900070,9548801,2812,984200,10533001,10.31
9900071,9982117,4157,1454950,11437067,14.58
9900072,9994489,3842,1344700,11339189,13.45
9900073,9989404,2711,948850,10938254,9.50
9900074,2495048,876,306600,2801648,12.29
9900075,9983370,3098,1084300,11067670,10.86
9900076,9987104,3621,1267350,11254454,12.69
9900077,9984341,4041,1414350,11398691,14.17
9900078,9981111,1823,638050,10619161,6.39
9900079,9971276,1968,688800,10660076,6.91
9900080,9977025,4384,1534400,11511425,15.38
9900081,9981132,2306,807100,10788232,8.09
9900082,9980332,4429,1550150,11530482,15.53
9900083,9945081,1163,407050,10352131,4.09
9900084,9988704,5133,1796550,11785254,17.99
9900085,9993344,2731,955850,10949194,9.56
9900086,9979004,2562,896700,10875704,8.99
9900087,9975429,4702,1645700,11621129,16.50
9900088,9512502,855,299250,9811752,3.15
9900089,9997305,4016,1405600,11402905,14.06
9900090,9985968,2293,802550,10788518,8.04
9900091,9990831,4755,1664250,11655081,16.66
9900092,9999524,2976,1041600,11041124,10.42
9900093,9979581,4137,1447950,11427531,14.51
9900094,9847185,3018,1056300,10903485,10.73
9900095,9982479,6438,2253300,12235779,22.57
9900096,9991074,5784,2024400,12015474,20.26
9900097,9972584,5637,1972950,11945534,19.78
9900098,9982143,4633,1621550,11603693,16.24
9900099,9992069,5552,1943200,11935269,19.45
9900100,9994076,2784,974400,10968476,9.75
9900101,9982072,4586,1605100,11587172,16.08
9900102,9995114,5472,1915200,11910314,19.16
9900103,9979366,6201,2170350,12149716,21.75
9900104,9980787,2523,883050,10863837,8.85
9900105,9975154,3415,1195250,11170404,11.98
9900106,9989091,5010,1753500,11742591,17.55
9900107,9984026,2646,926100,10910126,9.28
9900108,9986137,6065,2122750,12108887,21.26
9900109,8846084,6180,2163000,11009084,24.45
9900110,9975433,4211,1473850,11449283,14.77
9900111,9962236,3393,1187550,11149786,11.92
9900112,9451883,7751,2712850,12164733,28.70
9900113,9947453,5246,1836100,11783553,18.46
9900114,9960839,7078,2477300,12438139,24.87
9900116,9956198,3651,1277850,11234048,12.83
9900117,6075709,3419,1196650,7272359,19.70
9900118,9950964,4701,1645350,11596314,16.53
9900119,9965315,4332,1516200,11481515,15.21
9900120,9964468,3542,1239700,11204168,12.44
9900121,9959987,3663,1282050,11242037,12.87
9900122,9966767,3735,1307250,11274017,13.12
9900124,9970287,3794,1327900,11298187,13.32
9900125,9972230,4745,1660750,11632980,16.65
9900126,9965485,5458,1910300,11875785,19.17
9900127,9966015,2957,1034950,11000965,10.38
9900128,9975416,5142,1799700,11775116,18.04
9900129,9985846,3818,1336300,11322146,13.38
9900130,9982309,3212,1124200,11106509,11.26
9900131,9988502,6911,2418850,12407352,24.22
9900132,9970688,3662,1281700,11252388,12.85
9900134,9978705,5419,1896650,11875355,19.01
9900135,9984565,5117,1790950,11775515,17.94
9900136,9977664,4134,1446900,11424564,14.50
9900137,9949715,3533,1236550,11186265,12.43
9900138,9957018,5829,2040150,11997168,20.49
9900139,9940734,4617,1615950,11556684,16.26
9900140,9936632,3028,1059800,10996432,10.67
9900142,9971076,4022,1407700,11378776,14.12
9900143,9229685,4119,1441650,10671335,15.62
9900144,9977214,4576,1601600,11578814,16.05
9900145,9974055,3259,1140650,11114705,11.44
9900146,9984848,3540,1239000,11223848,12.41
9900147,9982357,6616,2315600,12297957,23.20
9900148,9991344,3197,1118950,11110294,11.20
9900149,9972460,6349,2222150,12194610,22.28
9900150,9979893,4791,1676850,11656743,16.80
9900151,9985648,1853,648550,10634198,6.49
9900152,9983812,3373,1180550,11164362,11.82
9900153,9987184,4979,1742650,11729834,17.45
9900154,9983766,2481,868350,10852116,8.70
9900155,9989199,4398,1539300,11528499,15.41
9900156,9995742,3474,1215900,11211642,12.16
9900157,9996322,2731,955850,10952172,9.56
9900158,9906229,2908,1017800,10924029,10.27
9900159,9977566,2770,969500,10947066,9.72
9900160,9974080,4695,1643250,11617330,16.48
9900161,9978201,2914,1019900,10998101,10.22
9900162,9984684,4053,1418550,11403234,14.21
9900164,9991393,2111,738850,10730243,7.39
9900165,466000,200,70000,536000,15.02
9900166,569808,183,64050,633858,11.24
9900167,9973756,4485,1569750,11543506,15.74
9900168,9978398,3639,1273650,11252048,12.76
9900169,9973307,3768,1318800,11292107,13.22
9900170,5623838,2728,954800,6578638,16.98
9900171,9992808,4707,1647450,11640258,16.49
9900172,9980176,3833,1341550,11321726,13.44
9900173,9986684,4669,1634150,11620834,16.36
9900174,9987171,2640,924000,10911171,9.25
9900175,9981383,3945,1380750,11362133,13.83
9900176,9985787,4267,1493450,11479237,14.96
9900177,9991212,5139,1798650,11789862,18.00
9900178,9992756,3919,1371650,11364406,13.73
9900179,9982114,5970,2089500,12071614,20.93
9900180,9981475,5604,1961400,11942875,19.65
9900181,9975662,7682,2688700,12664362,26.95
9900182,9965802,1903,666050,10631852,6.68
9900183,9975377,4592,1607200,11582577,16.11
9900184,9976154,4278,1497300,11473454,15.01
9900185,9990641,7231,2530850,12521491,25.33
9900186,9977645,3911,1368850,11346495,13.72
9900187,9979008,3570,1249500,11228508,12.52
9900188,9975183,2951,1032850,11008033,10.35
9900189,9997156,3951,1382850,11380006,13.83
9900190,9995799,3930,1375500,11371299,13.76
9900191,9979538,4147,1451450,11430988,14.54
9900192,713866,509,178150,892016,24.96
9900193,9974098,3881,1358350,11332448,13.62
9900194,9986969,4203,1471050,11458019,14.73
9900195,9980573,5470,1914500,11895073,19.18
9900196,9974362,3467,1213450,11187812,12.17
9900197,9974079,3654,1278900,11252979,12.82
9900198,9986222,3672,1285200,11271422,12.87
9900199,9983584,2946,1031100,11014684,10.33
9900200,9992371,2340,819000,10811371,8.20
9900201,9983152,2930,1025500,11008652,10.27
9900202,9979066,4885,1709750,11688816,17.13
9900203,9960692,2966,1038100,10998792,10.42
9900204,9982889,4673,1635550,11618439,16.38
9900205,9989857,3709,1298150,11288007,12.99
9900206,9984468,5083,1779050,11763518,17.82
9900207,9275607,3342,1169700,10445307,12.61
9900208,9982634,5173,1810550,11793184,18.14
9900209,9956210,3416,1195600,11151810,12.01
9900210,9948079,4109,1438150,11386229,14.46
9900211,9950939,1134,396900,10347839,3.99
9900212,9972727,3626,1269100,11241827,12.73
9900213,9982490,1326,464100,10446590,4.65
9900215,9973320,1903,666050,10639370,6.68
9900216,9982679,1815,635250,10617929,6.36
9900217,9978062,4507,1577450,11555512,15.81
9900218,9930956,4157,1454950,11385906,14.65
9900219,9990055,4171,1459850,11449905,14.61
9900220,9969406,5396,1888600,11858006,18.94
9900221,9976893,2523,883050,10859943,8.85
9900222,9986415,1412,494200,10480615,4.95
9900223,9986027,1396,488600,10474627,4.89
9900224,9985607,4059,1420650,11406257,14.23
9900225,9976816,2871,1004850,10981666,10.07
9900226,9970921,4942,1729700,11700621,17.35
9900227,9974975,6020,2107000,12081975,21.12
9900228,9979698,5499,1924650,11904348,19.29
9900229,9988115,5202,1820700,11808815,18.23
9900230,9987338,3910,1368500,11355838,13.70
9900231,9991310,4527,1584450,11575760,15.86
9900233,9969982,5319,1861650,11831632,18.67
9900234,9989507,5116,1790600,11780107,17.92
9900235,9988174,2310,808500,10796674,8.09
9900237,9953875,3626,1269100,11222975,12.75
9900238,9962839,5808,2032800,11995639,20.40
9900239,9986256,1899,664650,10650906,6.66
9900240,9990209,3598,1259300,11249509,12.61
9900241,9975738,4016,1405600,11381338,14.09
9900242,9949597,3139,1098650,11048247,11.04
9900243,9974147,2951,1032850,11006997,10.36
9900244,9997102,2985,1044750,11041852,10.45
9900245,9974889,6317,2210950,12185839,22.17
9900246,9987064,5653,1978550,11965614,19.81
9900247,9994062,3725,1303750,11297812,13.05
9900248,9988338,3842,1344700,11333038,13.46
9900249,9983512,5327,1864450,11847962,18.68
9900250,9984865,3854,1348900,11333765,13.51
9900251,9995451,5385,1884750,11880201,18.86
9900252,9987014,2218,776300,10763314,7.77
9900253,9965411,4606,1612100,11577511,16.18
9900254,9984799,2412,844200,10828999,8.45
9900255,9974820,2603,911050,10885870,9.13
9900256,9983636,2964,1037400,11021036,10.39
9900257,2802976,499,174650,2977626,6.23
9900258,9950707,2738,958300,10909007,9.63
9900259,2451760,1062,371700,2823460,15.16
9900260,9994238,3548,1241800,11236038,12.43
9900261,9976370,3514,1229900,11206270,12.33
9900262,9986797,3830,1340500,11327297,13.42
9900263,9986288,3066,1073100,11059388,10.75
9900264,9994390,3474,1215900,11210290,12.17
9900265,9976161,2574,900900,10877061,9.03
9900266,9960988,4417,1545950,11506938,15.52
9900267,9970782,4598,1609300,11580082,16.14
9900268,9993580,3465,1212750,11206330,12.14
9900269,9980846,5214,1824900,11805746,18.28
9900270,9990397,4338,1518300,11508697,15.20
9900271,9977275,5019,1756650,11733925,17.61
9900273,9967073,3396,1188600,11155673,11.93
9900274,9959861,3864,1352400,11312261,13.58
9900275,9967230,4399,1539650,11506880,15.45
9900276,9976588,3800,1330000,11306588,13.33
9900277,9957104,6333,2216550,12173654,22.26
9900278,9979050,6287,2200450,12179500,22.05
9900279,9963820,3454,1208900,11172720,12.13
9900280,9965470,6705,2346750,12312220,23.55
9900281,9970983,2448,856800,10827783,8.59
9900282,9981843,4377,1531950,11513793,15.35
9900283,9961691,4099,1434650,11396341,14.40
9900284,9968796,4416,1545600,11514396,15.50
9900285,9975862,5044,1765400,11741262,17.70
9900286,9985760,3347,1171450,11157210,11.73
9900287,9976331,5523,1933050,11909381,19.38
9900288,9989199,4555,1594250,11583449,15.96
9900289,9993048,4807,1682450,11675498,16.84
9900290,9986181,103,36050,10022231,0.36
9900291,9555444,4771,1669850,11225294,17.48
9900292,9956109,3919,1371650,11327759,13.78
9900293,9962444,3626,1269100,11231544,12.74
9900294,9984436,3291,1151850,11136286,11.54
9900295,9974943,4476,1566600,11541543,15.71
9900296,9981627,42,14700,9996327,0.15
9900298,9979612,3733,1306550,11286162,13.09
9900299,9966356,2943,1030050,10996406,10.34
9900300,9972366,4517,1580950,11553316,15.85
9900301,9987891,4612,1614200,11602091,16.16
9900302,9972081,4503,1576050,11548131,15.80
9900303,9984236,3157,1104950,11089186,11.07
9900304,9978725,5867,2053450,12032175,20.58
9900305,9994141,6018,2106300,12100441,21.08
9900306,9995134,5838,2043300,12038434,20.44
9900307,9970138,4210,1473500,11443638,14.78
9900308,9990059,3809,1333150,11323209,13.34
9900309,9988382,3620,1267000,11255382,12.68
9900310,9999799,3868,1353800,11353599,13.54
9900311,9979599,2754,963900,10943499,9.66
9900313,9987959,5146,1801100,11789059,18.03
9900314,4673243,2068,723800,5397043,15.49
9900315,9983666,2633,921550,10905216,9.23
9900316,9990415,4623,1618050,11608465,16.20
9900317,9984729,1597,558950,10543679,5.60
9900318,7389198,1872,655200,8044398,8.87
9900319,9975448,6350,2222500,12197948,22.28
9900320,8805864,3906,1367100,10172964,15.52
9900321,9979718,4553,1593550,11573268,15.97
9900322,9968157,1285,449750,10417907,4.51
9900323,9968122,3371,1179850,11147972,11.84
9900324,9960473,4520,1582000,11542473,15.88
9900325,9960951,2455,859250,10820201,8.63
9900326,9957133,1333,466550,10423683,4.69
9900327,9960756,4398,1539300,11500056,15.45
9900329,9956104,71,24850,9980954,0.25
9900330,9955734,3549,1242150,11197884,12.48
9900331,9947117,3632,1271200,11218317,12.78
9900332,9960042,3454,1208900,11168942,12.14
9900333,9958552,3583,1254050,11212602,12.59
9900334,9973482,2092,732200,10705682,7.34
9900335,9982227,2839,993650,10975877,9.95
9900336,9970707,3540,1239000,11209707,12.43
9900337,9980306,3216,1125600,11105906,11.28
9900338,9756636,3282,1148700,10905336,11.77
9900339,9999042,71,24850,10023892,0.25
9900340,9974970,2792,977200,10952170,9.80
9900341,9976483,2312,809200,10785683,8.11
9900342,9979774,3435,1202250,11182024,12.05
9900343,9985229,2087,730450,10715679,7.32
9900344,9998579,3379,1182650,11181229,11.83
9900345,9969605,4397,1538950,11508555,15.44
9900346,9959920,2195,768250,10728170,7.71
9900347,9984665,2806,982100,10966765,9.84
9900348,9992968,2870,1004500,10997468,10.05
9900349,9974687,2037,712950,10687637,7.15
9900350,9971083,3771,1319850,11290933,13.24
9900351,9985084,4240,1484000,11469084,14.86
9900352,9971019,2788,975800,10946819,9.79
9900353,9997265,2831,990850,10988115,9.91
9900354,9989488,2569,899150,10888638,9.00
9900355,9977166,3117,1090950,11068116,10.93
9900356,9970218,4971,1739850,11710068,17.45
9900357,9991472,3623,1268050,11259522,12.69
9900358,9975978,2240,784000,10759978,7.86
9900359,9958929,3710,1298500,11257429,13.04
9900360,9974999,4424,1548400,11523399,15.52
9900361,9982585,3696,1293600,11276185,12.96
9900362,9977050,2818,986300,10963350,9.89
9900363,9969839,2703,946050,10915889,9.49
9900364,9974456,3045,1065750,11040206,10.68
9900365,9986480,5402,1890700,11877180,18.93
9900366,9993191,3389,1186150,11179341,11.87
9900367,9986327,3627,1269450,11255777,12.71
9900368,9982411,4982,1743700,11726111,17.47
9900369,9997831,3861,1351350,11349181,13.52
9900370,9977089,2064,722400,10699489,7.24
9900371,9551372,2554,893900,10445272,9.36
9900372,9982986,3014,1054900,11037886,10.57
9900373,9990651,3023,1058050,11048701,10.59
9900374,9963271,3412,1194200,11157471,11.99
9900375,2592183,865,302750,2894933,11.68
9900376,9970578,4100,1435000,11405578,14.39
9900377,9986985,2577,901950,10888935,9.03
9900378,9985879,4625,1618750,11604629,16.21
9900379,9703006,1626,569100,10272106,5.87
9900380,9986202,4161,1456350,11442552,14.58
9900381,4434078,1496,523600,4957678,11.81
9900382,9952655,4223,1478050,11430705,14.85
9900383,9968655,4735,1657250,11625905,16.62
9900384,9969301,2396,838600,10807901,8.41
9900385,9985007,1788,625800,10610807,6.27
9900386,3445782,1165,407750,3853532,11.83
9900387,9976860,3718,1301300,11278160,13.04
9900388,9922193,2902,1015700,10937893,10.24
9900389,6280987,1825,638750,6919737,10.17
9900390,9984022,5168,1808800,11792822,18.12
9900391,9974241,3724,1303400,11277641,13.07
9900392,9944535,3137,1097950,11042485,11.04
9900393,9978069,4569,1599150,11577219,16.03
9900394,9963006,3215,1125250,11088256,11.29
9900395,7300395,1572,550200,7850595,7.54
9900396,9984329,4691,1641850,11626179,16.44
9900397,4037135,2492,872200,4909335,21.60
9900398,9983288,5062,1771700,11754988,17.75
9900399,9995157,1432,501200,10496357,5.01
9900400,9986264,5458,1910300,11896564,19.13
9900401,9959990,6186,2165100,12125090,21.74
9900402,9976955,3943,1380050,11357005,13.83
9900403,9982829,3087,1080450,11063279,10.82
9900404,9965269,3906,1367100,11332369,13.72
9900405,9951584,4602,1610700,11562284,16.19
9900406,9942576,4507,1577450,11520026,15.87
9900407,9878285,1414,494900,10373185,5.01
9900408,9911309,6359,2225650,12136959,22.46
9900409,9925064,3702,1295700,11220764,13.05
9900410,9919307,2743,960050,10879357,9.68
9900411,9922184,3586,1255100,11177284,12.65
9900412,9499855,2781,973350,10473205,10.25
9900413,9926800,3941,1379350,11306150,13.90
9900414,9935512,3331,1165850,11101362,11.73
9900415,9949320,3348,1171800,11121120,11.78
9900416,9946813,3762,1316700,11263513,13.24
9900417,9946244,3581,1253350,11199594,12.60
9900418,9529489,4714,1649900,11179389,17.31
9900419,9978213,3131,1095850,11074063,10.98
9900420,9972333,4572,1600200,11572533,16.05
9900421,9980548,1816,635600,10616148,6.37
9900422,9998947,4912,1719200,11718147,17.19
9900423,2658298,683,239050,2897348,8.99
9900424,9973596,2832,991200,10964796,9.94
9900425,2909035,1560,546000,3455035,18.77
9900426,9981997,5014,1754900,11736897,17.58
9900427,9976404,4643,1625050,11601454,16.29
9900428,9978423,3677,1286950,11265373,12.90
9900429,9830157,4314,1509900,11340057,15.36
9900430,9984154,3100,1085000,11069154,10.87
9900431,9975589,3348,1171800,11147389,11.75
9900432,9995162,6213,2174550,12169712,21.76
9900433,9975332,3553,1243550,11218882,12.47
9900434,9989981,2916,1020600,11010581,10.22
9900435,9886958,1492,522200,10409158,5.28
9900436,9980687,4602,1610700,11591387,16.14
9900437,9987061,4061,1421350,11408411,14.23
9900438,7064628,4824,1688400,8753028,23.90
9900439,9983693,2950,1032500,11016193,10.34
9900440,9992460,2831,990850,10983310,9.92
9900441,878968,352,123200,1002168,14.02
9900442,9964170,2612,914200,10878370,9.17
9900443,9948109,3362,1176700,11124809,11.83
9900444,9966795,3531,1235850,11202645,12.40
9900445,9304842,3464,1212400,10517242,13.03
9900446,9965587,4146,1451100,11416687,14.56
9900447,9974188,4922,1722700,11696888,17.27
9900448,9967914,3688,1290800,11258714,12.95
9900449,9976514,3519,1231650,11208164,12.35
9900450,2941887,793,277550,3219437,9.43
9900451,9847535,2889,1011150,10858685,10.27
9900452,9975226,3435,1202250,11177476,12.05
9900453,9967781,4145,1450750,11418531,14.55
9900454,9984005,2167,758450,10742455,7.60
9900455,4893751,923,323050,5216801,6.60
9900456,2866811,2204,771400,3638211,26.91
9900457,9949143,6753,2363550,12312693,23.76
9900458,9955131,4007,1402450,11357581,14.09
9900459,9944590,3157,1104950,11049540,11.11
9900460,9958101,3407,1192450,11150551,11.97
9900461,9963425,4814,1684900,11648325,16.91
9900462,9973974,3427,1199450,11173424,12.03
9900464,9998031,3315,1160250,11158281,11.60
9900465,9979198,4722,1652700,11631898,16.56
9900466,9983486,2663,932050,10915536,9.34
9900467,7590666,2123,743050,8333716,9.79
9900468,9980040,2054,718900,10698940,7.20
9900469,9977120,4259,1490650,11467770,14.94
9900470,9984442,2887,1010450,10994892,10.12
9900471,9983383,3710,1298500,11281883,13.01
9900472,9987864,2410,843500,10831364,8.45
9900473,9990112,3818,1336300,11326412,13.38
9900474,9969913,1939,678650,10648563,6.81
9900475,8236813,1834,641900,8878713,7.79
9900476,9979647,4193,1467550,11447197,14.71
9900477,9987370,2198,769300,10756670,7.70
9900478,7312318,1086,380100,7692418,5.20
9900479,9950429,5290,1851500,11801929,18.61
9900480,9955241,2698,944300,10899541,9.49
9900482,9967455,3154,1103900,11071355,11.08
9900483,9702408,3516,1230600,10933008,12.68
9900484,9962278,320,112000,10074278,1.12
9900485,9979641,3240,1134000,11113641,11.36
9900487,1328758,542,189700,1518458,14.28
9900489,9977423,3036,1062600,11040023,10.65
9900490,9979791,3438,1203300,11183091,12.06
9900491,9990094,2649,927150,10917244,9.28
9900492,9981711,3382,1183700,11165411,11.86
9900493,9993435,2665,932750,10926185,9.33
9900494,9978874,4098,1434300,11413174,14.37
9900495,9983067,3265,1142750,11125817,11.45
9900496,9977028,2432,851200,10828228,8.53
9900497,9990673,3589,1256150,11246823,12.57
9900498,9964480,2880,1008000,10972480,10.12
9900499,9965514,4482,1568700,11534214,15.74
9900500,9528569,2424,848400,10376969,8.90
9900501,9974966,5907,2067450,12042416,20.73
9900502,9979240,3536,1237600,11216840,12.40
9900503,9999820,4802,1680700,11680520,16.81
9900504,9994804,3840,1344000,11338804,13.45
9900505,9982040,2636,922600,10904640,9.24
9900506,9983751,1481,518350,10502101,5.19
9900507,9974173,2209,773150,10747323,7.75
9900508,9970240,3991,1396850,11367090,14.01
9900509,9795778,5709,1998150,11793928,20.40
9900510,9986979,3698,1294300,11281279,12.96
9900511,9982462,3623,1268050,11250512,12.70
9900512,9981414,4698,1644300,11625714,16.47
9900513,9880322,2482,868700,10749022,8.79
9900514,9985323,2282,798700,10784023,8.00
9900515,9998533,3592,1257200,11255733,12.57
9900517,9975678,4411,1543850,11519528,15.48
9900518,9960215,4347,1521450,11481665,15.28
9900520,9977545,2162,756700,10734245,7.58
9900521,9854643,2080,728000,10582643,7.39
9900522,9982117,3323,1163050,11145167,11.65
9900523,9999564,2281,798350,10797914,7.98
9900524,9992085,2820,987000,10979085,9.88
9900525,9974639,2576,901600,10876239,9.04
9900526,9987995,2398,839300,10827295,8.40
9900527,9972486,2858,1000300,10972786,10.03
9900528,9982091,3556,1244600,11226691,12.47
9900529,9998801,4560,1596000,11594801,15.96
9900530,9995457,1489,521150,10516607,5.21
9900531,9971066,3507,1227450,11198516,12.31
9900532,9983190,4288,1500800,11483990,15.03
9900534,9988603,3702,1295700,11284303,12.97
9900535,9971969,3927,1374450,11346419,13.78
9900536,9972995,5337,1867950,11840945,18.73
9900537,9976552,3308,1157800,11134352,11.61
9900538,9983442,4958,1735300,11718742,17.38
9900539,9978413,2320,812000,10790413,8.14
9900540,9952448,2008,702800,10655248,7.06
9900541,9972066,3069,1074150,11046216,10.77
9900542,9958674,2744,960400,10919074,9.64
9900543,9954821,3840,1344000,11298821,13.50
9900544,9310259,4112,1439200,10749459,15.46
9900545,9958508,4257,1489950,11448458,14.96
9900546,9963950,3923,1373050,11337000,13.78
9900547,9979982,4116,1440600,11420582,14.43
9900548,9962311,2488,870800,10833111,8.74
9900549,1622723,788,275800,1898523,17.00
9900550,9954828,4896,1713600,11668428,17.21
9900551,9950254,161,56350,10006604,0.57
9900552,9969443,3277,1146950,11116393,11.50
9900553,5762909,2759,965650,6728559,16.76
9900554,9948220,5756,2014600,11962820,20.25
9900555,9934267,2147,751450,10685717,7.56
9900556,9934546,2609,913150,10847696,9.19
9900557,9947889,3262,1141700,11089589,11.48
9900558,9931134,3151,1102850,11033984,11.10
9900559,9945143,4350,1522500,11467643,15.31
9900560,9948508,2105,736750,10685258,7.41
9900561,9952282,854,298900,10251182,3.00
9900562,9954054,2331,815850,10769904,8.20
9900563,9968441,3960,1386000,11354441,13.90
9900564,9956780,1869,654150,10610930,6.57
9900565,9959879,3790,1326500,11286379,13.32
9900566,9963029,3114,1089900,11052929,10.94
9900568,3928842,1305,456750,4385592,11.63
9900569,4222511,3165,1107750,5330261,26.23
9900570,9969153,3845,1345750,11314903,13.50
9900571,9983252,4537,1587950,11571202,15.91
9900572,9978228,3078,1077300,11055528,10.80
9900573,9945406,3038,1063300,11008706,10.69
9900574,9977166,4576,1601600,11578766,16.05
9900575,9939311,4702,1645700,11585011,16.56
9900576,9997420,3064,1072400,11069820,10.73
9900577,9980975,3709,1298150,11279125,13.01
9900578,9974120,5129,1795150,11769270,18.00
9900579,9964211,3145,1100750,11064961,11.05
9900580,9951055,2865,1002750,10953805,10.08
9900582,9952132,3742,1309700,11261832,13.16
9900583,9949125,1720,602000,10551125,6.05
9900584,9951764,3067,1073450,11025214,10.79
9900585,9954021,3635,1272250,11226271,12.78
9900586,9975052,4911,1718850,11693902,17.23
9900587,9972545,5713,1999550,11972095,20.05
9900588,9967599,1841,644350,10611949,6.46
9900591,9967785,4039,1413650,11381435,14.18
9900592,9970308,3793,1327550,11297858,13.32
9900593,9995976,4424,1548400,11544376,15.49
9900594,9982101,2618,916300,10898401,9.18
9900595,9995441,2239,783650,10779091,7.84
9900597,9970243,4474,1565900,11536143,15.71
9900598,9976068,5180,1813000,11789068,18.17
9900599,3167206,2551,892850,4060056,28.19
9900600,9992029,3026,1059100,11051129,10.60
9900601,9977751,3356,1174600,11152351,11.77
9900602,9991584,3698,1294300,11285884,12.95
9900603,9985655,4094,1432900,11418555,14.35
9900604,9993028,5913,2069550,12062578,20.71
9900605,9964376,2426,849100,10813476,8.52
9900607,9976718,1586,555100,10531818,5.56
9900608,9979397,4054,1418900,11398297,14.22
9900609,9989345,3925,1373750,11363095,13.75
9900610,9986621,6106,2137100,12123721,21.40
9900611,9989266,3066,1073100,11062366,10.74
9900612,9991838,3222,1127700,11119538,11.29
9900613,9985658,4193,1467550,11453208,14.70
9900614,9977162,4345,1520750,11497912,15.24
9900615,4198101,1630,570500,4768601,13.59
9900616,9989822,3166,1108100,11097922,11.09
9900617,9982568,2923,1023050,11005618,10.25
9900618,9996003,3449,1207150,11203153,12.08
9900619,9990058,6465,2262750,12252808,22.65
9900620,9980988,1668,583800,10564788,5.85
9900621,9988264,4540,1589000,11577264,15.91
9900622,9984784,4883,1709050,11693834,17.12
9900623,9980674,3573,1250550,11231224,12.53
9900624,3591421,1869,654150,4245571,18.21
9900625,9978657,4866,1703100,11681757,17.07
9900627,1237669,706,247100,1484769,19.96
9900628,9979555,2819,986650,10966205,9.89
9900629,9985454,4332,1516200,11501654,15.18
9900630,9987091,4679,1637650,11624741,16.40
9900631,4581781,2168,758800,5340581,16.56
9900632,9983829,4872,1705200,11689029,17.08
9900633,9972319,2865,1002750,10975069,10.06
9900634,5571993,1872,655200,6227193,11.76
9900635,9994735,3796,1328600,11323335,13.29
9900636,9970120,4534,1586900,11557020,15.92
9900637,9989878,3721,1302350,11292228,13.04
9900638,9981313,4970,1739500,11720813,17.43
9900639,9984575,2780,973000,10957575,9.75
9900640,9983447,4554,1593900,11577347,15.97
9900641,9959962,4335,1517250,11477212,15.23
9900642,9982967,4435,1552250,11535217,15.55
9900643,9961262,3352,1173200,11134462,11.78
9900644,9965809,2438,853300,10819109,8.56
9900645,9979671,2804,981400,10961071,9.83
9900646,9965058,1162,406700,10371758,4.08
9900647,9961288,3961,1386350,11347638,13.92
9900648,9967887,2587,905450,10873337,9.08
9900649,9982117,4046,1416100,11398217,14.19
9900650,9371463,4500,1575000,10946463,16.81
9900651,9964100,3619,1266650,11230750,12.71
9900652,9955664,4206,1472100,11427764,14.79
9900653,9972896,2471,864850,10837746,8.67
9900654,9969359,1218,426300,10395659,4.28
9900655,9973792,3854,1348900,11322692,13.52
9900656,9981062,3155,1104250,11085312,11.06
9900657,9981856,1872,655200,10637056,6.56
9900658,9981737,3757,1314950,11296687,13.17
9900659,9999999,3105,1086750,11086749,10.87
9900660,9987359,3700,1295000,11282359,12.97
9900662,9988871,3811,1333850,11322721,13.35
9900663,9965798,6457,2259950,12225748,22.68
9900664,9949921,4228,1479800,11429721,14.87
9900665,9946980,3798,1329300,11276280,13.36
9900666,9962019,2654,928900,10890919,9.32
9900667,9965590,3937,1377950,11343540,13.83
9900668,9954790,3483,1219050,11173840,12.25
9900669,9957201,4168,1458800,11416001,14.65
9900670,9937063,2276,796600,10733663,8.02
9900671,9957848,2621,917350,10875198,9.21
9900672,9960493,4440,1554000,11514493,15.60
9900673,9952243,4876,1706600,11658843,17.15
9900674,9945788,2887,1010450,10956238,10.16
9900676,9926194,2534,886900,10813094,8.93
9900677,9932322,2500,875000,10807322,8.81
9900678,9939032,3600,1260000,11199032,12.68
9900679,9921127,1812,634200,10555327,6.39
9900680,9920672,1764,617400,10538072,6.22
9900681,9939298,2439,853650,10792948,8.59
9900682,9930403,1728,604800,10535203,6.09
9900683,9937402,4422,1547700,11485102,15.57
9900684,9947843,3260,1141000,11088843,11.47
9900685,9965711,2739,958650,10924361,9.62
9900686,5052285,1566,548100,5600385,10.85
9900687,9938800,4576,1601600,11540400,16.11
9900688,9934239,2979,1042650,10976889,10.50
9900689,9937171,1176,411600,10348771,4.14
9900690,9944062,3905,1366750,11310812,13.74
9900691,9761701,2456,859600,10621301,8.81
9900692,9954973,4450,1557500,11512473,15.65
9900693,9963677,4562,1596700,11560377,16.03
9900694,9960932,3164,1107400,11068332,11.12
9900695,9961526,3089,1081150,11042676,10.85
9900696,9972836,5171,1809850,11782686,18.15
9900697,9972212,4546,1591100,11563312,15.96
9900698,9959117,2200,770000,10729117,7.73
9900699,9969894,2440,854000,10823894,8.57
9900700,4247858,2228,779800,5027658,18.36
9900701,3293498,1437,502950,3796448,15.27
9900702,9930637,3310,1158500,11089137,11.67
9900703,9955917,3584,1254400,11210317,12.60
9900704,9964170,1071,374850,10339020,3.76
9900705,9962968,3203,1121050,11084018,11.25
9900706,9987023,6379,2232650,12219673,22.36
9900707,9980138,3737,1307950,11288088,13.11
9900708,9986465,3179,1112650,11099115,11.14
9900709,9979904,4555,1594250,11574154,15.97
9900710,9998520,777,271950,10270470,2.72
9900711,9980429,3727,1304450,11284879,13.07
9900712,9983739,3415,1195250,11178989,11.97
9900713,9970223,3499,1224650,11194873,12.28
9900714,9992350,2567,898450,10890800,8.99
9900715,9982502,2896,1013600,10996102,10.15
9900716,9985476,3151,1102850,11088326,11.04
9900717,9985576,3277,1146950,11132526,11.49
9900718,1875285,899,314650,2189935,16.78
9900719,9967460,3999,1399650,11367110,14.04
9900720,9964747,3925,1373750,11338497,13.79
9900721,9951009,3719,1301650,11252659,13.08
9900722,9954979,3675,1286250,11241229,12.92
9900723,9973405,3739,1308650,11282055,13.12
9900724,9970947,2185,764750,10735697,7.67
9900725,9983200,2658,930300,10913500,9.32
9900726,9986636,1031,360850,10347486,3.61
9900727,9986486,2973,1040550,11027036,10.42
9900728,9989764,2854,998900,10988664,10.00
9900729,6969852,1481,518350,7488202,7.44
9900730,9979329,4549,1592150,11571479,15.95
9900731,9980191,3146,1101100,11081291,11.03
9900732,9982955,5744,2010400,11993355,20.14
9900733,9987382,2936,1027600,11014982,10.29
9900734,9979345,4240,1484000,11463345,14.87
9900735,9996255,3108,1087800,11084055,10.88
9900736,9984945,4877,1706950,11691895,17.10
9900737,9989677,2025,708750,10698427,7.09
9900738,9984999,2643,925050,10910049,9.26
9900739,2649689,2376,831600,3481289,31.38
9900740,9982315,4113,1439550,11421865,14.42
9900741,9989866,1380,483000,10472866,4.83
9900742,9992790,2264,792400,10785190,7.93
9900743,9980863,6507,2277450,12258313,22.82
9900744,9988455,957,334950,10323405,3.35
9900745,9980329,4208,1472800,11453129,14.76
9900746,9988034,3581,1253350,11241384,12.55
9900747,9981002,1904,666400,10647402,6.68
9900748,9998472,3191,1116850,11115322,11.17
9900749,9995862,2625,918750,10914612,9.19
9900750,2649804,1403,491050,3140854,18.53
9900752,9989105,3350,1172500,11161605,11.74
9900753,9988976,5379,1882650,11871626,18.85
9900754,9979101,4354,1523900,11503001,15.27
9900755,1136418,378,132300,1268718,11.64
9900756,9978275,2547,891450,10869725,8.93
9900757,9973491,4209,1473150,11446641,14.77
9900758,9976346,3592,1257200,11233546,12.60
9900759,9973554,3961,1386350,11359904,13.90
9900760,9988238,3857,1349950,11338188,13.52
9900761,9965335,2220,777000,10742335,7.80
9900762,9958696,2503,876050,10834746,8.80
9900763,9950454,4750,1662500,11612954,16.71
9900764,9938262,4142,1449700,11387962,14.59
9900765,9955725,3367,1178450,11134175,11.84
9900766,9967189,3863,1352050,11319239,13.57
9900767,9952693,3228,1129800,11082493,11.35
9900769,9947646,3172,1110200,11057846,11.16
9900770,9962318,2210,773500,10735818,7.76
9900771,7779528,4416,1545600,9325128,19.87
9900772,9943349,4435,1552250,11495599,15.61
9900773,9960708,2919,1021650,10982358,10.26
9900774,9936491,4723,1653050,11589541,16.64
9900775,9506647,4588,1605800,11112447,16.89
9900776,9918814,2020,707000,10625814,7.13
9900777,9982058,3352,1173200,11155258,11.75
9900778,9988278,2722,952700,10940978,9.54
9900779,9967986,3628,1269800,11237786,12.74
9900780,9973384,4027,1409450,11382834,14.13
9900781,9987556,4473,1565550,11553106,15.68
9900782,9974041,3821,1337350,11311391,13.41
9900783,9996095,3326,1164100,11160195,11.65
9900784,3682993,1169,409150,4092143,11.11
9900785,9964529,3541,1239350,11203879,12.44
9900786,9965814,3662,1281700,11247514,12.86
9900787,9968612,2519,881650,10850262,8.84
9900788,9975814,3234,1131900,11107714,11.35
9900789,9970690,4941,1729350,11700040,17.34
9900790,9987694,3538,1238300,11225994,12.40
9900791,9986246,6211,2173850,12160096,21.77
9900792,9975817,2190,766500,10742317,7.68
9900793,9994270,4754,1663900,11658170,16.65
9900794,9969582,5329,1865150,11834732,18.71
9900795,9987864,2555,894250,10882114,8.95
9900796,9959558,2003,701050,10660608,7.04
9900797,9971412,1947,681450,10652862,6.83
9900798,9983797,4672,1635200,11618997,16.38
9900799,9986458,4566,1598100,11584558,16.00
9900800,4659077,2859,1000650,5659727,21.48
9900801,9971786,4845,1695750,11667536,17.01
9900802,1936122,697,243950,2180072,12.60
9900803,2237647,860,301000,2538647,13.45
9900804,9991045,3255,1139250,11130295,11.40
9900805,9991877,2871,1004850,10996727,10.06
9900806,9986951,1113,389550,10376501,3.90
9900807,9943961,3622,1267700,11211661,12.75
9900808,9971927,3102,1085700,11057627,10.89
9900809,9987973,4023,1408050,11396023,14.10
9900810,9981991,5195,1818250,11800241,18.22
9900811,9979078,3070,1074500,11053578,10.77
9900812,9993626,4499,1574650,11568276,15.76
9900813,9975635,3355,1174250,11149885,11.77
9900814,9976255,4618,1616300,11592555,16.20
9900815,9960164,3696,1293600,11253764,12.99
9900816,9981300,6193,2167550,12148850,21.72
9900817,9563011,2009,703150,10266161,7.35
9900818,9991281,2998,1049300,11040581,10.50
9900819,9992840,4888,1710800,11703640,17.12
9900820,9993677,3992,1397200,11390877,13.98
9900823,9700728,2009,703150,10403878,7.25
9900824,9972682,6635,2322250,12294932,23.29
9900825,1540752,549,192150,1732902,12.47
9900826,9959419,3205,1121750,11081169,11.26
9900828,9952183,3593,1257550,11209733,12.64
9900829,9970455,2605,911750,10882205,9.14
9900830,9987362,2730,955500,10942862,9.57
9900831,9974477,5155,1804250,11778727,18.09
9900832,9987300,3348,1171800,11159100,11.73
9900834,7817328,1896,663600,8480928,8.49
9900835,9947730,4911,1718850,11666580,17.28
9900836,9962387,1662,581700,10544087,5.84
9900837,9952153,4831,1690850,11643003,16.99
9900838,9963047,2943,1030050,10993097,10.34
9900839,9960455,3303,1156050,11116505,11.61
9900840,4425781,3133,1096550,5522331,24.78
9900841,9937185,3602,1260700,11197885,12.69
9900842,3254998,784,274400,3529398,8.43
9900843,9946960,1764,617400,10564360,6.21
9900844,9955398,4447,1556450,11511848,15.63
9900845,9955542,3389,1186150,11141692,11.91
9900846,8756841,4135,1447250,10204091,16.53
9900847,9951390,4987,1745450,11696840,17.54
9900848,9929434,4829,1690150,11619584,17.02
9900849,9841061,5434,1901900,11742961,19.33
9900850,9947011,5459,1910650,11857661,19.21
9900851,9952314,1835,642250,10594564,6.45
9900852,9944595,4828,1689800,11634395,16.99
9900853,9957156,4440,1554000,11511156,15.61
9900854,9956674,4890,1711500,11668174,17.19
9900855,9968223,5142,1799700,11767923,18.05
9900856,9956761,3937,1377950,11334711,13.84
9900857,9971814,4398,1539300,11511114,15.44
9900858,9976849,3401,1190350,11167199,11.93
9900859,9980133,6612,2314200,12294333,23.19
9900860,9988448,4256,1489600,11478048,14.91
9900861,9971622,4814,1684900,11656522,16.90
9900862,9996261,4514,1579900,11576161,15.80
9900863,9972342,1349,472150,10444492,4.73
9900864,9961368,4104,1436400,11397768,14.42
9900865,9958514,5483,1919050,11877564,19.27
9900866,9945801,4062,1421700,11367501,14.29
9900867,9950686,5076,1776600,11727286,17.85
9900868,9234172,1963,687050,9921222,7.44
9900869,4502212,2452,858200,5360412,19.06
9900870,9960047,4280,1498000,11458047,15.04
9900871,1157052,689,241150,1398202,20.84
9900872,9953442,2893,1012550,10965992,10.17
9900873,9009195,2462,861700,9870895,9.56
9900874,9946025,3582,1253700,11199725,12.61
9900875,9937381,5852,2048200,11985581,20.61
9900876,9904191,2681,938350,10842541,9.47
9900877,9928425,4952,1733200,11661625,17.46
9900878,9932899,4198,1469300,11402199,14.79
9900879,5709240,2217,775950,6485190,13.59
9900880,9955582,5093,1782550,11738132,17.91
9900881,9962068,3195,1118250,11080318,11.23
9900882,3349480,1042,364700,3714180,10.89
9900883,2391064,638,223300,2614364,9.34
9900884,9976060,4296,1503600,11479660,15.07
9900886,9971080,1181,413350,10384430,4.15
9900887,9982666,3537,1237950,11220616,12.40
9900888,9994568,4235,1482250,11476818,14.83
9900889,9984849,3870,1354500,11339349,13.57
9900891,9768059,3908,1367800,11135859,14.00
9900892,9978863,3815,1335250,11314113,13.38
9900893,9983357,4413,1544550,11527907,15.47
9900894,9984200,4383,1534050,11518250,15.36
9900895,9974417,3689,1291150,11265567,12.94
9900896,9973953,3714,1299900,11273853,13.03
9900897,9990896,2912,1019200,11010096,10.20
9900898,9985342,5959,2085650,12070992,20.89
9900899,8616255,4043,1415050,10031305,16.42
9900900,9979009,2015,705250,10684259,7.07
9900901,9977352,3216,1125600,11102952,11.28
9900902,9983939,5284,1849400,11833339,18.52
9900903,9976330,6466,2263100,12239430,22.68
9900904,6531740,4688,1640800,8172540,25.12
9900905,9966861,3023,1058050,11024911,10.62
9900906,9973257,4790,1676500,11649757,16.81
9900907,9973449,4680,1638000,11611449,16.42
9900908,9981852,5358,1875300,11857152,18.79
9900909,9983426,3484,1219400,11202826,12.21
9900910,9968834,3175,1111250,11080084,11.15
9900911,9982430,3879,1357650,11340080,13.60
9900912,9986034,4439,1553650,11539684,15.56
9900913,5757638,1447,506450,6264088,8.80
9900914,9983015,5315,1860250,11843265,18.63
9900915,9984635,1816,635600,10620235,6.37
9900916,9991933,2409,843150,10835083,8.44
9900917,9971883,3386,1185100,11156983,11.88
9900918,9955364,3237,1132950,11088314,11.38
9900919,9980280,3532,1236200,11216480,12.39
9900920,9979469,4221,1477350,11456819,14.80
9900921,9993556,4542,1589700,11583256,15.91
9900922,9976792,2986,1045100,11021892,10.48
9900923,9997191,3446,1206100,11203291,12.06
9900924,9982881,4255,1489250,11472131,14.92
9900925,9975183,3075,1076250,11051433,10.79
9900926,592134,348,121800,713934,20.57
9900927,9412783,3169,1109150,10521933,11.78
9900928,9996306,3167,1108450,11104756,11.09
9900929,1208935,420,147000,1355935,12.16
9900930,9848100,3600,1260000,11108100,12.79
9900931,9947909,6262,2191700,12139609,22.03
9900932,9956098,4330,1515500,11471598,15.22
9900933,9945609,3783,1324050,11269659,13.31
9900934,9937515,3854,1348900,11286415,13.57
9900935,2233409,1237,432950,2666359,19.39
9900936,9939282,5764,2017400,11956682,20.30
9900937,9935617,1859,650650,10586267,6.55
9900938,9908253,2347,821450,10729703,8.29
9900939,9937793,3341,1169350,11107143,11.77
9900940,9920110,3427,1199450,11119560,12.09
9900941,9935713,3902,1365700,11301413,13.75
9900942,3179332,1360,476000,3655332,14.97
9900943,1257719,726,254100,1511819,20.20
9900944,9963331,2280,798000,10761331,8.01
9900945,9954014,3421,1197350,11151364,12.03
9900946,9971250,6315,2210250,12181500,22.17
9900947,9970197,2416,845600,10815797,8.48
9900948,2185906,1511,528850,2714756,24.19
9900949,9959430,3839,1343650,11303080,13.49
9900950,9948807,5696,1993600,11942407,20.04
9900951,9947521,5780,2023000,11970521,20.34
9900952,787094,717,250950,1038044,31.88
9900953,9934430,4051,1417850,11352280,14.27
9900954,9931645,3114,1089900,11021545,10.97
9900955,9936506,3227,1129450,11065956,11.37
9900956,9933954,4252,1488200,11422154,14.98
9900957,9908234,4171,1459850,11368084,14.73
9900958,7333558,4285,1499750,8833308,20.45
9900959,9908109,3948,1381800,11289909,13.95
9900960,9898938,6667,2333450,12232388,23.57
9900961,9911649,2947,1031450,10943099,10.41
9900962,9927897,2946,1031100,10958997,10.39
9900963,9923192,5850,2047500,11970692,20.63
9900964,9916118,2487,870450,10786568,8.78
9900965,9922901,5058,1770300,11693201,17.84
9900966,9912874,3503,1226050,11138924,12.37
9900967,9904831,4518,1581300,11486131,15.96
9900968,9924713,3865,1352750,11277463,13.63
9900969,9904678,3979,1392650,11297328,14.06
9900970,9907560,3064,1072400,10979960,10.82
9900971,9925946,4219,1476650,11402596,14.88
9900972,9937889,4419,1546650,11484539,15.56
9900973,9909788,3663,1282050,11191838,12.94
9900974,9898641,2633,921550,10820191,9.31
9900975,9923934,3785,1324750,11248684,13.35
9900976,9923923,5683,1989050,11912973,20.04
9900977,9946369,3782,1323700,11270069,13.31
9900978,9934787,3485,1219750,11154537,12.28
9900979,9939761,4120,1442000,11381761,14.51
9900980,9943980,3586,1255100,11199080,12.62
9900981,9754557,3031,1060850,10815407,10.88
9900983,9932822,3298,1154300,11087122,11.62
9900984,9662055,5095,1783250,11445305,18.46
9900985,9958176,3969,1389150,11347326,13.95
9900986,9974644,3563,1247050,11221694,12.50
9900987,8242502,572,200200,8442702,2.43
9900988,9972298,4781,1673350,11645648,16.78
9900989,4345329,1659,580650,4925979,13.36
9900990,9945910,3902,1365700,11311610,13.73
9900991,9452228,3436,1202600,10654828,12.72
9900992,9976456,4865,1702750,11679206,17.07
9900993,1289085,1475,516250,1805335,40.05
9900994,9945375,4662,1631700,11577075,16.41
9900995,9955016,5793,2027550,11982566,20.37
9900996,9961838,3395,1188250,11150088,11.93
9900997,9972925,6182,2163700,12136625,21.70
9900998,9970373,2148,751800,10722173,7.54
9901000,9971641,6414,2244900,12216541,22.51
9901001,9981639,6127,2144450,12126089,21.48
9901003,9979259,3884,1359400,11338659,13.62
9901004,8249178,3450,1207500,9456678,14.64
9901005,9995073,5158,1805300,11800373,18.06
9901006,9989340,5798,2029300,12018640,20.31
9901007,9977491,5037,1762950,11740441,17.67
9901008,9996155,3201,1120350,11116505,11.21
9901009,9960234,5706,1997100,11957334,20.05
9901010,5574363,3651,1277850,6852213,22.92
9901011,9983008,4238,1483300,11466308,14.86
9901012,2831277,1820,637000,3468277,22.50
9901014,9255472,2691,941850,10197322,10.18
9901015,5737481,3296,1153600,6891081,20.11
9901016,9979149,4618,1616300,11595449,16.20
9901017,9987171,6178,2162300,12149471,21.65
9901018,2848893,1451,507850,3356743,17.83
9901019,9983884,5101,1785350,11769234,17.88
9901020,9987310,3683,1289050,11276360,12.91
9901021,9972932,3278,1147300,11120232,11.50
9901022,9983702,5257,1839950,11823652,18.43
9901023,9989855,3487,1220450,11210305,12.22
9901024,9987681,1984,694400,10682081,6.95
9901025,9991819,4274,1495900,11487719,14.97
9901026,9971799,2845,995750,10967549,9.99
9901027,9965977,4836,1692600,11658577,16.98
9901028,9962287,3342,1169700,11131987,11.74
9901029,9956210,4336,1517600,11473810,15.24
9901030,9964029,4452,1558200,11522229,15.64
9901031,9965852,5179,1812650,11778502,18.19
9901032,9974927,4552,1593200,11568127,15.97
9901033,9968120,5348,1871800,11839920,18.78
9901034,9096167,5109,1788150,10884317,19.66
9901035,6170911,2316,810600,6981511,13.14
9901036,9984073,2133,746550,10730623,7.48
9901037,9997250,3891,1361850,11359100,13.62
9901039,9982572,4106,1437100,11419672,14.40
9901040,9990522,2613,914550,10905072,9.15
9901041,9988064,4131,1445850,11433914,14.48
9901043,9963256,5269,1844150,11807406,18.51
9901044,9956678,6354,2223900,12180578,22.34
9901045,9944532,6008,2102800,12047332,21.15
9901046,9940372,5341,1869350,11809722,18.81
9901047,9952040,4334,1516900,11468940,15.24
9901048,9956382,5937,2077950,12034332,20.87
9901049,9949558,1713,599550,10549108,6.03
9901050,9936823,5143,1800050,11736873,18.11
9901051,9949978,3599,1259650,11209628,12.66
9901052,9924185,4808,1682800,11606985,16.96
9901053,9924336,4649,1627150,11551486,16.40
9901054,9910993,3789,1326150,11237143,13.38
9901055,9892581,5047,1766450,11659031,17.86
9901056,9906124,4671,1634850,11540974,16.50
9901057,547580,623,218050,765630,39.82
9901058,9926197,3250,1137500,11063697,11.46
9901059,9920696,5029,1760150,11680846,17.74
9901060,9913880,5845,2045750,11959630,20.64
9901061,9925261,5340,1869000,11794261,18.83
9901062,9904337,4564,1597400,11501737,16.13
9901063,9908557,5533,1936550,11845107,19.54
9901064,9920734,3900,1365000,11285734,13.76
9901065,9921529,4739,1658650,11580179,16.72
9901066,9925778,3777,1321950,11247728,13.32
9901067,9938204,5087,1780450,11718654,17.92
9901068,9954507,4096,1433600,11388107,14.40
9901069,7942937,3988,1395800,9338737,17.57
9901070,9960618,5946,2081100,12041718,20.89
9901071,9951484,6712,2349200,12300684,23.61
9901072,9937897,4814,1684900,11622797,16.95
9901073,9951800,4706,1647100,11598900,16.55
9901074,9947787,4622,1617700,11565487,16.26
9901075,9955055,5371,1879850,11834905,18.88
9901076,9945539,4484,1569400,11514939,15.78
9901077,9942907,5804,2031400,11974307,20.43
9901078,9931735,4007,1402450,11334185,14.12
9901079,9933715,3972,1390200,11323915,13.99
9901080,9921350,4144,1450400,11371750,14.62
9901081,9919242,4413,1544550,11463792,15.57
9901082,6715910,4520,1582000,8297910,23.56
9901083,9945405,2701,945350,10890755,9.51
9901084,9932050,5558,1945300,11877350,19.59
9901085,9943795,4743,1660050,11603845,16.69
9901086,9922579,4429,1550150,11472729,15.62
9901088,9922366,3654,1278900,11201266,12.89
9901089,8991163,1130,395500,9386663,4.40
9901090,9918927,7921,2772350,12691277,27.95
9901091,3457762,2144,750400,4208162,21.70
9901092,3407017,1503,526050,3933067,15.44
9901093,9922170,6705,2346750,12268920,23.65
9901094,9929098,3403,1191050,11120148,12.00
9901095,9945559,4652,1628200,11573759,16.37
9901096,9940052,4093,1432550,11372602,14.41
9901097,9766173,2818,986300,10752473,10.10
9901098,9929903,3653,1278550,11208453,12.88
9901099,7673452,2571,899850,8573302,11.73
9901100,9932923,3120,1092000,11024923,10.99
9901101,9928136,5978,2092300,12020436,21.07
9901102,9950753,1854,648900,10599653,6.52
9901103,9936195,5007,1752450,11688645,17.64
9901104,8974332,4102,1435700,10410032,16.00
9901105,9937243,5537,1937950,11875193,19.50
9901106,9922846,5197,1818950,11741796,18.33
9901107,9946584,3610,1263500,11210084,12.70
9901108,3007673,935,327250,3334923,10.88
9901109,9933230,5685,1989750,11922980,20.03
9901110,9958455,3772,1320200,11278655,13.26
9901111,9954430,3513,1229550,11183980,12.35
9901112,9958141,3682,1288700,11246841,12.94
9901113,9982704,2070,724500,10707204,7.26
9901114,9965191,2821,987350,10952541,9.91
9901115,9956383,4737,1657950,11614333,16.65
9901116,9957102,5867,2053450,12010552,20.62
9901117,9979513,4971,1739850,11719363,17.43
9901118,9979458,2372,830200,10809658,8.32
9901119,9956310,4457,1559950,11516260,15.67
9901120,9976471,3888,1360800,11337271,13.64
9901121,9968996,3525,1233750,11202746,12.38
9901123,9980488,5108,1787800,11768288,17.91
9901124,9907054,4273,1495550,11402604,15.10
9901126,9966493,2846,996100,10962593,9.99
9901127,9988276,2482,868700,10856976,8.70
9901128,9995449,2437,852950,10848399,8.53
9901129,9974089,3939,1378650,11352739,13.82
9901130,9985508,2604,911400,10896908,9.13
9901131,9986845,2180,763000,10749845,7.64
9901132,9961548,2497,873950,10835498,8.77
9901133,7572389,4056,1419600,8991989,18.75
9901134,9975370,3885,1359750,11335120,13.63
9901135,9964217,2837,992950,10957167,9.97
9901136,9974454,3881,1358350,11332804,13.62
9901137,9987125,3670,1284500,11271625,12.86
9901138,9971879,3657,1279950,11251829,12.84
9901140,9974949,4953,1733550,11708499,17.38
9901142,9952255,6867,2403450,12355705,24.15
9901143,9952451,4710,1648500,11600951,16.56
9901144,9945828,3856,1349600,11295428,13.57
9901145,9938556,6704,2346400,12284956,23.61
9901146,9935057,2384,834400,10769457,8.40
9901147,7107239,1919,671650,7778889,9.45
9901148,9850809,4457,1559950,11410759,15.84
9901149,9851279,3988,1395800,11247079,14.17
9901150,9936094,4462,1561700,11497794,15.72
9901151,9954001,4432,1551200,11505201,15.58
9901152,9962201,3806,1332100,11294301,13.37
9901153,9963731,3758,1315300,11279031,13.20
9901154,9971452,3881,1358350,11329802,13.62
9901155,9965906,5720,2002000,11967906,20.09
9901156,2795962,618,216300,3012262,7.74
9901157,9963615,4219,1476650,11440265,14.82
9901158,9968022,3977,1391950,11359972,13.96
9901159,9967194,6328,2214800,12181994,22.22
9901160,9939894,3723,1303050,11242944,13.11
9901161,9972507,2847,996450,10968957,9.99
9901162,2712941,1148,401800,3114741,14.81
9901163,9962910,7097,2483950,12446860,24.93
9901164,9963561,4473,1565550,11529111,15.71
9901165,9982577,4354,1523900,11506477,15.27
9901166,9977481,2980,1043000,11020481,10.45
9901167,8887693,1679,587650,9475343,6.61
9901168,1953447,303,106050,2059497,5.43
9901169,6978427,3153,1103550,8081977,15.81
9901170,9994012,4737,1657950,11651962,16.59
9901171,9983122,3313,1159550,11142672,11.62
9901172,9962766,1838,643300,10606066,6.46
9901174,4196368,2660,931000,5127368,22.19
9901175,9979058,2964,1037400,11016458,10.40
9901176,7066455,2758,965300,8031755,13.66
9901177,9998325,4610,1613500,11611825,16.14
9901178,9988994,6167,2158450,12147444,21.61
9901179,9972337,4268,1493800,11466137,14.98
9901180,9956335,5850,2047500,12003835,20.56
9901181,9977704,4506,1577100,11554804,15.81
9901182,9986441,5654,1978900,11965341,19.82
9901183,9977277,5099,1784650,11761927,17.89
9901184,3777384,1775,621250,4398634,16.45
9901185,9980134,5478,1917300,11897434,19.21
9901186,9966556,5280,1848000,11814556,18.54
9901187,9974881,6026,2109100,12083981,21.14
9901188,9986579,5408,1892800,11879379,18.95
9901189,9958178,1448,506800,10464978,5.09
9901190,9975069,3379,1182650,11157719,11.86
9901191,9970354,3013,1054550,11024904,10.58
9901192,9990419,4354,1523900,11514319,15.25
9901193,9980880,4094,1432900,11413780,14.36
9901194,9974714,3777,1321950,11296664,13.25
9901195,9980537,4122,1442700,11423237,14.46
9901196,9980871,3796,1328600,11309471,13.31
9901197,9986334,4872,1705200,11691534,17.08
9901198,9989748,4747,1661450,11651198,16.63
9901199,9998206,5205,1821750,11819956,18.22
9901200,9972861,3986,1395100,11367961,13.99
9901201,9962620,4349,1522150,11484770,15.28
9901202,9976809,3815,1335250,11312059,13.38
9901204,1298445,151,52850,1351295,4.07
9901205,9956581,5836,2042600,11999181,20.52
9901206,9949423,2176,761600,10711023,7.65
9901207,9906149,4306,1507100,11413249,15.21
9901208,9975606,3317,1160950,11136556,11.64
9901209,9942990,1744,610400,10553390,6.14
9901210,9969927,3925,1373750,11343677,13.78
9901211,9954403,3613,1264550,11218953,12.70
9901212,9972476,5774,2020900,11993376,20.26
9901213,9968180,5293,1852550,11820730,18.58
9901214,9953724,5049,1767150,11720874,17.75
9901215,9956171,3117,1090950,11047121,10.96
9901216,9972460,2996,1048600,11021060,10.51
9901217,1367511,1134,396900,1764411,29.02
9901218,9945811,2870,1004500,10950311,10.10
9901219,9940261,6373,2230550,12170811,22.44
9901221,9537395,2813,984550,10521945,10.32
9901222,9930199,3490,1221500,11151699,12.30
9901223,9945879,4926,1724100,11669979,17.33
9901224,9959797,3552,1243200,11202997,12.48
9901225,9884260,3783,1324050,11208310,13.40
9901226,9977013,3782,1323700,11300713,13.27
9901227,9967417,4344,1520400,11487817,15.25
9901228,9962243,4325,1513750,11475993,15.19
9901229,9959407,3322,1162700,11122107,11.67
9901230,9627174,3296,1153600,10780774,11.98
9901231,9946141,919,321650,10267791,3.23
9901232,9936073,4625,1618750,11554823,16.29
9901233,9953660,1973,690550,10644210,6.94
9901234,9939227,3021,1057350,10996577,10.64
9901235,9936310,4774,1670900,11607210,16.82
9901236,9955076,2789,976150,10931226,9.81
9901237,9970323,4461,1561350,11531673,15.66
9901238,9968457,3741,1309350,11277807,13.13
9901239,9715466,1032,361200,10076666,3.72
9901240,9964849,4601,1610350,11575199,16.16
9901241,6345049,2458,860300,7205349,13.56
9901242,314517,408,142800,457317,45.40
9901243,9968405,2983,1044050,11012455,10.47
9901244,9966444,3045,1065750,11032194,10.69
9901245,9971219,4759,1665650,11636869,16.70
9901246,9976686,6022,2107700,12084386,21.13
9901247,9970337,2631,920850,10891187,9.24
9901249,9981565,3609,1263150,11244715,12.65
9901250,9974421,3935,1377250,11351671,13.81
9901252,9962699,3182,1113700,11076399,11.18
9901253,9949935,4344,1520400,11470335,15.28
9901255,9940065,5087,1780450,11720515,17.91
9901256,9934611,4521,1582350,11516961,15.93
9901257,9931641,3959,1385650,11317291,13.95
9901258,9789078,3163,1107050,10896128,11.31
9901259,9920458,5516,1930600,11851058,19.46
9901260,9916685,4283,1499050,11415735,15.12
9901262,9914089,1004,351400,10265489,3.54
9901263,9917547,4887,1710450,11627997,17.25
9901264,9914886,4356,1524600,11439486,15.38
9901265,9924443,4654,1628900,11553343,16.41
9901266,9911329,5041,1764350,11675679,17.80
9901267,9926375,3567,1248450,11174825,12.58
9901268,9915965,4969,1739150,11655115,17.54
9901269,9918950,1185,414750,10333700,4.18
9901270,9895922,5854,2048900,11944822,20.70
9901271,9908400,3901,1365350,11273750,13.78
9901272,9919789,3957,1384950,11304739,13.96
9901273,9915206,2974,1040900,10956106,10.50
9901274,9921654,3630,1270500,11192154,12.81
9901275,9942002,5732,2006200,11948202,20.18
9901276,9926676,1375,481250,10407926,4.85
9901277,9920646,6476,2266600,12187246,22.85
9901278,9926518,3228,1129800,11056318,11.38
9901279,9944304,3326,1164100,11108404,11.71
9901280,9946538,3081,1078350,11024888,10.84
9901281,9945008,3428,1199800,11144808,12.06
9901282,9958030,3411,1193850,11151880,11.99
9901283,9972201,3585,1254750,11226951,12.58
9901284,9963180,2779,972650,10935830,9.76
9901285,9979265,3666,1283100,11262365,12.86
9901286,9984679,2791,976850,10961529,9.78
9901287,9968825,3867,1353450,11322275,13.58
9901288,9985393,4652,1628200,11613593,16.31
9901289,6554490,1773,620550,7175040,9.47
9901290,9979606,4870,1704500,11684106,17.08
9901291,9980777,1407,492450,10473227,4.93
9901292,9970510,3539,1238650,11209160,12.42
9901293,9959127,4385,1534750,11493877,15.41
9901294,9956481,5626,1969100,11925581,19.78
9901295,9970725,3021,1057350,11028075,10.60
9901296,9965420,3232,1131200,11096620,11.35
9901297,9971100,2926,1024100,10995200,10.27
9901298,9965151,2804,981400,10946551,9.85
9901299,9969770,4570,1599500,11569270,16.04
9901300,9983930,3415,1195250,11179180,11.97
9901301,9877542,2438,853300,10730842,8.64
9901302,9992899,4597,1608950,11601849,16.10
9901303,9996261,2467,863450,10859711,8.64
9901304,9953130,2150,752500,10705630,7.56
9901305,9966039,3358,1175300,11141339,11.79
9901306,9952451,2917,1020950,10973401,10.26
9901307,9963448,3612,1264200,11227648,12.69
9901308,9984392,3371,1179850,11164242,11.82
9901309,9965362,2296,803600,10768962,8.06
9901310,9946811,2207,772450,10719261,7.77
9901311,9963387,4648,1626800,11590187,16.33
9901312,9965245,1854,648900,10614145,6.51
9901313,9962455,3652,1278200,11240655,12.83
9901314,9941831,3215,1125250,11067081,11.32
9901315,9927966,5637,1972950,11900916,19.87
9901316,9943222,2459,860650,10803872,8.66
9901317,3955711,925,323750,4279461,8.18
9901318,3948967,1441,504350,4453317,12.77
9901319,9911118,5138,1798300,11709418,18.14
9901320,9930063,1990,696500,10626563,7.01
9901321,9923939,3728,1304800,11228739,13.15
9901322,9939346,5423,1898050,11837396,19.10
9901324,6648358,2964,1037400,7685758,15.60
9901325,9936156,4930,1725500,11661656,17.37
9901326,9693526,3479,1217650,10911176,12.56
9901327,9952995,2361,826350,10779345,8.30
9901328,9475161,3979,1392650,10867811,14.70
9901329,9979847,2006,702100,10681947,7.04
9901330,9984822,4248,1486800,11471622,14.89
9901331,9964951,4693,1642550,11607501,16.48
9901332,9988639,3790,1326500,11315139,13.28
9901333,9997143,4940,1729000,11726143,17.29
9901335,9988177,4301,1505350,11493527,15.07
9901336,9970295,1826,639100,10609395,6.41
9901337,6208463,1779,622650,6831113,10.03
9901338,9989059,3655,1279250,11268309,12.81
9901339,9983163,4491,1571850,11555013,15.75
9901340,9423430,4739,1658650,11082080,17.60
9901341,9976771,4574,1600900,11577671,16.05
9901342,9979130,4197,1468950,11448080,14.72
9901343,9971565,4078,1427300,11398865,14.31
9901344,8261320,2976,1041600,9302920,12.61
9901345,9992162,5262,1841700,11833862,18.43
9901346,9997170,3129,1095150,11092320,10.95
9901347,9988714,3020,1057000,11045714,10.58
9901348,9997221,4129,1445150,11442371,14.46
9901349,9981386,3866,1353100,11334486,13.56
9901350,9982863,4403,1541050,11523913,15.44
9901351,9974332,4502,1575700,11550032,15.80
9901352,9972439,5012,1754200,11726639,17.59
9901353,9984290,5025,1758750,11743040,17.62
9901354,9975055,3176,1111600,11086655,11.14
9901355,9983922,4804,1681400,11665322,16.84
9901356,9979220,2187,765450,10744670,7.67
9901357,9979444,1688,590800,10570244,5.92
9901358,9984182,3196,1118600,11102782,11.20
9901359,9984395,1771,619850,10604245,6.21
9901360,9986731,3928,1374800,11361531,13.77
9901361,9972490,5809,2033150,12005640,20.39
9901362,9998374,4594,1607900,11606274,16.08
9901364,9981602,4874,1705900,11687502,17.09
9901365,9965398,3678,1287300,11252698,12.92
9901366,9965194,4205,1471750,11436944,14.77
9901367,9884239,6603,2311050,12195289,23.38
9901368,9981679,3260,1141000,11122679,11.43
9901369,9985138,2535,887250,10872388,8.89
9901370,9981690,2989,1046150,11027840,10.48
9901372,9983601,3456,1209600,11193201,12.12
9901374,9986443,2414,844900,10831343,8.46
9901375,4798859,2218,776300,5575159,16.18
9901376,9986377,4177,1461950,11448327,14.64
9901377,4259252,882,308700,4567952,7.25
9901378,9968562,3860,1351000,11319562,13.55
9901379,9956932,3964,1387400,11344332,13.93
9901380,9668429,3704,1296400,10964829,13.41
9901381,9965577,4089,1431150,11396727,14.36
9901382,9973625,5646,1976100,11949725,19.81
9901383,9992037,4458,1560300,11552337,15.62
9901384,9925431,5848,2046800,11972231,20.62
9901385,9977422,4228,1479800,11457222,14.83
9901386,2662924,2122,742700,3405624,27.89
9901387,9974267,5625,1968750,11943017,19.74
9901388,6321673,1671,584850,6906523,9.25
9901389,9977430,4536,1587600,11565030,15.91
9901390,9982012,5266,1843100,11825112,18.46
9901391,9967252,2765,967750,10935002,9.71
9901392,9973938,5214,1824900,11798838,18.30
9901393,9963198,5017,1755950,11719148,17.62
9901394,9972531,4363,1527050,11499581,15.31
9901395,9980164,1079,377650,10357814,3.78
9901396,9967658,3067,1073450,11041108,10.77
9901397,9972631,2445,855750,10828381,8.58
9901398,9975129,4913,1719550,11694679,17.24
9901399,9474421,4709,1648150,11122571,17.40
9901400,9972805,2193,767550,10740355,7.70
9901401,9995288,7109,2488150,12483438,24.89
9901402,9994276,7448,2606800,12601076,26.08
9901403,9991236,3053,1068550,11059786,10.69
9901404,9990551,5160,1806000,11796551,18.08
9901405,9970838,3637,1272950,11243788,12.77
9901406,9984661,3626,1269100,11253761,12.71
9901407,4433462,1110,388500,4821962,8.76
9901408,9973697,1641,574350,10548047,5.76
9901409,5010316,3618,1266300,6276616,25.27
9901410,9273076,4878,1707300,10980376,18.41
9901411,9971898,3877,1356950,11328848,13.61
9901412,9969403,3965,1387750,11357153,13.92
9901413,5385425,1828,639800,6025225,11.88
9901414,1555604,1014,354900,1910504,22.81
9901415,9970439,2910,1018500,10988939,10.22
9901416,1012294,807,282450,1294744,27.90
9901417,5391775,2771,969850,6361625,17.99
9901418,9964765,3341,1169350,11134115,11.73
9901420,9956345,6039,2113650,12069995,21.23
9901421,9979548,5583,1954050,11933598,19.58
9901422,9969972,5299,1854650,11824622,18.60
9901423,9973152,4208,1472800,11445952,14.77
9901424,9997898,2926,1024100,11021998,10.24
9901425,9983601,6002,2100700,12084301,21.04
9901426,9981851,3506,1227100,11208951,12.29
9901427,9996734,2943,1030050,11026784,10.30
9901428,9979670,2936,1027600,11007270,10.30
9901429,9996800,6589,2306150,12302950,23.07
9901430,9976231,2874,1005900,10982131,10.08
9901431,9974075,5678,1987300,11961375,19.92
9901432,9982910,3876,1356600,11339510,13.59
9901433,2181382,2002,700700,2882082,32.12
9901434,9969284,3755,1314250,11283534,13.18
9901435,8309245,4107,1437450,9746695,17.30
9901437,9993357,3778,1322300,11315657,13.23
9901438,9986514,3719,1301650,11288164,13.03
9901439,9988161,4210,1473500,11461661,14.75
9901440,9995415,3186,1115100,11110515,11.16
9901441,9971772,6208,2172800,12144572,21.79
9901442,9978163,3911,1368850,11347013,13.72
9901443,9964852,4028,1409800,11374652,14.15
9901444,9970195,4061,1421350,11391545,14.26
9901445,9969454,2512,879200,10848654,8.82
9901447,9954454,3093,1082550,11037004,10.88
9901448,9961164,5981,2093350,12054514,21.02
9901449,9963279,5492,1922200,11885479,19.29
9901450,9974929,2653,928550,10903479,9.31
9901451,2539086,1672,585200,3124286,23.05
9901452,9960551,1427,499450,10460001,5.01
9901454,9954522,5228,1829800,11784322,18.38
9901455,9947302,3330,1165500,11112802,11.72
9901456,9951495,2711,948850,10900345,9.53
9901457,9867343,4177,1461950,11329293,14.82
9901458,9963610,2002,700700,10664310,7.03
9901459,9952735,3874,1355900,11308635,13.62
9901460,9964052,6209,2173150,12137202,21.81
9901461,9964731,4547,1591450,11556181,15.97
9901462,9988725,2912,1019200,11007925,10.20
9901463,9998036,2176,761600,10759636,7.62
9901464,9988246,6029,2110150,12098396,21.13
9901465,9968941,4702,1645700,11614641,16.51
9901466,9975939,4325,1513750,11489689,15.17
9901467,9971046,5496,1923600,11894646,19.29
9901468,9987448,3898,1364300,11351748,13.66
9901469,9977981,3804,1331400,11309381,13.34
9901470,9980498,5222,1827700,11808198,18.31
9901471,9991087,2989,1046150,11037237,10.47
9901472,9988050,5533,1936550,11924600,19.39
9901473,4454015,1868,653800,5107815,14.68
9901474,9971954,6818,2386300,12358254,23.93
9901475,9984693,4766,1668100,11652793,16.71
9901476,9991311,1902,665700,10657011,6.66
9901477,9992550,3660,1281000,11273550,12.82
9901479,9978810,2681,938350,10917160,9.40
9901480,9989501,5234,1831900,11821401,18.34
9901481,9990090,5163,1807050,11797140,18.09
9901482,9993065,4142,1449700,11442765,14.51
9901483,9990487,4411,1543850,11534337,15.45
9901484,3805691,1359,475650,4281341,12.50
9901486,9968603,5543,1940050,11908653,19.46
9901487,9973819,4402,1540700,11514519,15.45
9901488,9981484,6595,2308250,12289734,23.13
9901489,9996940,1258,440300,10437240,4.40
9901490,9635074,4232,1481200,11116274,15.37
9901491,778294,790,276500,1054794,35.53
9901492,9353592,2468,863800,10217392,9.23
9901493,9987275,4020,1407000,11394275,14.09
9901494,8488802,7541,2639350,11128152,31.09
9901495,9985345,3209,1123150,11108495,11.25
9901496,9991684,5663,1982050,11973734,19.84
9901497,9995444,3262,1141700,11137144,11.42
9901498,9988447,4086,1430100,11418547,14.32
9901499,9974828,2876,1006600,10981428,10.09
9901500,9977750,5326,1864100,11841850,18.68
9901501,9955653,3231,1130850,11086503,11.36
9901502,1260006,179,62650,1322656,4.97
9901503,9943912,5181,1813350,11757262,18.24
9901504,9944374,1892,662200,10606574,6.66
9901505,9946756,2752,963200,10909956,9.68
9901507,9959589,4098,1434300,11393889,14.40
9901508,2975376,3656,1279600,4254976,43.01
9901509,9996083,2472,865200,10861283,8.66
9901510,9998696,3497,1223950,11222646,12.24
9901511,9977839,2758,965300,10943139,9.67
9901512,9985927,3744,1310400,11296327,13.12
9901513,5573549,4974,1740900,7314449,31.24
9901514,9967901,2362,826700,10794601,8.29
9901515,9992266,2848,996800,10989066,9.98
9901516,4625865,2163,757050,5382915,16.37
9901517,9987458,7101,2485350,12472808,24.88
9901518,9993260,2696,943600,10936860,9.44
9901519,9990000,6175,2161250,12151250,21.63
9901520,9974436,3548,1241800,11216236,12.45
9901521,9985720,3744,1310400,11296120,13.12
9901522,9980558,4210,1473500,11454058,14.76
9901523,9992622,5616,1965600,11958222,19.67
9901524,9979861,4829,1690150,11670011,16.94
9901525,9986538,4870,1704500,11691038,17.07
9901526,9983219,2142,749700,10732919,7.51
9901527,894327,353,123550,1017877,13.81
9901528,613771,154,53900,667671,8.78
9901529,9939432,3050,1067500,11006932,10.74
9901530,1524578,1740,609000,2133578,39.95
9901531,9936615,2205,771750,10708365,7.77
9901532,9954196,3435,1202250,11156446,12.08
9901533,9969072,3281,1148350,11117422,11.52
9901534,9957045,2852,998200,10955245,10.03
9901535,9961589,3255,1139250,11100839,11.44
9901536,9977666,4323,1513050,11490716,15.16
9901537,9966985,7083,2479050,12446035,24.87
9901538,7964327,1626,569100,8533427,7.15
9901539,3736853,500,175000,3911853,4.68
9901540,9991711,7053,2468550,12460261,24.71
9901541,9988878,4440,1554000,11542878,15.56
9901542,9972438,5277,1846950,11819388,18.52
9901543,9959351,2982,1043700,11003051,10.48
9901544,9951542,427,149450,10100992,1.50
9901545,9953265,2951,1032850,10986115,10.38
9901546,9968137,3940,1379000,11347137,13.83
9901547,9974416,3089,1081150,11055566,10.84
9901548,9983307,1956,684600,10667907,6.86
9901549,9977927,7471,2614850,12592777,26.21
9901550,9972706,2824,988400,10961106,9.91
9901551,9956485,2550,892500,10848985,8.96
9901552,9966827,1827,639450,10606277,6.42
9901553,9987187,1390,486500,10473687,4.87
9901554,9978104,3913,1369550,11347654,13.73
9901555,9975818,7837,2742950,12718768,27.50
9901556,9913095,4013,1404550,11317645,14.17
9901557,9968518,5895,2063250,12031768,20.70
9901558,9968501,4313,1509550,11478051,15.14
9901559,9971119,2687,940450,10911569,9.43
9901560,9978350,2036,712600,10690950,7.14
9901561,9988274,4023,1408050,11396324,14.10
9901562,9987553,4732,1656200,11643753,16.58
9901563,9960931,6415,2245250,12206181,22.54
9901564,9982842,6598,2309300,12292142,23.13
9901565,9986656,3172,1110200,11096856,11.12
9901566,9966812,2532,886200,10853012,8.89
9901567,2366787,610,213500,2580287,9.02
9901568,9977503,3366,1178100,11155603,11.81
9901569,9976392,1951,682850,10659242,6.84
9901570,9981192,3655,1279250,11260442,12.82
9901571,9983325,2339,818650,10801975,8.20
9901572,9984050,5087,1780450,11764500,17.83
9901573,9962802,5214,1824900,11787702,18.32
9901574,9972988,7024,2458400,12431388,24.65
9901575,5837071,2390,836500,6673571,14.33
9901576,9970775,3130,1095500,11066275,10.99
9901577,9980861,3174,1110900,11091761,11.13
9901578,9981447,3031,1060850,11042297,10.63
9901579,9979683,2492,872200,10851883,8.74
9901580,9977552,1935,677250,10654802,6.79
9901581,9993056,3008,1052800,11045856,10.54
9901582,9981314,3685,1289750,11271064,12.92
9901583,9992555,3632,1271200,11263755,12.72
9901584,9951738,2862,1001700,10953438,10.07
9901585,9971060,3462,1211700,11182760,12.15
9901586,2714535,438,153300,2867835,5.65
9901587,9955304,4114,1439900,11395204,14.46
9901588,9962585,4515,1580250,11542835,15.86
9901589,9987386,2633,921550,10908936,9.23
9901590,9990356,3587,1255450,11245806,12.57
9901591,9988392,4804,1681400,11669792,16.83
9901592,9993918,3448,1206800,11200718,12.08
9901593,9985185,2687,940450,10925635,9.42
9901594,9988346,2914,1019900,11008246,10.21
9901595,9901041,2978,1042300,10943341,10.53
9901596,9960150,2483,869050,10829200,8.73
9901597,9964560,4172,1460200,11424760,14.65
9901598,3693628,1781,623350,4316978,16.88
9901599,9949595,3189,1116150,11065745,11.22
9901600,9934656,4957,1734950,11669606,17.46
9901601,9928415,3258,1140300,11068715,11.49
9901602,9923911,2981,1043350,10967261,10.51
9901603,9930171,2764,967400,10897571,9.74
9901604,9930686,3351,1172850,11103536,11.81
9901605,9930278,3351,1172850,11103128,11.81
9901606,9918975,5349,1872150,11791125,18.87
9901607,9919564,3485,1219750,11139314,12.30
9901608,9907829,2769,969150,10876979,9.78
9901609,9912671,3391,1186850,11099521,11.97
9901610,9937479,2023,708050,10645529,7.13
9901611,9923352,3865,1352750,11276102,13.63
9901612,9934691,5277,1846950,11781641,18.59
9901613,9926180,3908,1367800,11293980,13.78
9901614,9936985,4632,1621200,11558185,16.31
9901615,4932640,2327,814450,5747090,16.51
9901616,9960616,3813,1334550,11295166,13.40
9901617,9958497,3991,1396850,11355347,14.03
9901618,9964069,4785,1674750,11638819,16.81
9901619,9967043,3272,1145200,11112243,11.49
9901620,9946207,5208,1822800,11769007,18.33
9901621,9966402,3829,1340150,11306552,13.45
9901622,9964201,4728,1654800,11619001,16.61
9901623,9959420,2203,771050,10730470,7.74
9901624,9981471,2504,876400,10857871,8.78
9901625,9959624,2668,933800,10893424,9.38
9901626,9965265,4709,1648150,11613415,16.54
9901627,9963264,4102,1435700,11398964,14.41
9901628,9980809,4011,1403850,11384659,14.07
9901629,9965766,5399,1889650,11855416,18.96
9901631,9949976,1889,661150,10611126,6.64
9901632,9962342,4366,1528100,11490442,15.34
9901633,9966574,2978,1042300,11008874,10.46
9901634,9975158,5106,1787100,11762258,17.92
9901635,9975018,5411,1893850,11868868,18.99
9901636,9982024,3763,1317050,11299074,13.19
9901637,4781580,2164,757400,5538980,15.84
9901638,7238979,3183,1114050,8353029,15.39
9901639,9990995,5451,1907850,11898845,19.10
9901640,3550781,831,290850,3841631,8.19
9901641,9981502,3544,1240400,11221902,12.43
9901642,9982384,6249,2187150,12169534,21.91
9901643,9984968,3459,1210650,11195618,12.12
9901644,9993364,4221,1477350,11470714,14.78
9901645,9969441,3100,1085000,11054441,10.88
9901646,7856612,3922,1372700,9229312,17.47
9901647,9996120,4275,1496250,11492370,14.97
9901648,9987701,4013,1404550,11392251,14.06
9901649,3182557,2133,746550,3929107,23.46
9901650,9905971,4315,1510250,11416221,15.25
9901651,3079264,953,333550,3412814,10.83
9901652,9970553,4254,1488900,11459453,14.93
9901653,9933353,3890,1361500,11294853,13.71
9901654,9955759,3397,1188950,11144709,11.94
9901655,9974269,1727,604450,10578719,6.06
9901656,9953603,5290,1851500,11805103,18.60
9901657,9956062,2621,917350,10873412,9.21
9901658,9970981,1723,603050,10574031,6.05
9901660,5423567,2963,1037050,6460617,19.12
9901661,9983046,3175,1111250,11094296,11.13
9901662,9971300,3150,1102500,11073800,11.06
9901663,9985718,2318,811300,10797018,8.12
9901664,9994740,7080,2478000,12472740,24.79
9901666,9976696,2293,802550,10779246,8.04
9901667,9983628,3026,1059100,11042728,10.61
9901668,9975190,2983,1044050,11019240,10.47
9901669,9990232,3531,1235850,11226082,12.37
9901670,9976280,3309,1158150,11134430,11.61
9901671,9990547,3454,1208900,11199447,12.10
9901672,9977872,5476,1916600,11894472,19.21
9901673,9971409,1254,438900,10410309,4.40
9901674,9300140,2124,743400,10043540,7.99
9901675,9980555,4834,1691900,11672455,16.95
9901676,9973758,4042,1414700,11388458,14.18
9901677,9994493,1613,564550,10559043,5.65
9901678,9984391,1654,578900,10563291,5.80
9901679,9985088,3938,1378300,11363388,13.80
9901680,9986491,2679,937650,10924141,9.39
9901681,9977908,6093,2132550,12110458,21.37
9901682,9953861,5519,1931650,11885511,19.41
9901683,9962566,1467,513450,10476016,5.15
9901684,9983710,2512,879200,10862910,8.81
9901685,9979332,4004,1401400,11380732,14.04
9901686,9992800,2893,1012550,11005350,10.13
9901687,9976511,2286,800100,10776611,8.02
9901688,9978366,4390,1536500,11514866,15.40
9901689,9984704,4937,1727950,11712654,17.31
9901690,9994150,4179,1462650,11456800,14.64
9901691,9973809,4134,1446900,11420709,14.51
9901692,9975325,3040,1064000,11039325,10.67
9901693,9972450,3405,1191750,11164200,11.95
9901694,9982731,4937,1727950,11710681,17.31
9901695,9985447,5376,1881600,11867047,18.84
9901696,9987942,4234,1481900,11469842,14.84
9901697,9969284,3426,1199100,11168384,12.03
9901699,9973038,4464,1562400,11535438,15.67
9901700,9980394,2369,829150,10809544,8.31
9901701,9982424,3270,1144500,11126924,11.47
9901702,9974032,1348,471800,10445832,4.73
9901703,9962113,4301,1505350,11467463,15.11
9901704,9909673,1232,431200,10340873,4.35
9901705,9969959,3540,1239000,11208959,12.43
9901706,9971007,4358,1525300,11496307,15.30
9901707,9984535,2766,968100,10952635,9.70
9901708,9988466,4241,1484350,11472816,14.86
9901710,9978965,3055,1069250,11048215,10.72
9901711,8683561,3468,1213800,9897361,13.98
9901712,9983758,5738,2008300,11992058,20.12
9901713,9965301,8269,2894150,12859451,29.04
9901714,9958585,3794,1327900,11286485,13.33
9901715,9973533,4371,1529850,11503383,15.34
9901716,9981312,2333,816550,10797862,8.18
9901717,9969533,5641,1974350,11943883,19.80
9901718,3484507,867,303450,3787957,8.71
9901719,9959467,4316,1510600,11470067,15.17
9901720,8914116,2319,811650,9725766,9.11
9901721,9948807,3420,1197000,11145807,12.03
9901722,9956756,4789,1676150,11632906,16.83
9901723,9935711,3664,1282400,11218111,12.91
9901724,9945111,2644,925400,10870511,9.31
9901725,9966229,4067,1423450,11389679,14.28
9901726,9978717,3456,1209600,11188317,12.12
9901727,9971040,1377,481950,10452990,4.83
9901728,6600501,1515,530250,7130751,8.03
9901730,9969309,3353,1173550,11142859,11.77
9901731,9980991,1358,475300,10456291,4.76
9901733,4562343,1927,674450,5236793,14.78
9901734,9987854,1655,579250,10567104,5.80
9901735,9997101,3477,1216950,11214051,12.17
9901736,9969797,4737,1657950,11627747,16.63
9901737,9977721,2713,949550,10927271,9.52
9901738,9985713,2939,1028650,11014363,10.30
9901739,9982868,3443,1205050,11187918,12.07
9901740,9984907,2761,966350,10951257,9.68
9901741,9984184,3249,1137150,11121334,11.39
9901742,9982207,3967,1388450,11370657,13.91
9901743,9965317,2526,884100,10849417,8.87
9901744,9968749,3794,1327900,11296649,13.32
9901745,9961785,3980,1393000,11354785,13.98
9901746,9960258,2912,1019200,10979458,10.23
9901747,9980232,1979,692650,10672882,6.94
9901748,9988106,4442,1554700,11542806,15.57
9901749,9985949,3694,1292900,11278849,12.95
9901750,9998383,5911,2068850,12067233,20.69
9901751,9972740,3957,1384950,11357690,13.89
9901752,9970329,4402,1540700,11511029,15.45
9901753,9956116,3007,1052450,11008566,10.57
9901754,9970070,3776,1321600,11291670,13.26
9901755,9950059,794,277900,10227959,2.79
9901756,9962374,3014,1054900,11017274,10.59
9901757,9961004,3430,1200500,11161504,12.05
9901758,3283501,755,264250,3547751,8.05
9901759,9972629,3528,1234800,11207429,12.38
9901760,9976267,4382,1533700,11509967,15.37
9901761,9990544,3560,1246000,11236544,12.47
9901762,9989427,1399,489650,10479077,4.90
9901763,9977728,3305,1156750,11134478,11.59
9901764,9979248,3088,1080800,11060048,10.83
9901765,9978603,3347,1171450,11150053,11.74
9901766,9957535,4624,1618400,11575935,16.25
9901767,9964372,3212,1124200,11088572,11.28
9901768,9941920,3055,1069250,11011170,10.75
9901769,9955106,2511,878850,10833956,8.83
9901770,9936032,4200,1470000,11406032,14.79
9901771,9974936,2236,782600,10757536,7.85
9901772,9974996,3767,1318450,11293446,13.22
9901773,9973882,2535,887250,10861132,8.90
9901774,9991496,4854,1698900,11690396,17.00
9901775,2079801,499,174650,2254451,8.40
9901776,9986251,2974,1040900,11027151,10.42
9901777,9996754,3039,1063650,11060404,10.64
9901778,9977190,2496,873600,10850790,8.76
9901779,9992260,1849,647150,10639410,6.48
9901780,9971031,2945,1030750,11001781,10.34
9901781,3165355,1389,486150,3651505,15.36
9901782,9974578,5839,2043650,12018228,20.49
9901783,9986291,3035,1062250,11048541,10.64
9901784,9964446,4531,1585850,11550296,15.92
9901785,9279477,2057,719950,9999427,7.76
9901786,9989743,4298,1504300,11494043,15.06
9901787,9978645,1792,627200,10605845,6.29
9901788,9976609,4255,1489250,11465859,14.93
9901789,9930194,1537,537950,10468144,5.42
9901790,2386353,1066,373100,2759453,15.63
9901791,9957704,4101,1435350,11393054,14.41
9901792,9971578,3254,1138900,11110478,11.42
9901793,9975788,3919,1371650,11347438,13.75
9901794,9993858,2781,973350,10967208,9.74
9901795,9980271,3520,1232000,11212271,12.34
9901796,9993174,4032,1411200,11404374,14.12
9901797,9985039,2224,778400,10763439,7.80
9901798,9980476,4883,1709050,11689526,17.12
9901799,9994612,3280,1148000,11142612,11.49
9901800,9985918,3202,1120700,11106618,11.22
9901801,9979898,4351,1522850,11502748,15.26
9901802,9981637,4423,1548050,11529687,15.51
9901803,9987309,2390,836500,10823809,8.38
9901804,9991654,2812,984200,10975854,9.85
9901805,8110509,2980,1043000,9153509,12.86
9901807,9970136,2183,764050,10734186,7.66
9901808,9951990,2345,820750,10772740,8.25
9901809,9940590,4811,1683850,11624440,16.94
9901810,9929741,2979,1042650,10972391,10.50
9901811,9968230,3276,1146600,11114830,11.50
9901812,9955769,2585,904750,10860519,9.09
9901813,9971303,2183,764050,10735353,7.66
9901814,9985763,3282,1148700,11134463,11.50
9901815,9996424,3350,1172500,11168924,11.73
9901816,2370603,1279,447650,2818253,18.88
9901817,9969553,2424,848400,10817953,8.51
9901818,9983275,3705,1296750,11280025,12.99
9901819,9975244,2570,899500,10874744,9.02
9901820,9958821,2995,1048250,11007071,10.53
9901821,9944930,2684,939400,10884330,9.45
9901822,9957362,3899,1364650,11322012,13.70
9901823,8859839,2759,965650,9825489,10.90
9901824,9967755,2932,1026200,10993955,10.30
9901825,9957334,3578,1252300,11209634,12.58
9901826,9958248,3665,1282750,11240998,12.88
9901827,1373879,448,156800,1530679,11.41
9901828,9946537,2501,875350,10821887,8.80
9901829,9945177,2723,953050,10898227,9.58
9901830,9875184,3170,1109500,10984684,11.24
9901831,9970009,3672,1285200,11255209,12.89
9901832,9971405,2543,890050,10861455,8.93
9901833,9917801,1555,544250,10462051,5.49
9901834,9955612,2597,908950,10864562,9.13
9901835,9971018,1881,658350,10629368,6.60
9901836,9971622,3421,1197350,11168972,12.01
9901837,9993425,3706,1297100,11290525,12.98
9901838,9984979,4038,1413300,11398279,14.15
9901839,9983794,3595,1258250,11242044,12.60
9901840,9980875,2381,833350,10814225,8.35
9901841,9987000,4597,1608950,11595950,16.11
9901842,9974886,4616,1615600,11590486,16.20
9901843,9987618,3053,1068550,11056168,10.70
9901844,9991348,2491,871850,10863198,8.73
9901845,9986592,2967,1038450,11025042,10.40
9901846,9997184,2324,813400,10810584,8.14
9901847,9974622,3473,1215550,11190172,12.19
9901848,9964968,3134,1096900,11061868,11.01
9901850,9971749,4619,1616650,11588399,16.21
9901851,9956528,2266,793100,10749628,7.97
9901853,9936829,4436,1552600,11489429,15.62
9901854,9947814,3622,1267700,11215514,12.74
9901855,9958258,4085,1429750,11388008,14.36
9901857,9951461,1888,660800,10612261,6.64
9901858,2455492,1058,370300,2825792,15.08
9901859,9953481,4199,1469650,11423131,14.77
9901860,9958284,4019,1406650,11364934,14.13
9901861,9970477,3577,1251950,11222427,12.56
9901862,9972427,4316,1510600,11483027,15.15
9901863,9986938,4700,1645000,11631938,16.47
9901864,9993990,1949,682150,10676140,6.83
9901865,9985760,5035,1762250,11748010,17.65
9901866,9988508,2691,941850,10930358,9.43
9901868,9987426,4491,1571850,11559276,15.74
9901869,9995902,5460,1911000,11906902,19.12
9901870,9991523,3063,1072050,11063573,10.73
9901871,9977980,4864,1702400,11680380,17.06
9901872,9959496,3810,1333500,11292996,13.39
9901873,9685209,2585,904750,10589959,9.34
9901874,9959037,1994,697900,10656937,7.01
9901875,9935139,2772,970200,10905339,9.77
9901876,9948572,4008,1402800,11351372,14.10
9901877,9657933,4096,1433600,11091533,14.84
9901878,9971766,2056,719600,10691366,7.22
9901879,9976999,2487,870450,10847449,8.72
9901880,9963339,6179,2162650,12125989,21.71
9901881,9979792,5068,1773800,11753592,17.77
9901882,9970000,3689,1291150,11261150,12.95
9901883,9959396,5264,1842400,11801796,18.50
9901884,9946421,3301,1155350,11101771,11.62
9901885,9957722,6891,2411850,12369572,24.22
9901886,5197187,2182,763700,5960887,14.69
9901887,9946925,3903,1366050,11312975,13.73
9901888,4467581,1716,600600,5068181,13.44
9901889,9956887,4684,1639400,11596287,16.46
9901890,9977518,3912,1369200,11346718,13.72
9901891,9953134,5674,1985900,11939034,19.95
9901892,9938075,4196,1468600,11406675,14.78
9901893,9972284,4192,1467200,11439484,14.71
9901894,9968482,4769,1669150,11637632,16.74
9901895,9989499,3455,1209250,11198749,12.11
9901896,9966943,5617,1965950,11932893,19.72
9901897,5185842,1567,548450,5734292,10.58
9901898,9890558,4215,1475250,11365808,14.92
9901899,9976439,3521,1232350,11208789,12.35
9901900,4871331,3021,1057350,5928681,21.71
9901901,9976652,5199,1819650,11796302,18.24
9901902,4594081,1860,651000,5245081,14.17
9901903,9981351,4981,1743350,11724701,17.47
9901904,9970876,3125,1093750,11064626,10.97
9901905,3048652,1001,350350,3399002,11.49
9901906,9953914,4537,1587950,11541864,15.95
9901908,9984690,2700,945000,10929690,9.46
9901909,4210329,2518,881300,5091629,20.93
9901910,9981053,2494,872900,10853953,8.75
9901911,2995808,3233,1131550,4127358,37.77
9901912,9969521,1510,528500,10498021,5.30
9901913,9964513,4707,1647450,11611963,16.53
9901914,9948142,2377,831950,10780092,8.36
9901915,9967242,4319,1511650,11478892,15.17
9901916,9390089,3286,1150100,10540189,12.25
9901917,9985582,4615,1615250,11600832,16.18
9901918,9979242,2173,760550,10739792,7.62
9901920,9993417,4902,1715700,11709117,17.17
9901921,9995696,3834,1341900,11337596,13.42
9901922,9998403,3880,1358000,11356403,13.58
9901923,9997278,2865,1002750,11000028,10.03
9901924,9989662,5232,1831200,11820862,18.33
9901925,9995445,3129,1095150,11090595,10.96
9901926,9994535,2509,878150,10872685,8.79
9901927,9986829,2192,767200,10754029,7.68
9901928,9976231,3019,1056650,11032881,10.59
9901929,9977295,4468,1563800,11541095,15.67
9901930,9887306,3913,1369550,11256856,13.85
9901931,2148804,1352,473200,2622004,22.02
9901933,9989183,3948,1381800,11370983,13.83
9901934,9984932,2872,1005200,10990132,10.07
9901935,7956784,3371,1179850,9136634,14.83
9901936,9990718,6020,2107000,12097718,21.09
9901937,9977093,5415,1895250,11872343,19.00
9901938,9976158,5804,2031400,12007558,20.36
9901939,9999169,2917,1020950,11020119,10.21
9901940,1922177,787,275450,2197627,14.33
9901941,9763198,2522,882700,10645898,9.04
9901942,9980205,2435,852250,10832455,8.54
9901943,9979160,5419,1896650,11875810,19.01
9901944,9984559,1731,605850,10590409,6.07
9901945,9986551,3049,1067150,11053701,10.69
9901946,9756643,4032,1411200,11167843,14.46
9901947,9896601,3173,1110550,11007151,11.22
9901948,9997744,5174,1810900,11808644,18.11
9901949,9997847,6127,2144450,12142297,21.45
9901950,9977531,2375,831250,10808781,8.33
9901951,9969186,5109,1788150,11757336,17.94
9901952,9982747,2992,1047200,11029947,10.49
9901953,9971273,3305,1156750,11128023,11.60
9901954,9993070,4809,1683150,11676220,16.84
9901955,9977353,3391,1186850,11164203,11.90
9901956,9987861,4431,1550850,11538711,15.53
9901957,9990455,3920,1372000,11362455,13.73
9901958,9985201,2184,764400,10749601,7.66
9901959,9978749,3398,1189300,11168049,11.92
9901960,9996100,3606,1262100,11258200,12.63
9901961,9980337,2742,959700,10940037,9.62
9901962,9975615,3500,1225000,11200615,12.28
9901963,9978896,4157,1454950,11433846,14.58
9901964,9976161,4183,1464050,11440211,14.68
9901965,9975502,4043,1415050,11390552,14.19
9901966,9980472,4206,1472100,11452572,14.75
9901967,9976495,3740,1309000,11285495,13.12
9901968,9960051,1885,659750,10619801,6.62
9901969,9983627,4486,1570100,11553727,15.73
9901970,9980154,3068,1073800,11053954,10.76
9901971,1198996,431,150850,1349846,12.58
9901972,9960330,2036,712600,10672930,7.15
9901973,9961147,2254,788900,10750047,7.92
9901974,9945323,2456,859600,10804923,8.64
9901975,9948522,2150,752500,10701022,7.56
9901976,9946882,2791,976850,10923732,9.82
9901977,9958140,3094,1082900,11041040,10.87
9901978,9952794,3142,1099700,11052494,11.05
9901979,9944005,2486,870100,10814105,8.75
9901980,9960788,3650,1277500,11238288,12.83
9901981,9941292,4875,1706250,11647542,17.16
9901982,3071287,1765,617750,3689037,20.11
9901983,9940546,3702,1295700,11236246,13.03
9901984,9957701,4938,1728300,11686001,17.36
9901985,9965982,4176,1461600,11427582,14.67
9901986,9956761,4129,1445150,11401911,14.51
9901987,9944685,4030,1410500,11355185,14.18
9901988,9961704,4728,1654800,11616504,16.61
9901989,9955419,2696,943600,10899019,9.48
9901990,9971512,4105,1436750,11408262,14.41
9901991,9956006,1792,627200,10583206,6.30
9901992,9981803,3914,1369900,11351703,13.72
9901993,9991119,4062,1421700,11412819,14.23
9901994,9969189,3610,1263500,11232689,12.67
9901995,1646370,730,255500,1901870,15.52
9901996,9998584,5624,1968400,11966984,19.69
9901997,9981270,3011,1053850,11035120,10.56
9901998,9976436,2939,1028650,11005086,10.31
9901999,9974257,3334,1166900,11141157,11.70
9902000,9978006,1180,413000,10391006,4.14
9902001,9981142,7317,2560950,12542092,25.66
9902002,9981168,4195,1468250,11449418,14.71
9902003,8945330,2400,840000,9785330,9.39
9902004,9986145,6390,2236500,12222645,22.40
9902006,9985018,2615,915250,10900268,9.17
9902007,9982704,5839,2043650,12026354,20.47
9902008,9989074,3390,1186500,11175574,11.88
9902009,6049555,1354,473900,6523455,7.83
9902010,9962856,3438,1203300,11166156,12.08
9902011,9971933,4167,1458450,11430383,14.63
9902012,9974578,3105,1086750,11061328,10.90
9902013,9973346,3719,1301650,11274996,13.05
9902014,9970740,2820,987000,10957740,9.90
9902015,2292149,415,145250,2437399,6.34
9902016,9967018,2833,991550,10958568,9.95
9902017,350247,107,37450,387697,10.69
9902018,9966350,2388,835800,10802150,8.39
9902019,9964894,5291,1851850,11816744,18.58
9902020,9973157,5373,1880550,11853707,18.86
9902021,9978911,4026,1409100,11388011,14.12
9902022,9987258,1030,360500,10347758,3.61
9902023,9980234,3710,1298500,11278734,13.01
9902024,9999393,2647,926450,10925843,9.27
9902026,9977812,4381,1533350,11511162,15.37
9902027,251408,189,66150,317558,26.31
9902028,9989727,4760,1666000,11655727,16.68
9902029,9995991,2017,705950,10701941,7.06
9902030,9985437,2910,1018500,11003937,10.20
9902031,3861680,1914,669900,4531580,17.35
9902032,4064757,1455,509250,4574007,12.53
9902033,9986754,4823,1688050,11674804,16.90
9902034,9972584,4558,1595300,11567884,16.00
9902035,3937760,558,195300,4133060,4.96
9902036,4447510,489,171150,4618660,3.85
9902037,9973288,3075,1076250,11049538,10.79
9902038,9940420,5453,1908550,11848970,19.20
9902039,5518853,3438,1203300,6722153,21.80
9902040,9938830,3059,1070650,11009480,10.77
9902041,734459,234,81900,816359,11.15
9902043,9942641,2161,756350,10698991,7.61
9902044,9962211,5170,1809500,11771711,18.16
9902045,3549248,1171,409850,3959098,11.55
9902046,9964628,2640,924000,10888628,9.27
9902047,9953941,3282,1148700,11102641,11.54
9902048,9969570,4732,1656200,11625770,16.61
9902049,4047924,1878,657300,4705224,16.24
9902050,287907,126,44100,332007,15.32
9902051,9955931,4100,1435000,11390931,14.41
9902052,8900999,1314,459900,9360899,5.17
9902053,9978415,3613,1264550,11242965,12.67
9902054,9992013,3248,1136800,11128813,11.38
9902055,7346321,2281,798350,8144671,10.87
9902056,9992066,1909,668150,10660216,6.69
9902057,9982338,3797,1328950,11311288,13.31
9902058,9973654,3365,1177750,11151404,11.81
9902059,9969655,1669,584150,10553805,5.86
9902060,1861144,555,194250,2055394,10.44
9902061,9966005,2916,1020600,10986605,10.24
9902062,9965569,3603,1261050,11226619,12.65
9902063,9985918,3015,1055250,11041168,10.57
9902064,9978360,4039,1413650,11392010,14.17
9902065,9973062,4008,1402800,11375862,14.07
9902066,9969701,2101,735350,10705051,7.38
9902067,9172688,1564,547400,9720088,5.97
9902068,9984808,3052,1068200,11053008,10.70
9902069,9987689,4331,1515850,11503539,15.18
9902070,9998904,3644,1275400,11274304,12.76
9902071,1106519,557,194950,1301469,17.62
9902072,9969818,4168,1458800,11428618,14.63
9902073,9962288,5337,1867950,11830238,18.75
9902074,9951304,3529,1235150,11186454,12.41
9902075,5761785,1982,693700,6455485,12.04
9902076,9961916,3663,1282050,11243966,12.87
9902077,9969364,3887,1360450,11329814,13.65
9902078,9974836,1642,574700,10549536,5.76
9902079,2821484,476,166600,2988084,5.90
9902080,3499088,2442,854700,4353788,24.43
9902081,9952396,2996,1048600,11000996,10.54
9902082,9972421,3147,1101450,11073871,11.04
9902083,9974491,3742,1309700,11284191,13.13
9902084,9985824,4530,1585500,11571324,15.88
9902086,9979607,3805,1331750,11311357,13.34
9902087,9977283,2144,750400,10727683,7.52
9902088,9863873,5160,1806000,11669873,18.31
9902089,9965006,3758,1315300,11280306,13.20
9902090,9970077,6165,2157750,12127827,21.64
9902091,9981193,5289,1851150,11832343,18.55
9902092,9990598,4602,1610700,11601298,16.12
9902093,9985732,3374,1180900,11166632,11.83
9902094,9996281,2397,838950,10835231,8.39
9902095,9589634,2788,975800,10565434,10.18
9902096,9986272,3491,1221850,11208122,12.24
9902097,9998391,6534,2286900,12285291,22.87
9902098,9974214,3140,1099000,11073214,11.02
9902099,9760271,4628,1619800,11380071,16.60
9902100,114615,42,14700,129315,12.83
9902101,9962522,4281,1498350,11460872,15.04
9902102,9985891,4427,1549450,11535341,15.52
9902103,9995511,2907,1017450,11012961,10.18
9902104,9980771,1482,518700,10499471,5.20
9902105,687879,619,216650,904529,31.50
9902106,1707915,947,331450,2039365,19.41
9902107,9957853,4058,1420300,11378153,14.26
9902108,9972990,5067,1773450,11746440,17.78
9902109,9983789,4109,1438150,11421939,14.40
9902110,9986527,3814,1334900,11321427,13.37
9902111,9979253,3492,1222200,11201453,12.25
9902112,9981317,3508,1227800,11209117,12.30
9902113,9083807,3195,1118250,10202057,12.31
9902114,7522060,3930,1375500,8897560,18.29
9902116,8162451,1787,625450,8787901,7.66
9902117,9961954,4396,1538600,11500554,15.44
9902118,9954555,3615,1265250,11219805,12.71
9902119,3881682,912,319200,4200882,8.22
9902120,9956324,4411,1543850,11500174,15.51
9902121,9959476,4375,1531250,11490726,15.37
9902122,9968953,4040,1414000,11382953,14.18
9902123,9967961,3744,1310400,11278361,13.15
9902124,1402372,400,140000,1542372,9.98
9902125,6287354,2011,703850,6991204,11.19
9902126,9985868,3339,1168650,11154518,11.70
9902127,9986287,3533,1236550,11222837,12.38
9902128,9975993,3107,1087450,11063443,10.90
9902129,9976182,5345,1870750,11846932,18.75
9902131,9958979,5494,1922900,11881879,19.31
9902132,9973513,2366,828100,10801613,8.30
9902133,9984920,4356,1524600,11509520,15.27
9902134,4489603,1937,677950,5167553,15.10
9902135,9994364,3179,1112650,11107014,11.13
9902136,9976798,3780,1323000,11299798,13.26
9902137,9994188,2778,972300,10966488,9.73
9902138,9999198,1058,370300,10369498,3.70
9902139,9992416,2087,730450,10722866,7.31
9902140,9996740,4584,1604400,11601140,16.05
9902142,9979865,2724,953400,10933265,9.55
9902143,9978461,2194,767900,10746361,7.70
9902144,9991677,3958,1385300,11376977,13.86
9902145,9988472,3857,1349950,11338422,13.52
9902146,9991090,3148,1101800,11092890,11.03
9902147,1980716,430,150500,2131216,7.60
9902148,4221282,1226,429100,4650382,10.17
9902149,5466491,4253,1488550,6955041,27.23
9902150,9970879,2138,748300,10719179,7.50
9902151,9989088,5043,1765050,11754138,17.67
9902152,9979984,3675,1286250,11266234,12.89
9902153,9987747,3173,1110550,11098297,11.12
9902154,9969795,2159,755650,10725445,7.58
9902155,9983459,3017,1055950,11039409,10.58
9902156,9839182,4493,1572550,11411732,15.98
9902157,9987965,3140,1099000,11086965,11.00
9902158,9973796,5195,1818250,11792046,18.23
9902159,9988960,3559,1245650,11234610,12.47
9902160,9994049,2770,969500,10963549,9.70
9902162,3941566,3893,1362550,5304116,34.57
9902165,9988345,3917,1370950,11359295,13.73
9902166,8978326,3861,1351350,10329676,15.05
9902167,9981744,5365,1877750,11859494,18.81
9902168,9983776,5840,2044000,12027776,20.47
9902169,9995583,4502,1575700,11571283,15.76
9902170,5642886,2102,735700,6378586,13.04
9902171,9967234,6847,2396450,12363684,24.04
9902172,9987282,4896,1713600,11700882,17.16
9902173,9990522,3281,1148350,11138872,11.49
9902174,9985907,6096,2133600,12119507,21.37
9902175,9984318,3443,1205050,11189368,12.07
9902176,9994125,2285,799750,10793875,8.00
9902177,9983063,2662,931700,10914763,9.33
9902178,9973827,3953,1383550,11357377,13.87
9902179,9974689,5720,2002000,11976689,20.07
9902180,9976654,3702,1295700,11272354,12.99
9902181,9988249,2798,979300,10967549,9.80
9902182,9983084,4087,1430450,11413534,14.33
9902183,9987158,3363,1177050,11164208,11.79
9902184,9982664,2808,982800,10965464,9.85
9902185,9981986,3876,1356600,11338586,13.59
9902186,9977269,4541,1589350,11566619,15.93
9902187,9978545,3992,1397200,11375745,14.00
9902188,5577217,3596,1258600,6835817,22.57
9902189,9966295,6056,2119600,12085895,21.27
9902190,9985917,2273,795550,10781467,7.97
9902191,9983265,3727,1304450,11287715,13.07
9902192,9000870,1787,625450,9626320,6.95
9902193,9970267,3320,1162000,11132267,11.65
9902194,9969510,6127,2144450,12113960,21.51
9902195,9999639,1655,579250,10578889,5.79
9902196,9980525,5403,1891050,11871575,18.95
9902197,9999192,5855,2049250,12048442,20.49
9902198,9973394,3198,1119300,11092694,11.22
9902199,582343,406,142100,724443,24.40
9902200,9955036,5806,2032100,11987136,20.41
9902201,9954635,6378,2232300,12186935,22.42
9902202,5451361,2080,728000,6179361,13.35
9902203,9956710,2007,702450,10659160,7.06
9902204,9959233,4545,1590750,11549983,15.97
9902205,9956901,5223,1828050,11784951,18.36
9902206,9962350,4894,1712900,11675250,17.19
9902207,9955910,2905,1016750,10972660,10.21
9902208,9954818,4808,1682800,11637618,16.90
9902209,9943243,4276,1496600,11439843,15.05
9902210,9963856,4241,1484350,11448206,14.90
9902211,9955933,2722,952700,10908633,9.57
9902212,9961376,4995,1748250,11709626,17.55
9902213,9964033,4446,1556100,11520133,15.62
9902214,9955991,2215,775250,10731241,7.79
9902215,9914274,6022,2107700,12021974,21.26
9902216,9969430,3291,1151850,11121280,11.55
9902217,1989212,431,150850,2140062,7.58
9902218,9982580,1923,673050,10655630,6.74
9902219,8319279,1696,593600,8912879,7.14
9902220,8546745,2555,894250,9440995,10.46
9902221,9977037,5347,1871450,11848487,18.76
9902222,2195318,1772,620200,2815518,28.25
9902223,7913386,2998,1049300,8962686,13.26
9902224,9060245,2950,1032500,10092745,11.40
9902226,9973090,2716,950600,10923690,9.53
9902227,9992556,4448,1556800,11549356,15.58
9902228,9971930,6928,2424800,12396730,24.32
9902229,9958106,4144,1450400,11408506,14.57
9902230,9969175,3970,1389500,11358675,13.94
9902231,9953246,4532,1586200,11539446,15.94
9902232,9963641,5153,1803550,11767191,18.10
9902233,9952960,3615,1265250,11218210,12.71
9902234,9949938,2627,919450,10869388,9.24
9902235,9936328,4421,1547350,11483678,15.57
9902236,9903069,2732,956200,10859269,9.66
9902237,9818436,4006,1402100,11220536,14.28
9902238,9922870,4586,1605100,11527970,16.18
9902239,9545898,2101,735350,10281248,7.70
9902241,9918958,3381,1183350,11102308,11.93
9902242,9931536,3424,1198400,11129936,12.07
9902243,3822964,674,235900,4058864,6.17
9902244,9837367,4911,1718850,11556217,17.47
9902245,9904906,4389,1536150,11441056,15.51
9902246,9884079,2603,911050,10795129,9.22
9902247,9896392,1958,685300,10581692,6.92
9902249,9893790,3506,1227100,11120890,12.40
9902250,9886344,5503,1926050,11812394,19.48
9902251,1691550,241,84350,1775900,4.99
9902252,9890730,3227,1129450,11020180,11.42
9902253,9880089,5264,1842400,11722489,18.65
9902255,9897358,4381,1533350,11430708,15.49
9902256,9877425,4023,1408050,11285475,14.26
9902257,9875295,4396,1538600,11413895,15.58
9902258,9892470,2684,939400,10831870,9.50
9902259,9904657,3441,1204350,11109007,12.16
9902260,9905488,3571,1249850,11155338,12.62
9902261,9898646,3374,1180900,11079546,11.93
9902262,9906994,3741,1309350,11216344,13.22
9902263,9910208,1635,572250,10482458,5.77
9902264,9918976,4233,1481550,11400526,14.94
9902265,953544,252,88200,1041744,9.25
9902266,9908182,3959,1385650,11293832,13.98
9902267,5538417,1474,515900,6054317,9.31
9902269,9889457,4205,1471750,11361207,14.88
9902270,2503684,693,242550,2746234,9.69
9902271,9894987,4290,1501500,11396487,15.17
9902272,9881198,5266,1843100,11724298,18.65
9902273,9882487,4590,1606500,11488987,16.26
9902274,8018323,3228,1129800,9148123,14.09
9902275,429023,180,63000,492023,14.68
9902276,5727612,2533,886550,6614162,15.48
9902277,1374959,779,272650,1647609,19.83
9902278,9891786,4383,1534050,11425836,15.51
9902279,4031850,1738,608300,4640150,15.09
9902280,9867930,2607,912450,10780380,9.25
9902281,9869107,3687,1290450,11159557,13.08
9902282,3103729,1173,410550,3514279,13.23
9902283,9858373,4765,1667750,11526123,16.92
9902284,9397889,4058,1420300,10818189,15.11
9902285,9861889,4052,1418200,11280089,14.38
9902286,9875851,3441,1204350,11080201,12.19
9902287,9875958,3130,1095500,10971458,11.09
9902288,9874086,4612,1614200,11488286,16.35
9902289,9883327,2097,733950,10617277,7.43
9902290,2502777,1174,410900,2913677,16.42
9902291,9875079,4121,1442350,11317429,14.61
9902292,9898104,4054,1418900,11317004,14.34
9902293,1334722,277,96950,1431672,7.26
9902294,9896163,4715,1650250,11546413,16.68
9902295,9884953,5319,1861650,11746603,18.83
9902296,9900728,5037,1762950,11663678,17.81
9902297,9904802,4441,1554350,11459152,15.69
9902298,74747,30,10500,85247,14.05
9902299,9902276,3051,1067850,10970126,10.78
9902300,9902077,3669,1284150,11186227,12.97
9902301,9911922,5744,2010400,11922322,20.28
9902302,9902644,3872,1355200,11257844,13.69
9902303,9910334,2697,943950,10854284,9.52
9902304,9916813,6335,2217250,12134063,22.36
9902305,9913669,4362,1526700,11440369,15.40
9902306,9910785,5037,1762950,11673735,17.79
9902307,9898516,7233,2531550,12430066,25.58
9902308,9914163,2381,833350,10747513,8.41
9902309,8616823,7545,2640750,11257573,30.65
9902310,9904125,2685,939750,10843875,9.49
9902311,9918709,2362,826700,10745409,8.33
9902312,9928818,4618,1616300,11545118,16.28
9902313,9932686,3602,1260700,11193386,12.69
9902314,9954833,4355,1524250,11479083,15.31
9902315,9953755,5388,1885800,11839555,18.95
9902316,9938262,5464,1912400,11850662,19.24
9902317,9940189,3034,1061900,11002089,10.68
9902318,9966886,2705,946750,10913636,9.50
9902319,280920,847,296450,577370,105.53
9902320,9930415,2770,969500,10899915,9.76
9902321,1654397,65,22750,1677147,1.38
9902322,4188291,1734,606900,4795191,14.49
9902323,9951369,3652,1278200,11229569,12.84
9902325,9957593,4758,1665300,11622893,16.72
9902326,9961139,3931,1375850,11336989,13.81
9902327,9929599,3333,1166550,11096149,11.75
9902328,9941160,3320,1162000,11103160,11.69
9902329,9949192,1671,584850,10534042,5.88
9902330,2583301,686,240100,2823401,9.29
9902331,9947738,3918,1371300,11319038,13.79
9902332,4401306,4421,1547350,5948656,35.16
9902333,9941850,5356,1874600,11816450,18.86
9902334,9947953,6223,2178050,12126003,21.89
9902335,9962333,5005,1751750,11714083,17.58
9902336,9965016,4494,1572900,11537916,15.78
9902337,3573507,1793,627550,4201057,17.56
9902338,9933221,4220,1477000,11410221,14.87
9902339,9929124,2791,976850,10905974,9.84
9902340,9928623,4402,1540700,11469323,15.52
9902341,9359778,3693,1292550,10652328,13.81
9902342,9956466,5976,2091600,12048066,21.01
9902343,9958037,2632,921200,10879237,9.25
9902344,9980385,4500,1575000,11555385,15.78
9902345,9988078,4899,1714650,11702728,17.17
9902346,9982596,6996,2448600,12431196,24.53
9902347,837298,196,68600,905898,8.19
9902348,9992718,3063,1072050,11064768,10.73
9902349,466383,178,62300,528683,13.36
9902350,9998417,4503,1576050,11574467,15.76
9902351,9958049,2938,1028300,10986349,10.33
9902353,9980109,3696,1293600,11273709,12.96
9902354,9983937,5049,1767150,11751087,17.70
9902355,9977248,3680,1288000,11265248,12.91
9902356,9964550,5122,1792700,11757250,17.99
9902357,1486937,778,272300,1759237,18.31
9902358,9983693,3898,1364300,11347993,13.67
9902359,9982246,3269,1144150,11126396,11.46
9902360,9993131,3319,1161650,11154781,11.62
9902361,9977821,4217,1475950,11453771,14.79
9902362,9983854,2808,982800,10966654,9.84
9902363,9972422,4791,1676850,11649272,16.81
9902364,9988641,4628,1619800,11608441,16.22
9902365,9990405,2932,1026200,11016605,10.27
9902366,9974035,3219,1126650,11100685,11.30
9902367,9983739,4860,1701000,11684739,17.04
9902368,9984160,3879,1357650,11341810,13.60
9902369,9974014,5876,2056600,12030614,20.62
9902370,9965164,3101,1085350,11050514,10.89
9902371,9962467,5483,1919050,11881517,19.26
9902372,9977630,3740,1309000,11286630,13.12
9902373,533491,361,126350,659841,23.68
9902374,9950891,4623,1618050,11568941,16.26
9902375,9948986,2041,714350,10663336,7.18
9902376,782251,472,165200,947451,21.12
9902377,9932376,3362,1176700,11109076,11.85
9902378,9933515,2963,1037050,10970565,10.44
9902379,9947996,3505,1226750,11174746,12.33
9902380,9456103,4521,1582350,11038453,16.73
9902381,9942287,5308,1857800,11800087,18.69
9902382,9948824,2991,1046850,10995674,10.52
9902383,1126531,694,242900,1369431,21.56
9902384,9956047,4077,1426950,11382997,14.33
9902385,9966117,6948,2431800,12397917,24.40
9902386,9962802,3504,1226400,11189202,12.31
9902387,9965962,1689,591150,10557112,5.93
9902388,9988809,6055,2119250,12108059,21.22
9902389,1498739,668,233800,1732539,15.60
9902390,9970061,4953,1733550,11703611,17.39
9902391,9980754,4833,1691550,11672304,16.95
9902392,6282980,1585,554750,6837730,8.83
9902393,9964671,4102,1435700,11400371,14.41
9902394,9976290,7454,2608900,12585190,26.15
9902395,9988114,3614,1264900,11253014,12.66
9902396,9989333,3656,1279600,11268933,12.81
9902397,9977677,6492,2272200,12249877,22.77
9902398,9985793,6365,2227750,12213543,22.31
9902399,9963253,4969,1739150,11702403,17.46
9902400,9974156,4224,1478400,11452556,14.82
9902401,9990443,838,293300,10283743,2.94
9902402,9983104,4661,1631350,11614454,16.34
9902403,9974259,3460,1211000,11185259,12.14
9902404,9996010,4644,1625400,11621410,16.26
9902405,9989919,4581,1603350,11593269,16.05
9902406,9984711,3619,1266650,11251361,12.69
9902407,2155141,3539,1238650,3393791,57.47
9902408,5679474,2325,813750,6493224,14.33
9902409,9983876,4355,1524250,11508126,15.27
9902410,9984612,3356,1174600,11159212,11.76
9902411,9151520,2442,854700,10006220,9.34
9902412,9989390,4672,1635200,11624590,16.37
9902413,9983862,3376,1181600,11165462,11.84
9902414,9986228,3466,1213100,11199328,12.15
9902415,9962138,1810,633500,10595638,6.36
9902416,5340409,1638,573300,5913709,10.74
9902417,9974615,4246,1486100,11460715,14.90
9902418,9975431,2350,822500,10797931,8.25
9902419,9985522,3933,1376550,11362072,13.79
9902420,8585835,5379,1882650,10468485,21.93
9902421,1184737,226,79100,1263837,6.68
9902422,9986995,3633,1271550,11258545,12.73
9902423,9989075,3981,1393350,11382425,13.95
9902424,9975726,6106,2137100,12112826,21.42
9902425,9955860,3713,1299550,11255410,13.05
9902426,9977365,2037,712950,10690315,7.15
9902427,9902250,4622,1617700,11519950,16.34
9902429,9979677,3450,1207500,11187177,12.10
9902430,9978055,2312,809200,10787255,8.11
9902431,1412918,476,166600,1579518,11.79
9902432,9966783,5046,1766100,11732883,17.72
9902433,9973627,5601,1960350,11933977,19.66
9902434,9977802,3051,1067850,11045652,10.70
9902435,9970919,6366,2228100,12199019,22.35
9902436,9976592,5697,1993950,11970542,19.99
9902437,9979014,2277,796950,10775964,7.99
9902438,9970001,4973,1740550,11710551,17.46
9902439,9974239,2838,993300,10967539,9.96
9902440,9978428,4449,1557150,11535578,15.61
9902441,9998031,2946,1031100,11029131,10.31
9902442,9999507,4864,1702400,11701907,17.02
9902443,4334257,3868,1353800,5688057,31.23
9902444,9986402,4596,1608600,11595002,16.11
9902445,8825368,1209,423150,9248518,4.79
9902446,9978168,3115,1090250,11068418,10.93
9902447,9044804,3952,1383200,10428004,15.29
9902448,9972024,5330,1865500,11837524,18.71
9902449,9982602,2895,1013250,10995852,10.15
9902450,9988172,2927,1024450,11012622,10.26
9902451,9105142,2398,839300,9944442,9.22
9902452,9980511,4578,1602300,11582811,16.05
9902453,9958971,2620,917000,10875971,9.21
9902454,9977751,2546,891100,10868851,8.93
9902455,9995320,4024,1408400,11403720,14.09
9902456,9972016,2847,996450,10968466,9.99
9902457,9991028,4429,1550150,11541178,15.52
9902458,9980936,3098,1084300,11065236,10.86
9902459,9970869,3553,1243550,11214419,12.47
9902460,9969377,4774,1670900,11640277,16.76
9902462,9968470,2811,983850,10952320,9.87
9902463,9973868,3819,1336650,11310518,13.40
9902464,9968955,2964,1037400,11006355,10.41
9902465,9982282,2524,883400,10865682,8.85
9902466,9967009,2082,728700,10695709,7.31
9902467,9961902,2881,1008350,10970252,10.12
9902468,9951596,3141,1099350,11050946,11.05
9902469,9969016,4543,1590050,11559066,15.95
9902470,9971523,2964,1037400,11008923,10.40
9902471,9977561,3193,1117550,11095111,11.20
9902472,9974863,2699,944650,10919513,9.47
9902473,794783,146,51100,845883,6.43
9902474,9962008,2975,1041250,11003258,10.45
9902475,9983979,2768,968800,10952779,9.70
9902476,9990501,2334,816900,10807401,8.18
9902477,2847521,1353,473550,3321071,16.63
9902478,9964153,5342,1869700,11833853,18.76
9902479,9979344,2659,930650,10909994,9.33
9902480,9960438,1974,690900,10651338,6.94
9902481,9978955,5357,1874950,11853905,18.79
9902482,397807,322,112700,510507,28.33
9902484,9965261,3314,1159900,11125161,11.64
9902485,9980741,2850,997500,10978241,9.99
9902486,9994833,2476,866600,10861433,8.67
9902487,9988387,1540,539000,10527387,5.40
9902488,9982915,3629,1270150,11253065,12.72
9902489,1760231,781,273350,2033581,15.53
9902490,9981623,5301,1855350,11836973,18.59
9902491,937572,420,147000,1084572,15.68
9902492,9961415,4039,1413650,11375065,14.19
9902493,9928020,1757,614950,10542970,6.19
9902494,7645201,3446,1206100,8851301,15.78
9902495,9978834,5330,1865500,11844334,18.69
9902496,1262893,422,147700,1410593,11.70
9902497,4643741,2149,752150,5395891,16.20
9902498,9962163,4793,1677550,11639713,16.84
9902499,949979,629,220150,1170129,23.17
9902501,9948347,2656,929600,10877947,9.34
9902502,4448436,2723,953050,5401486,21.42
9902503,4076979,1301,455350,4532329,11.17
9902504,9929262,2302,805700,10734962,8.11
9902505,9988559,4116,1440600,11429159,14.42
9902506,9964295,3465,1212750,11177045,12.17
9902507,8581602,5157,1804950,10386552,21.03
9902508,556651,280,98000,654651,17.61
9902509,6308098,951,332850,6640948,5.28
9902510,9961666,2970,1039500,11001166,10.44
9902511,9964583,5324,1863400,11827983,18.70
9902512,9957017,1434,501900,10458917,5.04
9902513,6490521,2399,839650,7330171,12.94
9902514,9956453,2694,942900,10899353,9.47
9902515,4984800,2807,982450,5967250,19.71
9902516,9970642,3138,1098300,11068942,11.02
9902517,9826703,3523,1233050,11059753,12.55
9902518,9976124,5002,1750700,11726824,17.55
9902519,9992355,3410,1193500,11185855,11.94
9902521,9979587,3315,1160250,11139837,11.63
9902522,9989915,3765,1317750,11307665,13.19
9902523,9985515,3905,1366750,11352265,13.69
9902524,718335,101,35350,753685,4.92
9902525,9976071,4730,1655500,11631571,16.59
9902526,9989471,5072,1775200,11764671,17.77
9902527,9996522,6782,2373700,12370222,23.75
9902528,9971697,5218,1826300,11797997,18.31
9902529,9993574,5341,1869350,11862924,18.71
9902530,9998108,4960,1736000,11734108,17.36
9902531,2436741,1226,429100,2865841,17.61
9902533,9985743,4407,1542450,11528193,15.45
9902534,9985871,4414,1544900,11530771,15.47
9902535,9970737,4550,1592500,11563237,15.97
9902536,9979656,4445,1555750,11535406,15.59
9902537,9985926,4165,1457750,11443676,14.60
9902538,9982915,4984,1744400,11727315,17.47
9902539,9987635,4119,1441650,11429285,14.43
9902540,1072447,497,173950,1246397,16.22
9902541,9985415,3760,1316000,11301415,13.18
9902542,1957712,1557,544950,2502662,27.84
9902543,9974985,2401,840350,10815335,8.42
9902545,9963373,3228,1129800,11093173,11.34
9902546,9976393,3113,1089550,11065943,10.92
9902547,9978635,4177,1461950,11440585,14.65
9902548,9990823,3315,1160250,11151073,11.61
9902549,9979079,3148,1101800,11080879,11.04
9902551,9965313,3877,1356950,11322263,13.62
9902552,9971551,3916,1370600,11342151,13.75
9902553,9962704,4312,1509200,11471904,15.15
9902554,9966801,5307,1857450,11824251,18.64
9902555,9957049,2751,962850,10919899,9.67
9902556,3979082,2537,887950,4867032,22.32
9902557,9975092,2827,989450,10964542,9.92
9902558,9975440,1102,385700,10361140,3.87
9902559,9996206,4004,1401400,11397606,14.02
9902560,5961299,3675,1286250,7247549,21.58
9902561,9984871,3535,1237250,11222121,12.39
9902563,9950364,1112,389200,10339564,3.91
9902564,2849594,1185,414750,3264344,14.55
9902565,9937202,2285,799750,10736952,8.05
9902566,9950281,790,276500,10226781,2.78
9902567,9962384,1443,505050,10467434,5.07
9902568,9957834,2334,816900,10774734,8.20
9902569,9960315,3343,1170050,11130365,11.75
9902570,384537,230,80500,465037,20.93
9902571,187303,97,33950,221253,18.13
9902572,7688718,3612,1264200,8952918,16.44
9902573,9974412,3695,1293250,11267662,12.97
9902574,9969922,5681,1988350,11958272,19.94
9902575,9981575,5818,2036300,12017875,20.40
9902576,104184,24,8400,112584,8.06
9902577,1369970,1165,407750,1777720,29.76
9902578,9979271,4172,1460200,11439471,14.63
9902579,9976792,2936,1027600,11004392,10.30
9902580,9960827,3123,1093050,11053877,10.97
9902581,9985387,3812,1334200,11319587,13.36
9902582,9985154,1158,405300,10390454,4.06
9902583,9985713,3247,1136450,11122163,11.38
9902584,9983991,5181,1813350,11797341,18.16
9902585,4994546,3379,1182650,6177196,23.68
9902586,9981468,3975,1391250,11372718,13.94
9902587,9976576,4586,1605100,11581676,16.09
9902588,9990048,3666,1283100,11273148,12.84
9902589,9984566,3756,1314600,11299166,13.17
9902590,228927,160,56000,284927,24.46
9902591,9968861,5023,1758050,11726911,17.64
9902592,9923107,5393,1887550,11810657,19.02
9902593,4760408,1148,401800,5162208,8.44
9902594,9962339,3974,1390900,11353239,13.96
9902595,9967613,3897,1363950,11331563,13.68
9902596,9961687,4932,1726200,11687887,17.33
9902597,2836723,2728,954800,3791523,33.66
9902598,1384926,1523,533050,1917976,38.49
9902599,9959441,3944,1380400,11339841,13.86
9902600,9959038,2827,989450,10948488,9.94
9902601,963990,350,122500,1086490,12.71
9902602,9942423,3634,1271900,11214323,12.79
9902603,9955255,5100,1785000,11740255,17.93
9902604,9962213,5047,1766450,11728663,17.73
9902605,9981478,3969,1389150,11370628,13.92
9902606,9947379,4015,1405250,11352629,14.13
9902607,1149897,293,102550,1252447,8.92
9902608,9973539,4646,1626100,11599639,16.30
9902609,9971978,4271,1494850,11466828,14.99
9902610,9989206,2088,730800,10720006,7.32
9902611,8174731,4093,1432550,9607281,17.52
9902612,9961727,3970,1389500,11351227,13.95
9902613,9972689,3896,1363600,11336289,13.67
9902614,9970732,4476,1566600,11537332,15.71
9902615,9996541,4225,1478750,11475291,14.79
9902616,9978600,1762,616700,10595300,6.18
9902617,9978783,2697,943950,10922733,9.46
9902618,9969754,1871,654850,10624604,6.57
9902619,9417257,3044,1065400,10482657,11.31
9902620,9965464,1988,695800,10661264,6.98
9902621,9976553,3622,1267700,11244253,12.71
9902622,9949946,5518,1931300,11881246,19.41
9902623,9969200,2794,977900,10947100,9.81
9902624,6703372,3978,1392300,8095672,20.77
9902625,9968782,3182,1113700,11082482,11.17
9902626,9978073,3483,1219050,11197123,12.22
9902627,9986856,5745,2010750,11997606,20.13
9902628,9983335,3855,1349250,11332585,13.52
9902629,9989369,4939,1728650,11718019,17.30
9902630,9988968,2604,911400,10900368,9.12
9902631,9963490,1052,368200,10331690,3.70
9902632,9951684,3560,1246000,11197684,12.52
9902633,330783,220,77000,407783,23.28
9902634,9947357,5286,1850100,11797457,18.60
9902635,9949485,3358,1175300,11124785,11.81
9902636,6200421,2237,782950,6983371,12.63
9902637,9921808,2710,948500,10870308,9.56
9902638,9923320,6431,2250850,12174170,22.68
9902639,9916664,3671,1284850,11201514,12.96
9902640,9921537,1969,689150,10610687,6.95
9902641,9927507,6779,2372650,12300157,23.90
9902642,9926951,2458,860300,10787251,8.67
9902643,9937724,1043,365050,10302774,3.67
9902644,9952723,1043,365050,10317773,3.67
9902645,9953142,7234,2531900,12485042,25.44
9902646,541153,156,54600,595753,10.09
9902648,9938353,2916,1020600,10958953,10.27
9902649,9934161,5188,1815800,11749961,18.28
9902650,9939525,5930,2075500,12015025,20.88
9902651,1689597,184,64400,1753997,3.81
9902652,2208858,1362,476700,2685558,21.58
9902653,9911778,4922,1722700,11634478,17.38
9902654,809828,311,108850,918678,13.44
9902655,9825686,3691,1291850,11117536,13.15
9902656,9896916,6136,2147600,12044516,21.70
9902658,747887,165,57750,805637,7.72
9902659,9908694,2641,924350,10833044,9.33
9902660,9908109,5133,1796550,11704659,18.13
9902661,9892796,3388,1185800,11078596,11.99
9902662,2801671,1560,546000,3347671,19.49
9902663,9904553,3291,1151850,11056403,11.63
9902664,9915250,6198,2169300,12084550,21.88
9902665,9916097,4160,1456000,11372097,14.68
9902666,362216,171,59850,422066,16.52
9902667,9905831,4276,1496600,11402431,15.11
9902668,9884939,3950,1382500,11267439,13.99
9902669,410850,110,38500,449350,9.37
9902670,9887323,3249,1137150,11024473,11.50
9902671,9839169,4486,1570100,11409269,15.96
9902672,9900040,4200,1470000,11370040,14.85
9902673,1885446,2118,741300,2626746,39.32
9902674,696974,293,102550,799524,14.71
9902675,9875129,4386,1535100,11410229,15.55
9902676,9891642,3370,1179500,11071142,11.92
9902677,9438068,4038,1413300,10851368,14.97
9902678,9921275,2765,967750,10889025,9.75
9902679,9909829,2299,804650,10714479,8.12
9902681,9896545,5322,1862700,11759245,18.82
9902682,1826787,649,227150,2053937,12.43
9902683,9887929,4523,1583050,11470979,16.01
9902684,9734542,3652,1278200,11012742,13.13
9902685,9859247,3241,1134350,10993597,11.51
9902686,9860227,4953,1733550,11593777,17.58
9902687,9873346,5063,1772050,11645396,17.95
9902688,9879827,1979,692650,10572477,7.01
9902689,2655083,1857,649950,3305033,24.48
9902690,9887580,5651,1977850,11865430,20.00
9902691,9901994,3559,1245650,11147644,12.58
9902692,1875238,572,200200,2075438,10.68
9902693,9914624,3155,1104250,11018874,11.14
9902694,9918418,5494,1922900,11841318,19.39
9902695,9933809,6859,2400650,12334459,24.17
9902697,554255,305,106750,661005,19.26
9902698,9917102,3843,1345050,11262152,13.56
9902699,9291707,4181,1463350,10755057,15.75
9902700,9929181,4849,1697150,11626331,17.09
9902702,6143859,2113,739550,6883409,12.04
9902703,9930562,3969,1389150,11319712,13.99
9902704,9946802,4692,1642200,11589002,16.51
9902705,9948864,4120,1442000,11390864,14.49
9902706,9859945,2971,1039850,10899795,10.55
9902707,9954395,5363,1877050,11831445,18.86
9902708,9969351,3094,1082900,11052251,10.86
9902709,1582302,298,104300,1686602,6.59
9902711,6049439,2124,743400,6792839,12.29
9902712,9990776,3806,1332100,11322876,13.33
9902713,6671641,3914,1369900,8041541,20.53
9902714,9973634,4247,1486450,11460084,14.90
9902715,9975829,2467,863450,10839279,8.66
9902716,9997677,2789,976150,10973827,9.76
9902717,9996101,2975,1041250,11037351,10.42
9902718,2095063,1240,434000,2529063,20.72
9902719,1716044,545,190750,1906794,11.12
9902720,9957360,3583,1254050,11211410,12.59
9902721,9974794,4362,1526700,11501494,15.31
9902722,9977259,2124,743400,10720659,7.45
9902723,9992549,3037,1062950,11055499,10.64
9902724,9984848,2799,979650,10964498,9.81
9902725,9883876,1848,646800,10530676,6.54
9902726,9984685,4738,1658300,11642985,16.61
9902727,9987075,2486,870100,10857175,8.71
9902728,9981338,6762,2366700,12348038,23.71
9902729,9984298,5357,1874950,11859248,18.78
9902730,9986875,3020,1057000,11043875,10.58
9902731,4723118,2131,745850,5468968,15.79
9902732,9980496,4986,1745100,11725596,17.49
9902733,9993250,3264,1142400,11135650,11.43
9902734,9996246,4750,1662500,11658746,16.63
9902736,9976435,3519,1231650,11208085,12.35
9902737,9983581,3654,1278900,11262481,12.81
9902738,9989090,3266,1143100,11132190,11.44
9902739,9991147,3501,1225350,11216497,12.26
9902740,9969511,3270,1144500,11114011,11.48
9902741,2788134,911,318850,3106984,11.44
9902742,9981359,3845,1345750,11327109,13.48
9902743,9984402,5088,1780800,11765202,17.84
9902745,9980831,3069,1074150,11054981,10.76
9902746,2574619,1371,479850,3054469,18.64
9902747,2679242,857,299950,2979192,11.20
9902748,9981216,3265,1142750,11123966,11.45
9902749,9985573,3170,1109500,11095073,11.11
9902750,9975711,3849,1347150,11322861,13.50
9902751,1374257,593,207550,1581807,15.10
9902752,905241,370,129500,1034741,14.31
9902753,9987837,6015,2105250,12093087,21.08
9902754,9995284,3122,1092700,11087984,10.93
9902755,9767016,2642,924700,10691716,9.47
9902756,9956077,3409,1193150,11149227,11.98
9902757,9967596,3091,1081850,11049446,10.85
9902758,9981168,2463,862050,10843218,8.64
9902759,9985102,2806,982100,10967202,9.84
9902760,9982587,5336,1867600,11850187,18.71
9902761,9975932,4912,1719200,11695132,17.23
9902762,9963881,2686,940100,10903981,9.44
9902763,9964656,3985,1394750,11359406,14.00
9902764,9970994,4982,1743700,11714694,17.49
9902765,9976860,3658,1280300,11257160,12.83
9902766,9982878,4993,1747550,11730428,17.51
9902767,9984261,3439,1203650,11187911,12.06
9902768,9996536,4921,1722350,11718886,17.23
9902769,9971742,4233,1481550,11453292,14.86
9902770,9984441,2168,758800,10743241,7.60
9902771,9975881,2800,980000,10955881,9.82
9902772,9991249,3753,1313550,11304799,13.15
9902773,9998578,2774,970900,10969478,9.71
9902774,9974630,2394,837900,10812530,8.40
9902775,9983808,4036,1412600,11396408,14.15
9902776,9976835,3755,1314250,11291085,13.17
9902777,9970862,3081,1078350,11049212,10.82
9902778,9959792,2076,726600,10686392,7.30
9902779,9960210,1393,487550,10447760,4.89
9902780,9972937,4206,1472100,11445037,14.76
9902781,4099466,791,276850,4376316,6.75
9902783,9955307,2950,1032500,10987807,10.37
9902784,9934669,2441,854350,10789019,8.60
9902785,9956555,3009,1053150,11009705,10.58
9902786,9969319,2939,1028650,10997969,10.32
9902787,9967501,1432,501200,10468701,5.03
9902788,9960051,2522,882700,10842751,8.86
9902789,329822,194,67900,397722,20.59
9902791,9968175,1996,698600,10666775,7.01
9902792,3067534,923,323050,3390584,10.53
9902793,9962175,3392,1187200,11149375,11.92
9902794,9959367,4039,1413650,11373017,14.19
9902795,9795555,2981,1043350,10838905,10.65
9902796,9961010,2957,1034950,10995960,10.39
9902797,9945444,3145,1100750,11046194,11.07
9902798,9572948,2047,716450,10289398,7.48
9902799,9965562,3568,1248800,11214362,12.53
9902801,9959034,2203,771050,10730084,7.74
9902802,9965630,3550,1242500,11208130,12.47
9902803,9963331,4554,1593900,11557231,16.00
9902804,6047843,2152,753200,6801043,12.45
9902805,9963973,3409,1193150,11157123,11.97
9902806,9973168,3144,1100400,11073568,11.03
9902807,9978045,1443,505050,10483095,5.06
9902809,9961621,3957,1384950,11346571,13.90
9902810,9951789,2964,1037400,10989189,10.42
9902811,9939448,4386,1535100,11474548,15.44
9902812,9953240,3728,1304800,11258040,13.11
9902813,9927533,2709,948150,10875683,9.55
9902814,9958518,3549,1242150,11200668,12.47
9902815,9956809,2377,831950,10788759,8.36
9902816,9940476,1535,537250,10477726,5.40
9902817,6043605,1122,392700,6436305,6.50
9902818,4087957,1861,651350,4739307,15.93
9902819,6258514,2147,751450,7009964,12.01
9902820,9916653,2925,1023750,10940403,10.32
9902821,345866,81,28350,374216,8.20
9902822,6172324,1308,457800,6630124,7.42
9902823,5207979,2325,813750,6021729,15.63
9902824,9922946,3628,1269800,11192746,12.80
9902825,9928447,3993,1397550,11325997,14.08
9902826,9874346,3618,1266300,11140646,12.82
9902828,9941654,3326,1164100,11105754,11.71
9902829,9938163,3239,1133650,11071813,11.41
9902830,367603,210,73500,441103,19.99
9902831,9923134,3961,1386350,11309484,13.97
9902833,9911070,3096,1083600,10994670,10.93
9902834,9915217,3425,1198750,11113967,12.09
9902835,9898161,4318,1511300,11409461,15.27
9902836,9906930,2861,1001350,10908280,10.11
9902837,9866930,4350,1522500,11389430,15.43
9902838,7003618,2649,927150,7930768,13.24
9902840,9906245,2643,925050,10831295,9.34
9902841,1906303,1609,563150,2469453,29.54
9902842,1543843,624,218400,1762243,14.15
9902843,9918622,3143,1100050,11018672,11.09
9902844,9906421,4165,1457750,11364171,14.72
9902845,9897785,5405,1891750,11789535,19.11
9902846,9872120,3216,1125600,10997720,11.40
9902847,9925788,3076,1076600,11002388,10.85
9902848,9928402,3311,1158850,11087252,11.67
9902849,5780942,1592,557200,6338142,9.64
9902850,9944001,4112,1439200,11383201,14.47
9902851,9955214,5153,1803550,11758764,18.12
9902852,1336270,448,156800,1493070,11.73
9902853,9950574,3944,1380400,11330974,13.87
9902854,9961586,3986,1395100,11356686,14.00
9902855,9960230,4752,1663200,11623430,16.70
9902856,9960215,4133,1446550,11406765,14.52
9902857,9965046,6019,2106650,12071696,21.14
9902858,9968623,3831,1340850,11309473,13.45
9902859,9978130,3419,1196650,11174780,11.99
9902860,3777788,2897,1013950,4791738,26.84
9902861,9974316,3905,1366750,11341066,13.70
9902862,9971746,4681,1638350,11610096,16.43
9902864,9969342,6192,2167200,12136542,21.74
9902865,9976075,3515,1230250,11206325,12.33
9902866,9970406,3960,1386000,11356406,13.90
9902867,9988015,2663,932050,10920065,9.33
9902868,9973011,2474,865900,10838911,8.68
9902869,391771,141,49350,441121,12.60
9902870,9959727,5437,1902950,11862677,19.11
9902871,9974849,2931,1025850,11000699,10.28
9902872,9980650,6465,2262750,12243400,22.67
9902873,9996315,4166,1458100,11454415,14.59
9902874,9979702,3599,1259650,11239352,12.62
9902875,869176,274,95900,965076,11.03
9902876,9986577,2057,719950,10706527,7.21
9902877,9988156,4035,1412250,11400406,14.14
9902878,9970587,5159,1805650,11776237,18.11
9902879,9958298,2933,1026550,10984848,10.31
9902880,9960230,2973,1040550,11000780,10.45
9902881,9950269,3386,1185100,11135369,11.91
9902882,9956290,2663,932050,10888340,9.36
9902883,9953678,4596,1608600,11562278,16.16
9902884,9959653,4744,1660400,11620053,16.67
9902885,9966371,4178,1462300,11428671,14.67
9902886,9964473,2709,948150,10912623,9.52
9902887,3993871,2259,790650,4784521,19.80
9902888,9969403,2443,855050,10824453,8.58
9902889,9984485,3350,1172500,11156985,11.74
9902890,9977791,3841,1344350,11322141,13.47
9902891,9983686,3807,1332450,11316136,13.35
9902892,9957518,5418,1896300,11853818,19.04
9902893,2935724,1984,694400,3630124,23.65
9902894,9974211,2554,893900,10868111,8.96
9902895,9965188,2350,822500,10787688,8.25
9902896,9972623,4325,1513750,11486373,15.18
9902897,9972497,3904,1366400,11338897,13.70
9902898,2795820,1329,465150,3260970,16.64
9902899,9982245,3877,1356950,11339195,13.59
9902900,9986214,2779,972650,10958864,9.74
9902901,736516,503,176050,912566,23.90
9902902,9956813,4593,1607550,11564363,16.15
9902903,5471588,2153,753550,6225138,13.77
9902904,9940057,4175,1461250,11401307,14.70
9902905,9938261,3504,1226400,11164661,12.34
9902906,9946230,2147,751450,10697680,7.56
9902907,9939378,2762,966700,10906078,9.73
9902908,9936350,1877,656950,10593300,6.61
9902909,3368210,1433,501550,3869760,14.89
9902910,9958769,2607,912450,10871219,9.16
9902911,9953536,2754,963900,10917436,9.68
9902912,9960971,2998,1049300,11010271,10.53
9902913,6512582,1185,414750,6927332,6.37
9902914,9952748,4400,1540000,11492748,15.47
9902915,9979254,2495,873250,10852504,8.75
9902916,9954576,6120,2142000,12096576,21.52
9902917,6574804,2131,745850,7320654,11.34
9902918,9957518,3681,1288350,11245868,12.94
9902919,6087828,1849,647150,6734978,10.63
9902920,9984063,2874,1005900,10989963,10.08
9902921,9986804,2600,910000,10896804,9.11
9902922,9978080,1893,662550,10640630,6.64
9902923,9982448,3305,1156750,11139198,11.59
9902924,690289,163,57050,747339,8.26
9902925,9988717,3186,1115100,11103817,11.16
9902926,9985570,3204,1121400,11106970,11.23
9902927,9992432,2750,962500,10954932,9.63
9902928,9974567,2519,881650,10856217,8.84
9902929,9988738,1964,687400,10676138,6.88
9902930,7491798,2896,1013600,8505398,13.53
9902931,9975525,3121,1092350,11067875,10.95
9902932,9985234,2531,885850,10871084,8.87
9902933,9978018,2665,932750,10910768,9.35
9902934,9975964,1747,611450,10587414,6.13
9902935,9980207,2178,762300,10742507,7.64
9902936,4773063,1781,623350,5396413,13.06
9902937,2951993,669,234150,3186143,7.93
9902938,3095996,1530,535500,3631496,17.30
9902939,9977698,2980,1043000,11020698,10.45
9902940,9968885,2130,745500,10714385,7.48
9902941,9955002,3209,1123150,11078152,11.28
9902942,9951765,4679,1637650,11589415,16.46
9902943,9169619,3577,1251950,10421569,13.65
9902944,9975560,4070,1424500,11400060,14.28
9902945,2186238,1074,375900,2562138,17.19
9902946,9968038,2602,910700,10878738,9.14
9902947,9977781,6914,2419900,12397681,24.25
9902948,9987263,4539,1588650,11575913,15.91
9902949,9991643,3203,1121050,11112693,11.22
9902951,9991181,4185,1464750,11455931,14.66
9902952,9997327,3042,1064700,11062027,10.65
9902953,9987016,2784,974400,10961416,9.76
9902954,9974560,4256,1489600,11464160,14.93
9902955,9993263,4088,1430800,11424063,14.32
9902956,9983413,3908,1367800,11351213,13.70
9902957,9974191,5838,2043300,12017491,20.49
9902958,9951314,3342,1169700,11121014,11.75
9902959,9977555,3812,1334200,11311755,13.37
9902960,9122584,2961,1036350,10158934,11.36
9902961,6434215,2318,811300,7245515,12.61
9902962,9975692,3871,1354850,11330542,13.58
9902963,9984845,2518,881300,10866145,8.83
9902964,9991762,5166,1808100,11799862,18.10
9902965,331501,175,61250,392751,18.48
9902966,9978632,3555,1244250,11222882,12.47
9902967,9968335,3638,1273300,11241635,12.77
9902968,9969441,4637,1622950,11592391,16.28
9902969,9002350,2485,869750,9872100,9.66
9902970,9985857,4736,1657600,11643457,16.60
9902971,9971723,3061,1071350,11043073,10.74
9902972,9993241,3297,1153950,11147191,11.55
9902973,9976016,2854,998900,10974916,10.01
9902974,9975881,3833,1341550,11317431,13.45
9902975,9967251,3294,1152900,11120151,11.57
9902976,1160743,384,134400,1295143,11.58
9902977,9948870,4292,1502200,11451070,15.10
9902978,9771399,2221,777350,10548749,7.96
9902979,9949143,4966,1738100,11687243,17.47
9902980,9945390,4015,1405250,11350640,14.13
9902981,9952092,5205,1821750,11773842,18.31
9902982,9940913,3332,1166200,11107113,11.73
9902983,9940825,5415,1895250,11836075,19.07
9902984,2278628,392,137200,2415828,6.02
9902985,9964477,2580,903000,10867477,9.06
9902986,9985116,4435,1552250,11537366,15.55
9902987,9955372,4315,1510250,11465622,15.17
9902988,9959485,4184,1464400,11423885,14.70
9902989,9955617,4135,1447250,11402867,14.54
9902990,9973020,3415,1195250,11168270,11.98
9902991,9931176,3267,1143450,11074626,11.51
9902992,9984433,4693,1642550,11626983,16.45
9902993,9960088,2360,826000,10786088,8.29
9902994,9947423,2732,956200,10903623,9.61
9902995,9948499,4231,1480850,11429349,14.89
9902996,9951758,1726,604100,10555858,6.07
9902997,9962982,3731,1305850,11268832,13.11
9902998,9961163,4832,1691200,11652363,16.98
9902999,9982376,2958,1035300,11017676,10.37
9903000,9970863,3276,1146600,11117463,11.50
9903001,9962574,3793,1327550,11290124,13.33
9903002,9960381,3998,1399300,11359681,14.05
9903003,9978715,3155,1104250,11082965,11.07
9903004,9987753,3551,1242850,11230603,12.44
9903005,9986399,2997,1048950,11035349,10.50
9903006,9992866,2803,981050,10973916,9.82
9903007,9995817,6032,2111200,12107017,21.12
9903008,9988687,3450,1207500,11196187,12.09
9903009,9964586,3016,1055600,11020186,10.59
9903010,9981487,2530,885500,10866987,8.87
9903011,9974355,7698,2694300,12668655,27.01
9903012,9976487,2436,852600,10829087,8.55
9903013,9977082,4763,1667050,11644132,16.71
9903015,9958410,5382,1883700,11842110,18.92
9903016,9953253,4745,1660750,11614003,16.69
9903018,9929170,2567,898450,10827620,9.05
9903019,9945550,4027,1409450,11355000,14.17
9903021,9935394,3146,1101100,11036494,11.08
9903022,9931667,4957,1734950,11666617,17.47
9903023,9935215,3706,1297100,11232315,13.06
9903025,3020448,1592,557200,3577648,18.45
9903026,9917891,4674,1635900,11553791,16.49
9903027,9913698,3248,1136800,11050498,11.47
9903028,9926618,4143,1450050,11376668,14.61
9903029,9931190,3179,1112650,11043840,11.20
9903030,9924337,4040,1414000,11338337,14.25
9903031,9483141,2398,839300,10322441,8.85
9903032,9933493,3441,1204350,11137843,12.12
9903033,9928513,3407,1192450,11120963,12.01
9903034,9939303,3925,1373750,11313053,13.82
9903035,2312668,986,345100,2657768,14.92
9903036,9934688,5460,1911000,11845688,19.24
9903037,9943566,3789,1326150,11269716,13.34
9903038,9684863,3917,1370950,11055813,14.16
9903039,9971908,3636,1272600,11244508,12.76
9903040,9974680,3518,1231300,11205980,12.34
9903041,9966487,2912,1019200,10985687,10.23
9903042,9976225,2050,717500,10693725,7.19
9903043,9970096,4166,1458100,11428196,14.62
9903044,9973042,3399,1189650,11162692,11.93
9903045,9947181,4685,1639750,11586931,16.48
9903046,9971969,2354,823900,10795869,8.26
9903047,9974788,3691,1291850,11266638,12.95
9903048,9755745,2823,988050,10743795,10.13
9903049,9973019,3484,1219400,11192419,12.23
9903050,9957676,2406,842100,10799776,8.46
9903051,9934868,5514,1929900,11864768,19.43
9903052,9940638,4095,1433250,11373888,14.42
9903054,9946637,3275,1146250,11092887,11.52
9903055,9952146,3741,1309350,11261496,13.16
9903056,9931102,5064,1772400,11703502,17.85
9903057,2535985,1625,568750,3104735,22.43
9903058,9927270,2516,880600,10807870,8.87
9903059,4932886,1854,648900,5581786,13.15
9903060,9907631,3022,1057700,10965331,10.68
9903061,9949251,5672,1985200,11934451,19.95
9903062,1818812,777,271950,2090762,14.95
9903063,9938994,5688,1990800,11929794,20.03
9903064,9938734,4299,1504650,11443384,15.14
9903065,9927166,3191,1116850,11044016,11.25
9903066,9919390,2839,993650,10913040,10.02
9903067,9943076,2295,803250,10746326,8.08
9903068,9357417,2655,929250,10286667,9.93
9903069,9925924,1066,373100,10299024,3.76
9903070,9917852,2806,982100,10899952,9.90
9903071,8652626,2633,921550,9574176,10.65
9903072,9943038,4223,1478050,11421088,14.87
9903073,9950133,3495,1223250,11173383,12.29
9903074,9954468,1622,567700,10522168,5.70
9903075,9950629,2505,876750,10827379,8.81
9903076,9967726,2067,723450,10691176,7.26
9903077,306305,84,29400,335705,9.60
9903078,9932629,3346,1171100,11103729,11.79
9903079,9950346,4242,1484700,11435046,14.92
9903080,9941476,5228,1829800,11771276,18.41
9903081,9940115,4359,1525650,11465765,15.35
9903082,9940749,2286,800100,10740849,8.05
9903083,9941890,2527,884450,10826340,8.90
9903084,9928899,2881,1008350,10937249,10.16
9903085,9929560,3569,1249150,11178710,12.58
9903086,9935333,5222,1827700,11763033,18.40
9903087,9909754,4461,1561350,11471104,15.76
9903088,9923195,3822,1337700,11260895,13.48
9903089,9848329,4345,1520750,11369079,15.44
9903090,9930731,3329,1165150,11095881,11.73
9903091,9945845,3408,1192800,11138645,11.99
9903092,9941540,3264,1142400,11083940,11.49
9903093,9906735,522,182700,10089435,1.84
9903095,9974977,3161,1106350,11081327,11.09
9903096,9969576,3677,1286950,11256526,12.91
9903097,9976036,2744,960400,10936436,9.63
9903099,9958768,5162,1806700,11765468,18.14
9903100,6989756,922,322700,7312456,4.62
9903101,9981863,4646,1626100,11607963,16.29
9903102,1171909,747,261450,1433359,22.31
9903103,6423216,1914,669900,7093116,10.43
9903104,9999406,4367,1528450,11527856,15.29
9903105,8796067,5303,1856050,10652117,21.10
9903106,9989686,3175,1111250,11100936,11.12
9903107,723543,118,41300,764843,5.71
9903108,9968156,2808,982800,10950956,9.86
9903109,9968758,4671,1634850,11603608,16.40
9903110,9988189,1822,637700,10625889,6.38
9903111,9994858,4863,1702050,11696908,17.03
9903112,9958043,1685,589750,10547793,5.92
9903113,9979421,4473,1565550,11544971,15.69
9903114,3603820,1259,440650,4044470,12.23
9903115,9980695,3486,1220100,11200795,12.22
9903116,9995716,3362,1176700,11172416,11.77
9903117,9992656,4127,1444450,11437106,14.46
9903118,3255665,1255,439250,3694915,13.49
9903119,9980629,3943,1380050,11360679,13.83
9903120,9999534,6395,2238250,12237784,22.38
9903121,7203517,2526,884100,8087617,12.27
9903122,9962690,4313,1509550,11472240,15.15
9903123,9976546,4291,1501850,11478396,15.05
9903124,9960269,3857,1349950,11310219,13.55
9903125,9971571,4589,1606150,11577721,16.11
9903126,9987649,4361,1526350,11513999,15.28
9903127,9968610,3261,1141350,11109960,11.45
9903128,9976447,2593,907550,10883997,9.10
9903130,9983762,3689,1291150,11274912,12.93
9903131,9984937,4102,1435700,11420637,14.38
9903132,9990510,3428,1199800,11190310,12.01
9903133,9983826,3115,1090250,11074076,10.92
9903134,9993522,2304,806400,10799922,8.07
9903135,9983304,2535,887250,10870554,8.89
9903136,9980412,1234,431900,10412312,4.33
9903137,9978974,3236,1132600,11111574,11.35
9903138,9987062,3628,1269800,11256862,12.71
9903139,9992341,4206,1472100,11464441,14.73
9903140,9984819,2706,947100,10931919,9.49
9903141,9988461,4147,1451450,11439911,14.53
9903142,9973249,3900,1365000,11338249,13.69
9903143,2547263,927,324450,2871713,12.74
9903144,9963117,3389,1186150,11149267,11.91
9903145,9963581,4181,1463350,11426931,14.69
9903146,9965991,4059,1420650,11386641,14.25
9903147,9988731,3806,1332100,11320831,13.34
9903148,9984913,3346,1171100,11156013,11.73
9903149,9987480,3252,1138200,11125680,11.40
9903150,9991107,2644,925400,10916507,9.26
9903151,9988428,3638,1273300,11261728,12.75
9903152,9982354,1771,619850,10602204,6.21
9903153,9985927,3524,1233400,11219327,12.35
9903154,9976032,4731,1655850,11631882,16.60
9903155,9969667,3468,1213800,11183467,12.17
9903156,9972711,4542,1589700,11562411,15.94
9903157,1653929,828,289800,1943729,17.52
9903158,5848946,1814,634900,6483846,10.85
9903159,9976201,2342,819700,10795901,8.22
9903160,1317786,461,161350,1479136,12.24
9903161,9981821,1818,636300,10618121,6.37
9903162,9974979,4846,1696100,11671079,17.00
9903163,9987172,3143,1100050,11087222,11.01
9903164,9983069,4386,1535100,11518169,15.38
9903165,9985083,4979,1742650,11727733,17.45
9903166,9994027,3395,1188250,11182277,11.89
9903167,9996695,5622,1967700,11964395,19.68
9903168,9970443,4703,1646050,11616493,16.51
9903169,9984037,4219,1476650,11460687,14.79
9903170,9947125,5398,1889300,11836425,18.99
9903171,9987394,4607,1612450,11599844,16.14
9903172,9992624,3770,1319500,11312124,13.20
9903173,9994557,5800,2030000,12024557,20.31
9903174,485787,260,91000,576787,18.73
9903175,9974987,4780,1673000,11647987,16.77
9903176,4114796,2135,747250,4862046,18.16
9903177,9999257,2674,935900,10935157,9.36
9903178,2454635,923,323050,2777685,13.16
9903179,9965997,8754,3063900,13029897,30.74
9903180,9975627,3970,1389500,11365127,13.93
9903181,609115,295,103250,712365,16.95
9903182,9973260,2764,967400,10940660,9.70
9903183,6832897,2971,1039850,7872747,15.22
9903184,9969522,3994,1397900,11367422,14.02
9903185,9977338,1273,445550,10422888,4.47
9903186,9998840,3465,1212750,11211590,12.13
9903187,9994269,3246,1136100,11130369,11.37
9903188,9990171,5227,1829450,11819621,18.31
9903189,9990554,4464,1562400,11552954,15.64
9903190,9969239,3000,1050000,11019239,10.53
9903191,6125068,2526,884100,7009168,14.43
9903192,9960995,2664,932400,10893395,9.36
9903193,9942293,5305,1856750,11799043,18.68
9903194,9561517,4376,1531600,11093117,16.02
9903195,9954960,5805,2031750,11986710,20.41
9903196,9974584,3061,1071350,11045934,10.74
9903197,9978912,4197,1468950,11447862,14.72
9903198,6341922,3161,1106350,7448272,17.45
9903199,6528470,3533,1236550,7765020,18.94
9903200,9994152,6380,2233000,12227152,22.34
9903201,9969703,2925,1023750,10993453,10.27
9903202,9980902,872,305200,10286102,3.06
9903203,9976690,1836,642600,10619290,6.44
9903204,9985675,2918,1021300,11006975,10.23
9903205,9975216,6129,2145150,12120366,21.50
9903206,9998126,5533,1936550,11934676,19.37
9903207,9987245,5021,1757350,11744595,17.60
9903208,9991239,2951,1032850,11024089,10.34
9903209,9999631,4081,1428350,11427981,14.28
9903210,9983042,4107,1437450,11420492,14.40
9903211,9976913,3326,1164100,11141013,11.67
9903212,9973700,5347,1871450,11845150,18.76
9903213,9984494,4131,1445850,11430344,14.48
9903214,9978550,4093,1432550,11411100,14.36
9903215,5376237,350,122500,5498737,2.28
9903216,9972593,4384,1534400,11506993,15.39
9903217,9973985,2681,938350,10912335,9.41
9903218,9812306,3774,1320900,11133206,13.46
9903219,9980907,6799,2379650,12360557,23.84
9903220,9973760,4370,1529500,11503260,15.34
9903221,4278122,1553,543550,4821672,12.71
9903222,9988452,3162,1106700,11095152,11.08
9903223,3006503,1506,527100,3533603,17.53
9903224,9984457,3466,1213100,11197557,12.15
9903225,9983502,7451,2607850,12591352,26.12
9903226,9992713,4673,1635550,11628263,16.37
9903228,9985263,6635,2322250,12307513,23.26
9903229,9980047,4859,1700650,11680697,17.04
9903230,9922804,4122,1442700,11365504,14.54
9903231,9962065,505,176750,10138815,1.77
9903232,9971668,2814,984900,10956568,9.88
9903233,9921016,4180,1463000,11384016,14.75
9903234,9996953,6146,2151100,12148053,21.52
9903235,9979358,3954,1383900,11363258,13.87
9903237,9984204,7051,2467850,12452054,24.72
9903238,9983088,3790,1326500,11309588,13.29
9903239,9973059,2509,878150,10851209,8.81
9903240,9967888,3605,1261750,11229638,12.66
9903241,9944030,2316,810600,10754630,8.15
9903242,9976739,5523,1933050,11909789,19.38
9903243,9977299,4352,1523200,11500499,15.27
9903244,9989228,4221,1477350,11466578,14.79
9903245,9971500,3260,1141000,11112500,11.44
9903246,9987325,5781,2023350,12010675,20.26
9903247,9993711,6075,2126250,12119961,21.28
9903248,9989585,4910,1718500,11708085,17.20
9903249,9990161,3264,1142400,11132561,11.44
9903250,9981081,3892,1362200,11343281,13.65
9903251,9983143,4691,1641850,11624993,16.45
9903252,9999185,2253,788550,10787735,7.89
9903253,9972241,5060,1771000,11743241,17.76
9903254,9966758,2142,749700,10716458,7.52
9903255,9988746,4330,1515500,11504246,15.17
9903256,9977397,4641,1624350,11601747,16.28
9903257,9989591,4643,1625050,11614641,16.27
9903258,9975425,5689,1991150,11966575,19.96
9903259,9983698,2760,966000,10949698,9.68
9903260,9989681,3361,1176350,11166031,11.78
9903261,9973790,3224,1128400,11102190,11.31
9903262,9982230,4509,1578150,11560380,15.81
9903263,9975275,3952,1383200,11358475,13.87
9903264,9969474,6633,2321550,12291024,23.29
9903265,9990802,4351,1522850,11513652,15.24
9903266,9978120,3570,1249500,11227620,12.52
9903268,9975329,4131,1445850,11421179,14.49
9903269,9958922,4936,1727600,11686522,17.35
9903270,9957728,3771,1319850,11277578,13.25
9903271,9964330,2738,958300,10922630,9.62
9903272,9947827,4538,1588300,11536127,15.97
9903273,9944684,2701,945350,10890034,9.51
9903275,9946695,3672,1285200,11231895,12.92
9903276,9961621,4645,1625750,11587371,16.32
9903277,4778128,3017,1055950,5834078,22.10
9903278,9978674,6635,2322250,12300924,23.27
9903279,9960783,6747,2361450,12322233,23.71
9903280,9975555,4074,1425900,11401455,14.29
9903281,9986589,3960,1386000,11372589,13.88
9903283,9973653,2581,903350,10877003,9.06
9903284,9971010,5316,1860600,11831610,18.66
9903285,9994100,4683,1639050,11633150,16.40
9903286,9986960,2713,949550,10936510,9.51
9903287,9989782,5494,1922900,11912682,19.25
9903288,9979856,3969,1389150,11369006,13.92
9903289,9986419,4862,1701700,11688119,17.04
9903290,9972859,4656,1629600,11602459,16.34
9903291,9970104,4102,1435700,11405804,14.40
9903292,9974679,4496,1573600,11548279,15.78
9903293,6936341,3639,1273650,8209991,18.36
9903294,2381628,1358,475300,2856928,19.96
9903295,9950041,1632,571200,10521241,5.74
9903296,9970711,7106,2487100,12457811,24.94
9903297,9982525,3807,1332450,11314975,13.35
9903298,9988449,4120,1442000,11430449,14.44
9903299,9985154,3597,1258950,11244104,12.61
9903300,9981987,3588,1255800,11237787,12.58
9903301,9947232,3302,1155700,11102932,11.62
9903302,9974561,3221,1127350,11101911,11.30
9903303,9997458,3202,1120700,11118158,11.21
9903304,9970027,5970,2089500,12059527,20.96
9903305,9975574,4168,1458800,11434374,14.62
9903307,9984609,4075,1426250,11410859,14.28
9903308,9991199,7525,2633750,12624949,26.36
9903309,9982249,3347,1171450,11153699,11.74
9903310,9955554,3877,1356950,11312504,13.63
9903311,8980652,5305,1856750,10837402,20.68
9903312,8998678,4120,1442000,10440678,16.02
9903313,9980967,4093,1432550,11413517,14.35
9903314,9974315,4026,1409100,11383415,14.13
9903315,9987389,3547,1241450,11228839,12.43
9903316,9985714,6483,2269050,12254764,22.72
9903317,9983184,6383,2234050,12217234,22.38
9903318,9981375,4369,1529150,11510525,15.32
9903319,9958077,5711,1998850,11956927,20.07
9903320,9960080,5001,1750350,11710430,17.57
9903321,9951462,5585,1954750,11906212,19.64
9903322,9966022,5285,1849750,11815772,18.56
9903323,9968590,4087,1430450,11399040,14.35
9903324,9971061,5137,1797950,11769011,18.03
9903325,9962596,6649,2327150,12289746,23.36
9903326,9979697,6351,2222850,12202547,22.27
9903327,9960864,5308,1857800,11818664,18.65
9903328,9959712,3494,1222900,11182612,12.28
9903329,9954291,7330,2565500,12519791,25.77
9903330,9962460,5742,2009700,11972160,20.17
9903331,4445796,2111,738850,5184646,16.62
9903332,5763136,3916,1370600,7133736,23.78
9903333,9977439,3743,1310050,11287489,13.13
9903334,9988768,6396,2238600,12227368,22.41
9903335,9993134,4263,1492050,11485184,14.93
9903336,9975275,2947,1031450,11006725,10.34
9903337,9996324,4460,1561000,11557324,15.62
9903338,1556296,278,97300,1653596,6.25
9903339,9983815,5630,1970500,11954315,19.74
9903340,9993181,4515,1580250,11573431,15.81
9903341,9996287,3946,1381100,11377387,13.82
9903342,9985729,2197,768950,10754679,7.70
9903343,9979128,3339,1168650,11147778,11.71
9903344,9984369,1331,465850,10450219,4.67
9903346,9980913,514,179900,10160813,1.80
9903347,9971135,3744,1310400,11281535,13.14
9903348,9978340,5373,1880550,11858890,18.85
9903349,9976676,5177,1811950,11788626,18.16
9903350,9966550,5448,1906800,11873350,19.13
9903351,9907946,6243,2185050,12092996,22.05
9903352,9987381,4603,1611050,11598431,16.13
9903353,9979051,3837,1342950,11322001,13.46
9903354,9969318,5522,1932700,11902018,19.39
9903355,9968340,3865,1352750,11321090,13.57
9903356,9953859,3420,1197000,11150859,12.03
9903357,9688316,5312,1859200,11547516,19.19
9903358,9975031,5154,1803900,11778931,18.08
9903359,9980225,3478,1217300,11197525,12.20
9903360,930988,484,169400,1100388,18.20
9903361,9986572,3057,1069950,11056522,10.71
9903363,9980550,2973,1040550,11021100,10.43
9903364,9984940,2504,876400,10861340,8.78
9903365,9964693,4835,1692250,11656943,16.98
9903366,9981535,3591,1256850,11238385,12.59
9903367,9975818,4732,1656200,11632018,16.60
9903368,9997898,5738,2008300,12006198,20.09
9903369,9981652,7087,2480450,12462102,24.85
9903370,9998066,6675,2336250,12334316,23.37
9903371,9981196,2913,1019550,11000746,10.21
9903372,9993049,3438,1203300,11196349,12.04
9903373,9722337,4522,1582700,11305037,16.28
9903374,9989986,4582,1603700,11593686,16.05
9903375,9980634,6129,2145150,12125784,21.49
9903376,9992606,3533,1236550,11229156,12.37
9903377,9977694,3862,1351700,11329394,13.55
9903378,9969306,4343,1520050,11489356,15.25
9903380,9984002,4105,1436750,11420752,14.39
9903381,9971188,4165,1457750,11428938,14.62
9903382,9967171,3777,1321950,11289121,13.26
9903383,9964565,6748,2361800,12326365,23.70
9903384,9892971,4775,1671250,11564221,16.89
9903385,9902186,1380,483000,10385186,4.88
9903386,9995264,6740,2359000,12354264,23.60
9903387,9969566,5597,1958950,11928516,19.65
9903388,9981705,5024,1758400,11740105,17.62
9903389,9957922,5178,1812300,11770222,18.20
9903390,9961982,946,331100,10293082,3.32
9903391,4312124,1799,629650,4941774,14.60
9903392,2730736,2383,834050,3564786,30.54
9903393,9970171,2822,987700,10957871,9.91
9903394,9974062,5537,1937950,11912012,19.43
9903395,9979999,5513,1929550,11909549,19.33
9903396,9968259,4712,1649200,11617459,16.54
9903397,9971671,3398,1189300,11160971,11.93
9903398,9960852,4925,1723750,11684602,17.31
9903399,9974231,1076,376600,10350831,3.78
9903400,9957978,3507,1227450,11185428,12.33
9903401,9971244,2903,1016050,10987294,10.19
9903402,9591646,1415,495250,10086896,5.16
9903403,9969478,4596,1608600,11578078,16.14
9903404,9981714,5065,1772750,11754464,17.76
9903405,9995864,3661,1281350,11277214,12.82
9903406,9987077,5501,1925350,11912427,19.28
9903407,9962543,6096,2133600,12096143,21.42
9903409,9988314,4539,1588650,11576964,15.91
9903410,9984407,2579,902650,10887057,9.04
9903411,9983902,6144,2150400,12134302,21.54
9903412,9969805,3681,1288350,11258155,12.92
9903413,8965615,4390,1536500,10502115,17.14
9903414,9998147,2522,882700,10880847,8.83
9903415,9984541,5582,1953700,11938241,19.57
9903416,9964167,5657,1979950,11944117,19.87
9903417,9985417,4980,1743000,11728417,17.46
9903418,9986837,2506,877100,10863937,8.78
9903419,9999251,3289,1151150,11150401,11.51
9903420,9507193,4675,1636250,11143443,17.21
9903421,9972392,4246,1486100,11458492,14.90
9903422,9981997,5373,1880550,11862547,18.84
9903423,9983746,6332,2216200,12199946,22.20
9903424,9975719,2992,1047200,11022919,10.50
9903425,9984248,5584,1954400,11938648,19.57
9903426,9976830,4024,1408400,11385230,14.12
9903427,9974523,6045,2115750,12090273,21.21
9903428,9976415,5325,1863750,11840165,18.68
9903429,9960499,2849,997150,10957649,10.01
9903430,9976706,602,210700,10187406,2.11
9903431,9987350,2802,980700,10968050,9.82
9903432,9981257,4929,1725150,11706407,17.28
9903433,9999724,5880,2058000,12057724,20.58
9903434,9984399,1732,606200,10590599,6.07
9903435,4180905,3380,1183000,5363905,28.30
9903436,9962318,4552,1593200,11555518,15.99
9903437,9994485,4459,1560650,11555135,15.62
9903438,9974008,3473,1215550,11189558,12.19
9903439,9969583,4085,1429750,11399333,14.34
9903440,9993755,4490,1571500,11565255,15.72
9903441,9982865,3901,1365350,11348215,13.68
9903442,4511980,2733,956550,5468530,21.20
9903443,9985132,6384,2234400,12219532,22.38
9903444,9982675,2730,955500,10938175,9.57
9903445,9959219,5994,2097900,12057119,21.06
9903446,9992403,3103,1086050,11078453,10.87
9903447,9959939,5485,1919750,11879689,19.27
9903448,9987047,2616,915600,10902647,9.17
9903449,9986086,3938,1378300,11364386,13.80
9903450,9966418,4811,1683850,11650268,16.90
9903451,9981187,3968,1388800,11369987,13.91
9903453,9974882,1888,660800,10635682,6.62
9903455,9981875,6122,2142700,12124575,21.47
9903456,9976465,5021,1757350,11733815,17.61
9903457,9965379,3578,1252300,11217679,12.57
9903458,9952804,3521,1232350,11185154,12.38
9903459,9953130,4891,1711850,11664980,17.20
9903460,9943937,4333,1516550,11460487,15.25
9903461,9246415,3387,1185450,10431865,12.82
9903462,9968908,3599,1259650,11228558,12.64
9903464,9967700,6204,2171400,12139100,21.78
9903465,1843034,977,341950,2184984,18.55
9903467,9940469,3946,1381100,11321569,13.89
9903468,502110,192,67200,569310,13.38
9903469,6458278,2201,770350,7228628,11.93
9903470,9947863,3438,1203300,11151163,12.10
9903471,9973047,4419,1546650,11519697,15.51
9903472,9980493,2360,826000,10806493,8.28
9903473,9979068,5731,2005850,11984918,20.10
9903474,9962725,7242,2534700,12497425,25.44
9903475,9970434,3981,1393350,11363784,13.97
9903476,9966682,1650,577500,10544182,5.79
9903477,9972519,3090,1081500,11054019,10.84
9903478,9974527,7826,2739100,12713627,27.46
9903479,9990887,3997,1398950,11389837,14.00
9903480,9996963,4973,1740550,11737513,17.41
9903481,9982936,836,292600,10275536,2.93
9903482,3403295,1284,449400,3852695,13.20
9903483,9061607,5230,1830500,10892107,20.20
9903484,9984141,5645,1975750,11959891,19.79
9903485,9982333,3805,1331750,11314083,13.34
9903486,9993488,1831,640850,10634338,6.41
9903487,9986365,4439,1553650,11540015,15.56
9903488,9971995,4243,1485050,11457045,14.89
9903489,2594383,677,236950,2831333,9.13
9903490,9954270,4495,1573250,11527520,15.80
9903491,9947477,7130,2495500,12442977,25.09
9903492,9922322,4347,1521450,11443772,15.33
9903493,9942890,2720,952000,10894890,9.57
9903494,9901870,4429,1550150,11452020,15.66
9903495,9934656,5427,1899450,11834106,19.12
9903496,9935618,5256,1839600,11775218,18.52
9903497,9926650,4793,1677550,11604200,16.90
9903498,9957286,5403,1891050,11848336,18.99
9903499,9945707,3842,1344700,11290407,13.52
9903500,9920155,3534,1236900,11157055,12.47
9903501,9930001,2691,941850,10871851,9.48
9903502,9940053,4586,1605100,11545153,16.15
9903503,9915951,3050,1067500,10983451,10.77
9903504,9931233,4636,1622600,11553833,16.34
9903505,9915409,3589,1256150,11171559,12.67
9903506,9915356,3711,1298850,11214206,13.10
9903507,9932600,4035,1412250,11344850,14.22
9903508,9932505,3461,1211350,11143855,12.20
9903509,9917346,5197,1818950,11736296,18.34
9903510,9908340,6604,2311400,12219740,23.33
9903511,9930718,3281,1148350,11079068,11.56
9903512,9924005,4461,1561350,11485355,15.73
9903513,9914175,5461,1911350,11825525,19.28
9903514,9924008,4442,1554700,11478708,15.67
9903515,9933131,5858,2050300,11983431,20.64
9903516,9919614,6293,2202550,12122164,22.20
9903517,9940124,4021,1407350,11347474,14.16
9903518,9928222,4658,1630300,11558522,16.42
9903519,9920625,3909,1368150,11288775,13.79
9903520,9906219,5311,1858850,11765069,18.76
9903521,6866648,4542,1589700,8456348,23.15
9903522,9932115,4132,1446200,11378315,14.56
9903523,9923997,4537,1587950,11511947,16.00
9903524,9890110,4786,1675100,11565210,16.94
9903525,9927044,4941,1729350,11656394,17.42
9903526,9914361,3508,1227800,11142161,12.38
9903527,9921204,4840,1694000,11615204,17.07
9903528,9851115,4149,1452150,11303265,14.74
9903529,9924960,5412,1894200,11819160,19.09
9903530,9771784,2690,941500,10713284,9.63
9903531,84129,79,27650,111779,32.87
9903532,9934563,3654,1278900,11213463,12.87
9903533,9937495,5830,2040500,11977995,20.53
9903534,9941980,5084,1779400,11721380,17.90
9903535,9929732,2422,847700,10777432,8.54
9903537,9935270,5927,2074450,12009720,20.88
9903538,9912905,2576,901600,10814505,9.10
9903539,9934449,3087,1080450,11014899,10.88
9903540,9926715,2682,938700,10865415,9.46
9903541,9941071,6273,2195550,12136621,22.09
9903542,9939380,2395,838250,10777630,8.43
9903543,9911728,4676,1636600,11548328,16.51
9903544,9945658,4533,1586550,11532208,15.95
9903545,9944165,4143,1450050,11394215,14.58
9903546,9944741,4803,1681050,11625791,16.90
9903547,9357838,4066,1423100,10780938,15.21
9903548,9965841,6437,2252950,12218791,22.61
9903549,9945149,5393,1887550,11832699,18.98
9903550,9962100,2978,1042300,11004400,10.46
9903551,9961812,5481,1918350,11880162,19.26
9903552,9966501,3932,1376200,11342701,13.81
9903553,9970432,7283,2549050,12519482,25.57
9903554,9969712,2173,760550,10730262,7.63
9903555,9211521,3243,1135050,10346571,12.32
9903556,9985707,3391,1186850,11172557,11.89
9903557,9979434,3930,1375500,11354934,13.78
9903558,9973056,3820,1337000,11310056,13.41
9903559,9974335,1731,605850,10580185,6.07
9903560,9971348,3571,1249850,11221198,12.53
9903561,9998514,4663,1632050,11630564,16.32
9903562,9973644,5614,1964900,11938544,19.70
9903563,9966023,3436,1202600,11168623,12.07
9903564,9976907,4536,1587600,11564507,15.91
9903565,9990123,6906,2417100,12407223,24.19
9903566,9988221,5759,2015650,12003871,20.18
9903567,9977199,2178,762300,10739499,7.64
9903568,9981871,5220,1827000,11808871,18.30
9903569,6279310,1994,697900,6977210,11.11
9903570,9969769,4968,1738800,11708569,17.44
9903571,9973716,4178,1462300,11436016,14.66
9903572,9980993,2837,992950,10973943,9.95
9903573,870753,396,138600,1009353,15.92
9903574,9970609,3321,1162350,11132959,11.66
9903575,2022492,1708,597800,2620292,29.56
9903576,9953793,4589,1606150,11559943,16.14
9903577,9962453,3934,1376900,11339353,13.82
9903578,9447828,6272,2195200,11643028,23.23
9903579,9973120,4755,1664250,11637370,16.69
9903580,9687833,3688,1290800,10978633,13.32
9903581,9994949,1566,548100,10543049,5.48
9903582,431792,172,60200,491992,13.94
9903583,9996677,3688,1290800,11287477,12.91
9903584,9985606,6013,2104550,12090156,21.08
9903585,5435533,1832,641200,6076733,11.80
9903586,9993412,3763,1317050,11310462,13.18
9903587,9995118,6840,2394000,12389118,23.95
9903588,9989552,3847,1346450,11336002,13.48
9903589,9989538,3620,1267000,11256538,12.68
9903590,9974458,3557,1244950,11219408,12.48
9903591,9982225,3335,1167250,11149475,11.69
9903592,9953350,5843,2045050,11998400,20.55
9903593,9981492,4960,1736000,11717492,17.39
9903594,4826677,792,277200,5103877,5.74
9903595,9971864,3681,1288350,11260214,12.92
9903596,3527496,831,290850,3818346,8.25
9903597,5189751,2280,798000,5987751,15.38
9903598,9996505,3806,1332100,11328605,13.33
9903599,9997613,5091,1781850,11779463,17.82
9903600,9842529,3048,1066800,10909329,10.84
9903601,9990032,5689,1991150,11981182,19.93
9903602,9896791,3481,1218350,11115141,12.31
9903603,9963212,2740,959000,10922212,9.63
9903604,2228190,1115,390250,2618440,17.51
9903605,2767387,465,162750,2930137,5.88
9903606,9976778,2988,1045800,11022578,10.48
9903607,9970389,2853,998550,10968939,10.02
9903608,9951302,3254,1138900,11090202,11.44
9903609,9958109,2764,967400,10925509,9.71
9903610,9957029,3888,1360800,11317829,13.67
9903611,9946678,1230,430500,10377178,4.33
9903612,9941093,3444,1205400,11146493,12.13
9903613,4877548,2047,716450,5593998,14.69
9903614,9962070,5305,1856750,11818820,18.64
9903615,9844939,3838,1343300,11188239,13.64
9903616,9960076,4184,1464400,11424476,14.70
9903617,9970099,3790,1326500,11296599,13.30
9903618,9968524,4527,1584450,11552974,15.89
9903619,9975560,3766,1318100,11293660,13.21
9903620,9986315,5438,1903300,11889615,19.06
9903621,9966952,3902,1365700,11332652,13.70
9903622,9996604,5467,1913450,11910054,19.14
9903623,9980225,3146,1101100,11081325,11.03
9903624,9980519,2890,1011500,10992019,10.13
9903625,9989943,4777,1671950,11661893,16.74
9903626,9987643,2500,875000,10862643,8.76
9903627,9971333,3529,1235150,11206483,12.39
9903628,9967743,4409,1543150,11510893,15.48
9903629,9604182,3747,1311450,10915632,13.65
9903630,9974389,5542,1939700,11914089,19.45
9903631,9201015,2072,725200,9926215,7.88
9903632,9940811,2859,1000650,10941461,10.07
9903633,9949236,4167,1458450,11407686,14.66
9903634,9944569,1741,609350,10553919,6.13
9903635,9951187,6050,2117500,12068687,21.28
9903636,9959359,1286,450100,10409459,4.52
9903637,9953294,4096,1433600,11386894,14.40
9903638,9960683,4760,1666000,11626683,16.73
9903639,9958473,4469,1564150,11522623,15.71
9903640,9964907,4270,1494500,11459407,15.00
9903641,9962768,6611,2313850,12276618,23.22
9903642,9967253,3327,1164450,11131703,11.68
9903643,9962425,4497,1573950,11536375,15.80
9903644,9964316,2001,700350,10664666,7.03
9903645,9971202,2849,997150,10968352,10.00
9903646,9986557,3913,1369550,11356107,13.71
9903647,9992019,2253,788550,10780569,7.89
9903648,9991868,4252,1488200,11480068,14.89
9903649,5810769,1377,481950,6292719,8.29
9903650,3728407,2550,892500,4620907,23.94
9903651,9957789,4158,1455300,11413089,14.61
9903652,9955059,3957,1384950,11340009,13.91
9903653,9951776,3003,1051050,11002826,10.56
9903654,9942030,5034,1761900,11703930,17.72
9903655,9959276,3147,1101450,11060726,11.06
9903656,1972284,619,216650,2188934,10.98
9903657,9726305,3887,1360450,11086755,13.99
9903658,9953887,4772,1670200,11624087,16.78
9903659,9732769,1544,540400,10273169,5.55
9903660,9967142,3171,1109850,11076992,11.14
9903661,9976501,4732,1656200,11632701,16.60
9903662,9979807,6572,2300200,12280007,23.05
9903663,9969854,5538,1938300,11908154,19.44
9903664,9951186,5000,1750000,11701186,17.59
9903665,9937006,5110,1788500,11725506,18.00
9903666,9937892,3045,1065750,11003642,10.72
9903667,9954907,4435,1552250,11507157,15.59
9903668,1394280,483,169050,1563330,12.12
9903669,9934670,3982,1393700,11328370,14.03
9903670,541429,505,176750,718179,32.65
9903671,9888322,3000,1050000,10938322,10.62
9903672,9927437,4093,1432550,11359987,14.43
9903673,9944578,3478,1217300,11161878,12.24
9903674,9928379,3763,1317050,11245429,13.27
9903675,9861169,6245,2185750,12046919,22.17
9903676,9962907,2307,807450,10770357,8.10
9903677,9970820,3701,1295350,11266170,12.99
